Date,Description,Deposits,Withdrawls,Balance,Category
20-Aug-20,Cheque,"5,82,827.75",0,"6,09,730.09",Food
20-Aug-20,Interest,00.00,"76,216.26","5,33,513.83",Food
20-Aug-20,Cheque,00.00,"1,77,837.94","3,55,675.89",Food
20-Aug-20,Tax,00.00,"50,810.84","3,04,865.05",Food
20-Aug-20,Debit Card,"2,60,428.00",00.00,"5,65,293.05",Food
20-Aug-20,Interest,"10,289.95",00.00,"5,75,583.00",Food
20-Aug-20,ATM,00.00,"5,75,583.00",00.00,Food
20-Aug-20,Commission,02.00,00.00,02.00,Food
20-Aug-20,RTGS,"2,59,250.00",00.00,"2,59,252.00",Food
20-Aug-20,RTGS,"15,87,927.50",00.00,"18,47,179.50",Food
20-Aug-20,Reversal,03.00,00.00,"18,47,182.50",Food
20-Aug-20,ATM,"7,39,105.00",00.00,"25,86,287.50",Food
20-Aug-20,Tax,00.00,"4,31,047.92","21,55,239.58",Food
20-Aug-20,Purchase,"4,58,962.50",00.00,"26,14,202.08",Food
20-Aug-20,RTGS,"31,544.40",00.00,"26,45,746.48",Food
20-Aug-20,Cheque,00.00,"26,45,746.48",00.00,Food
20-Aug-20,IMPS,21.6,00.00,21.6,Food
20-Aug-20,Purchase,"1,33,742.00",00.00,"1,33,763.60",Food
20-Aug-20,NEFT,00.00,"14,862.62","1,18,900.98",Food
20-Aug-20,Tax,02.80,00.00,"1,18,903.78",Food
20-Aug-20,Commission,"1,55,885.00",00.00,"2,74,788.78",Food
20-Aug-20,Purchase,184.23,00.00,"2,74,973.01",Food
20-Aug-20,Transportellaneous,00.00,"54,994.60","2,19,978.41",Food
20-Aug-20,Debit Card,380.93,00.00,"2,20,359.34",Food
21-Aug-20,Cash,00.00,"31,479.91","1,88,879.43",Food
21-Aug-20,Cash,00.00,"47,219.86","1,41,659.57",Food
21-Aug-20,Reversal,00.00,"47,219.86","94,439.71",Food
21-Aug-20,Tax,00.00,"13,491.39","80,948.32",Food
21-Aug-20,Transfer,35.89,00.00,"80,984.21",Food
21-Aug-20,Bill,47,00.00,"81,031.21",Food
21-Aug-20,Reversal,00.00,"13,505.20","67,526.01",Food
21-Aug-20,IMPS,00.00,"67,526.01",00.00,Food
21-Aug-20,Bill,"29,903.10",00.00,"29,903.10",Food
21-Aug-20,Purchase,"22,292.40",00.00,"52,195.50",Food
21-Aug-20,Purchase,"8,36,681.00",00.00,"8,88,876.50",Food
21-Aug-20,Cheque,"12,62,915.00",00.00,"21,51,791.50",Food
21-Aug-20,Reversal,00.00,"2,15,179.15","19,36,612.35",Transport
21-Aug-20,Transportellaneous,11.3,00.00,"19,36,623.65",Transport
21-Aug-20,Interest,"22,367.00",00.00,"19,58,990.65",Transport
21-Aug-20,Cheque,00.00,"2,44,873.83","17,14,116.82",Transport
21-Aug-20,IMPS,00.00,"3,42,823.36","13,71,293.46",Transport
21-Aug-20,Tax,01.60,00.00,"13,71,295.06",Transport
21-Aug-20,NEFT,"63,677.91",00.00,"14,34,972.97",Transport
21-Aug-20,Cheque,00.00,"2,04,996.14","12,29,976.83",Transport
21-Aug-20,NEFT,00.00,"1,75,710.98","10,54,265.85",Transport
21-Aug-20,Transfer,"9,002.50",00.00,"10,63,268.35",Transport
21-Aug-20,Debit Card,00.00,"1,77,211.39","8,86,056.96",Transport
21-Aug-20,Cheque,"2,98,564.00",00.00,"11,84,620.96",Transport
21-Aug-20,Transfer,00.00,"1,97,436.83","9,87,184.13",Transport
21-Aug-20,Transfer,00.00,"1,97,436.83","7,89,747.30",Transport
21-Aug-20,Cash,00.00,"7,89,747.30",00.00,Transport
21-Aug-20,Reversal,"1,94,534.00",00.00,"1,94,534.00",Transport
21-Aug-20,IMPS,00.00,"24,316.75","1,70,217.25",Transport
21-Aug-20,IMPS,09.25,00.00,"1,70,226.50",Transport
21-Aug-20,Debit Card,00.00,"17,022.65","1,53,203.85",Transport
21-Aug-20,IMPS,00.00,"21,886.26","1,31,317.59",Transport
21-Aug-20,IMPS,00.00,"65,658.80","65,658.80",Transport
21-Aug-20,Tax,36.12,00.00,"65,694.92",Transport
21-Aug-20,RTGS,"93,975.00",00.00,"1,59,669.92",Transport
21-Aug-20,ATM,00.00,"19,958.74","1,39,711.18",Transport
21-Aug-20,Purchase,"10,70,024.75",00.00,"12,09,735.93",Transport
21-Aug-20,Transportellaneous,00.00,"1,51,216.99","10,58,518.94",Transport
21-Aug-20,Reversal,00.00,"10,58,518.94",00.00,Transport
21-Aug-20,Debit Card,"2,09,014.00",00.00,"2,09,014.00",Transport
21-Aug-20,RTGS,00.00,"20,901.40","1,88,112.60",Transport
21-Aug-20,NEFT,"4,258.00",00.00,"1,92,370.60",Transport
21-Aug-20,RTGS,00.00,"19,237.06","1,73,133.54",Transport
21-Aug-20,Commission,00.00,"86,566.77","86,566.77",Transport
21-Aug-20,Cash,263.7,00.00,"86,830.47",Transport
21-Aug-20,Transfer,"1,49,670.00",00.00,"2,36,500.47",Transport
21-Aug-20,Commission,00.00,"78,833.49","1,57,666.98",Transport
21-Aug-20,Transportellaneous,00.00,"22,523.85","1,35,143.13",Transport
21-Aug-20,Bill,02.83,00.00,"1,35,145.96",Transport
21-Aug-20,Bill,53.11,00.00,"1,35,199.07",Transport
21-Aug-20,NEFT,"1,85,008.90",00.00,"3,20,207.97",Transport
21-Aug-20,Reversal,139,00.00,"3,20,346.97",Transport
21-Aug-20,Transportellaneous,04.80,00.00,"3,20,351.77",Transport
21-Aug-20,Transportellaneous,00.00,"80,087.94","2,40,263.83",Transport
21-Aug-20,Bill,15.12,00.00,"2,40,278.95",Transport
21-Aug-20,Cash,00.00,"60,069.74","1,80,209.21",Transport
21-Aug-20,NEFT,347,00.00,"1,80,556.21",Transport
21-Aug-20,Interest,"21,316.46",00.00,"2,01,872.67",Transport
21-Aug-20,IMPS,01.70,00.00,"2,01,874.37",Transport
21-Aug-20,Interest,00.44,00.00,"2,01,874.81",Transport
21-Aug-20,Debit Card,07.00,00.00,"2,01,881.81",Transport
21-Aug-20,IMPS,00.00,"1,00,940.91","1,00,940.90",Transport
21-Aug-20,NEFT,06.44,00.00,"1,00,947.34",Transport
21-Aug-20,Purchase,00.00,"33,649.11","67,298.23",Transport
21-Aug-20,ATM,00.00,"9,614.03","57,684.20",Transport
21-Aug-20,Transportellaneous,02.60,00.00,"57,686.80",Transport
21-Aug-20,Debit Card,00.00,"14,421.70","43,265.10",Transport
21-Aug-20,Cheque,00.00,"7,210.85","36,054.25",Transport
21-Aug-20,Purchase,36,00.00,"36,090.25",Transport
21-Aug-20,ATM,208.61,00.00,"36,298.86",Transport
21-Aug-20,Transportellaneous,00.00,"18,149.43","18,149.43",Transport
21-Aug-20,Tax,00.00,"18,149.43",00.00,Transport
21-Aug-20,Cash,"8,487.81",00.00,"8,487.81",Transport
21-Aug-20,Interest,06.61,00.00,"8,494.42",Transport
21-Aug-20,Bill,33,00.00,"8,527.42",Transport
21-Aug-20,Purchase,"29,988.00",00.00,"38,515.42",Transport
21-Aug-20,Tax,21.1,00.00,"38,536.52",Transport
21-Aug-20,Tax,"23,286.10",00.00,"61,822.62",Transport
21-Aug-20,Debit Card,00.00,"10,303.77","51,518.85",Transport
21-Aug-20,Debit Card,347.7,00.00,"51,866.55",Transport
21-Aug-20,Debit Card,00.00,"7,409.51","44,457.04",Transport
21-Aug-20,Transportellaneous,00.00,"11,114.26","33,342.78",Transport
21-Aug-20,Tax,00.00,"6,668.56","26,674.22",Transport
21-Aug-20,RTGS,00.00,"2,963.80","23,710.42",Transport
21-Aug-20,Cash,00.00,"2,371.04","21,339.38",Transport
21-Aug-20,Debit Card,466,00.00,"21,805.38",Transport
21-Aug-20,Purchase,00.00,"2,422.82","19,382.56",Transport
21-Aug-20,Commission,"6,55,348.00",00.00,"6,74,730.56",Transport
21-Aug-20,Transfer,167,00.00,"6,74,897.56",Transport
21-Aug-20,Bill,00.00,"1,12,482.93","5,62,414.63",Transport
21-Aug-20,Reversal,00.00,"1,12,482.93","4,49,931.70",Transport
21-Aug-20,Cheque,00.00,"4,49,931.70",00.00,Transport
21-Aug-20,Transfer,04.60,00.00,04.60,Transport
21-Aug-20,IMPS,456.34,00.00,460.94,Transport
21-Aug-20,Cheque,00.00,57.62,403.32,Transport
22-Aug-20,Purchase,00.00,100.83,302.49,Transport
22-Aug-20,Bill,"19,81,317.80",00.00,"19,81,620.29",Transport
22-Aug-20,Transfer,453,00.00,"19,82,073.29",Transport
22-Aug-20,Purchase,308,00.00,"19,82,381.29",Transport
22-Aug-20,Transfer,05.00,00.00,"19,82,386.29",Transport
22-Aug-20,Interest,00.00,"3,96,477.26","15,85,909.03",Transport
22-Aug-20,Cheque,05.36,00.00,"15,85,914.39",Transport
22-Aug-20,Transportellaneous,00.00,"3,17,182.88","12,68,731.51",Transport
22-Aug-20,Bill,"15,733.50",00.00,"12,84,465.01",Transport
22-Aug-20,Debit Card,00.00,"2,56,893.00","10,27,572.01",Transport
22-Aug-20,Interest,00.00,"1,71,262.00","8,56,310.01",Transport
22-Aug-20,Tax,00.00,"8,56,310.01",00.00,Transport
22-Aug-20,Cheque,06.10,00.00,06.10,Transport
22-Aug-20,NEFT,00.00,03.05,03.05,Transport
22-Aug-20,Bill,00.00,01.53,01.52,Transport
23-Aug-20,Bill,00.00,00.38,01.14,Transport
23-Aug-20,RTGS,00.00,00.16,00.98,Transport
23-Aug-20,Tax,52.57,00.00,53.55,Transport
23-Aug-20,RTGS,00.00,07.65,45.9,Transport
23-Aug-20,NEFT,18,00.00,63.9,Transport
23-Aug-20,RTGS,59.41,00.00,123.31,Transport
23-Aug-20,Purchase,297.5,00.00,420.81,Transport
23-Aug-20,IMPS,33.95,00.00,454.76,Transport
23-Aug-20,Interest,00.00,454.76,00.00,Transport
23-Aug-20,Transportellaneous,57,00.00,57,Transport
23-Aug-20,Reversal,"9,486.00",00.00,"9,543.00",Transport
23-Aug-20,IMPS,"1,90,201.70",00.00,"1,99,744.70",Transport
23-Aug-20,Interest,"3,78,589.25",00.00,"5,78,333.95",Transport
23-Aug-20,Purchase,223.79,00.00,"5,78,557.74",Transport
23-Aug-20,Bill,46.69,00.00,"5,78,604.43",Transport
23-Aug-20,Transportellaneous,00.00,"72,325.55","5,06,278.88",Transport
23-Aug-20,IMPS,00.00,"84,379.81","4,21,899.07",Transport
23-Aug-20,Transportellaneous,"24,681.00",00.00,"4,46,580.07",Transport
23-Aug-20,RTGS,46.75,00.00,"4,46,626.82",Transport
23-Aug-20,Tax,00.00,"74,437.80","3,72,189.02",Transport
23-Aug-20,Purchase,00.00,"1,86,094.51","1,86,094.51",Transport
23-Aug-20,Commission,"2,01,518.00",00.00,"3,87,612.51",Transport
23-Aug-20,Reversal,00.00,"38,761.25","3,48,851.26",Transport
23-Aug-20,IMPS,171.9,00.00,"3,49,023.16",Transport
23-Aug-20,Purchase,419.1,00.00,"3,49,442.26",Transport
23-Aug-20,Interest,00.00,"38,826.92","3,10,615.34",Transport
23-Aug-20,Cash,00.00,"77,653.84","2,32,961.50",Transport
23-Aug-20,Transportellaneous,00.00,"23,296.15","2,09,665.35",Transport
23-Aug-20,Purchase,00.00,"1,04,832.68","1,04,832.68",Transport
23-Aug-20,Debit Card,00.00,"20,966.54","83,866.14",Transport
23-Aug-20,Transfer,"3,351.42",00.00,"87,217.56",Transport
23-Aug-20,Tax,"15,99,028.00",00.00,"16,86,245.56",Transport
23-Aug-20,Reversal,21.9,00.00,"16,86,267.46",Transport
23-Aug-20,Interest,01.30,00.00,"16,86,268.76",Transport
23-Aug-20,Transportellaneous,"1,10,661.20",00.00,"17,96,929.96",Transport
23-Aug-20,Transportellaneous,"10,582.20",00.00,"18,07,512.16",Transport
23-Aug-20,Commission,07.00,00.00,"18,07,519.16",Transport
23-Aug-20,Interest,00.00,"2,00,835.46","16,06,683.70",Transport
23-Aug-20,Transportellaneous,00.00,"8,03,341.85","8,03,341.85",Transport
23-Aug-20,IMPS,"3,806.27",00.00,"8,07,148.12",Transport
23-Aug-20,Transportellaneous,00.00,"1,00,893.52","7,06,254.60",Transport
23-Aug-20,Tax,00.00,"88,281.83","6,17,972.78",Transport
23-Aug-20,Interest,00.00,"1,54,493.20","4,63,479.58",Transport
23-Aug-20,Tax,36.45,00.00,"4,63,516.03",Transport
23-Aug-20,Tax,00.00,"51,501.78","4,12,014.25",Transport
23-Aug-20,Reversal,00.00,"4,12,014.25",00.00,Transport
23-Aug-20,Tax,20.99,00.00,20.99,Transport
23-Aug-20,Cheque,07.50,00.00,28.49,Transport
23-Aug-20,Commission,"2,34,063.00",00.00,"2,34,091.49",Transport
23-Aug-20,Tax,01.30,00.00,"2,34,092.79",Transport
23-Aug-20,IMPS,"3,159.00",00.00,"2,37,251.79",Transport
23-Aug-20,Bill,00.00,"23,725.18","2,13,526.61",Transport
23-Aug-20,Interest,31.9,00.00,"2,13,558.51",Transport
23-Aug-20,Debit Card,00.00,"23,728.72","1,89,829.79",Transport
23-Aug-20,Interest,406.8,00.00,"1,90,236.59",Transport
23-Aug-20,Interest,00.00,"95,118.30","95,118.30",Transport
23-Aug-20,Purchase,"30,921.47",00.00,"1,26,039.77",Transport
23-Aug-20,Interest,00.00,"12,603.98","1,13,435.79",Transport
23-Aug-20,Transportellaneous,00.00,"14,179.47","99,256.32",Transport
23-Aug-20,Cheque,00.00,"11,028.48","88,227.84",Transport
23-Aug-20,Commission,00.00,"14,704.64","73,523.20",Transport
23-Aug-20,RTGS,00.00,"12,253.87","61,269.33",Transport
23-Aug-20,Tax,00.00,"6,126.93","55,142.40",Transport
23-Aug-20,Purchase,00.00,"27,571.20","27,571.20",Transport
24-Aug-20,Tax,"9,075.07",00.00,"36,646.27",Transport
24-Aug-20,Purchase,"2,22,086.00",00.00,"2,58,732.27",Transport
24-Aug-20,Interest,"7,79,073.80",00.00,"10,37,806.07",Transport
24-Aug-20,Transfer,00.00,"5,18,903.04","5,18,903.04",Transport
24-Aug-20,Transfer,00.00,"5,18,903.04",00.00,Transport
24-Aug-20,Transportellaneous,57,00.00,57,Transport
24-Aug-20,Cash,00.00,11.4,45.6,Transport
24-Aug-20,Reversal,"2,24,476.31",00.00,"2,24,521.91",Transport
24-Aug-20,Transportellaneous,"1,38,805.28",00.00,"3,63,327.19",Transport
24-Aug-20,Interest,387,00.00,"3,63,714.19",Transport
24-Aug-20,ATM,00.00,"1,81,857.10","1,81,857.10",Transport
24-Aug-20,Cash,147.9,00.00,"1,82,005.00",Transport
24-Aug-20,Purchase,"6,10,829.25",00.00,"7,92,834.25",Transport
24-Aug-20,Reversal,00.00,"1,58,566.85","6,34,267.40",Transport
24-Aug-20,Cheque,00.00,"2,11,422.47","4,22,844.93",Transport
24-Aug-20,Cash,00.00,"1,05,711.23","3,17,133.70",Transport
24-Aug-20,Debit Card,00.00,"52,855.62","2,64,278.08",Transport
24-Aug-20,IMPS,00.00,"66,069.52","1,98,208.56",Transport
24-Aug-20,Debit Card,418.2,00.00,"1,98,626.76",Transport
25-Aug-20,Purchase,59.32,00.00,"1,98,686.08",Transport
25-Aug-20,Cheque,"1,90,294.40",00.00,"3,88,980.48",Transport
25-Aug-20,Reversal,"9,60,797.00",00.00,"13,49,777.48",Transport
25-Aug-20,Cheque,00.00,"1,68,722.19","11,81,055.30",Transport
25-Aug-20,Transfer,00.00,"1,31,228.37","10,49,826.93",Transport
25-Aug-20,Tax,00.00,"1,74,971.16","8,74,855.77",Transport
25-Aug-20,Purchase,00.00,"1,45,809.30","7,29,046.48",Transport
25-Aug-20,Bill,00.00,"2,43,015.49","4,86,030.99",Transport
25-Aug-20,Transfer,"1,76,425.50",00.00,"6,62,456.49",Transport
25-Aug-20,IMPS,00.00,"3,31,228.25","3,31,228.24",Transport
25-Aug-20,Reversal,"1,43,443.00",00.00,"4,74,671.24",Transport
25-Aug-20,Transfer,04.00,00.00,"4,74,675.24",Transport
25-Aug-20,Transfer,00.00,"2,37,337.62","2,37,337.62",Transport
25-Aug-20,Commission,"3,768.00",00.00,"2,41,105.62",Transport
26-Aug-20,Commission,00.00,"1,20,552.81","1,20,552.81",Transport
26-Aug-20,Interest,"2,870.20",00.00,"1,23,423.01",Transport
26-Aug-20,Purchase,00.00,"12,342.30","1,11,080.71",Transport
26-Aug-20,Purchase,04.40,00.00,"1,11,085.11",Transport
26-Aug-20,Reversal,"28,472.10",00.00,"1,39,557.21",Transport
26-Aug-20,Interest,00.00,"46,519.07","93,038.14",Transport
26-Aug-20,Bill,00.49,00.00,"93,038.63",Transport
26-Aug-20,Cash,00.00,"31,012.88","62,025.75",Transport
26-Aug-20,Reversal,00.00,"10,337.63","51,688.12",Transport
26-Aug-20,Debit Card,04.70,00.00,"51,692.82",Transport
26-Aug-20,ATM,00.00,"25,846.41","25,846.41",Transport
26-Aug-20,Transportellaneous,"53,876.70",00.00,"79,723.11",Transport
26-Aug-20,NEFT,00.00,"11,389.02","68,334.09",Transport
26-Aug-20,RTGS,604.04,00.00,"68,938.13",Transport
26-Aug-20,Tax,05.08,00.00,"68,943.21",Transport
26-Aug-20,NEFT,"1,499.83",00.00,"70,443.04",Transport
26-Aug-20,Interest,00.00,"70,443.04",00.00,Transport
26-Aug-20,Purchase,"1,61,788.70",00.00,"1,61,788.70",Transport
26-Aug-20,NEFT,14.51,00.00,"1,61,803.21",Transport
26-Aug-20,Debit Card,05.00,00.00,"1,61,808.21",Transport
26-Aug-20,Tax,"9,69,973.00",00.00,"11,31,781.21",Transport
26-Aug-20,Bill,"2,164.00",00.00,"11,33,945.21",Transport
26-Aug-20,Transportellaneous,00.00,"3,77,981.74","7,55,963.47",Transport
26-Aug-20,Tax,00.00,"1,25,993.91","6,29,969.56",Transport
26-Aug-20,Tax,"1,016.40",00.00,"6,30,985.96",Transport
26-Aug-20,Transfer,47.48,00.00,"6,31,033.44",Transport
26-Aug-20,Cash,"69,776.19",00.00,"7,00,809.63",Transport
26-Aug-20,Reversal,00.00,"1,16,801.61","5,84,008.02",Transport
26-Aug-20,Transfer,00.00,"97,334.67","4,86,673.35",Transport
26-Aug-20,Tax,00.00,"48,667.34","4,38,006.01",Transport
26-Aug-20,Interest,"2,135.62",00.00,"4,40,141.63",Transport
26-Aug-20,Cheque,00.00,"4,40,141.63",00.00,Transport
26-Aug-20,Debit Card,01.30,00.00,01.30,Transport
26-Aug-20,Interest,00.00,00.65,00.65,Transport
26-Aug-20,ATM,"1,955.00",00.00,"1,955.65",Transport
26-Aug-20,NEFT,00.00,"1,955.65",00.00,Transport
26-Aug-20,NEFT,"19,096.00",00.00,"19,096.00",Transport
26-Aug-20,Tax,00.00,"6,365.33","12,730.67",Transport
26-Aug-20,Cash,02.00,00.00,"12,732.67",Transport
26-Aug-20,Cheque,"1,43,963.30",00.00,"1,56,695.97",Transport
26-Aug-20,Commission,07.00,00.00,"1,56,702.97",Transport
26-Aug-20,NEFT,00.00,"39,175.74","1,17,527.23",Transport
26-Aug-20,Reversal,00.00,"29,381.81","88,145.42",Transport
26-Aug-20,Interest,184,00.00,"88,329.42",Transport
26-Aug-20,Commission,938,00.00,"89,267.42",Transport
26-Aug-20,Tax,00.00,"17,853.48","71,413.94",Transport
26-Aug-20,Bill,"1,78,381.00",00.00,"2,49,794.94",Transport
26-Aug-20,Commission,00.00,"24,979.49","2,24,815.45",Transport
26-Aug-20,Tax,00.00,"22,481.55","2,02,333.90",Transport
26-Aug-20,IMPS,59,00.00,"2,02,392.90",Transport
26-Aug-20,Bill,"19,213.10",00.00,"2,21,606.00",Transport
26-Aug-20,Interest,00.00,"22,160.60","1,99,445.40",Transport
26-Aug-20,IMPS,00.00,"33,240.90","1,66,204.50",Transport
26-Aug-20,Cheque,470.15,00.00,"1,66,674.65",Transport
26-Aug-20,NEFT,00.00,"1,66,674.65",00.00,Transport
26-Aug-20,NEFT,"1,810.10",00.00,"1,810.10",Transport
26-Aug-20,Cheque,"30,822.00",00.00,"32,632.10",Transport
26-Aug-20,Transfer,"2,40,016.00",00.00,"2,72,648.10",Transport
26-Aug-20,Transfer,99.99,00.00,"2,72,748.09",Transport
26-Aug-20,Cheque,00.00,"38,964.01","2,33,784.08",Transport
26-Aug-20,Tax,"3,722.01",00.00,"2,37,506.09",Transport
26-Aug-20,Purchase,00.00,"79,168.70","1,58,337.39",Transport
26-Aug-20,Bill,00.00,"15,833.74","1,42,503.65",Transport
26-Aug-20,Cheque,"1,350.30",00.00,"1,43,853.95",Transport
26-Aug-20,IMPS,06.20,00.00,"1,43,860.15",Transport
26-Aug-20,RTGS,"2,043.30",00.00,"1,45,903.45",Transport
26-Aug-20,Commission,25.5,00.00,"1,45,928.95",Transport
26-Aug-20,Transportellaneous,00.00,"36,482.24","1,09,446.71",Transport
26-Aug-20,Reversal,"2,03,959.12",00.00,"3,13,405.83",Transport
26-Aug-20,Transportellaneous,00.00,"1,56,702.92","1,56,702.92",Transport
26-Aug-20,Transportellaneous,00.00,"39,175.73","1,17,527.19",Transport
26-Aug-20,Commission,"9,085.79",00.00,"1,26,612.98",Transport
26-Aug-20,NEFT,00.00,"18,087.57","1,08,525.41",Transport
26-Aug-20,NEFT,00.00,"54,262.71","54,262.70",Transport
26-Aug-20,Debit Card,00.00,"7,751.81","46,510.89",Transport
26-Aug-20,Bill,00.00,"7,751.82","38,759.07",Transport
26-Aug-20,NEFT,62,00.00,"38,821.07",Transport
26-Aug-20,Cash,00.00,"4,313.45","34,507.62",Transport
26-Aug-20,Transfer,785.38,00.00,"35,293.00",Transport
27-Aug-20,RTGS,88,00.00,"35,381.00",Transport
27-Aug-20,Reversal,00.00,"3,538.10","31,842.90",Transport
27-Aug-20,ATM,"15,816.30",00.00,"47,659.20",Transport
27-Aug-20,ATM,00.00,"5,957.40","41,701.80",Transport
27-Aug-20,Bill,00.00,"8,340.36","33,361.44",Transport
27-Aug-20,Bill,"2,214.00",00.00,"35,575.44",Transport
27-Aug-20,NEFT,00.00,"5,082.21","30,493.23",Transport
27-Aug-20,Interest,00.00,"3,049.32","27,443.91",Transport
27-Aug-20,NEFT,09.54,00.00,"27,453.45",Transport
27-Aug-20,IMPS,00.00,"6,863.36","20,590.09",Transport
27-Aug-20,NEFT,272,00.00,"20,862.09",Transport
27-Aug-20,Bill,00.00,"2,980.30","17,881.79",Transport
27-Aug-20,Commission,27.41,00.00,"17,909.20",Transport
27-Aug-20,Bill,"25,223.42",00.00,"43,132.62",Transport
27-Aug-20,NEFT,00.00,"43,132.62",00.00,Transport
27-Aug-20,NEFT,01.85,00.00,01.85,Transport
27-Aug-20,Tax,00.00,00.31,01.54,Transport
27-Aug-20,Debit Card,00.00,00.19,01.35,Transport
27-Aug-20,Tax,00.00,00.27,01.08,Transport
27-Aug-20,Cheque,"1,31,849.00",00.00,"1,31,850.08",Transport
27-Aug-20,NEFT,00.00,"43,950.03","87,900.05",Transport
27-Aug-20,Cash,00.00,"29,300.02","58,600.03",Transport
27-Aug-20,NEFT,456.29,00.00,"59,056.32",Transport
27-Aug-20,Transfer,00.00,"6,561.81","52,494.51",Transport
27-Aug-20,NEFT,00.00,"26,247.26","26,247.26",Transport
27-Aug-20,Cheque,00.00,"5,249.45","20,997.81",Transport
27-Aug-20,Transfer,"3,031.00",00.00,"24,028.81",Transport
27-Aug-20,Interest,00.00,"2,669.87","21,358.94",Transport
27-Aug-20,IMPS,00.00,"5,339.74","16,019.20",Transport
27-Aug-20,Cash,40.87,00.00,"16,060.07",Transport
27-Aug-20,IMPS,00.00,"5,353.36","10,706.71",Transport
27-Aug-20,Bill,"30,108.38",00.00,"40,815.09",Transport
27-Aug-20,Debit Card,"1,83,150.00",00.00,"2,23,965.09",Transport
27-Aug-20,Cheque,"1,69,834.20",00.00,"3,93,799.29",Transport
27-Aug-20,Transportellaneous,00.00,"3,93,799.29",00.00,Transport
27-Aug-20,Reversal,247.9,00.00,247.9,Transport
27-Aug-20,Purchase,58,00.00,305.9,Transport
27-Aug-20,ATM,"3,746.00",00.00,"4,051.90",Transport
27-Aug-20,Transportellaneous,252.9,00.00,"4,304.80",Transport
27-Aug-20,Cheque,00.00,478.31,"3,826.49",Transport
27-Aug-20,Cash,00.00,956.62,"2,869.87",Transport
27-Aug-20,IMPS,00.00,"1,434.94","1,434.94",Transport
27-Aug-20,Bill,174.17,00.00,"1,609.11",Transport
27-Aug-20,Transportellaneous,"77,265.20",00.00,"78,874.31",Transport
27-Aug-20,Interest,38,00.00,"78,912.31",Transport
27-Aug-20,Bill,07.00,00.00,"78,919.31",Transport
27-Aug-20,Tax,01.00,00.00,"78,920.31",Transport
27-Aug-20,RTGS,"25,608.56",00.00,"1,04,528.87",Transport
27-Aug-20,Bill,37,00.00,"1,04,565.87",Transport
27-Aug-20,IMPS,00.00,"10,456.59","94,109.28",Transport
27-Aug-20,Debit Card,00.00,"10,456.59","83,652.69",Transport
27-Aug-20,Commission,00.00,"13,942.12","69,710.58",Transport
27-Aug-20,Transfer,00.00,"13,942.12","55,768.46",Transport
27-Aug-20,Interest,00.00,"7,966.92","47,801.54",Transport
27-Aug-20,Cash,00.00,"47,801.54",00.00,Transport
27-Aug-20,NEFT,341.16,00.00,341.16,Transport
27-Aug-20,NEFT,07.36,00.00,348.52,Transport
27-Aug-20,Transportellaneous,00.00,348.52,00.00,Transport
27-Aug-20,Debit Card,474.08,00.00,474.08,Transport
27-Aug-20,RTGS,00.00,59.26,414.82,Transport
27-Aug-20,Bill,00.00,51.85,362.97,Transport
27-Aug-20,Transportellaneous,00.00,36.3,326.67,Transport
27-Aug-20,IMPS,00.00,108.89,217.78,Transport
27-Aug-20,ATM,39.15,00.00,256.93,Transport
27-Aug-20,Purchase,00.00,64.23,192.7,Transport
27-Aug-20,Transportellaneous,"18,51,946.00",00.00,"18,52,138.70",Transport
27-Aug-20,IMPS,23.53,00.00,"18,52,162.23",Transport
27-Aug-20,NEFT,00.00,"3,08,693.71","15,43,468.52",Transport
27-Aug-20,NEFT,00.00,"15,43,468.52",00.00,Transport
27-Aug-20,Reversal,22.77,00.00,22.77,Transport
27-Aug-20,Commission,00.00,11.39,11.38,Transport
27-Aug-20,Cheque,00.00,03.79,07.59,Transport
27-Aug-20,RTGS,00.00,00.84,06.75,Transport
27-Aug-20,Interest,00.00,02.25,04.50,Transport
27-Aug-20,Interest,00.00,04.50,00.00,Transport
27-Aug-20,Interest,08.00,00.00,08.00,Transport
27-Aug-20,Bill,"2,57,850.16",00.00,"2,57,858.16",Transport
27-Aug-20,IMPS,00.00,"1,28,929.08","1,28,929.08",Transport
27-Aug-20,RTGS,"76,143.84",00.00,"2,05,072.92",Transport
27-Aug-20,Cheque,00.00,"51,268.23","1,53,804.69",Transport
27-Aug-20,Purchase,00.00,"1,53,804.69",00.00,Transport
27-Aug-20,Tax,07.00,00.00,07.00,Transport
27-Aug-20,Bill,19,00.00,26,Transport
27-Aug-20,Tax,00.00,08.67,17.33,Transport
27-Aug-20,Reversal,00.00,02.48,14.85,Transport
27-Aug-20,RTGS,"24,661.00",00.00,"24,675.85",Transport
27-Aug-20,ATM,"1,18,041.00",00.00,"1,42,716.85",Transport
27-Aug-20,Bill,00.00,"23,786.14","1,18,930.71",Transport
27-Aug-20,Purchase,02.68,00.00,"1,18,933.39",Transport
27-Aug-20,Bill,11.2,00.00,"1,18,944.59",Transport
27-Aug-20,Cash,00.00,"23,788.92","95,155.67",Transport
27-Aug-20,Cheque,00.00,"9,515.57","85,640.10",Transport
27-Aug-20,NEFT,23.4,00.00,"85,663.50",Transport
27-Aug-20,Bill,00.00,"10,707.94","74,955.56",Transport
27-Aug-20,Debit Card,00.00,"9,369.45","65,586.11",Transport
27-Aug-20,RTGS,00.00,"65,586.11",00.00,Transport
27-Aug-20,IMPS,48.13,00.00,48.13,Transport
27-Aug-20,Cash,00.00,12.03,36.1,Transport
27-Aug-20,Transfer,00.00,18.05,18.05,Transport
27-Aug-20,NEFT,40,00.00,58.05,Transport
27-Aug-20,RTGS,"18,017.00",00.00,"18,075.05",Transport
27-Aug-20,Cash,41.5,00.00,"18,116.55",Transport
27-Aug-20,Bill,00.00,"3,623.31","14,493.24",Transport
27-Aug-20,Cash,01.00,00.00,"14,494.24",Transport
27-Aug-20,Cheque,00.00,"3,623.56","10,870.68",Transport
27-Aug-20,IMPS,00.00,"3,623.56","7,247.12",Transport
27-Aug-20,Cash,00.00,"1,207.85","6,039.27",Transport
27-Aug-20,Commission,24,00.00,"6,063.27",Transport
27-Aug-20,NEFT,"2,60,845.00",00.00,"2,66,908.27",Transport
27-Aug-20,Bill,477.69,00.00,"2,67,385.96",Transport
27-Aug-20,Cash,888,00.00,"2,68,273.96",Transport
27-Aug-20,Tax,00.00,"38,324.85","2,29,949.11",Transport
27-Aug-20,IMPS,"21,147.70",00.00,"2,51,096.81",Transport
27-Aug-20,Reversal,00.00,"41,849.47","2,09,247.34",Transport
27-Aug-20,Interest,"1,71,357.22",00.00,"3,80,604.56",Transport
27-Aug-20,Cash,"1,11,626.00",00.00,"4,92,230.56",Transport
27-Aug-20,Tax,"1,86,913.90",00.00,"6,79,144.46",Transport
27-Aug-20,RTGS,"7,83,641.00",00.00,"14,62,785.46",Transport
27-Aug-20,NEFT,00.00,"1,62,531.72","13,00,253.74",Transport
27-Aug-20,Interest,00.00,"6,50,126.87","6,50,126.87",Transport
27-Aug-20,Commission,00.00,"3,25,063.44","3,25,063.44",Transport
27-Aug-20,Commission,"22,113.56",00.00,"3,47,177.00",Transport
27-Aug-20,Tax,512,00.00,"3,47,689.00",Transport
27-Aug-20,NEFT,"4,83,813.50",00.00,"8,31,502.50",Transport
27-Aug-20,Cheque,"2,53,094.70",00.00,"10,84,597.20",Transport
27-Aug-20,ATM,"13,53,039.00",00.00,"24,37,636.20",Transport
27-Aug-20,Cash,00.00,"6,09,409.05","18,28,227.15",Transport
27-Aug-20,Debit Card,458.26,00.00,"18,28,685.41",Transport
27-Aug-20,NEFT,"2,04,007.00",00.00,"20,32,692.41",Transport
27-Aug-20,Cheque,00.00,"2,25,854.71","18,06,837.70",Transport
27-Aug-20,Reversal,00.00,"6,02,279.23","12,04,558.47",Transport
27-Aug-20,Purchase,270.12,00.00,"12,04,828.59",Transport
27-Aug-20,Transfer,135.2,00.00,"12,04,963.79",Transport
27-Aug-20,RTGS,00.00,"1,20,496.38","10,84,467.41",Transport
27-Aug-20,Debit Card,"25,501.09",00.00,"11,09,968.50",Transport
27-Aug-20,Transportellaneous,00.00,"3,69,989.50","7,39,979.00",Transport
27-Aug-20,Debit Card,00.00,"1,05,711.29","6,34,267.71",Transport
27-Aug-20,Reversal,"18,99,984.00",00.00,"25,34,251.71",Transport
27-Aug-20,Cash,00.00,"5,06,850.34","20,27,401.37",Transport
27-Aug-20,Commission,00.00,"6,75,800.46","13,51,600.91",Transport
27-Aug-20,IMPS,00.00,"3,37,900.23","10,13,700.68",Transport
27-Aug-20,ATM,05.20,00.00,"10,13,705.88",Transport
27-Aug-20,ATM,05.40,00.00,"10,13,711.28",Transport
27-Aug-20,Debit Card,06.00,00.00,"10,13,717.28",Transport
27-Aug-20,Interest,00.00,"3,37,905.76","6,75,811.52",Transport
27-Aug-20,Interest,00.00,"96,544.50","5,79,267.02",Transport
27-Aug-20,RTGS,41,00.00,"5,79,308.02",Transport
27-Aug-20,Reversal,"25,207.00",00.00,"6,04,515.02",Transport
27-Aug-20,Debit Card,02.38,00.00,"6,04,517.40",Transport
27-Aug-20,Cash,00.00,"2,01,505.80","4,03,011.60",Transport
28-Aug-20,Cash,00.00,"40,301.16","3,62,710.44",Transport
28-Aug-20,IMPS,"9,574.54",00.00,"3,72,284.98",Transport
28-Aug-20,Commission,411,00.00,"3,72,695.98",Transport
28-Aug-20,IMPS,"8,181.00",00.00,"3,80,876.98",Transport
28-Aug-20,Bill,00.00,"95,219.25","2,85,657.74",Transport
28-Aug-20,Commission,"8,91,198.00",00.00,"11,76,855.74",Transport
28-Aug-20,Tax,"9,979.21",00.00,"11,86,834.95",Transport
28-Aug-20,Cash,00.00,"2,37,366.99","9,49,467.96",Transport
28-Aug-20,Transportellaneous,"2,21,719.30",00.00,"11,71,187.26",Transport
28-Aug-20,Cheque,504.53,00.00,"11,71,691.79",Transport
28-Aug-20,ATM,"2,88,208.00",00.00,"14,59,899.79",Transport
28-Aug-20,Interest,00.00,"7,29,949.90","7,29,949.90",Transport
28-Aug-20,Bill,"11,694.21",00.00,"7,41,644.11",Transport
28-Aug-20,Reversal,00.00,"74,164.41","6,67,479.70",Transport
28-Aug-20,Bill,00.00,"66,747.97","6,00,731.73",Transport
28-Aug-20,Transportellaneous,00.00,"1,20,146.35","4,80,585.38",Transport
28-Aug-20,Debit Card,00.00,"53,398.38","4,27,187.00",Transport
28-Aug-20,NEFT,"46,265.80",00.00,"4,73,452.80",Transport
28-Aug-20,NEFT,00.00,"94,690.56","3,78,762.24",Transport
28-Aug-20,Cheque,00.00,"3,78,762.24",00.00,Transport
28-Aug-20,Cash,"1,30,530.00",00.00,"1,30,530.00",Transport
28-Aug-20,Purchase,00.00,"26,106.00","1,04,424.00",Transport
28-Aug-20,Tax,440.66,00.00,"1,04,864.66",Transport
28-Aug-20,Interest,"10,15,571.00",00.00,"11,20,435.66",Transport
28-Aug-20,Tax,27.37,00.00,"11,20,463.03",Transport
28-Aug-20,ATM,04.00,00.00,"11,20,467.03",Transport
28-Aug-20,Cash,00.00,"1,86,744.51","9,33,722.52",Transport
28-Aug-20,Reversal,52.6,00.00,"9,33,775.12",Transport
28-Aug-20,IMPS,00.00,"9,33,775.12",00.00,Transport
28-Aug-20,Interest,03.02,00.00,03.02,Transport
28-Aug-20,Transfer,11.69,00.00,14.71,Transport
28-Aug-20,Transfer,00.00,14.71,00.00,Transport
28-Aug-20,Cash,"9,77,676.80",00.00,"9,77,676.80",Transport
28-Aug-20,ATM,00.00,"1,22,209.60","8,55,467.20",Transport
28-Aug-20,NEFT,487,00.00,"8,55,954.20",Transport
28-Aug-20,Transportellaneous,05.20,00.00,"8,55,959.40",Transport
28-Aug-20,Transportellaneous,175.85,00.00,"8,56,135.25",Transport
28-Aug-20,RTGS,01.90,00.00,"8,56,137.15",Transport
28-Aug-20,Reversal,00.00,"4,28,068.58","4,28,068.58",Transport
28-Aug-20,Cheque,08.00,00.00,"4,28,076.58",Transport
29-Aug-20,Purchase,611.3,00.00,"4,28,687.88",Transport
29-Aug-20,Transportellaneous,"10,906.10",00.00,"4,39,593.98",Transport
29-Aug-20,Reversal,296.78,00.00,"4,39,890.76",Transport
29-Aug-20,Debit Card,60.9,00.00,"4,39,951.66",Transport
29-Aug-20,Reversal,00.00,"2,19,975.83","2,19,975.83",Transport
29-Aug-20,Transportellaneous,00.00,"27,496.98","1,92,478.85",Transport
29-Aug-20,Transportellaneous,"7,308.20",00.00,"1,99,787.05",Transport
29-Aug-20,RTGS,00.00,"49,946.76","1,49,840.29",Transport
29-Aug-20,IMPS,"8,58,393.00",00.00,"10,08,233.29",Transport
29-Aug-20,IMPS,00.00,"1,26,029.16","8,82,204.13",Transport
29-Aug-20,IMPS,00.00,"1,47,034.02","7,35,170.11",Transport
29-Aug-20,Interest,00.00,"1,83,792.53","5,51,377.58",Transport
29-Aug-20,NEFT,00.00,"91,896.26","4,59,481.32",Transport
29-Aug-20,Commission,00.00,"65,640.19","3,93,841.13",Transport
29-Aug-20,Transportellaneous,14,00.00,"3,93,855.13",Transport
29-Aug-20,Debit Card,"11,763.70",00.00,"4,05,618.83",Transport
29-Aug-20,Purchase,"6,959.50",00.00,"4,12,578.33",Transport
29-Aug-20,Purchase,277,00.00,"4,12,855.33",Transport
29-Aug-20,Debit Card,161.92,00.00,"4,13,017.25",Transport
29-Aug-20,ATM,00.00,"45,890.81","3,67,126.44",Transport
29-Aug-20,NEFT,00.00,"61,187.74","3,05,938.70",Transport
29-Aug-20,Commission,00.00,"3,05,938.70",00.00,Transport
29-Aug-20,Transfer,01.00,00.00,01.00,Transport
29-Aug-20,Debit Card,320,00.00,321,Transport
29-Aug-20,Transfer,00.00,107,214,Transport
30-Aug-20,Cheque,00.00,107,107,Transport
30-Aug-20,Transfer,00.00,21.4,85.6,Transport
30-Aug-20,IMPS,00.00,12.23,73.37,Transport
30-Aug-20,RTGS,"1,61,559.00",00.00,"1,61,632.37",Transport
30-Aug-20,Transportellaneous,00.00,"32,326.47","1,29,305.90",Transport
30-Aug-20,RTGS,103,00.00,"1,29,408.90",Transport
30-Aug-20,Reversal,07.00,00.00,"1,29,415.90",Transport
30-Aug-20,Reversal,"19,747.70",00.00,"1,49,163.60",Transport
30-Aug-20,RTGS,00.00,"16,573.73","1,32,589.87",Transport
31-Aug-20,Transportellaneous,00.00,"14,732.21","1,17,857.66",Transport
31-Aug-20,Transfer,"2,62,028.20",00.00,"3,79,885.86",Transport
31-Aug-20,Purchase,00.00,"63,314.31","3,16,571.55",Transport
31-Aug-20,Bill,00.00,"45,224.51","2,71,347.04",Transport
31-Aug-20,Reversal,"31,706.55",00.00,"3,03,053.59",Transport
31-Aug-20,Reversal,00.00,"1,01,017.86","2,02,035.73",Transport
31-Aug-20,RTGS,"12,33,713.00",00.00,"14,35,748.73",Transport
31-Aug-20,Interest,00.00,"1,79,468.59","12,56,280.14",Transport
31-Aug-20,Transfer,00.00,"1,79,468.59","10,76,811.55",Transport
31-Aug-20,Purchase,00.00,"1,53,830.22","9,22,981.33",Transport
31-Aug-20,Bill,00.00,"3,07,660.44","6,15,320.89",Transport
31-Aug-20,NEFT,00.00,"1,02,553.48","5,12,767.41",Transport
31-Aug-20,Transfer,00.00,"2,56,383.71","2,56,383.70",Transport
31-Aug-20,Transfer,02.00,00.00,"2,56,385.70",Transport
31-Aug-20,Purchase,00.00,"32,048.21","2,24,337.49",Transport
31-Aug-20,Transfer,00.00,"28,042.19","1,96,295.30",Transport
31-Aug-20,Interest,00.00,"65,431.77","1,30,863.53",Transport
31-Aug-20,Cash,00.00,"18,694.79","1,12,168.74",Transport
31-Aug-20,Transportellaneous,"2,32,425.22",00.00,"3,44,593.96",Transport
31-Aug-20,Interest,00.00,"68,918.79","2,75,675.17",Transport
31-Aug-20,Transportellaneous,55,00.00,"2,75,730.17",Transport
31-Aug-20,RTGS,"1,76,271.00",00.00,"4,52,001.17",Transport
31-Aug-20,Transportellaneous,00.00,"4,52,001.17",00.00,Transport
31-Aug-20,Interest,"8,86,954.00",00.00,"8,86,954.00",Transport
31-Aug-20,Commission,174.26,00.00,"8,87,128.26",Transport
31-Aug-20,NEFT,07.40,00.00,"8,87,135.66",Transport
31-Aug-20,Reversal,07.65,00.00,"8,87,143.31",Transport
31-Aug-20,Cheque,"24,253.00",00.00,"9,11,396.31",Transport
31-Aug-20,Debit Card,00.00,"3,03,798.77","6,07,597.54",Transport
31-Aug-20,Purchase,78,00.00,"6,07,675.54",Transport
31-Aug-20,Interest,00.00,"1,51,918.89","4,55,756.66",Transport
31-Aug-20,RTGS,"13,488.00",00.00,"4,69,244.66",Transport
31-Aug-20,ATM,00.00,"58,655.58","4,10,589.08",Transport
31-Aug-20,ATM,00.00,"4,10,589.08",00.00,Transport
31-Aug-20,IMPS,"2,93,589.80",00.00,"2,93,589.80",Transport
31-Aug-20,Purchase,"66,283.44",00.00,"3,59,873.24",Transport
31-Aug-20,Transfer,"18,64,251.20",00.00,"22,24,124.44",Transport
31-Aug-20,Commission,00.00,"11,12,062.22","11,12,062.22",Transport
31-Aug-20,IMPS,00.00,"5,56,031.11","5,56,031.11",Transport
31-Aug-20,NEFT,00.00,"55,603.11","5,00,428.00",Transport
31-Aug-20,Cheque,00.00,"83,404.67","4,17,023.33",Transport
31-Aug-20,IMPS,"22,341.00",00.00,"4,39,364.33",Transport
31-Aug-20,IMPS,"8,10,075.80",00.00,"12,49,440.13",Transport
31-Aug-20,Interest,00.00,"1,24,944.01","11,24,496.12",Transport
01-Sep-20,RTGS,33,00.00,"11,24,529.12",Transport
01-Sep-20,ATM,15,00.00,"11,24,544.12",Transport
01-Sep-20,RTGS,00.00,"1,24,949.35","9,99,594.77",Transport
01-Sep-20,NEFT,"2,885.00",00.00,"10,02,479.77",Transport
01-Sep-20,Reversal,00.00,"3,34,159.92","6,68,319.85",Transport
02-Sep-20,ATM,00.00,"83,539.98","5,84,779.87",Transport
02-Sep-20,Cheque,00.00,"64,975.54","5,19,804.33",Transport
02-Sep-20,IMPS,00.00,"51,980.43","4,67,823.90",Transport
02-Sep-20,Bill,"4,924.00",00.00,"4,72,747.90",Transport
02-Sep-20,Commission,61,00.00,"4,72,808.90",Transport
02-Sep-20,Transportellaneous,00.00,"94,561.78","3,78,247.12",Transport
02-Sep-20,Reversal,00.00,"1,89,123.56","1,89,123.56",Transport
02-Sep-20,IMPS,"99,097.00",00.00,"2,88,220.56",Transport
02-Sep-20,Purchase,19.3,00.00,"2,88,239.86",Transport
02-Sep-20,Transfer,07.30,00.00,"2,88,247.16",Transport
02-Sep-20,Purchase,00.00,"28,824.72","2,59,422.44",Transport
02-Sep-20,Bill,218.6,00.00,"2,59,641.04",Transport
02-Sep-20,Reversal,00.00,"2,59,641.04",00.00,Transport
02-Sep-20,Reversal,02.10,00.00,02.10,Transport
02-Sep-20,Interest,"16,551.40",00.00,"16,553.50",Transport
02-Sep-20,Cash,07.20,00.00,"16,560.70",Transport
02-Sep-20,IMPS,"2,32,002.25",00.00,"2,48,562.95",Transport
02-Sep-20,Transfer,381,00.00,"2,48,943.95",Transport
02-Sep-20,Purchase,"1,876.35",00.00,"2,50,820.30",Transport
02-Sep-20,ATM,00.00,"31,352.54","2,19,467.76",Transport
02-Sep-20,Debit Card,"17,565.00",00.00,"2,37,032.76",Transport
02-Sep-20,Tax,05.90,00.00,"2,37,038.66",Transport
02-Sep-20,Interest,188.7,00.00,"2,37,227.36",Transport
02-Sep-20,ATM,479,00.00,"2,37,706.36",Transport
02-Sep-20,Commission,08.10,00.00,"2,37,714.46",Transport
02-Sep-20,Cheque,00.00,"29,714.31","2,08,000.15",Transport
02-Sep-20,Reversal,"18,853.00",00.00,"2,26,853.15",Transport
02-Sep-20,ATM,00.00,"22,685.32","2,04,167.84",Transport
02-Sep-20,Cash,"3,059.22",00.00,"2,07,227.06",Transport
02-Sep-20,Transfer,"1,160.10",00.00,"2,08,387.16",Transport
02-Sep-20,Debit Card,00.00,"69,462.39","1,38,924.77",Transport
02-Sep-20,IMPS,00.00,"15,436.09","1,23,488.68",Transport
02-Sep-20,Cash,482.53,00.00,"1,23,971.21",Transport
02-Sep-20,Cash,00.00,"41,323.74","82,647.47",Transport
02-Sep-20,Cash,258.52,00.00,"82,905.99",Transport
02-Sep-20,Bill,"15,58,175.20",00.00,"16,41,081.19",Transport
02-Sep-20,Commission,108,00.00,"16,41,189.19",Transport
02-Sep-20,Interest,00.00,"3,28,237.84","13,12,951.35",Transport
02-Sep-20,NEFT,00.00,"4,37,650.45","8,75,300.90",Transport
02-Sep-20,IMPS,00.00,"2,18,825.23","6,56,475.68",Transport
02-Sep-20,Reversal,00.00,"1,09,412.61","5,47,063.07",Transport
03-Sep-20,Purchase,00.00,"60,784.79","4,86,278.28",Transport
03-Sep-20,Debit Card,00.00,"60,784.79","4,25,493.50",Transport
03-Sep-20,Interest,"7,10,341.00",00.00,"11,35,834.50",Transport
03-Sep-20,Bill,00.00,"1,41,979.31","9,93,855.19",Transport
03-Sep-20,Transfer,00.00,"2,48,463.80","7,45,391.39",Transport
03-Sep-20,Reversal,07.40,00.00,"7,45,398.79",Transport
03-Sep-20,NEFT,11.43,00.00,"7,45,410.22",Transport
03-Sep-20,ATM,"7,267.66",00.00,"7,52,677.88",Transport
03-Sep-20,NEFT,01.00,00.00,"7,52,678.88",Transport
03-Sep-20,IMPS,"20,40,331.50",00.00,"27,93,010.38",Transport
03-Sep-20,ATM,134,00.00,"27,93,144.38",Transport
03-Sep-20,Purchase,"10,412.33",00.00,"28,03,556.71",Transport
03-Sep-20,ATM,00.00,"9,34,518.90","18,69,037.81",Transport
03-Sep-20,Commission,00.00,"2,33,629.73","16,35,408.08",Transport
03-Sep-20,NEFT,00.00,"2,72,568.01","13,62,840.07",Transport
03-Sep-20,Tax,00.00,"1,70,355.01","11,92,485.06",Transport
03-Sep-20,Bill,00.20,00.00,"11,92,485.26",Transport
03-Sep-20,Purchase,00.00,"3,97,495.09","7,94,990.17",Transport
03-Sep-20,Reversal,02.20,00.00,"7,94,992.37",Transport
03-Sep-20,Cash,"77,961.00",00.00,"8,72,953.37",Transport
04-Sep-20,Transportellaneous,"1,86,759.84",00.00,"10,59,713.21",Transport
04-Sep-20,NEFT,"7,565.45",00.00,"10,67,278.66",Transport
04-Sep-20,Commission,61,00.00,"10,67,339.66",Transport
04-Sep-20,Tax,00.00,"10,67,339.66",00.00,Transport
04-Sep-20,Commission,"3,277.00",00.00,"3,277.00",Transport
04-Sep-20,Bill,"23,126.87",00.00,"26,403.87",Transport
04-Sep-20,Interest,00.00,"6,600.97","19,802.90",Transport
04-Sep-20,NEFT,00.00,"6,600.97","13,201.93",Transport
04-Sep-20,Debit Card,"13,25,445.00",00.00,"13,38,646.93",Transport
04-Sep-20,Tax,00.00,"3,34,661.73","10,03,985.20",Transport
04-Sep-20,Bill,"29,159.91",00.00,"10,33,145.11",Transport
04-Sep-20,Transfer,00.00,"3,44,381.70","6,88,763.41",Transport
04-Sep-20,NEFT,"28,884.40",00.00,"7,17,647.81",Transport
04-Sep-20,Purchase,00.00,"71,764.78","6,45,883.03",Transport
04-Sep-20,ATM,"18,10,525.00",00.00,"24,56,408.03",Transport
04-Sep-20,Purchase,421.64,00.00,"24,56,829.67",Transport
04-Sep-20,Transportellaneous,"13,097.34",00.00,"24,69,927.01",Transport
04-Sep-20,Interest,30.7,00.00,"24,69,957.71",Transport
04-Sep-20,Bill,146.34,00.00,"24,70,104.05",Transport
04-Sep-20,Bill,06.60,00.00,"24,70,110.65",Transport
04-Sep-20,Transportellaneous,00.00,"2,47,011.07","22,23,099.58",Transport
04-Sep-20,Tax,"2,241.69",00.00,"22,25,341.27",Transport
05-Sep-20,Interest,02.00,00.00,"22,25,343.27",Transport
05-Sep-20,Commission,02.00,00.00,"22,25,345.27",Transport
05-Sep-20,Tax,00.00,"7,41,781.76","14,83,563.51",Transport
05-Sep-20,NEFT,"2,20,283.81",00.00,"17,03,847.32",Transport
05-Sep-20,Transportellaneous,00.00,"5,67,949.11","11,35,898.21",Transport
05-Sep-20,Interest,"95,863.00",00.00,"12,31,761.21",Transport
05-Sep-20,Interest,00.00,"12,31,761.21",00.00,Transport
05-Sep-20,RTGS,05.00,00.00,05.00,Transport
05-Sep-20,NEFT,00.00,02.50,02.50,Transport
05-Sep-20,Reversal,"1,68,260.00",00.00,"1,68,262.50",Transport
05-Sep-20,Cheque,07.42,00.00,"1,68,269.92",Transport
05-Sep-20,Purchase,00.00,"56,089.97","1,12,179.95",Transport
05-Sep-20,Debit Card,00.00,"37,393.32","74,786.63",Transport
05-Sep-20,Reversal,00.00,"8,309.63","66,477.00",Transport
05-Sep-20,Reversal,00.00,"33,238.50","33,238.50",Transport
05-Sep-20,Interest,03.00,00.00,"33,241.50",Transport
05-Sep-20,Reversal,00.00,"3,693.50","29,548.00",Transport
05-Sep-20,Transportellaneous,00.00,"4,221.14","25,326.86",Transport
05-Sep-20,Reversal,00.00,"3,165.86","22,161.00",Transport
05-Sep-20,Reversal,657.02,00.00,"22,818.02",Transport
05-Sep-20,Transportellaneous,"3,539.00",00.00,"26,357.02",Transport
05-Sep-20,Interest,"99,300.00",00.00,"1,25,657.02",Transport
05-Sep-20,Transportellaneous,"4,060.00",00.00,"1,29,717.02",Transport
05-Sep-20,Bill,830.32,00.00,"1,30,547.34",Transport
05-Sep-20,Interest,00.00,"32,636.84","97,910.50",Transport
05-Sep-20,IMPS,00.00,"97,910.50",00.00,Transport
05-Sep-20,Cash,07.52,00.00,07.52,Transport
05-Sep-20,Cheque,00.00,01.07,06.45,Transport
05-Sep-20,Debit Card,499.7,00.00,506.15,Transport
06-Sep-20,NEFT,"1,13,619.25",00.00,"1,14,125.40",Transport
06-Sep-20,Tax,01.00,00.00,"1,14,126.40",Transport
06-Sep-20,NEFT,00.00,"11,412.64","1,02,713.76",Transport
06-Sep-20,Bill,"7,16,955.25",00.00,"8,19,669.01",Transport
06-Sep-20,Bill,"3,893.38",00.00,"8,23,562.39",Transport
06-Sep-20,Reversal,"1,86,805.09",00.00,"10,10,367.48",Transport
06-Sep-20,Reversal,"29,510.80",00.00,"10,39,878.28",Transport
06-Sep-20,Transfer,00.00,"1,29,984.79","9,09,893.50",Transport
06-Sep-20,Interest,00.00,"1,29,984.79","7,79,908.71",Transport
07-Sep-20,Cheque,00.00,"1,55,981.74","6,23,926.97",Transport
07-Sep-20,IMPS,"16,621.30",00.00,"6,40,548.27",Transport
07-Sep-20,ATM,00.00,"1,28,109.65","5,12,438.62",Transport
07-Sep-20,Tax,00.00,"85,406.44","4,27,032.18",Transport
07-Sep-20,Transfer,00.00,"61,004.60","3,66,027.58",Transport
07-Sep-20,Bill,494,00.00,"3,66,521.58",Transport
07-Sep-20,Cheque,33.5,00.00,"3,66,555.08",Transport
07-Sep-20,Tax,00.00,"36,655.51","3,29,899.57",Transport
07-Sep-20,RTGS,14.41,00.00,"3,29,913.98",Transport
07-Sep-20,Purchase,00.00,"1,64,956.99","1,64,956.99",Transport
07-Sep-20,Bill,"3,406.70",00.00,"1,68,363.69",Transport
07-Sep-20,Bill,00.00,"42,090.92","1,26,272.77",Transport
07-Sep-20,Interest,"2,719.00",00.00,"1,28,991.77",Transport
07-Sep-20,Bill,00.00,"21,498.63","1,07,493.14",Transport
07-Sep-20,Transportellaneous,00.00,"10,749.31","96,743.83",Transport
07-Sep-20,Interest,"11,64,284.00",00.00,"12,61,027.83",Transport
07-Sep-20,NEFT,00.00,"1,26,102.78","11,34,925.05",Transport
07-Sep-20,Transfer,"1,530.00",00.00,"11,36,455.05",Transport
07-Sep-20,Debit Card,00.00,"1,62,350.72","9,74,104.33",Transport
07-Sep-20,Commission,00.00,"3,24,701.44","6,49,402.89",Transport
07-Sep-20,Cheque,00.00,"81,175.36","5,68,227.53",Transport
07-Sep-20,Purchase,00.00,"1,13,645.51","4,54,582.02",Transport
07-Sep-20,Bill,00.00,"45,458.20","4,09,123.82",Transport
07-Sep-20,Reversal,00.00,"45,458.20","3,63,665.62",Transport
07-Sep-20,NEFT,858.15,00.00,"3,64,523.77",Transport
08-Sep-20,Transportellaneous,00.00,"40,502.64","3,24,021.13",Transport
08-Sep-20,RTGS,00.00,"81,005.28","2,43,015.85",Transport
08-Sep-20,Commission,"79,059.60",00.00,"3,22,075.45",Transport
08-Sep-20,Purchase,15,00.00,"3,22,090.45",Transport
08-Sep-20,Cash,"6,04,302.00",00.00,"9,26,392.45",Transport
08-Sep-20,ATM,05.70,00.00,"9,26,398.15",Transport
08-Sep-20,RTGS,00.00,"1,85,279.63","7,41,118.52",Transport
08-Sep-20,Purchase,24.49,00.00,"7,41,143.01",Transport
08-Sep-20,Transportellaneous,"2,643.30",00.00,"7,43,786.31",Transport
08-Sep-20,NEFT,"29,277.39",00.00,"7,73,063.70",Transport
08-Sep-20,RTGS,"14,94,483.00",00.00,"22,67,546.70",Transport
08-Sep-20,Tax,"15,03,367.00",00.00,"37,70,913.70",Transport
08-Sep-20,NEFT,295.3,00.00,"37,71,209.00",Transport
08-Sep-20,NEFT,00.00,"7,54,241.80","30,16,967.20",Transport
08-Sep-20,Commission,"69,756.00",00.00,"30,86,723.20",Transport
08-Sep-20,NEFT,00.00,"4,40,960.46","26,45,762.74",Transport
08-Sep-20,Commission,00.00,"2,64,576.27","23,81,186.47",Transport
08-Sep-20,Interest,00.00,"11,90,593.24","11,90,593.24",Transport
08-Sep-20,Transfer,00.00,"11,90,593.24",00.00,Transport
08-Sep-20,Cash,00.97,00.00,00.97,Transport
08-Sep-20,Purchase,13,00.00,13.97,Transport
09-Sep-20,RTGS,"2,61,880.30",00.00,"2,61,894.27",Transport
09-Sep-20,Commission,"2,280.40",00.00,"2,64,174.67",Transport
10-Sep-20,Transfer,00.00,"52,834.93","2,11,339.74",Transport
10-Sep-20,Purchase,"5,453.00",00.00,"2,16,792.74",Transport
10-Sep-20,Debit Card,00.00,"54,198.19","1,62,594.56",Transport
10-Sep-20,Tax,"38,903.88",00.00,"2,01,498.44",Transport
10-Sep-20,Reversal,00.00,"67,166.15","1,34,332.29",Transport
10-Sep-20,Transfer,"8,542.00",00.00,"1,42,874.29",Transport
10-Sep-20,Interest,"2,21,480.20",00.00,"3,64,354.49",Transport
10-Sep-20,NEFT,00.00,"52,050.64","3,12,303.85",Transport
10-Sep-20,Purchase,360.7,00.00,"3,12,664.55",Transport
10-Sep-20,Cash,"33,517.40",00.00,"3,46,181.95",Transport
10-Sep-20,Cheque,00.00,"1,73,090.98","1,73,090.98",Transport
10-Sep-20,Cheque,00.00,"1,73,090.98",00.00,Transport
11-Sep-20,Cash,05.00,00.00,05.00,Transport
11-Sep-20,Purchase,00.00,02.50,02.50,Transport
11-Sep-20,IMPS,"19,96,046.25",00.00,"19,96,048.75",Transport
11-Sep-20,Bill,"7,36,832.00",00.00,"27,32,880.75",Transport
12-Sep-20,Commission,"19,899.68",00.00,"27,52,780.43",Transport
12-Sep-20,Transfer,399.63,00.00,"27,53,180.06",Transport
12-Sep-20,Cash,00.00,"13,76,590.03","13,76,590.03",Transport
12-Sep-20,Cheque,"30,766.67",00.00,"14,07,356.70",Transport
12-Sep-20,Tax,00.00,"1,75,919.59","12,31,437.11",Transport
12-Sep-20,ATM,00.00,"3,07,859.28","9,23,577.83",Transport
12-Sep-20,Bill,"2,42,287.00",00.00,"11,65,864.83",Transport
12-Sep-20,Debit Card,00.00,"2,33,172.97","9,32,691.86",Transport
12-Sep-20,Debit Card,00.00,"4,66,345.93","4,66,345.93",Transport
12-Sep-20,ATM,02.84,00.00,"4,66,348.77",Transport
12-Sep-20,Cheque,00.00,"93,269.75","3,73,079.02",Transport
12-Sep-20,Reversal,00.00,"74,615.80","2,98,463.22",Transport
12-Sep-20,Tax,00.00,"49,743.87","2,48,719.35",Transport
12-Sep-20,Purchase,"29,028.00",00.00,"2,77,747.35",Transport
12-Sep-20,NEFT,00.00,"39,678.19","2,38,069.16",Transport
12-Sep-20,Tax,08.54,00.00,"2,38,077.70",Transport
12-Sep-20,Transportellaneous,00.00,"79,359.23","1,58,718.47",Transport
13-Sep-20,Reversal,"10,858.71",00.00,"1,69,577.18",Transport
13-Sep-20,Purchase,00.00,"42,394.30","1,27,182.88",Transport
13-Sep-20,Tax,00.00,"25,436.58","1,01,746.30",Transport
13-Sep-20,IMPS,00.60,00.00,"1,01,746.90",Transport
13-Sep-20,ATM,"15,92,296.50",00.00,"16,94,043.40",Transport
14-Sep-20,IMPS,"11,768.03",00.00,"17,05,811.43",Transport
14-Sep-20,ATM,00.00,"1,89,534.60","15,16,276.83",Transport
14-Sep-20,Debit Card,00.00,"3,03,255.37","12,13,021.46",Transport
14-Sep-20,Cash,00.00,"2,42,604.29","9,70,417.17",Transport
14-Sep-20,NEFT,"75,372.00",00.00,"10,45,789.17",Transport
14-Sep-20,ATM,00.00,"1,16,198.80","9,29,590.37",Transport
14-Sep-20,ATM,00.00,"1,54,931.73","7,74,658.64",Transport
14-Sep-20,Transfer,178.8,00.00,"7,74,837.44",Transport
14-Sep-20,Transfer,"4,54,054.25",00.00,"12,28,891.69",Transport
14-Sep-20,Reversal,126.44,00.00,"12,29,018.13",Transport
14-Sep-20,Bill,00.00,"1,36,557.57","10,92,460.56",Transport
14-Sep-20,IMPS,00.00,"1,56,065.79","9,36,394.77",Transport
14-Sep-20,ATM,00.00,"9,36,394.77",00.00,Transport
14-Sep-20,ATM,"20,11,523.00",00.00,"20,11,523.00",Transport
14-Sep-20,Reversal,00.00,"2,87,360.43","17,24,162.57",Transport
14-Sep-20,NEFT,00.00,"5,74,720.86","11,49,441.71",Transport
14-Sep-20,Tax,"1,47,138.00",00.00,"12,96,579.71",Transport
14-Sep-20,NEFT,00.00,"4,32,193.24","8,64,386.47",Transport
15-Sep-20,Tax,"1,53,857.00",00.00,"10,18,243.47",Transport
15-Sep-20,RTGS,00.00,"3,39,414.49","6,78,828.98",Transport
15-Sep-20,NEFT,00.00,"96,975.57","5,81,853.41",Transport
15-Sep-20,Transportellaneous,00.00,"1,45,463.35","4,36,390.06",Transport
15-Sep-20,ATM,00.00,"2,18,195.03","2,18,195.03",Transport
15-Sep-20,NEFT,"11,502.00",00.00,"2,29,697.03",Transport
16-Sep-20,Cheque,00.00,"28,712.13","2,00,984.90",Transport
16-Sep-20,Cheque,00.00,"2,00,984.90",00.00,Transport
16-Sep-20,Commission,426.28,00.00,426.28,Transport
16-Sep-20,Reversal,39.58,00.00,465.86,Transport
16-Sep-20,Transportellaneous,00.00,116.47,349.4,Transport
16-Sep-20,Bill,07.00,00.00,356.4,Transport
16-Sep-20,Cash,00.00,178.2,178.2,Transport
16-Sep-20,Commission,00.00,22.28,155.92,Transport
16-Sep-20,Debit Card,00.00,25.99,129.93,Transport
16-Sep-20,NEFT,00.58,00.00,130.51,Transport
16-Sep-20,Commission,"28,787.00",00.00,"28,917.51",Transport
16-Sep-20,Interest,00.00,"4,819.59","24,097.92",Transport
17-Sep-20,Interest,318.9,00.00,"24,416.82",Transport
17-Sep-20,Reversal,"16,168.60",00.00,"40,585.42",Transport
17-Sep-20,Interest,00.00,"4,509.49","36,075.93",Transport
17-Sep-20,Tax,00.00,"4,509.49","31,566.44",Transport
17-Sep-20,Cheque,00.00,"10,522.15","21,044.29",Transport
17-Sep-20,Debit Card,00.00,"2,338.25","18,706.04",Transport
17-Sep-20,Interest,"11,60,476.00",00.00,"11,79,182.04",Transport
17-Sep-20,Tax,00.30,00.00,"11,79,182.34",Transport
17-Sep-20,RTGS,00.00,"3,93,060.78","7,86,121.56",Transport
17-Sep-20,Bill,00.00,"1,31,020.26","6,55,101.30",Transport
17-Sep-20,Transportellaneous,00.40,00.00,"6,55,101.70",Transport
17-Sep-20,Debit Card,00.00,"65,510.17","5,89,591.53",Transport
17-Sep-20,IMPS,00.00,"2,94,795.77","2,94,795.76",Transport
17-Sep-20,Cheque,00.00,"58,959.15","2,35,836.61",Transport
17-Sep-20,Interest,40.57,00.00,"2,35,877.18",Transport
17-Sep-20,RTGS,00.00,"78,625.73","1,57,251.45",Transport
17-Sep-20,ATM,"7,15,719.00",00.00,"8,72,970.45",Transport
17-Sep-20,Transportellaneous,00.00,"1,45,495.08","7,27,475.38",Transport
17-Sep-20,Reversal,00.00,"1,45,495.08","5,81,980.30",Transport
17-Sep-20,Purchase,"11,287.04",00.00,"5,93,267.34",Transport
17-Sep-20,Tax,00.00,"59,326.73","5,33,940.61",Transport
17-Sep-20,Reversal,00.00,00.00,"5,33,940.61",Transport
17-Sep-20,IMPS,"3,280.00",00.00,"5,37,220.61",Transport
17-Sep-20,Debit Card,49.8,00.00,"5,37,270.41",Transport
17-Sep-20,NEFT,145,00.00,"5,37,415.41",Transport
17-Sep-20,Debit Card,00.00,"1,79,138.47","3,58,276.94",Transport
17-Sep-20,Tax,"14,395.00",00.00,"3,72,671.94",Transport
17-Sep-20,Bill,00.00,"37,267.19","3,35,404.75",Transport
17-Sep-20,Reversal,"1,10,750.03",00.00,"4,46,154.78",Transport
17-Sep-20,Cash,00.00,"44,615.48","4,01,539.30",Transport
17-Sep-20,Cash,"3,084.30",00.00,"4,04,623.60",Transport
17-Sep-20,Cheque,"5,12,883.50",00.00,"9,17,507.10",Transport
17-Sep-20,NEFT,"18,56,147.20",00.00,"27,73,654.30",Transport
17-Sep-20,Transportellaneous,00.00,"3,46,706.79","24,26,947.51",Transport
17-Sep-20,Interest,00.00,"6,06,736.88","18,20,210.63",Transport
17-Sep-20,ATM,00.00,"18,20,210.63",00.00,Transport
17-Sep-20,IMPS,"26,459.30",00.00,"26,459.30",Transport
17-Sep-20,Cheque,455,00.00,"26,914.30",Transport
17-Sep-20,Reversal,00.00,"5,382.86","21,531.44",Transport
17-Sep-20,Tax,"2,738.00",00.00,"24,269.44",Transport
17-Sep-20,Transportellaneous,00.00,"3,467.06","20,802.38",Transport
17-Sep-20,Cheque,03.10,00.00,"20,805.48",Transport
17-Sep-20,Tax,00.00,"2,600.69","18,204.79",Transport
17-Sep-20,Purchase,00.00,"4,551.20","13,653.59",Transport
17-Sep-20,IMPS,29,00.00,"13,682.59",Transport
17-Sep-20,ATM,00.00,"1,710.32","11,972.27",Transport
18-Sep-20,Transfer,00.50,00.00,"11,972.77",Transport
18-Sep-20,Reversal,"73,315.94",00.00,"85,288.71",Transport
18-Sep-20,RTGS,178,00.00,"85,466.71",Transport
18-Sep-20,Tax,40,00.00,"85,506.71",Transport
18-Sep-20,IMPS,01.00,00.00,"85,507.71",Transport
19-Sep-20,Cheque,00.00,"12,215.39","73,292.32",Transport
19-Sep-20,Interest,"3,908.28",00.00,"77,200.60",Transport
19-Sep-20,Tax,"26,704.81",00.00,"1,03,905.41",Transport
19-Sep-20,IMPS,00.00,"1,03,905.41",00.00,Transport
19-Sep-20,Bill,286.04,00.00,286.04,Transport
19-Sep-20,Debit Card,00.00,95.35,190.69,Transport
19-Sep-20,Debit Card,00.00,63.56,127.13,Transport
19-Sep-20,Transfer,"2,708.97",00.00,"2,836.10",Transport
19-Sep-20,IMPS,"1,04,688.00",00.00,"1,07,524.10",Transport
19-Sep-20,IMPS,00.00,"26,881.03","80,643.08",Transport
19-Sep-20,IMPS,191,00.00,"80,834.08",Transport
20-Sep-20,Bill,"4,951.00",00.00,"85,785.08",Transport
20-Sep-20,ATM,00.00,"28,595.03","57,190.05",Transport
20-Sep-20,Purchase,00.00,"6,354.45","50,835.60",Transport
20-Sep-20,Cheque,00.00,"10,167.12","40,668.48",Transport
20-Sep-20,Transportellaneous,00.00,"6,778.08","33,890.40",Transport
20-Sep-20,Cash,494.5,00.00,"34,384.90",Transport
20-Sep-20,Cash,05.00,00.00,"34,389.90",Transport
20-Sep-20,Cash,08.64,00.00,"34,398.54",Transport
20-Sep-20,Commission,00.00,"11,466.18","22,932.36",Transport
20-Sep-20,ATM,"76,524.00",00.00,"99,456.36",Transport
20-Sep-20,RTGS,"2,29,994.00",00.00,"3,29,450.36",Transport
20-Sep-20,NEFT,18.15,00.00,"3,29,468.51",Transport
20-Sep-20,Interest,00.00,"65,893.70","2,63,574.81",Transport
20-Sep-20,IMPS,"31,768.00",00.00,"2,95,342.81",Transport
20-Sep-20,Cash,112.86,00.00,"2,95,455.67",Transport
20-Sep-20,Purchase,77,00.00,"2,95,532.67",Transport
20-Sep-20,NEFT,00.00,"42,218.95","2,53,313.72",Transport
20-Sep-20,Cash,"3,920.23",00.00,"2,57,233.95",Transport
20-Sep-20,Transportellaneous,00.00,"51,446.79","2,05,787.16",Transport
20-Sep-20,Reversal,00.00,"41,157.43","1,64,629.73",Transport
20-Sep-20,RTGS,00.00,"82,314.87","82,314.87",Transport
20-Sep-20,Bill,07.30,00.00,"82,322.17",Transport
20-Sep-20,Transfer,00.00,"10,290.27","72,031.90",Transport
20-Sep-20,NEFT,98.6,00.00,"72,130.50",Transport
20-Sep-20,RTGS,00.00,"10,304.36","61,826.14",Transport
20-Sep-20,Reversal,00.00,"7,728.27","54,097.87",Transport
20-Sep-20,Cash,00.00,"7,728.27","46,369.60",Transport
20-Sep-20,NEFT,00.00,"5,796.20","40,573.40",Transport
20-Sep-20,Cheque,00.00,"5,796.20","34,777.20",Transport
20-Sep-20,Commission,07.00,00.00,"34,784.20",Transport
20-Sep-20,ATM,00.00,"17,392.10","17,392.10",Transport
20-Sep-20,Tax,00.00,"17,392.10",00.00,Transport
20-Sep-20,Debit Card,"1,13,373.80",00.00,"1,13,373.80",Transport
20-Sep-20,Reversal,00.00,"37,791.27","75,582.53",Transport
20-Sep-20,IMPS,00.00,"37,791.27","37,791.26",Transport
20-Sep-20,Transfer,"37,558.00",00.00,"75,349.26",Transport
20-Sep-20,Cheque,219.8,00.00,"75,569.06",Transport
20-Sep-20,Transportellaneous,"1,275.31",00.00,"76,844.37",Transport
20-Sep-20,Debit Card,"1,968.00",00.00,"78,812.37",Transport
20-Sep-20,Transfer,00.00,"19,703.09","59,109.28",Transport
20-Sep-20,IMPS,"16,57,443.75",00.00,"17,16,553.03",Transport
20-Sep-20,Transportellaneous,00.00,"2,45,221.86","14,71,331.17",Transport
20-Sep-20,Tax,45.88,00.00,"14,71,377.05",Transport
20-Sep-20,Transfer,00.00,"1,47,137.71","13,24,239.34",Transport
20-Sep-20,Transfer,60.88,00.00,"13,24,300.22",Transport
20-Sep-20,ATM,00.00,"1,65,537.53","11,58,762.69",Transport
20-Sep-20,NEFT,00.00,"5,79,381.35","5,79,381.34",Transport
20-Sep-20,Tax,07.06,00.00,"5,79,388.40",Transport
20-Sep-20,NEFT,00.00,"5,79,388.40",00.00,Transport
20-Sep-20,Transportellaneous,283,00.00,283,Transport
20-Sep-20,IMPS,00.00,94.33,188.67,Transport
21-Sep-20,NEFT,00.00,23.58,165.09,Transport
21-Sep-20,Reversal,00.60,00.00,165.69,Transport
21-Sep-20,Reversal,00.00,16.57,149.12,Transport
22-Sep-20,IMPS,458.7,00.00,607.82,Transport
22-Sep-20,Cash,07.20,00.00,615.02,Transport
22-Sep-20,Purchase,00.00,205.01,410.01,Transport
22-Sep-20,Commission,07.90,00.00,417.91,Transport
22-Sep-20,Interest,51.9,00.00,469.81,Transport
22-Sep-20,NEFT,00.00,117.45,352.36,Transport
22-Sep-20,Tax,55,00.00,407.36,Transport
22-Sep-20,Interest,02.00,00.00,409.36,Transport
22-Sep-20,NEFT,"15,939.00",00.00,"16,348.36",Transport
22-Sep-20,NEFT,00.00,"2,043.55","14,304.82",Transport
22-Sep-20,Commission,01.70,00.00,"14,306.52",Transport
22-Sep-20,Reversal,01.20,00.00,"14,307.72",Transport
22-Sep-20,RTGS,46.9,00.00,"14,354.62",Transport
22-Sep-20,Bill,"24,230.10",00.00,"38,584.72",Transport
22-Sep-20,Transportellaneous,41,00.00,"38,625.72",Transport
22-Sep-20,Tax,"2,12,382.80",00.00,"2,51,008.52",Transport
22-Sep-20,NEFT,00.00,"2,51,008.52",00.00,Transport
22-Sep-20,RTGS,01.82,00.00,01.82,Transport
22-Sep-20,Debit Card,00.00,00.23,01.59,Transport
22-Sep-20,Tax,00.00,00.27,01.33,Transport
22-Sep-20,IMPS,00.00,00.13,01.20,Transport
22-Sep-20,Transfer,00.00,00.40,00.80,Transport
22-Sep-20,ATM,"20,80,047.00",00.00,"20,80,047.80",Transport
22-Sep-20,Reversal,00.00,"5,20,011.95","15,60,035.85",Transport
22-Sep-20,Interest,00.00,"7,80,017.93","7,80,017.92",Transport
22-Sep-20,Cash,"35,064.80",00.00,"8,15,082.72",Transport
22-Sep-20,Commission,"31,664.00",00.00,"8,46,746.72",Transport
22-Sep-20,Cheque,187.2,00.00,"8,46,933.92",Transport
22-Sep-20,IMPS,"22,248.61",00.00,"8,69,182.53",Transport
22-Sep-20,Tax,21.96,00.00,"8,69,204.49",Transport
22-Sep-20,IMPS,377,00.00,"8,69,581.49",Transport
22-Sep-20,Tax,00.00,"1,24,225.93","7,45,355.56",Transport
22-Sep-20,Cash,00.00,"3,72,677.78","3,72,677.78",Transport
22-Sep-20,Transportellaneous,345,00.00,"3,73,022.78",Transport
22-Sep-20,NEFT,00.00,"46,627.85","3,26,394.93",Transport
22-Sep-20,Transfer,01.00,00.00,"3,26,395.93",Transport
22-Sep-20,Transportellaneous,00.00,"1,08,798.64","2,17,597.29",Transport
22-Sep-20,Transfer,"29,587.00",00.00,"2,47,184.29",Transport
22-Sep-20,Bill,"2,48,391.00",00.00,"4,95,575.29",Transport
22-Sep-20,Reversal,"25,655.88",00.00,"5,21,231.17",Transport
22-Sep-20,NEFT,"5,693.30",00.00,"5,26,924.47",Transport
22-Sep-20,Transportellaneous,00.00,"1,75,641.49","3,51,282.98",Transport
22-Sep-20,IMPS,03.00,00.00,"3,51,285.98",Transport
22-Sep-20,Reversal,04.54,00.00,"3,51,290.52",Transport
23-Sep-20,Bill,13,00.00,"3,51,303.52",Transport
23-Sep-20,RTGS,00.00,"35,130.35","3,16,173.17",Transport
23-Sep-20,NEFT,"2,49,104.09",00.00,"5,65,277.26",Transport
23-Sep-20,NEFT,14,00.00,"5,65,291.26",Transport
23-Sep-20,RTGS,15.1,00.00,"5,65,306.36",Transport
23-Sep-20,Bill,00.00,"94,217.73","4,71,088.63",Transport
23-Sep-20,Transfer,00.00,"47,108.86","4,23,979.77",Transport
23-Sep-20,Debit Card,00.00,"60,568.54","3,63,411.23",Transport
23-Sep-20,ATM,00.00,"1,21,137.08","2,42,274.15",Transport
23-Sep-20,Cheque,"15,80,179.00",00.00,"18,22,453.15",Transport
23-Sep-20,Transfer,00.00,"4,55,613.29","13,66,839.86",Transport
23-Sep-20,Cheque,"16,221.00",00.00,"13,83,060.86",Transport
23-Sep-20,RTGS,00.00,"1,72,882.61","12,10,178.25",Transport
23-Sep-20,Bill,"2,141.31",00.00,"12,12,319.56",Transport
23-Sep-20,Purchase,290,00.00,"12,12,609.56",Transport
23-Sep-20,Bill,"12,51,455.50",00.00,"24,64,065.06",Transport
23-Sep-20,Commission,25,00.00,"24,64,090.06",Transport
23-Sep-20,Commission,"18,45,833.00",00.00,"43,09,923.06",Transport
23-Sep-20,Tax,07.01,00.00,"43,09,930.07",Transport
23-Sep-20,Interest,00.00,"8,61,986.01","34,47,944.06",Transport
24-Sep-20,Transfer,"11,762.00",00.00,"34,59,706.06",Transport
24-Sep-20,RTGS,02.20,00.00,"34,59,708.26",Transport
24-Sep-20,RTGS,00.00,"4,32,463.53","30,27,244.73",Transport
24-Sep-20,Cash,57.86,00.00,"30,27,302.59",Transport
25-Sep-20,Interest,00.00,"3,02,730.26","27,24,572.33",Transport
25-Sep-20,Cheque,00.00,"13,62,286.17","13,62,286.16",Transport
25-Sep-20,RTGS,00.00,"1,94,612.31","11,67,673.85",Transport
25-Sep-20,Transportellaneous,00.00,"3,89,224.62","7,78,449.23",Transport
25-Sep-20,Transfer,00.00,"77,844.92","7,00,604.31",Transport
25-Sep-20,NEFT,00.00,"2,33,534.77","4,67,069.54",Transport
25-Sep-20,RTGS,150,00.00,"4,67,219.54",Transport
25-Sep-20,Tax,00.00,"1,55,739.85","3,11,479.69",Transport
25-Sep-20,Purchase,00.00,"77,869.92","2,33,609.77",Transport
25-Sep-20,RTGS,256.6,00.00,"2,33,866.37",Transport
25-Sep-20,Interest,"28,499.09",00.00,"2,62,365.46",Transport
25-Sep-20,RTGS,137.1,00.00,"2,62,502.56",Transport
25-Sep-20,Bill,00.00,"37,500.37","2,25,002.19",Transport
25-Sep-20,NEFT,"31,904.00",00.00,"2,56,906.19",Transport
25-Sep-20,Tax,00.00,"2,56,906.19",00.00,Transport
25-Sep-20,Cheque,387,00.00,387,Transport
25-Sep-20,Cheque,"1,10,390.00",00.00,"1,10,777.00",Transport
25-Sep-20,Reversal,00.00,"27,694.25","83,082.75",Transport
25-Sep-20,Debit Card,00.00,"11,868.96","71,213.79",Transport
25-Sep-20,Tax,00.00,"71,213.79",00.00,Transport
25-Sep-20,IMPS,"17,71,572.00",00.00,"17,71,572.00",Transport
25-Sep-20,Reversal,00.00,"2,21,446.50","15,50,125.50",Transport
25-Sep-20,NEFT,09.19,00.00,"15,50,134.69",Transport
25-Sep-20,Cash,00.00,"2,58,355.78","12,91,778.91",Transport
25-Sep-20,Cash,81.08,00.00,"12,91,859.99",Transport
25-Sep-20,IMPS,"3,11,841.00",00.00,"16,03,700.99",Transport
25-Sep-20,Bill,02.00,00.00,"16,03,702.99",Transport
25-Sep-20,Commission,00.00,"4,00,925.75","12,02,777.24",Transport
25-Sep-20,Reversal,00.00,"6,01,388.62","6,01,388.62",Transport
25-Sep-20,Commission,00.00,"1,20,277.72","4,81,110.90",Transport
25-Sep-20,Commission,597,00.00,"4,81,707.90",Transport
25-Sep-20,Bill,23,00.00,"4,81,730.90",Transport
25-Sep-20,Reversal,06.57,00.00,"4,81,737.47",Transport
26-Sep-20,IMPS,48,00.00,"4,81,785.47",Transport
26-Sep-20,Debit Card,00.00,"53,531.72","4,28,253.75",Transport
26-Sep-20,Tax,00.00,"71,375.63","3,56,878.12",Transport
26-Sep-20,Debit Card,280,00.00,"3,57,158.12",Transport
26-Sep-20,Debit Card,00.00,"59,526.35","2,97,631.77",Transport
26-Sep-20,Transfer,"1,87,367.72",00.00,"4,84,999.49",Transport
26-Sep-20,Cheque,354,00.00,"4,85,353.49",Transport
26-Sep-20,Transfer,00.00,"48,535.35","4,36,818.14",Transport
27-Sep-20,IMPS,"3,49,453.00",00.00,"7,86,271.14",Transport
27-Sep-20,NEFT,00.00,"87,363.46","6,98,907.68",Transport
27-Sep-20,Debit Card,06.00,00.00,"6,98,913.68",Transport
27-Sep-20,IMPS,00.00,"6,98,913.68",00.00,Transport
27-Sep-20,Transfer,316.87,00.00,316.87,Transport
27-Sep-20,Reversal,00.00,39.61,277.26,Transport
27-Sep-20,NEFT,"12,90,266.00",00.00,"12,90,543.26",Transport
27-Sep-20,Tax,00.00,"4,30,181.09","8,60,362.17",Transport
27-Sep-20,ATM,"1,84,328.40",00.00,"10,44,690.57",Transport
27-Sep-20,Purchase,"3,400.73",00.00,"10,48,091.30",Transport
27-Sep-20,IMPS,00.00,"1,49,727.33","8,98,363.97",Transport
27-Sep-20,Transfer,09.00,00.00,"8,98,372.97",Transport
27-Sep-20,Transfer,00.00,"1,12,296.62","7,86,076.35",Transport
27-Sep-20,Interest,00.00,"1,31,012.73","6,55,063.62",Transport
27-Sep-20,Transfer,00.00,"72,784.85","5,82,278.77",Transport
27-Sep-20,Transportellaneous,00.00,"72,784.85","5,09,493.92",Transport
27-Sep-20,Debit Card,00.00,"56,610.44","4,52,883.48",Transport
27-Sep-20,Commission,37.01,00.00,"4,52,920.49",Transport
27-Sep-20,Tax,00.00,"4,52,920.49",00.00,Transport
27-Sep-20,Tax,25.86,00.00,25.86,Transport
27-Sep-20,Interest,00.00,02.59,23.27,Transport
27-Sep-20,Cheque,00.00,03.88,19.39,Transport
27-Sep-20,Cash,00.00,04.85,14.54,Transport
27-Sep-20,Debit Card,00.00,01.82,12.72,Transport
27-Sep-20,RTGS,"2,237.00",00.00,"2,249.72",Transport
27-Sep-20,IMPS,01.47,00.00,"2,251.19",Transport
27-Sep-20,Reversal,00.00,750.4,"1,500.79",Transport
27-Sep-20,RTGS,"3,006.00",00.00,"4,506.79",Transport
27-Sep-20,NEFT,"25,219.00",00.00,"29,725.79",Transport
27-Sep-20,Bill,03.10,00.00,"29,728.89",Transport
27-Sep-20,Tax,"2,806.00",00.00,"32,534.89",Transport
27-Sep-20,Commission,00.00,"4,647.84","27,887.05",Transport
27-Sep-20,Interest,00.00,"3,983.86","23,903.19",Transport
27-Sep-20,Cash,00.00,"2,390.32","21,512.87",Transport
27-Sep-20,Reversal,00.00,"5,378.22","16,134.65",Transport
27-Sep-20,RTGS,"1,113.50",00.00,"17,248.15",Transport
27-Sep-20,Interest,00.00,"1,916.46","15,331.69",Transport
27-Sep-20,Cash,"1,079.00",00.00,"16,410.69",Transport
27-Sep-20,Cash,08.00,00.00,"16,418.69",Transport
27-Sep-20,Interest,"1,550.44",00.00,"17,969.13",Transport
27-Sep-20,Reversal,"20,280.42",00.00,"38,249.55",Transport
27-Sep-20,Interest,00.00,"6,374.93","31,874.63",Transport
27-Sep-20,Commission,360.1,00.00,"32,234.73",Transport
27-Sep-20,ATM,00.00,"6,446.95","25,787.78",Transport
27-Sep-20,Interest,00.00,"25,787.78",00.00,Transport
27-Sep-20,Interest,"14,38,178.00",00.00,"14,38,178.00",Transport
27-Sep-20,IMPS,25.4,00.00,"14,38,203.40",Transport
28-Sep-20,Debit Card,"27,682.11",00.00,"14,65,885.51",Transport
28-Sep-20,Reversal,00.00,"1,62,876.17","13,03,009.34",Transport
28-Sep-20,Debit Card,"13,41,141.00",00.00,"26,44,150.34",Transport
28-Sep-20,Transfer,00.00,"6,61,037.59","19,83,112.76",Transport
28-Sep-20,NEFT,"25,225.16",00.00,"20,08,337.92",Transport
28-Sep-20,Transportellaneous,00.00,"3,34,722.99","16,73,614.93",Transport
28-Sep-20,Transfer,409.5,00.00,"16,74,024.43",Transport
28-Sep-20,Bill,"9,32,894.00",00.00,"26,06,918.43",Transport
28-Sep-20,ATM,00.00,"6,51,729.61","19,55,188.82",Transport
28-Sep-20,NEFT,17,00.00,"19,55,205.82",Transport
28-Sep-20,Commission,00.00,"3,91,041.16","15,64,164.66",Transport
28-Sep-20,IMPS,"2,41,496.50",00.00,"18,05,661.16",Transport
28-Sep-20,Interest,16.2,00.00,"18,05,677.36",Transport
28-Sep-20,IMPS,00.00,"2,25,709.67","15,79,967.69",Transport
28-Sep-20,Cheque,05.00,00.00,"15,79,972.69",Transport
28-Sep-20,Cash,54,00.00,"15,80,026.69",Transport
28-Sep-20,Bill,02.76,00.00,"15,80,029.45",Transport
28-Sep-20,RTGS,00.00,"1,75,558.83","14,04,470.62",Transport
28-Sep-20,Cheque,90,00.00,"14,04,560.62",Transport
28-Sep-20,Purchase,55,00.00,"14,04,615.62",Transport
28-Sep-20,Interest,00.00,"1,40,461.56","12,64,154.06",Transport
28-Sep-20,Debit Card,00.00,"2,52,830.81","10,11,323.25",Transport
28-Sep-20,Transfer,29.35,00.00,"10,11,352.60",Transport
28-Sep-20,NEFT,00.00,"1,68,558.77","8,42,793.83",Transport
28-Sep-20,Cheque,"2,677.00",00.00,"8,45,470.83",Transport
28-Sep-20,RTGS,00.00,"93,941.20","7,51,529.63",Transport
28-Sep-20,Bill,00.00,"1,50,305.93","6,01,223.70",Transport
28-Sep-20,Commission,548.26,00.00,"6,01,771.96",Transport
28-Sep-20,Interest,00.00,"1,50,442.99","4,51,328.97",Transport
29-Sep-20,Reversal,00.00,"90,265.79","3,61,063.18",Transport
29-Sep-20,Transportellaneous,00.00,"1,80,531.59","1,80,531.59",Transport
29-Sep-20,Debit Card,00.00,"20,059.07","1,60,472.52",Transport
29-Sep-20,Interest,136,00.00,"1,60,608.52",Transport
29-Sep-20,IMPS,54,00.00,"1,60,662.52",Transport
29-Sep-20,IMPS,11,00.00,"1,60,673.52",Transport
29-Sep-20,Tax,"2,12,315.31",00.00,"3,72,988.83",Transport
29-Sep-20,Cash,00.00,"3,72,988.83",00.00,Transport
29-Sep-20,ATM,"30,827.81",00.00,"30,827.81",Transport
29-Sep-20,Cash,00.00,"4,403.97","26,423.84",Transport
29-Sep-20,Reversal,02.00,00.00,"26,425.84",Transport
29-Sep-20,Reversal,00.00,"5,285.17","21,140.67",Transport
29-Sep-20,RTGS,00.00,"3,020.10","18,120.57",Transport
29-Sep-20,NEFT,03.00,00.00,"18,123.57",Transport
29-Sep-20,Tax,00.00,"1,812.36","16,311.21",Transport
29-Sep-20,Interest,54.8,00.00,"16,366.01",Transport
29-Sep-20,ATM,02.70,00.00,"16,368.71",Transport
29-Sep-20,ATM,00.00,"2,728.12","13,640.59",Transport
29-Sep-20,Reversal,"1,275.77",00.00,"14,916.36",Transport
29-Sep-20,Debit Card,00.00,"2,130.91","12,785.45",Transport
29-Sep-20,IMPS,00.00,"3,196.36","9,589.09",Transport
29-Sep-20,Transportellaneous,00.00,"3,196.36","6,392.73",Transport
29-Sep-20,Commission,"47,878.00",00.00,"54,270.73",Transport
29-Sep-20,Reversal,"20,59,310.20",00.00,"21,13,580.93",Transport
29-Sep-20,Transfer,"10,209.50",00.00,"21,23,790.43",Transport
29-Sep-20,IMPS,06.61,00.00,"21,23,797.04",Transport
29-Sep-20,Tax,"45,636.20",00.00,"21,69,433.24",Transport
29-Sep-20,IMPS,50.8,00.00,"21,69,484.04",Transport
29-Sep-20,Transportellaneous,"2,695.17",00.00,"21,72,179.21",Transport
29-Sep-20,Reversal,"2,023.00",00.00,"21,74,202.21",Transport
29-Sep-20,ATM,"17,059.45",00.00,"21,91,261.66",Transport
29-Sep-20,IMPS,51,00.00,"21,91,312.66",Transport
29-Sep-20,Debit Card,401,00.00,"21,91,713.66",Transport
29-Sep-20,Cheque,"1,95,970.00",00.00,"23,87,683.66",Transport
29-Sep-20,Transfer,00.00,"23,87,683.66",00.00,Transport
29-Sep-20,RTGS,"24,190.90",00.00,"24,190.90",Transport
29-Sep-20,NEFT,"2,200.75",00.00,"26,391.65",Transport
29-Sep-20,Cheque,00.00,"2,639.17","23,752.48",Transport
29-Sep-20,NEFT,00.00,"5,938.12","17,814.36",Transport
29-Sep-20,Interest,60,00.00,"17,874.36",Transport
29-Sep-20,IMPS,00.00,"1,787.44","16,086.92",Transport
29-Sep-20,Transportellaneous,05.80,00.00,"16,092.72",Transport
29-Sep-20,Transfer,00.00,"4,023.18","12,069.54",Transport
29-Sep-20,Transportellaneous,407.6,00.00,"12,477.14",Transport
29-Sep-20,Commission,00.00,"2,495.43","9,981.71",Transport
29-Sep-20,Purchase,00.00,"1,425.96","8,555.75",Transport
29-Sep-20,Interest,00.00,"1,425.96","7,129.79",Transport
29-Sep-20,Debit Card,00.00,"2,376.60","4,753.19",Transport
29-Sep-20,Purchase,"36,520.20",00.00,"41,273.39",Transport
29-Sep-20,Tax,00.00,"8,254.68","33,018.71",Transport
29-Sep-20,Transportellaneous,53.69,00.00,"33,072.40",Transport
29-Sep-20,NEFT,00.00,"6,614.48","26,457.92",Transport
29-Sep-20,Cheque,"29,265.70",00.00,"55,723.62",Transport
29-Sep-20,Interest,00.00,"6,191.51","49,532.11",Transport
29-Sep-20,RTGS,304.6,00.00,"49,836.71",Transport
29-Sep-20,Bill,63.54,00.00,"49,900.25",Transport
29-Sep-20,Transfer,"28,711.00",00.00,"78,611.25",Transport
29-Sep-20,NEFT,07.10,00.00,"78,618.35",Transport
29-Sep-20,NEFT,00.00,"13,103.06","65,515.29",Transport
29-Sep-20,IMPS,00.00,"10,919.22","54,596.08",Transport
29-Sep-20,Reversal,66,00.00,"54,662.08",Transport
29-Sep-20,IMPS,00.00,"18,220.69","36,441.39",Transport
29-Sep-20,Tax,00.00,"3,644.14","32,797.25",Transport
29-Sep-20,Interest,"1,12,806.00",00.00,"1,45,603.25",Transport
29-Sep-20,NEFT,"3,066.00",00.00,"1,48,669.25",Transport
29-Sep-20,Transfer,00.00,"49,556.42","99,112.83",Transport
29-Sep-20,Reversal,00.00,"14,158.98","84,953.85",Transport
29-Sep-20,Debit Card,00.00,"84,953.85",00.00,Transport
29-Sep-20,RTGS,05.70,00.00,05.70,Transport
29-Sep-20,Debit Card,341,00.00,346.7,Transport
29-Sep-20,Tax,00.00,49.53,297.17,Transport
29-Sep-20,Debit Card,00.00,99.06,198.11,Transport
29-Sep-20,Transfer,114.8,00.00,312.91,Transport
29-Sep-20,Cash,"3,732.80",00.00,"4,045.71",Transport
29-Sep-20,Interest,00.00,674.29,"3,371.42",Transport
29-Sep-20,Cheque,00.00,"1,685.71","1,685.71",Transport
29-Sep-20,Cheque,"9,13,807.00",00.00,"9,15,492.71",Transport
29-Sep-20,IMPS,"1,85,059.00",00.00,"11,00,551.71",Transport
29-Sep-20,NEFT,00.00,"1,57,221.67","9,43,330.04",Transport
29-Sep-20,Interest,00.00,"2,35,832.51","7,07,497.53",Transport
29-Sep-20,Debit Card,"2,50,243.25",00.00,"9,57,740.78",Transport
29-Sep-20,NEFT,00.00,"1,36,820.11","8,20,920.67",Transport
29-Sep-20,NEFT,"3,69,211.50",00.00,"11,90,132.17",Transport
29-Sep-20,Tax,"9,11,899.20",00.00,"21,02,031.37",Transport
29-Sep-20,IMPS,00.00,"5,25,507.84","15,76,523.53",Transport
29-Sep-20,NEFT,451,00.00,"15,76,974.53",Transport
29-Sep-20,NEFT,00.00,"3,94,243.63","11,82,730.90",Transport
29-Sep-20,Commission,00.00,"1,47,841.36","10,34,889.54",Transport
29-Sep-20,Transfer,00.00,"1,47,841.36","8,87,048.18",Transport
29-Sep-20,RTGS,00.00,"2,21,762.05","6,65,286.14",Transport
29-Sep-20,Reversal,00.00,"1,66,321.54","4,98,964.60",Transport
29-Sep-20,Commission,"21,773.00",00.00,"5,20,737.60",Transport
29-Sep-20,Debit Card,"23,637.92",00.00,"5,44,375.52",Transport
29-Sep-20,Bill,39.48,00.00,"5,44,415.00",Transport
29-Sep-20,Transportellaneous,"10,374.20",00.00,"5,54,789.20",Transport
29-Sep-20,Interest,00.00,"5,54,789.20",00.00,Transport
29-Sep-20,Transfer,"26,576.75",00.00,"26,576.75",Transport
29-Sep-20,RTGS,"86,216.20",00.00,"1,12,792.95",Transport
29-Sep-20,Cash,00.00,"28,198.24","84,594.71",Transport
29-Sep-20,RTGS,00.00,"9,399.41","75,195.30",Transport
29-Sep-20,Purchase,00.00,"37,597.65","37,597.65",Transport
29-Sep-20,NEFT,00.00,"18,798.83","18,798.82",Transport
29-Sep-20,Bill,30,00.00,"18,828.82",Transport
29-Sep-20,ATM,00.00,"2,689.83","16,138.99",Transport
29-Sep-20,Transportellaneous,"1,58,255.50",00.00,"1,74,394.49",Transport
29-Sep-20,Bill,"2,40,281.00",00.00,"4,14,675.49",Transport
29-Sep-20,Reversal,"1,85,647.70",00.00,"6,00,323.19",Transport
29-Sep-20,Cheque,"4,60,045.00",00.00,"10,60,368.19",Transport
29-Sep-20,Transfer,00.00,"2,65,092.05","7,95,276.14",Transport
29-Sep-20,IMPS,03.70,00.00,"7,95,279.84",Transport
29-Sep-20,Transportellaneous,"2,36,055.06",00.00,"10,31,334.90",Transport
29-Sep-20,NEFT,00.00,"1,47,333.56","8,84,001.34",Transport
29-Sep-20,Interest,"11,16,914.00",00.00,"20,00,915.34",Transport
29-Sep-20,Tax,07.00,00.00,"20,00,922.34",Transport
29-Sep-20,Bill,298,00.00,"20,01,220.34",Transport
29-Sep-20,Debit Card,20.36,00.00,"20,01,240.70",Transport
29-Sep-20,Transportellaneous,"1,03,555.62",00.00,"21,04,796.32",Transport
29-Sep-20,NEFT,00.00,"2,10,479.63","18,94,316.69",Transport
29-Sep-20,Transportellaneous,"3,887.00",00.00,"18,98,203.69",Transport
29-Sep-20,Cheque,"1,59,222.25",00.00,"20,57,425.94",Transport
29-Sep-20,Tax,00.00,"3,42,904.32","17,14,521.62",Transport
29-Sep-20,Commission,00.00,"17,14,521.62",00.00,Transport
29-Sep-20,Debit Card,234,00.00,234,Transport
29-Sep-20,RTGS,00.00,26,208,Transport
29-Sep-20,Cash,04.85,00.00,212.85,Transport
29-Sep-20,Bill,00.00,70.95,141.9,Transport
29-Sep-20,Interest,00.00,47.3,94.6,Transport
29-Sep-20,Transfer,00.00,23.65,70.95,Transport
29-Sep-20,Debit Card,37.89,00.00,108.84,Transport
29-Sep-20,Cheque,00.00,12.09,96.75,Transport
29-Sep-20,NEFT,00.00,96.75,00.00,Transport
29-Sep-20,ATM,"20,27,135.00",00.00,"20,27,135.00",Transport
29-Sep-20,Cash,"2,085.00",00.00,"20,29,220.00",Transport
29-Sep-20,NEFT,206.6,00.00,"20,29,426.60",Transport
29-Sep-20,Interest,"19,216.91",00.00,"20,48,643.51",Transport
29-Sep-20,Reversal,00.00,"20,48,643.51",00.00,Transport
29-Sep-20,Transportellaneous,"26,489.31",00.00,"26,489.31",Transport
29-Sep-20,Debit Card,00.00,"5,297.86","21,191.45",Transport
29-Sep-20,Cheque,"9,52,533.50",00.00,"9,73,724.95",Transport
29-Sep-20,Bill,00.00,"1,21,715.62","8,52,009.33",Transport
29-Sep-20,NEFT,457.8,00.00,"8,52,467.13",Transport
29-Sep-20,Cash,00.00,"1,42,077.86","7,10,389.28",Transport
29-Sep-20,Bill,00.00,"3,55,194.64","3,55,194.64",Transport
29-Sep-20,Purchase,00.00,"3,55,194.64",00.00,Transport
29-Sep-20,Cheque,"1,63,385.25",00.00,"1,63,385.25",Transport
29-Sep-20,Interest,00.00,"18,153.92","1,45,231.33",Transport
29-Sep-20,Commission,"1,142.46",00.00,"1,46,373.79",Transport
29-Sep-20,IMPS,00.00,"16,263.75","1,30,110.04",Transport
29-Sep-20,Tax,00.00,"14,456.67","1,15,653.37",Transport
29-Sep-20,RTGS,"19,44,408.80",00.00,"20,60,062.17",Transport
29-Sep-20,NEFT,01.80,00.00,"20,60,063.97",Transport
29-Sep-20,ATM,00.00,"2,94,294.85","17,65,769.12",Transport
29-Sep-20,Interest,00.00,"2,20,721.14","15,45,047.98",Transport
29-Sep-20,Reversal,46,00.00,"15,45,093.98",Transport
29-Sep-20,Transportellaneous,34.87,00.00,"15,45,128.85",Transport
29-Sep-20,Debit Card,"20,82,417.25",00.00,"36,27,546.10",Transport
29-Sep-20,RTGS,00.00,"6,04,591.02","30,22,955.08",Transport
29-Sep-20,Transportellaneous,56.6,00.00,"30,23,011.68",Transport
29-Sep-20,Transportellaneous,"1,949.10",00.00,"30,24,960.78",Transport
29-Sep-20,Cash,318,00.00,"30,25,278.78",Transport
29-Sep-20,Cash,00.00,"3,02,527.88","27,22,750.90",Transport
29-Sep-20,Interest,00.00,"5,44,550.18","21,78,200.72",Transport
29-Sep-20,Cash,"1,26,482.90",00.00,"23,04,683.62",Transport
29-Sep-20,Cheque,00.00,"11,52,341.81","11,52,341.81",Transport
29-Sep-20,Tax,"13,19,137.00",00.00,"24,71,478.81",Transport
29-Sep-20,Reversal,00.00,"8,23,826.27","16,47,652.54",Transport
29-Sep-20,Transportellaneous,00.00,"2,05,956.57","14,41,695.97",Transport
29-Sep-20,Interest,"42,458.00",00.00,"14,84,153.97",Transport
29-Sep-20,Commission,00.00,"2,47,359.00","12,36,794.98",Transport
29-Sep-20,Transportellaneous,00.00,"3,09,198.75","9,27,596.24",Transport
29-Sep-20,Debit Card,05.00,00.00,"9,27,601.24",Transport
29-Sep-20,Purchase,00.00,"1,54,600.21","7,73,001.03",Transport
29-Sep-20,Interest,00.00,"85,889.00","6,87,112.03",Transport
29-Sep-20,NEFT,490.7,00.00,"6,87,602.73",Transport
29-Sep-20,Transfer,45.1,00.00,"6,87,647.83",Transport
29-Sep-20,ATM,00.00,"1,71,911.96","5,15,735.87",Transport
29-Sep-20,Transportellaneous,500,00.00,"5,16,235.87",Transport
30-Sep-20,ATM,00.00,"1,72,078.62","3,44,157.25",Transport
30-Sep-20,RTGS,"11,42,340.00",00.00,"14,86,497.25",Transport
30-Sep-20,Cheque,"18,13,731.00",00.00,"33,00,228.25",Transport
30-Sep-20,NEFT,20.65,00.00,"33,00,248.90",Transport
30-Sep-20,Bill,04.00,00.00,"33,00,252.90",Transport
30-Sep-20,Transfer,00.00,"3,30,025.29","29,70,227.61",Transport
01-Oct-20,Transfer,987.6,00.00,"29,71,215.21",Transport
01-Oct-20,Transfer,00.00,"3,30,135.02","26,41,080.19",Transport
01-Oct-20,RTGS,00.40,00.00,"26,41,080.59",Transport
01-Oct-20,Transfer,"7,97,401.50",00.00,"34,38,482.09",Transport
01-Oct-20,Purchase,360,00.00,"34,38,842.09",Transport
01-Oct-20,Transfer,00.00,"11,46,280.70","22,92,561.39",Transport
01-Oct-20,RTGS,"1,321.11",00.00,"22,93,882.50",Transport
01-Oct-20,ATM,"17,12,788.50",00.00,"40,06,671.00",Transport
01-Oct-20,Purchase,00.00,"40,06,671.00",00.00,Transport
01-Oct-20,RTGS,"32,316.22",00.00,"32,316.22",Transport
01-Oct-20,Debit Card,00.00,"3,231.62","29,084.60",Transport
01-Oct-20,Cash,00.00,"7,271.15","21,813.45",Transport
02-Oct-20,Reversal,08.17,00.00,"21,821.62",Transport
02-Oct-20,ATM,00.00,"7,273.87","14,547.75",Transport
02-Oct-20,Interest,00.00,"3,636.94","10,910.81",Transport
02-Oct-20,Reversal,"13,51,914.50",00.00,"13,62,825.31",Transport
02-Oct-20,Bill,"13,257.80",00.00,"13,76,083.11",Transport
02-Oct-20,Debit Card,355,00.00,"13,76,438.11",Transport
02-Oct-20,Bill,02.69,00.00,"13,76,440.80",Transport
02-Oct-20,Commission,"26,622.10",00.00,"14,03,062.90",Transport
02-Oct-20,Bill,"1,632.90",00.00,"14,04,695.80",Transport
02-Oct-20,Debit Card,00.00,00.00,"14,04,695.80",Transport
02-Oct-20,Bill,04.60,00.00,"14,04,700.40",Transport
02-Oct-20,Commission,"10,60,288.50",00.00,"24,64,988.90",Transport
02-Oct-20,Cheque,00.00,"8,21,662.97","16,43,325.93",Transport
02-Oct-20,Transfer,00.00,"4,10,831.48","12,32,494.45",Transport
02-Oct-20,Interest,07.90,00.00,"12,32,502.35",Transport
02-Oct-20,RTGS,317,00.00,"12,32,819.35",Transport
02-Oct-20,Debit Card,"59,515.25",00.00,"12,92,334.60",Transport
02-Oct-20,Cash,06.00,00.00,"12,92,340.60",Transport
02-Oct-20,RTGS,00.00,"3,23,085.15","9,69,255.45",Transport
02-Oct-20,Reversal,00.00,"1,21,156.93","8,48,098.52",Transport
02-Oct-20,Debit Card,00.00,"1,21,156.93","7,26,941.59",Transport
02-Oct-20,ATM,"1,57,870.00",00.00,"8,84,811.59",Transport
02-Oct-20,Cash,"2,16,275.50",00.00,"11,01,087.09",Transport
02-Oct-20,Transfer,00.00,"1,37,635.89","9,63,451.20",Transport
02-Oct-20,Cash,06.23,00.00,"9,63,457.43",Transport
02-Oct-20,Reversal,00.00,"1,60,576.24","8,02,881.19",Transport
03-Oct-20,Reversal,00.00,"2,67,627.06","5,35,254.13",Transport
03-Oct-20,NEFT,63.9,00.00,"5,35,318.03",Transport
03-Oct-20,IMPS,"31,656.60",00.00,"5,66,974.63",Transport
03-Oct-20,ATM,200,00.00,"5,67,174.63",Transport
03-Oct-20,Transfer,25.7,00.00,"5,67,200.33",Transport
03-Oct-20,Cheque,20.53,00.00,"5,67,220.86",Transport
03-Oct-20,Cash,00.00,"81,031.55","4,86,189.31",Transport
03-Oct-20,Tax,01.00,00.00,"4,86,190.31",Transport
03-Oct-20,Interest,"5,918.32",00.00,"4,92,108.63",Transport
03-Oct-20,IMPS,373.63,00.00,"4,92,482.26",Transport
03-Oct-20,NEFT,"19,59,690.25",00.00,"24,52,172.51",Transport
03-Oct-20,Reversal,00.00,"2,72,463.61","21,79,708.90",Transport
03-Oct-20,Transfer,"29,220.97",00.00,"22,08,929.87",Transport
03-Oct-20,Commission,00.00,"2,20,892.99","19,88,036.88",Transport
03-Oct-20,RTGS,00.00,"1,98,803.69","17,89,233.19",Transport
04-Oct-20,Debit Card,"3,243.00",00.00,"17,92,476.19",Transport
04-Oct-20,NEFT,00.00,"17,92,476.19",00.00,Transport
04-Oct-20,Commission,08.90,00.00,08.90,Transport
04-Oct-20,Reversal,25.4,00.00,34.3,Transport
04-Oct-20,Cheque,00.00,06.86,27.44,Transport
04-Oct-20,Debit Card,"2,901.10",00.00,"2,928.54",Transport
05-Oct-20,Purchase,"8,355.80",00.00,"11,284.34",Transport
05-Oct-20,ATM,00.00,"5,642.17","5,642.17",Transport
05-Oct-20,Reversal,"1,77,263.62",00.00,"1,82,905.79",Transport
05-Oct-20,Interest,"94,772.10",00.00,"2,77,677.89",Transport
05-Oct-20,Bill,"2,036.00",00.00,"2,79,713.89",Transport
05-Oct-20,RTGS,03.91,00.00,"2,79,717.80",Transport
05-Oct-20,Cheque,00.00,"31,079.76","2,48,638.04",Transport
05-Oct-20,Cash,51,00.00,"2,48,689.04",Transport
05-Oct-20,Interest,150,00.00,"2,48,839.04",Transport
05-Oct-20,RTGS,00.00,"24,883.90","2,23,955.14",Transport
05-Oct-20,Interest,00.00,"2,23,955.14",00.00,Transport
05-Oct-20,Reversal,35.64,00.00,35.64,Transport
05-Oct-20,Reversal,"2,02,089.00",00.00,"2,02,124.64",Transport
06-Oct-20,Cash,"2,446.00",00.00,"2,04,570.64",Transport
06-Oct-20,IMPS,"19,52,958.00",00.00,"21,57,528.64",Transport
06-Oct-20,Debit Card,"11,64,217.80",00.00,"33,21,746.44",Transport
06-Oct-20,ATM,00.00,"11,07,248.81","22,14,497.63",Transport
06-Oct-20,NEFT,"10,39,583.25",00.00,"32,54,080.88",Transport
06-Oct-20,Reversal,00.00,"3,61,564.54","28,92,516.34",Transport
06-Oct-20,Purchase,00.00,"4,82,086.06","24,10,430.28",Transport
06-Oct-20,Cheque,"17,11,514.50",00.00,"41,21,944.78",Transport
06-Oct-20,Cash,"11,790.50",00.00,"41,33,735.28",Transport
06-Oct-20,Bill,"2,30,454.50",00.00,"43,64,189.78",Transport
06-Oct-20,Commission,"1,18,920.00",00.00,"44,83,109.78",Transport
06-Oct-20,Transportellaneous,"13,81,942.00",00.00,"58,65,051.78",Transport
07-Oct-20,Transportellaneous,"31,604.00",00.00,"58,96,655.78",Transport
07-Oct-20,Bill,429.3,00.00,"58,97,085.08",Transport
07-Oct-20,Reversal,00.00,"19,65,695.03","39,31,390.05",Transport
07-Oct-20,Commission,00.00,"4,91,423.76","34,39,966.29",Transport
07-Oct-20,Cash,00.00,"4,91,423.76","29,48,542.53",Transport
07-Oct-20,Reversal,00.00,"14,74,271.27","14,74,271.26",Transport
07-Oct-20,Debit Card,11.81,00.00,"14,74,283.07",Transport
07-Oct-20,Cash,00.00,"7,37,141.54","7,37,141.54",Transport
08-Oct-20,Cheque,00.00,"81,904.62","6,55,236.92",Transport
08-Oct-20,RTGS,00.00,00.00,"6,55,236.92",Transport
08-Oct-20,NEFT,00.00,"2,18,412.31","4,36,824.61",Transport
08-Oct-20,Transfer,"29,239.10",00.00,"4,66,063.71",Transport
08-Oct-20,Bill,00.00,"66,580.53","3,99,483.18",Transport
08-Oct-20,Cash,00.00,"99,870.80","2,99,612.38",Transport
08-Oct-20,ATM,00.00,"42,801.77","2,56,810.61",Transport
08-Oct-20,Transportellaneous,00.00,"28,534.51","2,28,276.10",Transport
08-Oct-20,Purchase,00.20,00.00,"2,28,276.30",Transport
08-Oct-20,Cash,00.00,"32,610.90","1,95,665.40",Transport
08-Oct-20,IMPS,54.6,00.00,"1,95,720.00",Transport
08-Oct-20,Reversal,00.00,"21,746.67","1,73,973.33",Transport
08-Oct-20,Purchase,"2,811.70",00.00,"1,76,785.03",Transport
08-Oct-20,Bill,00.00,"44,196.26","1,32,588.77",Transport
08-Oct-20,ATM,00.00,"66,294.39","66,294.38",Transport
08-Oct-20,RTGS,00.00,"7,366.04","58,928.34",Transport
08-Oct-20,NEFT,00.00,"14,732.09","44,196.26",Transport
08-Oct-20,Purchase,00.00,"8,839.25","35,357.01",Transport
08-Oct-20,Transportellaneous,"1,711.07",00.00,"37,068.08",Transport
08-Oct-20,Commission,00.00,"6,178.01","30,890.07",Transport
08-Oct-20,Commission,00.00,"6,178.01","24,712.06",Transport
08-Oct-20,ATM,00.00,"4,942.41","19,769.65",Transport
08-Oct-20,Interest,00.00,"9,884.83","9,884.83",Transport
08-Oct-20,Transportellaneous,"16,05,005.50",00.00,"16,14,890.33",Transport
08-Oct-20,Interest,"60,627.70",00.00,"16,75,518.03",Transport
08-Oct-20,Debit Card,00.00,"1,67,551.80","15,07,966.23",Transport
08-Oct-20,IMPS,447.7,00.00,"15,08,413.93",Transport
08-Oct-20,RTGS,217.39,00.00,"15,08,631.32",Transport
08-Oct-20,IMPS,00.00,"1,88,578.92","13,20,052.40",Transport
08-Oct-20,ATM,00.00,"13,20,052.40",00.00,Transport
08-Oct-20,Purchase,10.6,00.00,10.6,Transport
08-Oct-20,Interest,00.00,03.53,07.07,Transport
08-Oct-20,RTGS,00.00,07.07,00.00,Transport
08-Oct-20,Reversal,"1,866.00",00.00,"1,866.00",Transport
08-Oct-20,Interest,00.00,266.57,"1,599.43",Transport
08-Oct-20,Commission,00.00,228.49,"1,370.94",Transport
08-Oct-20,Cash,"26,790.10",00.00,"28,161.04",Transport
09-Oct-20,Reversal,00.00,"3,520.13","24,640.91",Transport
09-Oct-20,Purchase,00.00,"8,213.64","16,427.27",Transport
09-Oct-20,Cash,00.00,"8,213.64","8,213.64",Transport
09-Oct-20,NEFT,00.00,"1,173.38","7,040.26",Transport
09-Oct-20,Bill,00.00,"7,040.26",00.00,Transport
09-Oct-20,Transportellaneous,59.9,00.00,59.9,Transport
09-Oct-20,Transportellaneous,"2,895.82",00.00,"2,955.72",Transport
10-Oct-20,RTGS,00.00,295.57,"2,660.15",Transport
10-Oct-20,Tax,00.00,532.03,"2,128.12",Transport
10-Oct-20,Cheque,00.00,266.02,"1,862.10",Transport
10-Oct-20,Tax,00.00,186.21,"1,675.89",Transport
10-Oct-20,NEFT,36,00.00,"1,711.89",Transport
10-Oct-20,Cash,00.00,342.38,"1,369.51",Transport
10-Oct-20,Interest,00.00,228.25,"1,141.26",Transport
10-Oct-20,NEFT,"3,305.00",00.00,"4,446.26",Transport
10-Oct-20,ATM,07.18,00.00,"4,453.44",Transport
10-Oct-20,IMPS,"11,981.60",00.00,"16,435.04",Transport
10-Oct-20,Tax,00.00,"1,826.12","14,608.92",Transport
10-Oct-20,Purchase,"4,070.00",00.00,"18,678.92",Transport
10-Oct-20,Tax,00.00,"3,735.78","14,943.14",Transport
10-Oct-20,Tax,02.60,00.00,"14,945.74",Transport
10-Oct-20,NEFT,00.00,"2,135.11","12,810.63",Transport
10-Oct-20,Bill,"17,48,768.50",00.00,"17,61,579.13",Transport
10-Oct-20,RTGS,00.00,"3,52,315.83","14,09,263.30",Transport
10-Oct-20,Commission,00.00,"1,40,926.33","12,68,336.97",Transport
10-Oct-20,Transfer,00.00,"2,53,667.39","10,14,669.58",Transport
10-Oct-20,Cash,"36,091.50",00.00,"10,50,761.08",Transport
10-Oct-20,ATM,28.8,00.00,"10,50,789.88",Transport
10-Oct-20,Transportellaneous,00.00,"1,31,348.74","9,19,441.14",Transport
10-Oct-20,Transportellaneous,"9,09,288.80",00.00,"18,28,729.94",Transport
10-Oct-20,Tax,00.00,"2,61,247.13","15,67,482.81",Transport
10-Oct-20,Bill,00.00,"1,95,935.35","13,71,547.46",Transport
10-Oct-20,IMPS,409.6,00.00,"13,71,957.06",Transport
10-Oct-20,Debit Card,00.00,"3,42,989.27","10,28,967.80",Transport
10-Oct-20,Commission,53.8,00.00,"10,29,021.60",Transport
10-Oct-20,Purchase,"15,11,425.20",00.00,"25,40,446.80",Transport
10-Oct-20,Cheque,"74,811.00",00.00,"26,15,257.80",Transport
10-Oct-20,Cash,04.00,00.00,"26,15,261.80",Transport
10-Oct-20,Commission,00.00,"13,07,630.90","13,07,630.90",Transport
10-Oct-20,Transfer,15.29,00.00,"13,07,646.19",Transport
10-Oct-20,Cash,00.00,"1,45,294.02","11,62,352.17",Transport
10-Oct-20,Cash,00.00,"1,29,150.24","10,33,201.93",Transport
10-Oct-20,RTGS,00.00,"3,44,400.64","6,88,801.29",Transport
10-Oct-20,Reversal,159,00.00,"6,88,960.29",Transport
10-Oct-20,NEFT,"23,263.80",00.00,"7,12,224.09",Transport
10-Oct-20,Purchase,"26,815.82",00.00,"7,39,039.91",Transport
10-Oct-20,NEFT,00.00,"3,69,519.96","3,69,519.96",Transport
10-Oct-20,IMPS,260.59,00.00,"3,69,780.55",Transport
10-Oct-20,Interest,22.19,00.00,"3,69,802.74",Transport
10-Oct-20,ATM,196.8,00.00,"3,69,999.54",Transport
10-Oct-20,Purchase,00.00,"3,69,999.54",00.00,Transport
10-Oct-20,RTGS,"1,26,521.70",00.00,"1,26,521.70",Transport
10-Oct-20,Commission,"2,337.00",00.00,"1,28,858.70",Transport
11-Oct-20,RTGS,00.00,"42,952.90","85,905.80",Transport
11-Oct-20,Reversal,00.00,"9,545.09","76,360.71",Transport
11-Oct-20,Bill,00.00,"15,272.14","61,088.57",Transport
11-Oct-20,IMPS,"20,102.80",00.00,"81,191.37",Transport
11-Oct-20,IMPS,"2,631.30",00.00,"83,822.67",Transport
11-Oct-20,Debit Card,"8,18,772.00",00.00,"9,02,594.67",Transport
11-Oct-20,Reversal,"1,95,918.40",00.00,"10,98,513.07",Transport
11-Oct-20,NEFT,"2,705.40",00.00,"11,01,218.47",Transport
11-Oct-20,Bill,00.00,"2,75,304.62","8,25,913.85",Transport
12-Oct-20,RTGS,"10,44,686.50",00.00,"18,70,600.35",Transport
12-Oct-20,Transportellaneous,00.00,"6,23,533.45","12,47,066.90",Transport
12-Oct-20,RTGS,"91,701.00",00.00,"13,38,767.90",Transport
12-Oct-20,Reversal,"18,760.31",00.00,"13,57,528.21",Transport
12-Oct-20,Transfer,00.00,"13,57,528.21",00.00,Transport
12-Oct-20,Transfer,"18,18,009.20",00.00,"18,18,009.20",Transport
12-Oct-20,Bill,17.5,00.00,"18,18,026.70",Transport
12-Oct-20,Purchase,"1,881.00",00.00,"18,19,907.70",Transport
12-Oct-20,ATM,00.00,"2,27,488.46","15,92,419.24",Transport
12-Oct-20,Reversal,103.4,00.00,"15,92,522.64",Transport
12-Oct-20,Purchase,00.00,"3,18,504.53","12,74,018.11",Transport
12-Oct-20,Transfer,"98,051.22",00.00,"13,72,069.33",Transport
12-Oct-20,Commission,00.00,"3,43,017.33","10,29,052.00",Transport
12-Oct-20,Reversal,436.7,00.00,"10,29,488.70",Transport
12-Oct-20,Commission,00.00,"1,02,948.87","9,26,539.83",Transport
12-Oct-20,ATM,00.00,"1,54,423.31","7,72,116.52",Transport
12-Oct-20,Bill,"1,30,783.00",00.00,"9,02,899.52",Transport
12-Oct-20,Transfer,00.00,"9,02,899.52",00.00,Transport
12-Oct-20,NEFT,09.80,00.00,09.80,Transport
12-Oct-20,ATM,00.00,01.96,07.84,Transport
12-Oct-20,Bill,"2,14,130.70",00.00,"2,14,138.54",Transport
12-Oct-20,Commission,00.00,"21,413.85","1,92,724.69",Transport
12-Oct-20,IMPS,00.00,"38,544.94","1,54,179.75",Transport
12-Oct-20,Tax,05.03,00.00,"1,54,184.78",Transport
12-Oct-20,Debit Card,00.00,"19,273.10","1,34,911.68",Transport
12-Oct-20,IMPS,"18,302.00",00.00,"1,53,213.68",Transport
12-Oct-20,Tax,52,00.00,"1,53,265.68",Transport
12-Oct-20,IMPS,00.00,"21,895.10","1,31,370.58",Transport
12-Oct-20,Tax,00.00,"1,31,370.58",00.00,Transport
12-Oct-20,Cash,06.00,00.00,06.00,Transport
12-Oct-20,Interest,472.42,00.00,478.42,Transport
12-Oct-20,Cash,"15,235.09",00.00,"15,713.51",Transport
13-Oct-20,Transportellaneous,00.00,"15,713.51",00.00,Transport
13-Oct-20,Debit Card,"20,24,270.20",00.00,"20,24,270.20",Transport
13-Oct-20,Transfer,00.00,"20,24,270.20",00.00,Transport
13-Oct-20,IMPS,384,00.00,384,Transport
13-Oct-20,Bill,74.64,00.00,458.64,Transport
14-Oct-20,RTGS,"28,748.80",00.00,"29,207.44",Transport
14-Oct-20,Reversal,"18,143.70",00.00,"47,351.14",Transport
14-Oct-20,Cheque,25.62,00.00,"47,376.76",Transport
14-Oct-20,Transfer,"24,436.00",00.00,"71,812.76",Transport
14-Oct-20,Interest,00.00,"10,258.97","61,553.79",Transport
14-Oct-20,Interest,00.00,"6,155.38","55,398.41",Transport
14-Oct-20,Purchase,00.00,"55,398.41",00.00,Transport
14-Oct-20,ATM,"69,482.94",00.00,"69,482.94",Transport
14-Oct-20,Cheque,"9,36,663.25",00.00,"10,06,146.19",Transport
14-Oct-20,Commission,00.00,"1,00,614.62","9,05,531.57",Transport
14-Oct-20,Cash,00.00,"1,81,106.31","7,24,425.26",Transport
14-Oct-20,Reversal,00.00,"80,491.70","6,43,933.56",Transport
14-Oct-20,Transportellaneous,00.00,"3,21,966.78","3,21,966.78",Transport
14-Oct-20,Purchase,273.6,00.00,"3,22,240.38",Transport
14-Oct-20,Cash,00.00,"32,224.04","2,90,016.34",Transport
14-Oct-20,RTGS,"2,38,942.00",00.00,"5,28,958.34",Transport
15-Oct-20,Purchase,00.00,"75,565.48","4,53,392.86",Transport
15-Oct-20,Transfer,"26,871.40",00.00,"4,80,264.26",Transport
15-Oct-20,Tax,188.74,00.00,"4,80,453.00",Transport
16-Oct-20,Debit Card,03.77,00.00,"4,80,456.77",Transport
16-Oct-20,Bill,"10,27,584.00",00.00,"15,08,040.77",Transport
16-Oct-20,RTGS,133.5,00.00,"15,08,174.27",Transport
16-Oct-20,Tax,00.00,"7,54,087.14","7,54,087.14",Transport
16-Oct-20,Interest,00.00,"83,787.46","6,70,299.68",Transport
16-Oct-20,RTGS,00.00,"3,35,149.84","3,35,149.84",Transport
16-Oct-20,Transfer,00.00,"1,11,716.61","2,23,433.23",Transport
16-Oct-20,NEFT,"8,24,880.80",00.00,"10,48,314.03",Transport
16-Oct-20,Interest,00.00,"1,04,831.40","9,43,482.63",Transport
16-Oct-20,Transportellaneous,"23,663.60",00.00,"9,67,146.23",Transport
16-Oct-20,Interest,"3,278.00",00.00,"9,70,424.23",Transport
16-Oct-20,Cash,00.00,"1,38,632.03","8,31,792.20",Transport
16-Oct-20,RTGS,"20,08,474.00",00.00,"28,40,266.20",Transport
16-Oct-20,Tax,"1,31,609.16",00.00,"29,71,875.36",Transport
16-Oct-20,Tax,00.00,"4,24,553.62","25,47,321.74",Transport
16-Oct-20,Interest,00.00,"12,73,660.87","12,73,660.87",Transport
16-Oct-20,Reversal,00.00,"1,41,517.87","11,32,143.00",Transport
16-Oct-20,RTGS,00.00,"3,77,381.00","7,54,762.00",Transport
17-Oct-20,Commission,00.00,"7,54,762.00",00.00,Transport
17-Oct-20,Commission,"11,80,234.00",00.00,"11,80,234.00",Transport
17-Oct-20,Bill,00.00,"1,96,705.67","9,83,528.33",Transport
17-Oct-20,ATM,"17,65,999.25",00.00,"27,49,527.58",Transport
18-Oct-20,Cheque,00.00,"6,87,381.90","20,62,145.68",Transport
18-Oct-20,Transfer,00.00,"5,15,536.42","15,46,609.26",Transport
18-Oct-20,Reversal,00.00,"15,46,609.26",00.00,Transport
18-Oct-20,Commission,"2,939.60",00.00,"2,939.60",Transport
18-Oct-20,Cash,15.43,00.00,"2,955.03",Transport
18-Oct-20,RTGS,00.00,591.01,"2,364.02",Transport
18-Oct-20,Transfer,00.00,"1,182.01","1,182.01",Transport
18-Oct-20,IMPS,"1,655.29",00.00,"2,837.30",Transport
18-Oct-20,Bill,"84,725.90",00.00,"87,563.20",Transport
18-Oct-20,ATM,00.00,"29,187.73","58,375.47",Transport
18-Oct-20,Purchase,00.00,"8,339.35","50,036.12",Transport
18-Oct-20,Transfer,00.00,"50,036.12",00.00,Transport
18-Oct-20,Purchase,"1,90,919.25",00.00,"1,90,919.25",Transport
18-Oct-20,Debit Card,00.00,"21,213.25","1,69,706.00",Transport
18-Oct-20,Cheque,00.00,"42,426.50","1,27,279.50",Transport
18-Oct-20,Commission,"14,67,707.20",00.00,"15,94,986.70",Transport
18-Oct-20,Reversal,00.00,"2,65,831.12","13,29,155.58",Transport
18-Oct-20,Interest,00.00,"13,29,155.58",00.00,Transport
18-Oct-20,Tax,503.7,00.00,503.7,Transport
18-Oct-20,Debit Card,00.00,167.9,335.8,Transport
18-Oct-20,Cash,01.61,00.00,337.41,Transport
18-Oct-20,Interest,"30,461.43",00.00,"30,798.84",Transport
18-Oct-20,IMPS,02.10,00.00,"30,800.94",Transport
18-Oct-20,NEFT,00.00,"6,160.19","24,640.75",Transport
18-Oct-20,Interest,15.84,00.00,"24,656.59",Transport
18-Oct-20,NEFT,"12,796.23",00.00,"37,452.82",Transport
18-Oct-20,Purchase,00.00,"4,681.60","32,771.22",Transport
18-Oct-20,Interest,"27,516.00",00.00,"60,287.22",Transport
18-Oct-20,Purchase,00.00,"10,047.87","50,239.35",Transport
18-Oct-20,Bill,00.00,"6,279.92","43,959.43",Transport
18-Oct-20,Bill,03.60,00.00,"43,963.03",Transport
18-Oct-20,Transportellaneous,00.00,"5,495.38","38,467.65",Transport
18-Oct-20,NEFT,"15,594.00",00.00,"54,061.65",Transport
18-Oct-20,Tax,00.00,"54,061.65",00.00,Transport
18-Oct-20,RTGS,"2,799.00",00.00,"2,799.00",Transport
18-Oct-20,Purchase,00.00,559.8,"2,239.20",Transport
18-Oct-20,Bill,"48,028.00",00.00,"50,267.20",Transport
18-Oct-20,NEFT,00.00,"6,283.40","43,983.80",Transport
18-Oct-20,Reversal,888.81,00.00,"44,872.61",Transport
18-Oct-20,Transfer,00.00,"4,985.85","39,886.76",Transport
18-Oct-20,Reversal,00.00,"4,985.85","34,900.92",Transport
18-Oct-20,Transfer,"2,704.40",00.00,"37,605.32",Transport
18-Oct-20,Debit Card,"3,994.40",00.00,"41,599.72",Transport
18-Oct-20,IMPS,00.00,"4,622.19","36,977.53",Transport
18-Oct-20,Bill,00.00,"3,697.75","33,279.78",Transport
19-Oct-20,Cash,00.00,"4,754.25","28,525.53",Transport
19-Oct-20,RTGS,00.00,"5,705.11","22,820.42",Transport
19-Oct-20,Debit Card,02.00,00.00,"22,822.42",Transport
19-Oct-20,Cheque,00.00,"5,705.61","17,116.81",Transport
19-Oct-20,Interest,"2,25,356.09",00.00,"2,42,472.90",Transport
19-Oct-20,Purchase,"19,97,358.50",00.00,"22,39,831.40",Transport
19-Oct-20,RTGS,00.00,"7,46,610.47","14,93,220.93",Transport
19-Oct-20,Commission,00.40,00.00,"14,93,221.33",Transport
19-Oct-20,Debit Card,"1,13,614.00",00.00,"16,06,835.33",Transport
19-Oct-20,Transportellaneous,00.00,"1,78,537.26","14,28,298.07",Transport
19-Oct-20,Debit Card,"2,434.00",00.00,"14,30,732.07",Transport
19-Oct-20,Reversal,00.00,"7,15,366.04","7,15,366.04",Transport
19-Oct-20,RTGS,"19,70,982.80",00.00,"26,86,348.84",Transport
19-Oct-20,Commission,14,00.00,"26,86,362.84",Transport
19-Oct-20,IMPS,00.00,"13,43,181.42","13,43,181.42",Transport
19-Oct-20,Bill,14,00.00,"13,43,195.42",Transport
19-Oct-20,Tax,00.00,"4,47,731.81","8,95,463.61",Transport
19-Oct-20,Cheque,00.00,"1,79,092.72","7,16,370.89",Transport
19-Oct-20,Cheque,00.31,00.00,"7,16,371.20",Transport
19-Oct-20,ATM,"2,971.58",00.00,"7,19,342.78",Transport
19-Oct-20,Debit Card,09.40,00.00,"7,19,352.18",Transport
19-Oct-20,NEFT,40.6,00.00,"7,19,392.78",Transport
19-Oct-20,Tax,00.00,"7,19,392.78",00.00,Transport
19-Oct-20,Commission,"13,21,076.00",00.00,"13,21,076.00",Transport
20-Oct-20,RTGS,"2,526.00",00.00,"13,23,602.00",Transport
20-Oct-20,Reversal,"30,404.00",00.00,"13,54,006.00",Transport
20-Oct-20,NEFT,00.00,"1,69,250.75","11,84,755.25",Transport
20-Oct-20,Purchase,"2,19,243.88",00.00,"14,03,999.13",Transport
20-Oct-20,Commission,00.00,"2,33,999.86","11,69,999.27",Transport
20-Oct-20,Interest,"78,886.10",00.00,"12,48,885.37",Transport
20-Oct-20,Cash,"25,639.10",00.00,"12,74,524.47",Transport
20-Oct-20,Cash,"1,83,933.20",00.00,"14,58,457.67",Transport
20-Oct-20,IMPS,87,00.00,"14,58,544.67",Transport
20-Oct-20,Tax,"3,686.52",00.00,"14,62,231.19",Transport
20-Oct-20,IMPS,"8,08,043.25",00.00,"22,70,274.44",Transport
20-Oct-20,Cash,"17,560.30",00.00,"22,87,834.74",Transport
20-Oct-20,Transportellaneous,00.00,"4,57,566.95","18,30,267.79",Transport
20-Oct-20,Transfer,37,00.00,"18,30,304.79",Transport
20-Oct-20,Interest,315.36,00.00,"18,30,620.15",Transport
20-Oct-20,Bill,418.94,00.00,"18,31,039.09",Transport
20-Oct-20,IMPS,450.35,00.00,"18,31,489.44",Transport
20-Oct-20,Transfer,00.00,"4,57,872.36","13,73,617.08",Transport
20-Oct-20,Transfer,"2,300.80",00.00,"13,75,917.88",Transport
20-Oct-20,Interest,00.00,"6,87,958.94","6,87,958.94",Transport
20-Oct-20,Cheque,"2,151.62",00.00,"6,90,110.56",Transport
20-Oct-20,IMPS,"1,26,556.00",00.00,"8,16,666.56",Transport
20-Oct-20,Cheque,"3,638.04",00.00,"8,20,304.60",Transport
20-Oct-20,Commission,00.00,"1,02,538.08","7,17,766.52",Transport
20-Oct-20,Tax,00.00,"71,776.65","6,45,989.87",Transport
20-Oct-20,Tax,300,00.00,"6,46,289.87",Transport
20-Oct-20,Cash,"88,871.00",00.00,"7,35,160.87",Transport
20-Oct-20,Bill,504,00.00,"7,35,664.87",Transport
20-Oct-20,ATM,00.00,"1,47,132.97","5,88,531.90",Transport
20-Oct-20,Debit Card,00.00,"84,075.99","5,04,455.91",Transport
20-Oct-20,Debit Card,02.00,00.00,"5,04,457.91",Transport
20-Oct-20,Reversal,00.00,"56,050.88","4,48,407.03",Transport
20-Oct-20,Reversal,00.00,"49,823.00","3,98,584.03",Transport
20-Oct-20,Interest,"2,826.00",00.00,"4,01,410.03",Transport
20-Oct-20,Transportellaneous,"20,52,957.00",00.00,"24,54,367.03",Transport
20-Oct-20,IMPS,22.17,00.00,"24,54,389.20",Transport
20-Oct-20,Cash,"14,449.17",00.00,"24,68,838.37",Transport
20-Oct-20,Transfer,00.00,"6,17,209.59","18,51,628.78",Transport
20-Oct-20,Reversal,00.00,"3,08,604.80","15,43,023.98",Transport
20-Oct-20,Interest,"1,85,432.25",00.00,"17,28,456.23",Transport
20-Oct-20,Tax,"6,228.50",00.00,"17,34,684.73",Transport
20-Oct-20,Cash,24.4,00.00,"17,34,709.13",Transport
20-Oct-20,Transfer,00.00,"1,73,470.91","15,61,238.22",Transport
20-Oct-20,Purchase,"3,400.96",00.00,"15,64,639.18",Transport
20-Oct-20,Cheque,00.00,"1,95,579.90","13,69,059.28",Transport
21-Oct-20,Reversal,00.00,"2,28,176.55","11,40,882.73",Transport
21-Oct-20,Purchase,00.00,"1,14,088.27","10,26,794.46",Transport
21-Oct-20,Purchase,"2,16,760.00",00.00,"12,43,554.46",Transport
21-Oct-20,Cheque,00.00,00.00,"12,43,554.46",Transport
21-Oct-20,IMPS,05.40,00.00,"12,43,559.86",Transport
21-Oct-20,Bill,01.10,00.00,"12,43,560.96",Transport
21-Oct-20,Debit Card,56,00.00,"12,43,616.96",Transport
21-Oct-20,Commission,07.20,00.00,"12,43,624.16",Transport
21-Oct-20,Transfer,"32,474.82",00.00,"12,76,098.98",Transport
21-Oct-20,Purchase,00.00,"1,41,788.78","11,34,310.20",Transport
21-Oct-20,Transportellaneous,00.00,"1,13,431.02","10,20,879.18",Transport
21-Oct-20,Cash,00.00,"2,04,175.84","8,16,703.34",Transport
21-Oct-20,ATM,"33,473.94",00.00,"8,50,177.28",Transport
21-Oct-20,Tax,"9,25,903.20",00.00,"17,76,080.48",Transport
21-Oct-20,ATM,475.12,00.00,"17,76,555.60",Transport
22-Oct-20,Bill,"26,026.40",00.00,"18,02,582.00",Transport
22-Oct-20,Interest,190.82,00.00,"18,02,772.82",Transport
22-Oct-20,Purchase,"2,27,122.28",00.00,"20,29,895.10",Transport
22-Oct-20,RTGS,00.00,"5,07,473.78","15,22,421.33",Transport
23-Oct-20,Debit Card,"21,349.97",00.00,"15,43,771.30",Transport
23-Oct-20,Debit Card,00.00,"5,14,590.43","10,29,180.87",Transport
23-Oct-20,Bill,01.20,00.00,"10,29,182.07",Transport
23-Oct-20,Transfer,01.62,00.00,"10,29,183.69",Transport
23-Oct-20,RTGS,00.00,"2,05,836.74","8,23,346.95",Transport
23-Oct-20,Interest,"3,480.94",00.00,"8,26,827.89",Transport
23-Oct-20,Bill,456.9,00.00,"8,27,284.79",Transport
23-Oct-20,NEFT,05.81,00.00,"8,27,290.60",Transport
23-Oct-20,Cheque,00.00,"1,65,458.12","6,61,832.48",Transport
23-Oct-20,RTGS,"14,06,907.50",00.00,"20,68,739.98",Transport
23-Oct-20,Transfer,06.20,00.00,"20,68,746.18",Transport
23-Oct-20,NEFT,"4,018.88",00.00,"20,72,765.06",Transport
23-Oct-20,Transportellaneous,19.13,00.00,"20,72,784.19",Transport
23-Oct-20,Transportellaneous,49.8,00.00,"20,72,833.99",Transport
23-Oct-20,Commission,00.00,"20,72,833.99",00.00,Transport
23-Oct-20,RTGS,06.44,00.00,06.44,Transport
23-Oct-20,Debit Card,00.00,01.07,05.37,Transport
23-Oct-20,Bill,"15,513.30",00.00,"15,518.67",Transport
23-Oct-20,Bill,00.00,"15,518.67",00.00,Transport
23-Oct-20,Commission,10,00.00,10,Transport
23-Oct-20,RTGS,00.00,01.11,08.89,Transport
23-Oct-20,RTGS,"15,99,244.50",00.00,"15,99,253.39",Transport
23-Oct-20,Bill,06.15,00.00,"15,99,259.54",Transport
23-Oct-20,Bill,30,00.00,"15,99,289.54",Transport
23-Oct-20,Tax,00.00,"2,28,469.93","13,70,819.61",Transport
23-Oct-20,Cash,54.65,00.00,"13,70,874.26",Transport
23-Oct-20,Bill,00.00,"13,70,874.26",00.00,Transport
23-Oct-20,Interest,"2,35,185.00",00.00,"2,35,185.00",Transport
23-Oct-20,Cheque,07.00,00.00,"2,35,192.00",Transport
23-Oct-20,Commission,337,00.00,"2,35,529.00",Transport
23-Oct-20,Interest,"13,47,114.00",00.00,"15,82,643.00",Transport
24-Oct-20,Cash,"2,36,511.50",00.00,"18,19,154.50",Transport
24-Oct-20,Debit Card,00.00,"9,09,577.25","9,09,577.25",Transport
24-Oct-20,Transfer,"1,199.50",00.00,"9,10,776.75",Transport
25-Oct-20,ATM,00.00,"9,10,776.75",00.00,Transport
25-Oct-20,Cash,"20,419.61",00.00,"20,419.61",Transport
25-Oct-20,Reversal,00.00,"4,083.92","16,335.69",Transport
25-Oct-20,Bill,293.39,00.00,"16,629.08",Transport
26-Oct-20,ATM,"1,49,938.00",00.00,"1,66,567.08",Transport
26-Oct-20,Commission,00.00,"27,761.18","1,38,805.90",Transport
26-Oct-20,IMPS,"24,413.21",00.00,"1,63,219.11",Transport
26-Oct-20,Purchase,"2,133.00",00.00,"1,65,352.11",Transport
26-Oct-20,Transfer,00.00,"33,070.42","1,32,281.69",Transport
26-Oct-20,Cash,00.00,"16,535.21","1,15,746.48",Transport
26-Oct-20,ATM,00.00,"11,574.65","1,04,171.83",Transport
26-Oct-20,Commission,440.22,00.00,"1,04,612.05",Transport
26-Oct-20,Debit Card,05.60,00.00,"1,04,617.65",Transport
26-Oct-20,Cheque,"31,329.60",00.00,"1,35,947.25",Transport
26-Oct-20,NEFT,"12,203.31",00.00,"1,48,150.56",Transport
26-Oct-20,Bill,"2,121.00",00.00,"1,50,271.56",Transport
26-Oct-20,Reversal,00.00,"75,135.78","75,135.78",Transport
26-Oct-20,Purchase,"3,076.00",00.00,"78,211.78",Transport
26-Oct-20,Interest,00.00,"7,821.18","70,390.60",Transport
26-Oct-20,Purchase,"32,748.56",00.00,"1,03,139.16",Transport
26-Oct-20,Transfer,"1,622.00",00.00,"1,04,761.16",Transport
26-Oct-20,Tax,"43,995.80",00.00,"1,48,756.96",Transport
26-Oct-20,Debit Card,00.00,"49,585.65","99,171.31",Transport
26-Oct-20,Cheque,263.5,00.00,"99,434.81",Transport
26-Oct-20,Reversal,00.00,"99,434.81",00.00,Transport
26-Oct-20,Transfer,"6,682.14",00.00,"6,682.14",Transport
26-Oct-20,Cash,02.70,00.00,"6,684.84",Transport
26-Oct-20,ATM,00.00,"2,228.28","4,456.56",Transport
26-Oct-20,RTGS,00.00,"1,114.14","3,342.42",Transport
26-Oct-20,IMPS,"6,50,196.00",00.00,"6,53,538.42",Transport
26-Oct-20,Purchase,00.00,"72,615.38","5,80,923.04",Transport
26-Oct-20,Reversal,00.00,"58,092.30","5,22,830.74",Transport
26-Oct-20,IMPS,00.00,"1,04,566.15","4,18,264.59",Transport
26-Oct-20,Debit Card,07.00,00.00,"4,18,271.59",Transport
26-Oct-20,NEFT,00.00,"4,18,271.59",00.00,Transport
26-Oct-20,RTGS,"8,586.00",00.00,"8,586.00",Transport
26-Oct-20,Purchase,171.26,00.00,"8,757.26",Transport
26-Oct-20,Cheque,00.00,973.03,"7,784.23",Transport
26-Oct-20,ATM,"16,35,429.75",00.00,"16,43,213.98",Transport
26-Oct-20,Cash,00.00,"2,34,744.85","14,08,469.13",Transport
26-Oct-20,Commission,00.00,"1,56,496.57","12,51,972.56",Transport
26-Oct-20,Purchase,00.00,"1,39,108.06","11,12,864.50",Transport
26-Oct-20,Interest,00.00,"1,85,477.42","9,27,387.08",Transport
26-Oct-20,IMPS,00.00,"1,54,564.51","7,72,822.57",Transport
26-Oct-20,IMPS,"19,488.00",00.00,"7,92,310.57",Transport
26-Oct-20,Debit Card,"10,085.00",00.00,"8,02,395.57",Transport
26-Oct-20,Debit Card,00.00,"8,02,395.57",00.00,Transport
26-Oct-20,Debit Card,286,00.00,286,Transport
26-Oct-20,Debit Card,00.00,286,00.00,Transport
26-Oct-20,Cheque,"1,00,565.40",00.00,"1,00,565.40",Transport
26-Oct-20,RTGS,00.00,"33,521.80","67,043.60",Transport
26-Oct-20,Reversal,00.00,"7,449.29","59,594.31",Transport
26-Oct-20,Cash,246.4,00.00,"59,840.71",Transport
26-Oct-20,Reversal,06.00,00.00,"59,846.71",Transport
26-Oct-20,Bill,60.1,00.00,"59,906.81",Transport
26-Oct-20,Reversal,"2,25,474.90",00.00,"2,85,381.71",Transport
26-Oct-20,IMPS,00.48,00.00,"2,85,382.19",Transport
26-Oct-20,Commission,00.00,"2,85,382.19",00.00,Transport
26-Oct-20,IMPS,34,00.00,34,Transport
26-Oct-20,Bill,00.00,03.78,30.22,Transport
26-Oct-20,Cash,00.00,04.32,25.9,Transport
26-Oct-20,Debit Card,02.34,00.00,28.24,Transport
26-Oct-20,Debit Card,"3,210.23",00.00,"3,238.47",Transport
26-Oct-20,Tax,"2,070.70",00.00,"5,309.17",Transport
26-Oct-20,Reversal,00.76,00.00,"5,309.93",Transport
26-Oct-20,Cheque,00.00,884.99,"4,424.94",Transport
26-Oct-20,Cash,"1,91,658.75",00.00,"1,96,083.69",Transport
26-Oct-20,Cheque,00.00,"28,011.96","1,68,071.73",Transport
26-Oct-20,NEFT,00.00,"16,807.17","1,51,264.56",Transport
26-Oct-20,Reversal,182.88,00.00,"1,51,447.44",Transport
26-Oct-20,RTGS,163.6,00.00,"1,51,611.04",Transport
26-Oct-20,Commission,00.00,"16,845.67","1,34,765.37",Transport
26-Oct-20,Debit Card,354.4,00.00,"1,35,119.77",Transport
26-Oct-20,Purchase,00.60,00.00,"1,35,120.37",Transport
26-Oct-20,ATM,320.43,00.00,"1,35,440.80",Transport
26-Oct-20,NEFT,00.00,"16,930.10","1,18,510.70",Transport
26-Oct-20,ATM,00.00,"19,751.78","98,758.92",Transport
26-Oct-20,IMPS,"19,976.40",00.00,"1,18,735.32",Transport
26-Oct-20,Bill,"16,260.10",00.00,"1,34,995.42",Transport
26-Oct-20,Reversal,00.00,"33,748.86","1,01,246.56",Transport
26-Oct-20,Cheque,"1,60,689.00",00.00,"2,61,935.56",Transport
26-Oct-20,Cheque,"26,546.00",00.00,"2,88,481.56",Transport
26-Oct-20,NEFT,00.00,"96,160.52","1,92,321.04",Transport
26-Oct-20,IMPS,00.00,"27,474.43","1,64,846.61",Transport
26-Oct-20,Tax,00.00,"20,605.83","1,44,240.78",Transport
26-Oct-20,Transportellaneous,"2,53,841.75",00.00,"3,98,082.53",Transport
26-Oct-20,Reversal,00.00,"66,347.09","3,31,735.44",Transport
26-Oct-20,Purchase,"20,973.74",00.00,"3,52,709.18",Transport
26-Oct-20,Interest,00.00,"39,189.91","3,13,519.27",Transport
27-Oct-20,Interest,00.00,"78,379.82","2,35,139.45",Transport
27-Oct-20,Purchase,"25,291.90",00.00,"2,60,431.35",Transport
27-Oct-20,Interest,00.00,"1,30,215.68","1,30,215.68",Transport
27-Oct-20,Cash,"7,19,858.00",00.00,"8,50,073.68",Transport
27-Oct-20,RTGS,00.00,"1,21,439.10","7,28,634.58",Transport
27-Oct-20,Tax,"17,18,160.00",00.00,"24,46,794.58",Transport
27-Oct-20,Transfer,131.3,00.00,"24,46,925.88",Transport
27-Oct-20,RTGS,00.00,"3,05,865.74","21,41,060.14",Transport
27-Oct-20,Transportellaneous,"1,763.00",00.00,"21,42,823.14",Transport
27-Oct-20,Debit Card,"73,880.34",00.00,"22,16,703.48",Transport
27-Oct-20,Cheque,04.00,00.00,"22,16,707.48",Transport
27-Oct-20,ATM,00.00,"11,08,353.74","11,08,353.74",Transport
27-Oct-20,Transportellaneous,00.00,"1,10,835.37","9,97,518.37",Transport
27-Oct-20,Reversal,00.00,"4,98,759.19","4,98,759.18",Transport
27-Oct-20,Purchase,00.00,"49,875.92","4,48,883.26",Transport
27-Oct-20,Commission,00.00,"64,126.18","3,84,757.08",Transport
27-Oct-20,ATM,00.00,"1,92,378.54","1,92,378.54",Transport
27-Oct-20,Cash,404.52,00.00,"1,92,783.06",Transport
27-Oct-20,IMPS,826,00.00,"1,93,609.06",Transport
27-Oct-20,RTGS,"54,312.00",00.00,"2,47,921.06",Transport
27-Oct-20,RTGS,313,00.00,"2,48,234.06",Transport
27-Oct-20,Cash,00.00,"62,058.52","1,86,175.54",Transport
27-Oct-20,Purchase,00.00,"26,596.51","1,59,579.03",Transport
27-Oct-20,Purchase,00.00,"26,596.51","1,32,982.52",Transport
27-Oct-20,Cash,00.00,"16,622.82","1,16,359.70",Transport
27-Oct-20,Transfer,407.99,00.00,"1,16,767.69",Transport
27-Oct-20,Bill,00.00,"38,922.56","77,845.13",Transport
27-Oct-20,Purchase,00.00,"77,845.13",00.00,Transport
27-Oct-20,Tax,"18,845.59",00.00,"18,845.59",Transport
27-Oct-20,Purchase,00.00,"2,355.70","16,489.89",Transport
27-Oct-20,Transportellaneous,00.00,"2,355.70","14,134.19",Transport
27-Oct-20,Commission,00.00,"4,711.40","9,422.79",Transport
27-Oct-20,Tax,00.00,"1,046.98","8,375.81",Transport
27-Oct-20,Reversal,"6,564.32",00.00,"14,940.13",Transport
27-Oct-20,Cash,00.00,"14,940.13",00.00,Transport
27-Oct-20,Cheque,02.00,00.00,02.00,Transport
27-Oct-20,Debit Card,00.00,00.20,01.80,Transport
27-Oct-20,Reversal,43,00.00,44.8,Transport
27-Oct-20,Interest,00.00,11.2,33.6,Transport
27-Oct-20,Transportellaneous,01.00,00.00,34.6,Transport
27-Oct-20,Cash,"53,513.00",00.00,"53,547.60",Transport
27-Oct-20,Cheque,196.3,00.00,"53,743.90",Transport
27-Oct-20,IMPS,"13,08,568.50",00.00,"13,62,312.40",Transport
27-Oct-20,Debit Card,00.00,"1,94,616.06","11,67,696.34",Transport
27-Oct-20,Transportellaneous,00.00,"3,89,232.11","7,78,464.23",Transport
27-Oct-20,Cheque,00.00,"77,846.42","7,00,617.81",Transport
27-Oct-20,NEFT,00.00,"1,16,769.64","5,83,848.18",Transport
27-Oct-20,Cash,"12,62,995.25",00.00,"18,46,843.43",Transport
27-Oct-20,Debit Card,53.3,00.00,"18,46,896.73",Transport
27-Oct-20,Transfer,42.9,00.00,"18,46,939.63",Transport
27-Oct-20,NEFT,112.81,00.00,"18,47,052.44",Transport
27-Oct-20,Reversal,"1,09,883.00",00.00,"19,56,935.44",Transport
27-Oct-20,IMPS,00.00,"19,56,935.44",00.00,Transport
27-Oct-20,ATM,"8,16,948.00",00.00,"8,16,948.00",Transport
27-Oct-20,Transfer,00.00,"4,08,474.00","4,08,474.00",Transport
27-Oct-20,ATM,00.00,"68,079.00","3,40,395.00",Transport
27-Oct-20,Interest,00.00,"3,40,395.00",00.00,Transport
27-Oct-20,Cash,41,00.00,41,Transport
27-Oct-20,RTGS,"1,26,488.60",00.00,"1,26,529.60",Transport
27-Oct-20,Tax,07.88,00.00,"1,26,537.48",Transport
27-Oct-20,Interest,00.00,"31,634.37","94,903.11",Transport
27-Oct-20,RTGS,02.40,00.00,"94,905.51",Transport
27-Oct-20,Interest,00.00,"15,817.59","79,087.92",Transport
27-Oct-20,NEFT,"2,34,187.91",00.00,"3,13,275.83",Transport
27-Oct-20,IMPS,00.00,"78,318.96","2,34,956.87",Transport
27-Oct-20,Transfer,00.00,"1,17,478.44","1,17,478.44",Transport
27-Oct-20,IMPS,"8,716.41",00.00,"1,26,194.85",Transport
27-Oct-20,IMPS,00.00,"12,619.49","1,13,575.36",Transport
27-Oct-20,Reversal,01.50,00.00,"1,13,576.86",Transport
27-Oct-20,RTGS,00.00,"1,13,576.86",00.00,Transport
27-Oct-20,Bill,37.9,00.00,37.9,Transport
27-Oct-20,Transportellaneous,07.60,00.00,45.5,Transport
27-Oct-20,NEFT,00.00,06.50,39,Transport
27-Oct-20,Cheque,75,00.00,114,Transport
27-Oct-20,RTGS,"14,18,224.00",00.00,"14,18,338.00",Transport
27-Oct-20,Interest,00.00,"4,72,779.33","9,45,558.67",Transport
27-Oct-20,Interest,"3,371.00",00.00,"9,48,929.67",Transport
27-Oct-20,Transportellaneous,00.00,"1,89,785.93","7,59,143.74",Transport
27-Oct-20,Commission,"13,535.18",00.00,"7,72,678.92",Transport
27-Oct-20,Reversal,02.00,00.00,"7,72,680.92",Transport
27-Oct-20,Debit Card,00.00,"85,853.44","6,86,827.48",Transport
27-Oct-20,Reversal,370.61,00.00,"6,87,198.09",Transport
27-Oct-20,Reversal,"1,44,198.50",00.00,"8,31,396.59",Transport
27-Oct-20,Cheque,"18,90,926.25",00.00,"27,22,322.84",Transport
27-Oct-20,Bill,05.73,00.00,"27,22,328.57",Transport
27-Oct-20,Commission,192,00.00,"27,22,520.57",Transport
27-Oct-20,Transportellaneous,00.00,"3,88,931.51","23,33,589.06",Transport
27-Oct-20,Commission,"13,593.00",00.00,"23,47,182.06",Transport
27-Oct-20,Reversal,"1,447.02",00.00,"23,48,629.08",Transport
27-Oct-20,Debit Card,00.00,"3,91,438.18","19,57,190.90",Transport
27-Oct-20,Tax,00.00,"19,57,190.90",00.00,Transport
27-Oct-20,Reversal,"8,43,988.25",00.00,"8,43,988.25",Transport
27-Oct-20,Reversal,60.91,00.00,"8,44,049.16",Transport
27-Oct-20,Cash,00.00,"8,44,049.16",00.00,Transport
27-Oct-20,Interest,44.7,00.00,44.7,Transport
27-Oct-20,Reversal,"19,927.90",00.00,"19,972.60",Transport
27-Oct-20,RTGS,05.08,00.00,"19,977.68",Transport
28-Oct-20,Interest,"59,816.59",00.00,"79,794.27",Transport
28-Oct-20,NEFT,00.00,"15,958.85","63,835.42",Transport
28-Oct-20,Commission,00.00,"15,958.86","47,876.56",Transport
28-Oct-20,Cash,500.3,00.00,"48,376.86",Transport
28-Oct-20,NEFT,00.00,"5,375.21","43,001.65",Transport
28-Oct-20,NEFT,"2,252.00",00.00,"45,253.65",Transport
28-Oct-20,IMPS,160.06,00.00,"45,413.71",Transport
28-Oct-20,NEFT,00.00,"7,568.95","37,844.76",Transport
28-Oct-20,Commission,"1,310.52",00.00,"39,155.28",Transport
28-Oct-20,IMPS,28.4,00.00,"39,183.68",Transport
28-Oct-20,Interest,00.00,"5,597.67","33,586.01",Transport
28-Oct-20,Transfer,107.6,00.00,"33,693.61",Transport
28-Oct-20,Debit Card,00.00,"5,615.60","28,078.01",Transport
28-Oct-20,Reversal,"97,060.40",00.00,"1,25,138.41",Transport
28-Oct-20,Reversal,00.00,"41,712.80","83,425.61",Transport
28-Oct-20,Transfer,00.00,"83,425.61",00.00,Transport
28-Oct-20,Tax,"28,650.09",00.00,"28,650.09",Transport
28-Oct-20,Commission,02.60,00.00,"28,652.69",Transport
28-Oct-20,Transfer,00.00,"5,730.54","22,922.15",Transport
28-Oct-20,Cheque,00.00,"5,730.54","17,191.61",Transport
28-Oct-20,Transfer,00.00,"17,191.61",00.00,Transport
28-Oct-20,Cheque,62,00.00,62,Transport
28-Oct-20,ATM,"2,38,717.20",00.00,"2,38,779.20",Transport
28-Oct-20,RTGS,00.00,"47,755.84","1,91,023.36",Transport
28-Oct-20,Cheque,00.00,"95,511.68","95,511.68",Transport
28-Oct-20,Reversal,"23,141.82",00.00,"1,18,653.50",Transport
28-Oct-20,Transportellaneous,"7,278.00",00.00,"1,25,931.50",Transport
28-Oct-20,Transportellaneous,00.00,"41,977.17","83,954.33",Transport
28-Oct-20,Cheque,00.00,"11,993.48","71,960.85",Transport
28-Oct-20,Bill,00.00,"35,980.43","35,980.43",Transport
28-Oct-20,Cash,00.00,"17,990.22","17,990.22",Transport
28-Oct-20,Interest,"11,958.00",00.00,"29,948.22",Transport
28-Oct-20,Commission,00.00,"7,487.06","22,461.16",Transport
28-Oct-20,Transportellaneous,29.25,00.00,"22,490.41",Transport
29-Oct-20,NEFT,00.00,"11,245.21","11,245.20",Transport
29-Oct-20,RTGS,"2,819.60",00.00,"14,064.80",Transport
29-Oct-20,Transfer,00.00,"2,009.26","12,055.54",Transport
29-Oct-20,Bill,128.1,00.00,"12,183.64",Transport
29-Oct-20,Reversal,63,00.00,"12,246.64",Transport
29-Oct-20,NEFT,"2,206.90",00.00,"14,453.54",Transport
29-Oct-20,Cheque,"21,461.00",00.00,"35,914.54",Transport
29-Oct-20,Tax,00.00,"5,130.65","30,783.89",Transport
29-Oct-20,Transportellaneous,00.00,"4,397.70","26,386.19",Transport
29-Oct-20,Purchase,21,00.00,"26,407.19",Transport
29-Oct-20,RTGS,00.00,"2,934.13","23,473.06",Transport
29-Oct-20,NEFT,"2,87,356.00",00.00,"3,10,829.06",Transport
29-Oct-20,Debit Card,"1,712.00",00.00,"3,12,541.06",Transport
29-Oct-20,RTGS,00.00,"3,12,541.06",00.00,Transport
29-Oct-20,ATM,"9,99,784.75",00.00,"9,99,784.75",Transport
29-Oct-20,Transportellaneous,00.00,"1,24,973.09","8,74,811.66",Transport
29-Oct-20,NEFT,"14,22,238.00",00.00,"22,97,049.66",Transport
29-Oct-20,RTGS,00.00,"3,28,149.95","19,68,899.71",Transport
29-Oct-20,RTGS,00.00,"9,84,449.86","9,84,449.86",Transport
29-Oct-20,ATM,00.00,"1,23,056.23","8,61,393.63",Transport
29-Oct-20,Transfer,49.3,00.00,"8,61,442.93",Transport
29-Oct-20,Cash,00.00,"4,30,721.47","4,30,721.46",Transport
29-Oct-20,Reversal,00.00,"1,07,680.37","3,23,041.10",Transport
29-Oct-20,Transfer,00.00,"1,07,680.37","2,15,360.73",Transport
29-Oct-20,Purchase,00.00,"30,765.82","1,84,594.91",Transport
29-Oct-20,Bill,00.00,"20,510.55","1,64,084.36",Transport
29-Oct-20,NEFT,"3,392.00",00.00,"1,67,476.36",Transport
29-Oct-20,ATM,00.00,"41,869.09","1,25,607.27",Transport
29-Oct-20,Bill,98.82,00.00,"1,25,706.09",Transport
29-Oct-20,Cheque,00.00,"31,426.52","94,279.57",Transport
29-Oct-20,Transportellaneous,00.00,"47,139.79","47,139.78",Transport
29-Oct-20,Debit Card,00.00,"4,713.98","42,425.80",Transport
29-Oct-20,RTGS,00.00,"42,425.80",00.00,Transport
29-Oct-20,Reversal,"1,106.90",00.00,"1,106.90",Transport
29-Oct-20,Cash,00.00,368.97,737.93,Transport
29-Oct-20,NEFT,155.61,00.00,893.54,Transport
29-Oct-20,ATM,485,00.00,"1,378.54",Transport
29-Oct-20,Commission,00.00,275.71,"1,102.83",Transport
29-Oct-20,Bill,00.00,110.28,992.55,Transport
29-Oct-20,ATM,00.00,496.28,496.28,Transport
29-Oct-20,Debit Card,"32,649.25",00.00,"33,145.53",Transport
29-Oct-20,Cheque,00.00,"11,048.51","22,097.02",Transport
29-Oct-20,Bill,00.00,"11,048.51","11,048.51",Transport
29-Oct-20,Tax,03.71,00.00,"11,052.22",Transport
29-Oct-20,Cash,"2,226.00",00.00,"13,278.22",Transport
29-Oct-20,IMPS,00.00,"1,896.89","11,381.33",Transport
29-Oct-20,Debit Card,"2,47,152.09",00.00,"2,58,533.42",Transport
29-Oct-20,Transportellaneous,"71,246.50",00.00,"3,29,779.92",Transport
29-Oct-20,Bill,241.8,00.00,"3,30,021.72",Transport
29-Oct-20,Purchase,00.00,"82,505.43","2,47,516.29",Transport
29-Oct-20,Transportellaneous,03.88,00.00,"2,47,520.17",Transport
29-Oct-20,Cheque,"25,138.00",00.00,"2,72,658.17",Transport
29-Oct-20,Cheque,00.00,"34,082.27","2,38,575.90",Transport
29-Oct-20,IMPS,00.00,"2,38,575.90",00.00,Transport
29-Oct-20,IMPS,07.00,00.00,07.00,Transport
29-Oct-20,Bill,18.77,00.00,25.77,Transport
29-Oct-20,Cash,462.04,00.00,487.81,Transport
29-Oct-20,Tax,"22,102.50",00.00,"22,590.31",Transport
29-Oct-20,Tax,220.6,00.00,"22,810.91",Transport
29-Oct-20,Debit Card,"9,34,784.00",00.00,"9,57,594.91",Transport
29-Oct-20,ATM,"1,47,607.90",00.00,"11,05,202.81",Transport
29-Oct-20,Cheque,00.00,"3,68,400.94","7,36,801.87",Transport
29-Oct-20,Transportellaneous,00.00,"1,47,360.37","5,89,441.50",Transport
29-Oct-20,Tax,00.00,"73,680.19","5,15,761.31",Transport
29-Oct-20,ATM,"30,270.00",00.00,"5,46,031.31",Transport
29-Oct-20,NEFT,"9,162.31",00.00,"5,55,193.62",Transport
29-Oct-20,ATM,00.00,"1,11,038.72","4,44,154.90",Transport
29-Oct-20,Transfer,00.00,"44,415.49","3,99,739.41",Transport
29-Oct-20,Debit Card,00.00,"1,33,246.47","2,66,492.94",Transport
29-Oct-20,Commission,01.00,00.00,"2,66,493.94",Transport
29-Oct-20,Debit Card,"26,485.29",00.00,"2,92,979.23",Transport
29-Oct-20,Tax,00.00,"48,829.87","2,44,149.36",Transport
29-Oct-20,Transfer,"1,10,877.00",00.00,"3,55,026.36",Transport
29-Oct-20,IMPS,00.00,"50,718.05","3,04,308.31",Transport
29-Oct-20,Cash,00.00,"1,01,436.10","2,02,872.21",Transport
29-Oct-20,Transportellaneous,00.00,"2,02,872.21",00.00,Transport
29-Oct-20,Purchase,22,00.00,22,Transport
29-Oct-20,ATM,00.00,03.67,18.33,Transport
29-Oct-20,IMPS,00.00,06.11,12.22,Transport
29-Oct-20,Bill,07.97,00.00,20.19,Transport
29-Oct-20,Reversal,04.30,00.00,24.49,Transport
29-Oct-20,Transfer,"10,752.00",00.00,"10,776.49",Transport
29-Oct-20,NEFT,379,00.00,"11,155.49",Transport
29-Oct-20,Cash,00.00,"1,394.44","9,761.05",Transport
29-Oct-20,Cheque,"19,123.00",00.00,"28,884.05",Transport
29-Oct-20,Cheque,"54,635.00",00.00,"83,519.05",Transport
29-Oct-20,ATM,00.00,"20,879.76","62,639.29",Transport
29-Oct-20,Bill,06.00,00.00,"62,645.29",Transport
29-Oct-20,Cash,00.00,"8,949.33","53,695.96",Transport
29-Oct-20,Reversal,00.00,"13,423.99","40,271.97",Transport
29-Oct-20,Cheque,669.3,00.00,"40,941.27",Transport
29-Oct-20,IMPS,"5,61,367.50",00.00,"6,02,308.77",Transport
29-Oct-20,Transfer,00.00,"60,230.88","5,42,077.89",Transport
29-Oct-20,Purchase,07.60,00.00,"5,42,085.49",Transport
29-Oct-20,RTGS,00.00,"54,208.55","4,87,876.94",Transport
29-Oct-20,Debit Card,297,00.00,"4,88,173.94",Transport
29-Oct-20,ATM,00.00,"97,634.79","3,90,539.15",Transport
29-Oct-20,Purchase,00.00,"43,393.24","3,47,145.91",Transport
29-Oct-20,ATM,"20,02,231.75",00.00,"23,49,377.66",Transport
29-Oct-20,Bill,00.00,"23,49,377.66",00.00,Rent
29-Oct-20,RTGS,"3,323.24",00.00,"3,323.24",Rent
29-Oct-20,Transportellaneous,00.00,"1,661.62","1,661.62",Rent
29-Oct-20,RTGS,01.01,00.00,"1,662.63",Rent
29-Oct-20,Commission,00.00,237.52,"1,425.11",Rent
29-Oct-20,NEFT,"14,31,424.20",00.00,"14,32,849.31",Rent
29-Oct-20,Cheque,"1,090.44",00.00,"14,33,939.75",Rent
29-Oct-20,Bill,"26,632.96",00.00,"14,60,572.71",Rent
29-Oct-20,Tax,00.00,"1,82,571.59","12,78,001.12",Rent
29-Oct-20,Debit Card,00.00,"2,13,000.19","10,65,000.93",Rent
29-Oct-20,Transportellaneous,00.00,"1,52,142.99","9,12,857.94",Rent
29-Oct-20,RTGS,00.00,"4,56,428.97","4,56,428.97",Rent
29-Oct-20,Bill,00.00,"1,14,107.24","3,42,321.73",Rent
29-Oct-20,Commission,00.00,"48,903.10","2,93,418.63",Rent
29-Oct-20,Interest,"60,699.00",00.00,"3,54,117.63",Rent
29-Oct-20,Debit Card,00.00,"50,588.23","3,03,529.40",Rent
29-Oct-20,Transfer,35.2,00.00,"3,03,564.60",Rent
29-Oct-20,Reversal,00.00,"3,03,564.60",00.00,Rent
29-Oct-20,IMPS,"2,10,792.40",00.00,"2,10,792.40",Rent
29-Oct-20,Debit Card,"14,14,262.80",00.00,"16,25,055.20",Rent
29-Oct-20,Tax,"63,834.60",00.00,"16,88,889.80",Rent
29-Oct-20,ATM,00.00,"2,41,269.97","14,47,619.83",Rent
29-Oct-20,Reversal,"14,22,158.00",00.00,"28,69,777.83",Rent
29-Oct-20,ATM,00.00,"3,58,722.23","25,11,055.60",Rent
29-Oct-20,Cash,00.00,"4,18,509.27","20,92,546.33",Rent
29-Oct-20,Tax,00.00,"6,97,515.44","13,95,030.89",Rent
29-Oct-20,NEFT,00.00,"6,97,515.45","6,97,515.44",Rent
29-Oct-20,Cash,00.00,"1,39,503.09","5,58,012.35",Rent
29-Oct-20,Cash,00.00,"2,79,006.18","2,79,006.18",Rent
29-Oct-20,ATM,"5,90,002.20",00.00,"8,69,008.38",Rent
29-Oct-20,Cash,50,00.00,"8,69,058.38",Rent
29-Oct-20,Debit Card,00.00,"1,44,843.06","7,24,215.32",Rent
29-Oct-20,Reversal,00.00,"3,62,107.66","3,62,107.66",Rent
29-Oct-20,Reversal,00.00,"90,526.92","2,71,580.74",Rent
29-Oct-20,Transfer,00.00,"67,895.19","2,03,685.56",Rent
29-Oct-20,IMPS,00.00,"29,097.94","1,74,587.62",Rent
29-Oct-20,RTGS,00.00,"58,195.87","1,16,391.75",Rent
29-Oct-20,Commission,00.00,"19,398.63","96,993.12",Rent
29-Oct-20,Debit Card,59.97,00.00,"97,053.09",Rent
29-Oct-20,Reversal,00.00,"13,864.73","83,188.36",Rent
29-Oct-20,Interest,00.00,"27,729.45","55,458.91",Rent
30-Oct-20,Cheque,"2,56,983.40",00.00,"3,12,442.31",Rent
30-Oct-20,NEFT,"19,471.58",00.00,"3,31,913.89",Rent
30-Oct-20,IMPS,"1,772.89",00.00,"3,33,686.78",Rent
30-Oct-20,Commission,"18,43,542.00",00.00,"21,77,228.78",Rent
30-Oct-20,Cheque,00.00,"4,35,445.76","17,41,783.02",Rent
30-Oct-20,IMPS,"27,366.75",00.00,"17,69,149.77",Rent
30-Oct-20,IMPS,00.00,"17,69,149.77",00.00,Rent
30-Oct-20,Purchase,416,00.00,416,Rent
30-Oct-20,Cheque,00.00,46.22,369.78,Rent
30-Oct-20,Reversal,01.01,00.00,370.79,Rent
30-Oct-20,Cheque,"16,898.20",00.00,"17,268.99",Rent
30-Oct-20,Purchase,310,00.00,"17,578.99",Rent
30-Oct-20,Bill,00.00,"2,929.83","14,649.16",Rent
30-Oct-20,Bill,00.00,"3,662.29","10,986.87",Rent
30-Oct-20,Commission,"4,764.22",00.00,"15,751.09",Rent
30-Oct-20,Debit Card,494.22,00.00,"16,245.31",Rent
30-Oct-20,Transfer,00.00,"1,624.53","14,620.78",Rent
30-Oct-20,Reversal,"2,002.41",00.00,"16,623.19",Rent
30-Oct-20,Cash,00.00,"2,374.74","14,248.45",Rent
30-Oct-20,Debit Card,00.00,"3,562.11","10,686.34",Rent
30-Oct-20,Transfer,00.00,"2,671.59","8,014.76",Rent
30-Oct-20,RTGS,06.07,00.00,"8,020.83",Rent
30-Oct-20,Interest,59,00.00,"8,079.83",Rent
30-Oct-20,Cash,122.4,00.00,"8,202.23",Rent
30-Oct-20,Debit Card,"13,27,533.00",00.00,"13,35,735.23",Rent
30-Oct-20,Interest,"1,948.00",00.00,"13,37,683.23",Rent
30-Oct-20,RTGS,"32,662.00",00.00,"13,70,345.23",Rent
30-Oct-20,NEFT,00.00,"13,70,345.23",00.00,Rent
30-Oct-20,ATM,358.79,00.00,358.79,Rent
30-Oct-20,Debit Card,00.00,89.7,269.09,Rent
30-Oct-20,Transfer,"15,890.00",00.00,"16,159.09",Rent
30-Oct-20,Commission,187,00.00,"16,346.09",Rent
30-Oct-20,Transfer,160.1,00.00,"16,506.19",Rent
31-Oct-20,Transportellaneous,00.00,"8,253.10","8,253.09",Rent
31-Oct-20,Tax,00.00,"1,031.64","7,221.45",Rent
31-Oct-20,Commission,00.00,"1,805.36","5,416.09",Rent
31-Oct-20,RTGS,00.00,601.79,"4,814.30",Rent
31-Oct-20,Tax,00.00,534.92,"4,279.38",Rent
31-Oct-20,Purchase,"1,72,542.47",00.00,"1,76,821.85",Rent
31-Oct-20,Reversal,00.00,"44,205.46","1,32,616.39",Rent
31-Oct-20,Purchase,"2,05,743.00",00.00,"3,38,359.39",Rent
31-Oct-20,Cash,"24,315.80",00.00,"3,62,675.19",Rent
31-Oct-20,Bill,"13,48,774.80",00.00,"17,11,449.99",Rent
31-Oct-20,Transfer,285.22,00.00,"17,11,735.21",Rent
31-Oct-20,NEFT,"4,843.90",00.00,"17,16,579.11",Rent
31-Oct-20,Bill,00.00,"5,72,193.04","11,44,386.07",Rent
31-Oct-20,Tax,00.00,"1,63,483.72","9,80,902.35",Rent
31-Oct-20,NEFT,00.00,"2,45,225.59","7,35,676.76",Rent
31-Oct-20,Interest,00.00,"7,35,676.76",00.00,Rent
31-Oct-20,NEFT,"17,99,337.00",00.00,"17,99,337.00",Rent
31-Oct-20,ATM,"1,515.96",00.00,"18,00,852.96",Rent
31-Oct-20,Debit Card,06.00,00.00,"18,00,858.96",Rent
31-Oct-20,NEFT,"7,239.50",00.00,"18,08,098.46",Rent
31-Oct-20,Tax,291.37,00.00,"18,08,389.83",Rent
31-Oct-20,Commission,00.00,"2,00,932.20","16,07,457.63",Rent
31-Oct-20,Debit Card,00.00,"1,60,745.76","14,46,711.87",Rent
31-Oct-20,Transportellaneous,"1,649.64",00.00,"14,48,361.51",Rent
31-Oct-20,Commission,00.00,"4,82,787.17","9,65,574.34",Rent
31-Oct-20,Bill,00.00,"9,65,574.34",00.00,Rent
01-Nov-20,Transfer,06.91,00.00,06.91,Rent
01-Nov-20,IMPS,00.00,00.69,06.22,Rent
01-Nov-20,Reversal,00.00,01.56,04.66,Rent
01-Nov-20,Commission,40,00.00,44.66,Rent
01-Nov-20,Interest,00.00,05.58,39.08,Rent
01-Nov-20,Interest,"10,551.70",00.00,"10,590.78",
01-Nov-20,Interest,00.00,"10,590.78",00.00,
01-Nov-20,Debit Card,87.89,00.00,87.89,
01-Nov-20,Purchase,00.00,21.97,65.92,
01-Nov-20,Commission,00.00,13.18,52.74,
01-Nov-20,Cash,"4,686.00",00.00,"4,738.74",
01-Nov-20,Bill,00.00,"2,369.37","2,369.37",
01-Nov-20,Bill,00.00,263.26,"2,106.11",
01-Nov-20,Transportellaneous,00.00,351.02,"1,755.09",
01-Nov-20,Commission,26,00.00,"1,781.09",
01-Nov-20,Purchase,00.00,197.9,"1,583.19",
01-Nov-20,Interest,00.00,175.91,"1,407.28",
01-Nov-20,Transfer,01.80,00.00,"1,409.08",
01-Nov-20,Commission,00.00,140.91,"1,268.17",
01-Nov-20,RTGS,25.1,00.00,"1,293.27",
01-Nov-20,Bill,"1,643.00",00.00,"2,936.27",
01-Nov-20,Tax,00.00,"1,468.14","1,468.14",
01-Nov-20,Debit Card,"31,410.02",00.00,"32,878.16",
01-Nov-20,Bill,00.00,"10,959.39","21,918.77",
01-Nov-20,ATM,"2,99,058.50",00.00,"3,20,977.27",
01-Nov-20,Interest,50.18,00.00,"3,21,027.45",
01-Nov-20,Tax,"2,50,202.00",00.00,"5,71,229.45",
01-Nov-20,Transfer,644.8,00.00,"5,71,874.25",
01-Nov-20,Tax,"3,846.90",00.00,"5,75,721.15",
01-Nov-20,Debit Card,00.00,"1,15,144.23","4,60,576.92",
01-Nov-20,Cheque,"10,12,407.00",00.00,"14,72,983.92",
01-Nov-20,RTGS,"10,72,586.80",00.00,"25,45,570.72",
01-Nov-20,Purchase,02.87,00.00,"25,45,573.59",
01-Nov-20,Transportellaneous,00.00,"25,45,573.59",00.00,
01-Nov-20,Debit Card,"11,01,890.00",00.00,"11,01,890.00",
01-Nov-20,Reversal,00.00,"5,50,945.00","5,50,945.00",
01-Nov-20,Debit Card,00.00,"2,75,472.50","2,75,472.50",
01-Nov-20,Transfer,00.00,"34,434.06","2,41,038.44",
01-Nov-20,IMPS,00.00,"2,41,038.44",00.00,
01-Nov-20,Bill,06.50,00.00,06.50,
01-Nov-20,Bill,55,00.00,61.5,
01-Nov-20,Interest,10.7,00.00,72.2,
01-Nov-20,IMPS,00.00,18.05,54.15,
01-Nov-20,Debit Card,25.5,00.00,79.65,
01-Nov-20,Bill,42,00.00,121.65,
01-Nov-20,Cheque,00.00,12.17,109.48,
01-Nov-20,Tax,438.2,00.00,547.68,
01-Nov-20,Bill,387,00.00,934.68,
01-Nov-20,Bill,"7,665.00",00.00,"8,599.68",
01-Nov-20,Bill,00.00,"1,433.28","7,166.40",
01-Nov-20,Commission,00.00,"1,791.60","5,374.80",
01-Nov-20,Cheque,00.00,"5,374.80",00.00,
01-Nov-20,Commission,07.00,00.00,07.00,
01-Nov-20,RTGS,"3,945.20",00.00,"3,952.20",
01-Nov-20,Debit Card,"17,713.40",00.00,"21,665.60",
01-Nov-20,IMPS,11.09,00.00,"21,676.69",
01-Nov-20,Transfer,23,00.00,"21,699.69",
01-Nov-20,NEFT,00.00,"2,712.46","18,987.23",
01-Nov-20,NEFT,00.00,"2,712.46","16,274.77",
01-Nov-20,Debit Card,256.8,00.00,"16,531.57",
01-Nov-20,Commission,00.00,"16,531.57",00.00,
01-Nov-20,Cash,26.2,00.00,26.2,
01-Nov-20,NEFT,"2,26,705.88",00.00,"2,26,732.08",
01-Nov-20,Transportellaneous,00.00,"1,13,366.04","1,13,366.04",
01-Nov-20,Cash,00.00,"28,341.51","85,024.53",
01-Nov-20,Tax,"1,90,223.00",00.00,"2,75,247.53",
01-Nov-20,Bill,00.00,"34,405.94","2,40,841.59",
01-Nov-20,Debit Card,00.00,"40,140.27","2,00,701.32",
01-Nov-20,Reversal,00.00,"40,140.26","1,60,561.06",
01-Nov-20,Bill,00.00,"40,140.27","1,20,420.80",
01-Nov-20,Purchase,446.2,00.00,"1,20,867.00",
01-Nov-20,Commission,61.9,00.00,"1,20,928.90",
01-Nov-20,Commission,"1,27,318.80",00.00,"2,48,247.70",
02-Nov-20,Transfer,04.84,00.00,"2,48,252.54",
02-Nov-20,ATM,"8,244.00",00.00,"2,56,496.54",
02-Nov-20,Cheque,30,00.00,"2,56,526.54",
02-Nov-20,Bill,00.00,"28,502.95","2,28,023.59",
02-Nov-20,Interest,00.00,"28,502.95","1,99,520.64",
02-Nov-20,Commission,00.00,"22,168.96","1,77,351.68",
02-Nov-20,Bill,00.00,"59,117.23","1,18,234.45",
02-Nov-20,NEFT,"1,878.27",00.00,"1,20,112.72",
02-Nov-20,Interest,00.00,"15,014.09","1,05,098.63",
02-Nov-20,RTGS,"25,392.80",00.00,"1,30,491.43",
02-Nov-20,Debit Card,00.00,"43,497.14","86,994.29",
02-Nov-20,Interest,"2,356.50",00.00,"89,350.79",
02-Nov-20,Transportellaneous,00.00,"12,764.40","76,586.39",
02-Nov-20,ATM,"11,600.77",00.00,"88,187.16",
02-Nov-20,Debit Card,"2,05,894.60",00.00,"2,94,081.76",
02-Nov-20,IMPS,00.00,"2,94,081.76",00.00,
02-Nov-20,Purchase,"17,75,530.00",00.00,"17,75,530.00",
02-Nov-20,Debit Card,00.00,"3,55,106.00","14,20,424.00",
02-Nov-20,Transportellaneous,"1,73,817.00",00.00,"15,94,241.00",
02-Nov-20,IMPS,65.3,00.00,"15,94,306.30",
02-Nov-20,Purchase,00.00,"7,97,153.15","7,97,153.15",
02-Nov-20,Cheque,00.00,"3,98,576.58","3,98,576.58",
02-Nov-20,Bill,00.00,"56,939.51","3,41,637.07",
02-Nov-20,Purchase,00.00,"68,327.41","2,73,309.66",
02-Nov-20,Cash,00.00,"34,163.71","2,39,145.95",
02-Nov-20,Debit Card,06.00,00.00,"2,39,151.95",
02-Nov-20,ATM,00.00,"26,572.44","2,12,579.51",
02-Nov-20,Tax,00.00,"70,859.84","1,41,719.67",
02-Nov-20,Debit Card,"29,827.00",00.00,"1,71,546.67",
02-Nov-20,Cheque,"87,011.60",00.00,"2,58,558.27",
02-Nov-20,Cash,14.22,00.00,"2,58,572.49",
02-Nov-20,Reversal,00.00,"2,58,572.49",00.00,
02-Nov-20,RTGS,288,00.00,288,
02-Nov-20,Interest,00.00,41.14,246.86,
02-Nov-20,Transfer,07.00,00.00,253.86,
02-Nov-20,IMPS,00.00,28.21,225.65,
02-Nov-20,Purchase,00.00,32.24,193.41,
02-Nov-20,Transportellaneous,00.00,96.71,96.7,
03-Nov-20,ATM,00.10,00.00,96.8,
03-Nov-20,Purchase,00.00,32.27,64.53,
03-Nov-20,ATM,00.00,08.07,56.46,
03-Nov-20,RTGS,00.00,05.65,50.81,
03-Nov-20,RTGS,00.00,05.08,45.73,
03-Nov-20,Cheque,00.00,22.87,22.86,
03-Nov-20,Reversal,00.00,05.72,17.14,
03-Nov-20,Transportellaneous,00.00,08.57,08.57,
03-Nov-20,Commission,"18,26,892.75",00.00,"18,26,901.32",
03-Nov-20,Reversal,00.89,00.00,"18,26,902.21",
03-Nov-20,IMPS,00.00,"2,02,989.13","16,23,913.08",
03-Nov-20,Transfer,00.00,"16,23,913.08",00.00,
03-Nov-20,ATM,"12,843.50",00.00,"12,843.50",
03-Nov-20,Transportellaneous,"3,193.90",00.00,"16,037.40",
03-Nov-20,IMPS,00.00,"4,009.35","12,028.05",
03-Nov-20,NEFT,09.00,00.00,"12,037.05",
04-Nov-20,IMPS,00.00,"1,337.45","10,699.60",
04-Nov-20,Bill,"13,37,360.00",00.00,"13,48,059.60",
04-Nov-20,Commission,00.00,"1,49,784.40","11,98,275.20",
04-Nov-20,Cash,"7,475.20",00.00,"12,05,750.40",
04-Nov-20,Transportellaneous,02.90,00.00,"12,05,753.30",
04-Nov-20,NEFT,"86,781.44",00.00,"12,92,534.74",
04-Nov-20,Purchase,00.00,"6,46,267.37","6,46,267.37",
04-Nov-20,Tax,00.00,"3,23,133.69","3,23,133.68",
04-Nov-20,NEFT,"1,335.17",00.00,"3,24,468.85",
04-Nov-20,Tax,"4,38,118.50",00.00,"7,62,587.35",
04-Nov-20,Interest,"16,59,278.20",00.00,"24,21,865.55",
04-Nov-20,Interest,00.00,"12,10,932.78","12,10,932.77",
04-Nov-20,Interest,45,00.00,"12,10,977.77",
04-Nov-20,Purchase,00.00,"1,34,553.09","10,76,424.68",
04-Nov-20,Cash,03.00,00.00,"10,76,427.68",
05-Nov-20,Transportellaneous,00.00,"2,15,285.54","8,61,142.14",
05-Nov-20,ATM,00.00,"95,682.46","7,65,459.68",
05-Nov-20,Debit Card,00.00,"1,53,091.94","6,12,367.74",
05-Nov-20,Interest,00.00,"3,06,183.87","3,06,183.87",
05-Nov-20,Tax,49.81,00.00,"3,06,233.68",
05-Nov-20,Interest,"2,865.70",00.00,"3,09,099.38",
05-Nov-20,Purchase,03.90,00.00,"3,09,103.28",
05-Nov-20,Reversal,00.00,"1,03,034.43","2,06,068.85",
05-Nov-20,Debit Card,43.2,00.00,"2,06,112.05",
05-Nov-20,Transfer,12,00.00,"2,06,124.05",
05-Nov-20,RTGS,00.00,"1,03,062.03","1,03,062.02",
05-Nov-20,IMPS,00.00,"20,612.40","82,449.62",
05-Nov-20,Commission,"5,19,724.00",00.00,"6,02,173.62",
05-Nov-20,Bill,"9,19,031.75",00.00,"15,21,205.37",
05-Nov-20,Cash,00.00,"1,69,022.82","13,52,182.55",
05-Nov-20,Cash,00.00,"1,50,242.51","12,01,940.04",
05-Nov-20,Tax,00.00,"2,00,323.34","10,01,616.70",
05-Nov-20,Reversal,"1,24,357.30",00.00,"11,25,974.00",
05-Nov-20,Cash,00.00,"2,25,194.80","9,00,779.20",
05-Nov-20,Bill,00.00,"1,12,597.40","7,88,181.80",
05-Nov-20,Debit Card,"32,366.53",00.00,"8,20,548.33",
05-Nov-20,Transfer,00.00,"1,17,221.19","7,03,327.14",
05-Nov-20,IMPS,00.00,"1,17,221.19","5,86,105.95",
05-Nov-20,RTGS,"16,13,795.20",00.00,"21,99,901.15",
05-Nov-20,Debit Card,04.60,00.00,"21,99,905.75",
05-Nov-20,Cheque,00.00,"21,99,905.75",00.00,
05-Nov-20,Interest,"16,78,782.50",00.00,"16,78,782.50",
05-Nov-20,Tax,00.00,"16,78,782.50",00.00,
05-Nov-20,Transportellaneous,05.33,00.00,05.33,
05-Nov-20,Transfer,97.16,00.00,102.49,
05-Nov-20,Transportellaneous,00.00,17.08,85.41,
05-Nov-20,Transportellaneous,395.44,00.00,480.85,
05-Nov-20,Cash,00.00,68.69,412.16,
05-Nov-20,IMPS,00.00,82.43,329.73,
05-Nov-20,Commission,"14,20,692.50",00.00,"14,21,022.23",
05-Nov-20,Cheque,00.00,"1,77,627.78","12,43,394.45",
05-Nov-20,Tax,00.00,"4,14,464.82","8,28,929.63",
05-Nov-20,Commission,03.00,00.00,"8,28,932.63",
05-Nov-20,Transfer,"4,63,087.50",00.00,"12,92,020.13",
05-Nov-20,Reversal,00.00,"1,43,557.79","11,48,462.34",
05-Nov-20,Purchase,00.00,"1,64,066.05","9,84,396.29",
05-Nov-20,Bill,"15,185.95",00.00,"9,99,582.24",
05-Nov-20,Commission,00.00,"99,958.22","8,99,624.02",
05-Nov-20,Cash,"2,179.00",00.00,"9,01,803.02",
05-Nov-20,Cheque,00.00,"1,12,725.38","7,89,077.64",
05-Nov-20,Transportellaneous,00.00,"1,31,512.94","6,57,564.70",
05-Nov-20,RTGS,60.8,00.00,"6,57,625.50",
05-Nov-20,Bill,"77,467.00",00.00,"7,35,092.50",
05-Nov-20,Transportellaneous,00.70,00.00,"7,35,093.20",
05-Nov-20,Reversal,"63,688.30",00.00,"7,98,781.50",
05-Nov-20,Bill,"3,356.40",00.00,"8,02,137.90",
05-Nov-20,Tax,00.00,"2,67,379.30","5,34,758.60",
05-Nov-20,Debit Card,00.00,"66,844.83","4,67,913.78",
05-Nov-20,ATM,00.00,"93,582.76","3,74,331.02",
05-Nov-20,Commission,00.00,"74,866.20","2,99,464.82",
05-Nov-20,Tax,"19,309.90",00.00,"3,18,774.72",
05-Nov-20,ATM,"27,915.00",00.00,"3,46,689.72",
05-Nov-20,Bill,00.00,"3,46,689.72",00.00,
05-Nov-20,Transfer,34.9,00.00,34.9,
05-Nov-20,Transfer,00.00,34.9,00.00,
05-Nov-20,Transfer,07.00,00.00,07.00,
05-Nov-20,Bill,60.6,00.00,67.6,
05-Nov-20,Cash,"26,340.80",00.00,"26,408.40",
05-Nov-20,Transportellaneous,00.00,"4,401.40","22,007.00",
06-Nov-20,Debit Card,02.30,00.00,"22,009.30",
06-Nov-20,Cash,"2,241.00",00.00,"24,250.30",
06-Nov-20,NEFT,00.00,"3,031.29","21,219.01",
06-Nov-20,Transportellaneous,21,00.00,"21,240.01",
06-Nov-20,IMPS,05.31,00.00,"21,245.32",
06-Nov-20,IMPS,00.00,"3,035.05","18,210.27",
06-Nov-20,Cheque,00.00,"9,105.14","9,105.14",
07-Nov-20,RTGS,00.00,"9,105.14",00.00,
07-Nov-20,Transportellaneous,"3,778.00",00.00,"3,778.00",
08-Nov-20,ATM,"1,23,219.00",00.00,"1,26,997.00",
08-Nov-20,Tax,00.00,"31,749.25","95,247.75",
08-Nov-20,ATM,00.00,"11,905.97","83,341.78",
09-Nov-20,Tax,00.00,"20,835.45","62,506.34",
09-Nov-20,Transfer,00.00,"12,501.27","50,005.07",
09-Nov-20,Transportellaneous,00.00,"5,000.51","45,004.56",
09-Nov-20,Bill,00.00,"9,000.91","36,003.65",
09-Nov-20,Reversal,35.8,00.00,"36,039.45",
09-Nov-20,Debit Card,"3,779.18",00.00,"39,818.63",
10-Nov-20,Transfer,00.00,"9,954.66","29,863.97",
10-Nov-20,Bill,00.00,"29,863.97",00.00,
10-Nov-20,Cheque,"1,208.70",00.00,"1,208.70",
11-Nov-20,NEFT,23.6,00.00,"1,232.30",
11-Nov-20,ATM,00.00,"1,232.30",00.00,
11-Nov-20,Reversal,171.94,00.00,171.94,
12-Nov-20,Bill,00.00,57.31,114.63,
12-Nov-20,Purchase,01.80,00.00,116.43,
12-Nov-20,ATM,793.22,00.00,909.65,
13-Nov-20,RTGS,"19,661.30",00.00,"20,570.95",
14-Nov-20,Commission,00.00,"3,428.49","17,142.46",
14-Nov-20,ATM,02.00,00.00,"17,144.46",
14-Nov-20,Purchase,02.00,00.00,"17,146.46",
14-Nov-20,ATM,00.00,"4,286.62","12,859.84",
14-Nov-20,Transportellaneous,00.00,"4,286.61","8,573.23",
14-Nov-20,Debit Card,00.00,857.32,"7,715.91",
14-Nov-20,IMPS,00.00,"1,543.18","6,172.73",
14-Nov-20,ATM,"1,63,319.50",00.00,"1,69,492.23",
14-Nov-20,IMPS,"3,923.87",00.00,"1,73,416.10",
14-Nov-20,Debit Card,00.00,"57,805.37","1,15,610.73",
14-Nov-20,Bill,"20,77,599.50",00.00,"21,93,210.23",
14-Nov-20,Purchase,00.00,"3,65,535.04","18,27,675.19",
14-Nov-20,Transfer,09.00,00.00,"18,27,684.19",
14-Nov-20,Tax,00.00,"1,82,768.42","16,44,915.77",
14-Nov-20,Commission,00.00,"1,64,491.58","14,80,424.19",
14-Nov-20,RTGS,06.00,00.00,"14,80,430.19",
14-Nov-20,IMPS,"1,98,550.50",00.00,"16,78,980.69",
14-Nov-20,Cash,00.00,"1,67,898.07","15,11,082.62",
14-Nov-20,RTGS,"2,497.00",00.00,"15,13,579.62",
14-Nov-20,NEFT,00.00,"7,56,789.81","7,56,789.81",
14-Nov-20,ATM,00.00,"94,598.73","6,62,191.08",
14-Nov-20,RTGS,"8,633.80",00.00,"6,70,824.88",
14-Nov-20,Cash,443,00.00,"6,71,267.88",
14-Nov-20,NEFT,"4,353.03",00.00,"6,75,620.91",
14-Nov-20,Commission,"89,861.25",00.00,"7,65,482.16",
14-Nov-20,Transportellaneous,00.00,"7,65,482.16",00.00,
14-Nov-20,RTGS,"18,38,411.50",00.00,"18,38,411.50",
14-Nov-20,Transportellaneous,"1,98,997.40",00.00,"20,37,408.90",
14-Nov-20,Cheque,00.00,"2,03,740.89","18,33,668.01",
14-Nov-20,Interest,00.00,"6,11,222.67","12,22,445.34",
14-Nov-20,Transportellaneous,00.00,"2,44,489.07","9,77,956.27",
14-Nov-20,Commission,00.00,"1,95,591.25","7,82,365.02",
14-Nov-20,Cheque,195.63,00.00,"7,82,560.65",
14-Nov-20,Tax,00.00,"1,95,640.16","5,86,920.49",
14-Nov-20,Debit Card,00.00,"73,365.06","5,13,555.43",
14-Nov-20,Cash,00.00,"5,13,555.43",00.00,
14-Nov-20,Purchase,"5,51,819.00",00.00,"5,51,819.00",
14-Nov-20,ATM,00.00,"1,10,363.80","4,41,455.20",
14-Nov-20,Tax,"9,72,444.50",00.00,"14,13,899.70",
14-Nov-20,RTGS,00.00,"3,53,474.93","10,60,424.77",
14-Nov-20,RTGS,406.16,00.00,"10,60,830.93",
14-Nov-20,Reversal,348,00.00,"10,61,178.93",
14-Nov-20,NEFT,00.00,"1,76,863.16","8,84,315.77",
14-Nov-20,Interest,05.37,00.00,"8,84,321.14",
14-Nov-20,Bill,00.00,"8,84,321.14",00.00,
14-Nov-20,Interest,334.92,00.00,334.92,
14-Nov-20,Transportellaneous,"20,491.80",00.00,"20,826.72",
14-Nov-20,Transfer,"17,260.91",00.00,"38,087.63",
14-Nov-20,Commission,381,00.00,"38,468.63",
14-Nov-20,Cheque,"2,08,971.00",00.00,"2,47,439.63",
14-Nov-20,Reversal,"20,386.00",00.00,"2,67,825.63",
14-Nov-20,ATM,396.8,00.00,"2,68,222.43",
14-Nov-20,Tax,"1,104.73",00.00,"2,69,327.16",
14-Nov-20,Purchase,"32,395.00",00.00,"3,01,722.16",
14-Nov-20,RTGS,00.70,00.00,"3,01,722.86",
15-Nov-20,Cash,00.00,"37,715.36","2,64,007.50",
15-Nov-20,Cheque,00.00,"37,715.36","2,26,292.14",
15-Nov-20,Transfer,567.7,00.00,"2,26,859.84",
15-Nov-20,NEFT,00.00,"28,357.48","1,98,502.36",
15-Nov-20,RTGS,"1,59,688.41",00.00,"3,58,190.77",
15-Nov-20,Cash,"27,192.70",00.00,"3,85,383.47",
15-Nov-20,Reversal,00.00,"42,820.39","3,42,563.08",
15-Nov-20,Debit Card,00.00,"1,14,187.69","2,28,375.39",
15-Nov-20,Interest,00.00,"76,125.13","1,52,250.26",
15-Nov-20,RTGS,01.50,00.00,"1,52,251.76",
15-Nov-20,Tax,00.00,"1,52,251.76",00.00,
15-Nov-20,Transfer,76.9,00.00,76.9,
15-Nov-20,IMPS,00.00,19.23,57.68,
15-Nov-20,Bill,01.00,00.00,58.68,
15-Nov-20,RTGS,00.00,08.38,50.3,
15-Nov-20,Debit Card,"1,50,494.56",00.00,"1,50,544.86",
15-Nov-20,Bill,00.00,"37,636.22","1,12,908.64",
15-Nov-20,RTGS,00.00,"37,636.21","75,272.43",
15-Nov-20,Cash,"24,771.65",00.00,"1,00,044.08",
15-Nov-20,Reversal,00.00,"20,008.82","80,035.26",
15-Nov-20,Commission,00.00,"16,007.05","64,028.21",
15-Nov-20,Cash,"1,38,595.10",00.00,"2,02,623.31",
15-Nov-20,Debit Card,00.00,"50,655.83","1,51,967.48",
15-Nov-20,Reversal,00.00,"1,51,967.48",00.00,
15-Nov-20,Bill,05.20,00.00,05.20,
15-Nov-20,Reversal,00.00,05.20,00.00,
15-Nov-20,Bill,348,00.00,348,
15-Nov-20,Reversal,00.00,43.5,304.5,
15-Nov-20,NEFT,"2,406.66",00.00,"2,711.16",
15-Nov-20,Cheque,00.00,"2,711.16",00.00,
15-Nov-20,Debit Card,59.4,00.00,59.4,
15-Nov-20,Transfer,"25,321.00",00.00,"25,380.40",
15-Nov-20,Tax,00.00,"12,690.20","12,690.20",
15-Nov-20,Purchase,"2,55,931.00",00.00,"2,68,621.20",
15-Nov-20,Debit Card,00.00,"44,770.20","2,23,851.00",
15-Nov-20,IMPS,00.00,"37,308.50","1,86,542.50",
15-Nov-20,IMPS,05.09,00.00,"1,86,547.59",
15-Nov-20,IMPS,00.00,"31,091.27","1,55,456.33",
16-Nov-20,Interest,49,00.00,"1,55,505.33",
16-Nov-20,RTGS,00.00,"1,55,505.33",00.00,
16-Nov-20,Debit Card,"27,636.00",00.00,"27,636.00",
16-Nov-20,Commission,"22,735.20",00.00,"50,371.20",
16-Nov-20,Transportellaneous,00.00,"16,790.40","33,580.80",
16-Nov-20,Commission,46.7,00.00,"33,627.50",
16-Nov-20,Interest,"18,528.00",00.00,"52,155.50",
16-Nov-20,Transfer,00.00,"10,431.10","41,724.40",
16-Nov-20,Bill,00.00,"8,344.88","33,379.52",
16-Nov-20,Cash,268.96,00.00,"33,648.48",
16-Nov-20,NEFT,00.00,"11,216.16","22,432.32",
16-Nov-20,Debit Card,08.00,00.00,"22,440.32",
16-Nov-20,IMPS,"1,864.03",00.00,"24,304.35",
16-Nov-20,Debit Card,"21,454.62",00.00,"45,758.97",
16-Nov-20,Bill,"10,650.60",00.00,"56,409.57",
16-Nov-20,Debit Card,02.00,00.00,"56,411.57",
16-Nov-20,Bill,"15,36,756.80",00.00,"15,93,168.37",
16-Nov-20,NEFT,"61,346.50",00.00,"16,54,514.87",
16-Nov-20,Transportellaneous,00.00,"1,65,451.49","14,89,063.38",
16-Nov-20,ATM,00.00,"2,97,812.68","11,91,250.70",
16-Nov-20,Commission,00.00,"2,97,812.68","8,93,438.02",
16-Nov-20,ATM,00.00,"1,11,679.75","7,81,758.27",
16-Nov-20,ATM,05.00,00.00,"7,81,763.27",
16-Nov-20,Debit Card,00.00,"1,11,680.47","6,70,082.80",
16-Nov-20,Transfer,00.00,"83,760.35","5,86,322.45",
16-Nov-20,Interest,00.00,"83,760.35","5,02,562.10",
16-Nov-20,Transportellaneous,00.00,"62,820.26","4,39,741.84",
17-Nov-20,Transfer,00.00,"4,39,741.84",00.00,
17-Nov-20,Debit Card,475.1,00.00,475.1,
18-Nov-20,RTGS,00.00,59.39,415.71,
18-Nov-20,ATM,00.00,69.29,346.42,
18-Nov-20,Bill,00.00,38.49,307.93,
19-Nov-20,Transfer,00.00,34.21,273.72,
19-Nov-20,Tax,00.00,30.41,243.31,
19-Nov-20,Bill,"20,24,886.25",00.00,"20,25,129.56",
19-Nov-20,Commission,"21,299.00",00.00,"20,46,428.56",
19-Nov-20,IMPS,"21,204.31",00.00,"20,67,632.87",
19-Nov-20,Cash,45,00.00,"20,67,677.87",
19-Nov-20,Cash,"3,576.30",00.00,"20,71,254.17",
19-Nov-20,Cash,"2,004.30",00.00,"20,73,258.47",
19-Nov-20,IMPS,00.00,"4,14,651.69","16,58,606.78",
19-Nov-20,NEFT,00.00,"16,58,606.78",00.00,
19-Nov-20,NEFT,"2,23,556.00",00.00,"2,23,556.00",
19-Nov-20,Debit Card,00.00,"1,11,778.00","1,11,778.00",
19-Nov-20,Bill,00.00,"13,972.25","97,805.75",
19-Nov-20,Commission,381.56,00.00,"98,187.31",
19-Nov-20,Commission,00.00,"16,364.55","81,822.76",
19-Nov-20,Bill,00.00,"9,091.42","72,731.34",
19-Nov-20,Transportellaneous,00.00,"10,390.19","62,341.15",
20-Nov-20,Transportellaneous,"1,121.00",00.00,"63,462.15",
20-Nov-20,Interest,00.00,"63,462.15",00.00,
20-Nov-20,Bill,336,00.00,336,
20-Nov-20,RTGS,"2,657.80",00.00,"2,993.80",
20-Nov-20,Tax,"1,607.00",00.00,"4,600.80",
20-Nov-20,Interest,51.3,00.00,"4,652.10",
20-Nov-20,Bill,500.44,00.00,"5,152.54",
20-Nov-20,Reversal,975,00.00,"6,127.54",
20-Nov-20,Cash,35,00.00,"6,162.54",
20-Nov-20,Reversal,00.00,"1,027.09","5,135.45",
20-Nov-20,NEFT,00.00,733.64,"4,401.81",
20-Nov-20,Commission,"2,619.00",00.00,"7,020.81",
20-Nov-20,Cash,00.00,"1,755.20","5,265.61",
20-Nov-20,Reversal,901,00.00,"6,166.61",
20-Nov-20,Transportellaneous,00.00,"1,027.77","5,138.84",
20-Nov-20,Purchase,"2,895.50",00.00,"8,034.34",
20-Nov-20,Purchase,"4,92,070.00",00.00,"5,00,104.34",
20-Nov-20,Transportellaneous,183.4,00.00,"5,00,287.74",
20-Nov-20,NEFT,06.50,00.00,"5,00,294.24",
20-Nov-20,RTGS,00.00,"50,029.42","4,50,264.82",
20-Nov-20,RTGS,05.00,00.00,"4,50,269.82",
20-Nov-20,Transfer,00.00,"75,044.97","3,75,224.85",
20-Nov-20,Purchase,00.00,"46,903.11","3,28,321.74",
20-Nov-20,Purchase,00.00,"54,720.29","2,73,601.45",
20-Nov-20,RTGS,"2,49,087.56",00.00,"5,22,689.01",
20-Nov-20,IMPS,"2,43,862.53",00.00,"7,66,551.54",
20-Nov-20,NEFT,00.00,"7,66,551.54",00.00,
20-Nov-20,Commission,04.40,00.00,04.40,
20-Nov-20,Tax,266.4,00.00,270.8,
20-Nov-20,Debit Card,00.00,33.85,236.95,
20-Nov-20,Purchase,00.00,78.98,157.97,
20-Nov-20,Commission,"23,133.00",00.00,"23,290.97",
20-Nov-20,Tax,00.00,"3,881.83","19,409.14",
20-Nov-20,Commission,56.98,00.00,"19,466.12",
20-Nov-20,Commission,00.00,"3,893.22","15,572.90",
20-Nov-20,IMPS,959.4,00.00,"16,532.30",
20-Nov-20,Transfer,"12,887.71",00.00,"29,420.01",
20-Nov-20,Bill,00.00,"14,710.01","14,710.00",
20-Nov-20,ATM,00.00,"1,838.75","12,871.25",
20-Nov-20,Purchase,01.08,00.00,"12,872.33",
20-Nov-20,Interest,00.00,"6,436.17","6,436.16",
20-Nov-20,NEFT,00.00,"3,218.08","3,218.08",
20-Nov-20,Transportellaneous,"10,94,242.00",00.00,"10,97,460.08",
20-Nov-20,Interest,00.00,"1,37,182.51","9,60,277.57",
20-Nov-20,Reversal,00.00,"9,60,277.57",00.00,
20-Nov-20,Cheque,02.20,00.00,02.20,
20-Nov-20,Debit Card,00.00,00.73,01.47,
20-Nov-20,Transfer,"4,16,048.75",00.00,"4,16,050.22",
20-Nov-20,Interest,00.40,00.00,"4,16,050.62",
20-Nov-20,Transportellaneous,00.00,"52,006.33","3,64,044.29",
20-Nov-20,Transportellaneous,467.4,00.00,"3,64,511.69",
20-Nov-20,Debit Card,00.00,"3,64,511.69",00.00,
20-Nov-20,Interest,"1,02,931.00",00.00,"1,02,931.00",
20-Nov-20,IMPS,00.00,"11,436.78","91,494.22",
20-Nov-20,NEFT,01.84,00.00,"91,496.06",
20-Nov-20,Reversal,00.00,"18,299.21","73,196.85",
20-Nov-20,Tax,00.00,"7,319.69","65,877.17",
20-Nov-20,ATM,00.00,"21,959.06","43,918.11",
20-Nov-20,NEFT,00.00,"7,319.69","36,598.43",
20-Nov-20,Interest,"5,01,066.00",00.00,"5,37,664.43",
20-Nov-20,Cash,00.00,"67,208.05","4,70,456.38",
20-Nov-20,Cash,00.00,"52,272.93","4,18,183.45",
20-Nov-20,Tax,"1,62,425.00",00.00,"5,80,608.45",
20-Nov-20,Cheque,06.20,00.00,"5,80,614.65",
20-Nov-20,Cheque,"2,447.00",00.00,"5,83,061.65",
20-Nov-20,Reversal,00.00,"5,83,061.65",00.00,
20-Nov-20,Bill,"2,280.88",00.00,"2,280.88",
20-Nov-20,Cheque,454,00.00,"2,734.88",
20-Nov-20,Transportellaneous,264.3,00.00,"2,999.18",
20-Nov-20,Bill,00.00,499.86,"2,499.32",
20-Nov-20,Tax,00.00,357.05,"2,142.27",
20-Nov-20,Tax,00.00,"1,071.14","1,071.14",
20-Nov-20,Bill,00.00,535.57,535.57,
20-Nov-20,Commission,00.00,178.52,357.05,
20-Nov-20,Transportellaneous,"8,29,754.00",00.00,"8,30,111.05",
20-Nov-20,Reversal,00.00,"1,18,587.29","7,11,523.76",
20-Nov-20,Bill,00.00,"1,42,304.75","5,69,219.01",
20-Nov-20,Bill,"10,71,163.00",00.00,"16,40,382.01",
20-Nov-20,Transportellaneous,00.00,"1,64,038.20","14,76,343.81",
20-Nov-20,Debit Card,19.71,00.00,"14,76,363.52",
20-Nov-20,Cheque,00.00,"14,76,363.52",00.00,
20-Nov-20,NEFT,61.12,00.00,61.12,
21-Nov-20,Purchase,00.00,07.64,53.48,
21-Nov-20,Debit Card,00.00,10.7,42.78,
21-Nov-20,Transfer,00.00,06.11,36.67,
21-Nov-20,Debit Card,00.00,07.33,29.34,
21-Nov-20,NEFT,00.00,09.78,19.56,
21-Nov-20,Cheque,"2,33,537.84",00.00,"2,33,557.40",
21-Nov-20,Commission,06.00,00.00,"2,33,563.40",
21-Nov-20,Tax,00.00,"46,712.68","1,86,850.72",
21-Nov-20,Reversal,228.7,00.00,"1,87,079.42",
21-Nov-20,ATM,"18,330.00",00.00,"2,05,409.42",
21-Nov-20,Reversal,00.00,"1,02,704.71","1,02,704.71",
21-Nov-20,NEFT,"1,754.51",00.00,"1,04,459.22",
21-Nov-20,Commission,689.2,00.00,"1,05,148.42",
21-Nov-20,Cash,00.00,"17,524.74","87,623.68",
21-Nov-20,Cheque,00.00,"43,811.84","43,811.84",
21-Nov-20,Tax,00.00,"8,762.37","35,049.47",
21-Nov-20,Tax,00.00,"4,381.18","30,668.29",
21-Nov-20,Purchase,02.86,00.00,"30,671.15",
21-Nov-20,ATM,261.8,00.00,"30,932.95",
21-Nov-20,Cash,00.00,"4,418.99","26,513.96",
21-Nov-20,Reversal,"9,55,527.00",00.00,"9,82,040.96",
21-Nov-20,Debit Card,"3,37,690.80",00.00,"13,19,731.76",
21-Nov-20,Bill,228,00.00,"13,19,959.76",
21-Nov-20,IMPS,00.00,"1,64,994.97","11,54,964.79",
22-Nov-20,Reversal,"67,602.00",00.00,"12,22,566.79",
22-Nov-20,Reversal,00.00,"2,03,761.13","10,18,805.66",
22-Nov-20,Cash,"1,31,030.00",00.00,"11,49,835.66",
22-Nov-20,Debit Card,00.00,"1,64,262.24","9,85,573.42",
22-Nov-20,Cheque,81.83,00.00,"9,85,655.25",
22-Nov-20,Commission,500,00.00,"9,86,155.25",
22-Nov-20,IMPS,57.5,00.00,"9,86,212.75",
22-Nov-20,Interest,"13,82,422.20",00.00,"23,68,634.95",
22-Nov-20,Commission,00.00,"2,36,863.50","21,31,771.46",
22-Nov-20,ATM,"2,78,899.80",00.00,"24,10,671.26",
22-Nov-20,Transfer,00.00,"24,10,671.26",00.00,
22-Nov-20,Debit Card,14.43,00.00,14.43,
22-Nov-20,NEFT,00.00,02.41,12.02,
22-Nov-20,Transportellaneous,305.4,00.00,317.42,
22-Nov-20,RTGS,"4,708.07",00.00,"5,025.49",
22-Nov-20,Cash,00.00,"1,005.10","4,020.39",
22-Nov-20,Reversal,00.00,804.08,"3,216.31",
22-Nov-20,Reversal,"68,079.22",00.00,"71,295.53",
22-Nov-20,Interest,00.00,"14,259.11","57,036.42",
23-Nov-20,Bill,21,00.00,"57,057.42",
23-Nov-20,Bill,00.00,"19,019.14","38,038.28",
23-Nov-20,Purchase,"17,67,788.80",00.00,"18,05,827.08",
23-Nov-20,NEFT,00.30,00.00,"18,05,827.38",
23-Nov-20,Cheque,05.53,00.00,"18,05,832.91",
23-Nov-20,Commission,00.00,"2,25,729.11","15,80,103.80",
23-Nov-20,Cash,25,00.00,"15,80,128.80",
23-Nov-20,Bill,"4,207.80",00.00,"15,84,336.60",
23-Nov-20,Reversal,00.00,"5,28,112.20","10,56,224.40",
23-Nov-20,Cash,00.00,"1,05,622.44","9,50,601.96",
23-Nov-20,Bill,00.00,"1,18,825.25","8,31,776.72",
23-Nov-20,Bill,00.00,"1,18,825.25","7,12,951.47",
23-Nov-20,Purchase,03.10,00.00,"7,12,954.57",
24-Nov-20,Bill,"3,80,650.00",00.00,"10,93,604.57",
25-Nov-20,Cash,00.00,"3,64,534.86","7,29,069.71",
25-Nov-20,Transfer,00.00,"81,007.75","6,48,061.96",
25-Nov-20,Cash,"2,083.70",00.00,"6,50,145.66",
25-Nov-20,NEFT,00.00,"81,268.21","5,68,877.45",
25-Nov-20,Bill,"25,054.00",00.00,"5,93,931.45",
25-Nov-20,NEFT,"13,998.10",00.00,"6,07,929.55",
25-Nov-20,Debit Card,"13,29,326.20",00.00,"19,37,255.75",
26-Nov-20,RTGS,00.00,"3,87,451.15","15,49,804.60",
26-Nov-20,Cheque,00.00,"1,93,725.58","13,56,079.02",
26-Nov-20,RTGS,00.00,"2,26,013.17","11,30,065.85",
26-Nov-20,Debit Card,06.80,00.00,"11,30,072.65",
26-Nov-20,Cheque,00.00,"1,13,007.27","10,17,065.38",
26-Nov-20,ATM,02.71,00.00,"10,17,068.09",
26-Nov-20,Cash,00.00,"1,13,007.57","9,04,060.52",
26-Nov-20,NEFT,00.00,"1,00,451.17","8,03,609.35",
26-Nov-20,Transportellaneous,00.00,"1,60,721.87","6,42,887.48",
26-Nov-20,Purchase,46.04,00.00,"6,42,933.52",
26-Nov-20,Interest,00.00,"1,28,586.70","5,14,346.82",
26-Nov-20,Debit Card,00.00,"1,71,448.94","3,42,897.88",
26-Nov-20,Reversal,00.00,"3,42,897.88",00.00,
26-Nov-20,NEFT,"7,04,388.80",00.00,"7,04,388.80",
26-Nov-20,Purchase,"3,770.85",00.00,"7,08,159.65",
26-Nov-20,Bill,"19,071.90",00.00,"7,27,231.55",
26-Nov-20,Interest,00.00,"1,81,807.89","5,45,423.66",
26-Nov-20,Cash,"24,556.00",00.00,"5,69,979.66",
26-Nov-20,Reversal,"3,853.20",00.00,"5,73,832.86",
26-Nov-20,Bill,00.00,"5,73,832.86",00.00,
26-Nov-20,Debit Card,"18,22,775.00",00.00,"18,22,775.00",
26-Nov-20,Reversal,"3,407.65",00.00,"18,26,182.65",
26-Nov-20,NEFT,05.00,00.00,"18,26,187.65",
26-Nov-20,ATM,"2,11,308.00",00.00,"20,37,495.65",
26-Nov-20,Commission,303.9,00.00,"20,37,799.55",
26-Nov-20,Cash,26.4,00.00,"20,37,825.95",
27-Nov-20,ATM,"4,48,867.50",00.00,"24,86,693.45",
27-Nov-20,NEFT,"2,02,592.00",00.00,"26,89,285.45",
27-Nov-20,IMPS,"9,53,581.00",00.00,"36,42,866.45",
27-Nov-20,Cash,09.64,00.00,"36,42,876.09",
27-Nov-20,Purchase,"1,468.90",00.00,"36,44,344.99",
27-Nov-20,Debit Card,"13,19,238.00",00.00,"49,63,582.99",
28-Nov-20,Cash,"17,63,768.00",00.00,"67,27,350.99",
28-Nov-20,RTGS,990.6,00.00,"67,28,341.59",
28-Nov-20,ATM,"15,43,674.00",00.00,"82,72,015.59",
28-Nov-20,Reversal,00.00,"82,72,015.59",00.00,
28-Nov-20,Cash,"24,580.00",00.00,"24,580.00",
28-Nov-20,Bill,07.00,00.00,"24,587.00",
28-Nov-20,RTGS,"15,24,148.50",00.00,"15,48,735.50",
28-Nov-20,Transportellaneous,04.00,00.00,"15,48,739.50",
28-Nov-20,Transportellaneous,30,00.00,"15,48,769.50",
28-Nov-20,Transfer,"2,09,717.22",00.00,"17,58,486.72",
29-Nov-20,Tax,"3,744.53",00.00,"17,62,231.25",
29-Nov-20,RTGS,"1,615.24",00.00,"17,63,846.49",
29-Nov-20,Cash,"6,90,649.00",00.00,"24,54,495.49",
29-Nov-20,NEFT,"16,82,844.80",00.00,"41,37,340.29",
29-Nov-20,Purchase,300,00.00,"41,37,640.29",
29-Nov-20,ATM,00.00,"4,59,737.81","36,77,902.48",
29-Nov-20,NEFT,00.00,"12,25,967.49","24,51,934.99",
29-Nov-20,Cash,00.00,"12,25,967.50","12,25,967.50",
29-Nov-20,Interest,00.00,"4,08,655.83","8,17,311.67",
29-Nov-20,RTGS,"2,41,407.00",00.00,"10,58,718.67",
29-Nov-20,Interest,"3,909.03",00.00,"10,62,627.70",
29-Nov-20,Bill,00.00,"10,62,627.70",00.00,
29-Nov-20,Cash,158.4,00.00,158.4,
30-Nov-20,Transfer,414,00.00,572.4,
30-Nov-20,NEFT,00.00,572.4,00.00,
30-Nov-20,RTGS,"27,668.80",00.00,"27,668.80",
30-Nov-20,Bill,"13,450.93",00.00,"41,119.73",
30-Nov-20,Cash,13.68,00.00,"41,133.41",
30-Nov-20,Transfer,00.00,"41,133.41",00.00,
30-Nov-20,Transportellaneous,"29,006.64",00.00,"29,006.64",
30-Nov-20,Transportellaneous,00.00,"5,801.33","23,205.31",
30-Nov-20,Purchase,"1,03,484.00",00.00,"1,26,689.31",
30-Nov-20,ATM,00.00,"12,668.93","1,14,020.38",
30-Nov-20,ATM,392.9,00.00,"1,14,413.28",
30-Nov-20,Reversal,00.00,"22,882.66","91,530.62",
30-Nov-20,Cheque,00.00,"13,075.80","78,454.82",
30-Nov-20,Transfer,00.00,"9,806.85","68,647.97",
30-Nov-20,Transportellaneous,00.00,"6,864.80","61,783.17",
30-Nov-20,IMPS,00.00,"12,356.63","49,426.54",
30-Nov-20,Debit Card,00.00,"49,426.54",00.00,
30-Nov-20,Purchase,"31,772.10",00.00,"31,772.10",
30-Nov-20,Reversal,00.00,"15,886.05","15,886.05",
30-Nov-20,NEFT,"11,46,472.00",00.00,"11,62,358.05",
30-Nov-20,Purchase,"11,789.60",00.00,"11,74,147.65",
30-Nov-20,Reversal,00.00,"1,30,460.85","10,43,686.80",
30-Nov-20,RTGS,00.00,"1,04,368.68","9,39,318.12",
30-Nov-20,Cheque,49.77,00.00,"9,39,367.89",
30-Nov-20,Bill,02.00,00.00,"9,39,369.89",
30-Nov-20,Cheque,00.00,"3,13,123.30","6,26,246.59",
30-Nov-20,Transfer,26.32,00.00,"6,26,272.91",
30-Nov-20,Transportellaneous,00.00,"2,08,757.64","4,17,515.27",
30-Nov-20,ATM,"1,27,538.00",00.00,"5,45,053.27",
30-Nov-20,Transfer,00.00,"54,505.33","4,90,547.94",
30-Nov-20,Bill,00.00,"2,45,273.97","2,45,273.97",
30-Nov-20,Interest,342,00.00,"2,45,615.97",
30-Nov-20,Commission,00.00,"1,22,807.99","1,22,807.98",
30-Nov-20,Interest,01.60,00.00,"1,22,809.58",
30-Nov-20,Cash,00.00,"40,936.53","81,873.05",
30-Nov-20,Cheque,11,00.00,"81,884.05",
30-Nov-20,Bill,"1,52,390.40",00.00,"2,34,274.45",
30-Nov-20,Transportellaneous,"5,746.50",00.00,"2,40,020.95",
30-Nov-20,Reversal,"23,543.01",00.00,"2,63,563.96",
30-Nov-20,NEFT,00.00,"52,712.79","2,10,851.17",
30-Nov-20,Transfer,00.00,"30,121.60","1,80,729.57",
30-Nov-20,Interest,00.00,"30,121.60","1,50,607.98",
30-Nov-20,Transportellaneous,00.00,"21,515.43","1,29,092.55",
30-Nov-20,NEFT,00.00,"32,273.14","96,819.41",
30-Nov-20,RTGS,208,00.00,"97,027.41",
30-Nov-20,Bill,06.30,00.00,"97,033.71",
30-Nov-20,Reversal,00.00,"32,344.57","64,689.14",
30-Nov-20,Commission,00.00,"9,241.31","55,447.83",
30-Nov-20,Tax,00.00,"18,482.61","36,965.22",
30-Nov-20,Purchase,"18,236.00",00.00,"55,201.22",
30-Nov-20,Transfer,06.90,00.00,"55,208.12",
30-Nov-20,IMPS,00.00,"27,604.06","27,604.06",
30-Nov-20,Transfer,00.00,"2,760.41","24,843.65",
30-Nov-20,Cheque,"7,21,289.00",00.00,"7,46,132.65",
30-Nov-20,Cash,00.00,"1,06,590.38","6,39,542.27",
30-Nov-20,Commission,00.00,"2,13,180.76","4,26,361.51",
30-Nov-20,Cash,"2,574.90",00.00,"4,28,936.41",
30-Nov-20,Transportellaneous,00.00,"4,28,936.41",00.00,
30-Nov-20,Cheque,"57,228.00",00.00,"57,228.00",
30-Nov-20,NEFT,00.00,"6,358.67","50,869.33",
30-Nov-20,Purchase,"17,740.58",00.00,"68,609.91",
30-Nov-20,Tax,"2,586.90",00.00,"71,196.81",
30-Nov-20,Tax,00.00,"7,119.68","64,077.13",
30-Nov-20,Transfer,00.00,"21,359.04","42,718.09",
30-Nov-20,NEFT,"11,81,480.20",00.00,"12,24,198.29",
30-Nov-20,Transportellaneous,00.00,"1,22,419.83","11,01,778.46",
01-Dec-20,Transportellaneous,00.00,"2,20,355.69","8,81,422.77",
01-Dec-20,IMPS,118.8,00.00,"8,81,541.57",
01-Dec-20,Purchase,00.00,"1,25,934.51","7,55,607.06",
01-Dec-20,Cheque,00.00,"1,07,943.87","6,47,663.19",
01-Dec-20,Cheque,00.00,"1,29,532.64","5,18,130.55",
01-Dec-20,ATM,"19,101.00",00.00,"5,37,231.55",
01-Dec-20,Cash,00.00,"1,79,077.18","3,58,154.37",
01-Dec-20,Tax,00.00,"1,19,384.79","2,38,769.58",
01-Dec-20,Purchase,00.00,"39,794.93","1,98,974.65",
01-Dec-20,ATM,"1,384.00",00.00,"2,00,358.65",
01-Dec-20,Reversal,00.00,"20,035.87","1,80,322.78",
01-Dec-20,Transfer,00.00,"20,035.86","1,60,286.92",
01-Dec-20,ATM,"21,834.50",00.00,"1,82,121.42",
01-Dec-20,Bill,18.08,00.00,"1,82,139.50",
01-Dec-20,NEFT,"10,030.53",00.00,"1,92,170.03",
01-Dec-20,Tax,234.36,00.00,"1,92,404.39",
01-Dec-20,Debit Card,45.41,00.00,"1,92,449.80",
01-Dec-20,Purchase,00.00,"48,112.45","1,44,337.35",
01-Dec-20,Tax,00.00,"20,619.62","1,23,717.73",
01-Dec-20,Interest,"18,789.52",00.00,"1,42,507.25",
01-Dec-20,Transportellaneous,00.00,"23,751.21","1,18,756.04",
01-Dec-20,Bill,00.00,"14,844.51","1,03,911.53",
01-Dec-20,Purchase,00.00,"14,844.50","89,067.03",
01-Dec-20,Tax,04.00,00.00,"89,071.03",
01-Dec-20,IMPS,"1,404.00",00.00,"90,475.03",
01-Dec-20,Cash,"2,08,406.00",00.00,"2,98,881.03",
01-Dec-20,ATM,00.00,"33,209.00","2,65,672.03",
01-Dec-20,RTGS,00.00,"33,209.00","2,32,463.03",
01-Dec-20,Purchase,"2,25,195.00",00.00,"4,57,658.03",
01-Dec-20,Transportellaneous,00.00,"76,276.34","3,81,381.69",
01-Dec-20,ATM,"3,338.88",00.00,"3,84,720.57",
01-Dec-20,Bill,56,00.00,"3,84,776.57",
01-Dec-20,Commission,00.00,"1,92,388.29","1,92,388.28",
01-Dec-20,ATM,"93,656.00",00.00,"2,86,044.28",
01-Dec-20,Transfer,00.00,"2,86,044.28",00.00,
01-Dec-20,Transportellaneous,"10,545.20",00.00,"10,545.20",
01-Dec-20,ATM,00.00,"1,506.46","9,038.74",
01-Dec-20,Purchase,60.2,00.00,"9,098.94",
01-Dec-20,Cash,00.00,"1,010.99","8,087.95",
01-Dec-20,Commission,00.00,808.8,"7,279.16",
01-Dec-20,Bill,68.3,00.00,"7,347.46",
01-Dec-20,IMPS,00.30,00.00,"7,347.76",
01-Dec-20,Transfer,12,00.00,"7,359.76",
01-Dec-20,Transportellaneous,00.00,"1,051.39","6,308.37",
01-Dec-20,Tax,53.68,00.00,"6,362.05",
01-Dec-20,RTGS,00.00,636.21,"5,725.84",
01-Dec-20,Tax,63.2,00.00,"5,789.04",
01-Dec-20,Bill,00.00,827.01,"4,962.03",
01-Dec-20,Transfer,00.00,992.41,"3,969.62",
01-Dec-20,Tax,26.4,00.00,"3,996.02",
01-Dec-20,ATM,00.00,"1,998.01","1,998.01",
01-Dec-20,Bill,"9,316.89",00.00,"11,314.90",
01-Dec-20,Reversal,00.00,"2,262.98","9,051.92",
01-Dec-20,ATM,00.00,"9,051.92",00.00,
01-Dec-20,Tax,496.9,00.00,496.9,
01-Dec-20,Reversal,"5,474.06",00.00,"5,970.96",
02-Dec-20,Purchase,273.7,00.00,"6,244.66",
02-Dec-20,ATM,00.00,693.85,"5,550.81",
02-Dec-20,Transportellaneous,00.00,"2,775.41","2,775.40",
02-Dec-20,ATM,00.00,277.54,"2,497.86",
02-Dec-20,Reversal,04.00,00.00,"2,501.86",
02-Dec-20,Cash,00.00,625.47,"1,876.40",
02-Dec-20,IMPS,00.00,268.06,"1,608.34",
02-Dec-20,Purchase,"2,21,183.20",00.00,"2,22,791.54",
02-Dec-20,Reversal,"3,878.34",00.00,"2,26,669.88",
02-Dec-20,NEFT,00.00,"75,556.63","1,51,113.25",
02-Dec-20,Commission,"15,61,851.20",00.00,"17,12,964.45",
02-Dec-20,RTGS,"2,10,948.60",00.00,"19,23,913.05",
02-Dec-20,Cheque,00.00,"4,80,978.26","14,42,934.79",
02-Dec-20,Transfer,00.00,"3,60,733.70","10,82,201.09",
02-Dec-20,Commission,01.00,00.00,"10,82,202.09",
02-Dec-20,Commission,"7,98,192.00",00.00,"18,80,394.09",
02-Dec-20,Cheque,00.00,"9,40,197.05","9,40,197.04",
02-Dec-20,RTGS,00.00,"3,13,399.01","6,26,798.03",
02-Dec-20,Bill,05.90,00.00,"6,26,803.93",
02-Dec-20,Debit Card,19,00.00,"6,26,822.93",
02-Dec-20,Cheque,00.00,"1,04,470.49","5,22,352.44",
02-Dec-20,Debit Card,00.00,"87,058.74","4,35,293.70",
02-Dec-20,Tax,00.00,"48,365.97","3,86,927.73",
02-Dec-20,ATM,356.15,00.00,"3,87,283.88",
02-Dec-20,Cash,00.00,"48,410.49","3,38,873.40",
02-Dec-20,RTGS,07.40,00.00,"3,38,880.80",
02-Dec-20,Cash,07.60,00.00,"3,38,888.40",
02-Dec-20,Cash,00.00,"1,12,962.80","2,25,925.60",
02-Dec-20,Commission,00.00,"22,592.56","2,03,333.04",
02-Dec-20,NEFT,00.00,"22,592.56","1,80,740.48",
02-Dec-20,Purchase,00.00,"36,148.10","1,44,592.38",
02-Dec-20,RTGS,"20,06,364.00",00.00,"21,50,956.38",
02-Dec-20,IMPS,00.00,"3,58,492.73","17,92,463.65",
02-Dec-20,IMPS,"3,547.70",00.00,"17,96,011.35",
02-Dec-20,Purchase,00.00,"8,98,005.68","8,98,005.68",
02-Dec-20,Bill,00.00,"4,49,002.84","4,49,002.84",
02-Dec-20,RTGS,"14,92,954.75",00.00,"19,41,957.59",
02-Dec-20,Transfer,"7,21,560.50",00.00,"26,63,518.09",
02-Dec-20,IMPS,"26,795.80",00.00,"26,90,313.89",
02-Dec-20,RTGS,"2,383.41",00.00,"26,92,697.30",
02-Dec-20,Interest,"1,55,309.75",00.00,"28,48,007.05",
02-Dec-20,RTGS,00.00,"3,56,000.88","24,92,006.17",
02-Dec-20,Bill,"6,69,843.00",00.00,"31,61,849.17",
02-Dec-20,IMPS,"2,34,368.00",00.00,"33,96,217.17",
02-Dec-20,IMPS,00.00,"33,96,217.17",00.00,
02-Dec-20,IMPS,"8,74,478.00",00.00,"8,74,478.00",
02-Dec-20,IMPS,00.00,"8,74,478.00",00.00,
02-Dec-20,Bill,"62,681.00",00.00,"62,681.00",
02-Dec-20,Purchase,173.64,00.00,"62,854.64",
02-Dec-20,NEFT,"1,73,889.00",00.00,"2,36,743.64",
02-Dec-20,Cash,"1,08,663.20",00.00,"3,45,406.84",
02-Dec-20,Cash,"2,902.00",00.00,"3,48,308.84",
02-Dec-20,Cheque,00.00,"58,051.47","2,90,257.37",
02-Dec-20,Cash,00.00,"41,465.34","2,48,792.03",
02-Dec-20,Transfer,00.00,"41,465.34","2,07,326.69",
02-Dec-20,ATM,00.00,"23,036.30","1,84,290.39",
02-Dec-20,Transfer,"11,28,505.75",00.00,"13,12,796.14",
02-Dec-20,Tax,"2,980.60",00.00,"13,15,776.74",
02-Dec-20,Transfer,28.1,00.00,"13,15,804.84",
02-Dec-20,Transfer,01.20,00.00,"13,15,806.04",
02-Dec-20,Tax,00.00,"13,15,806.04",00.00,
02-Dec-20,Bill,"30,008.41",00.00,"30,008.41",
02-Dec-20,Transportellaneous,"29,312.54",00.00,"59,320.95",
02-Dec-20,Cheque,00.00,"9,886.83","49,434.12",
02-Dec-20,Bill,"31,511.97",00.00,"80,946.09",
02-Dec-20,Bill,00.00,"16,189.22","64,756.87",
02-Dec-20,Commission,334.6,00.00,"65,091.47",
02-Dec-20,Cash,00.00,"65,091.47",00.00,
02-Dec-20,Cheque,05.00,00.00,05.00,
02-Dec-20,Bill,02.42,00.00,07.42,
02-Dec-20,Debit Card,"17,969.00",00.00,"17,976.42",
02-Dec-20,ATM,06.66,00.00,"17,983.08",
02-Dec-20,ATM,"25,711.10",00.00,"43,694.18",
02-Dec-20,Cash,00.00,"7,282.36","36,411.82",
02-Dec-20,ATM,00.00,"6,068.64","30,343.18",
02-Dec-20,NEFT,00.00,"7,585.80","22,757.38",
02-Dec-20,Reversal,00.00,"3,251.05","19,506.33",
02-Dec-20,IMPS,"5,625.10",00.00,"25,131.43",
03-Dec-20,Interest,00.00,"12,565.72","12,565.72",
03-Dec-20,Interest,00.00,"4,188.57","8,377.15",
03-Dec-20,Commission,00.00,"1,675.43","6,701.72",
04-Dec-20,Bill,00.00,"6,701.72",00.00,
04-Dec-20,ATM,487.6,00.00,487.6,
04-Dec-20,Cash,00.00,97.52,390.08,
04-Dec-20,Purchase,36.65,00.00,426.73,
04-Dec-20,Transportellaneous,"33,668.00",00.00,"34,094.73",
04-Dec-20,IMPS,"2,393.90",00.00,"36,488.63",
04-Dec-20,NEFT,00.00,"4,054.29","32,434.34",
04-Dec-20,Purchase,"13,349.30",00.00,"45,783.64",
04-Dec-20,Transfer,00.00,"15,261.21","30,522.43",
04-Dec-20,Commission,"16,98,039.20",00.00,"17,28,561.63",
04-Dec-20,Transfer,"16,89,793.00",00.00,"34,18,354.63",
04-Dec-20,Transfer,00.00,"8,54,588.66","25,63,765.97",
04-Dec-20,Transportellaneous,15,00.00,"25,63,780.97",
04-Dec-20,Purchase,00.00,"2,56,378.10","23,07,402.87",
04-Dec-20,RTGS,"3,120.00",00.00,"23,10,522.87",
04-Dec-20,Cheque,00.10,00.00,"23,10,522.97",
04-Dec-20,Tax,"1,11,553.70",00.00,"24,22,076.67",
04-Dec-20,IMPS,00.00,"4,84,415.33","19,37,661.34",
04-Dec-20,IMPS,"9,211.86",00.00,"19,46,873.20",
04-Dec-20,RTGS,"31,488.17",00.00,"19,78,361.37",
05-Dec-20,Reversal,00.00,"1,97,836.14","17,80,525.23",
05-Dec-20,NEFT,01.22,00.00,"17,80,526.45",
05-Dec-20,IMPS,22.2,00.00,"17,80,548.65",
05-Dec-20,Cheque,00.40,00.00,"17,80,549.05",
05-Dec-20,Reversal,00.00,"3,56,109.81","14,24,439.24",
05-Dec-20,IMPS,00.00,"4,74,813.08","9,49,626.16",
05-Dec-20,Cheque,00.00,"1,05,514.02","8,44,112.14",
05-Dec-20,NEFT,00.00,"1,05,514.02","7,38,598.12",
05-Dec-20,Interest,00.00,"1,84,649.53","5,53,948.59",
05-Dec-20,Commission,00.00,"1,38,487.15","4,15,461.44",
06-Dec-20,Debit Card,00.00,"1,03,865.36","3,11,596.08",
06-Dec-20,Bill,00.00,"77,899.02","2,33,697.06",
06-Dec-20,ATM,00.00,"77,899.02","1,55,798.04",
06-Dec-20,Interest,00.00,"77,899.02","77,899.02",
06-Dec-20,Transfer,00.00,"7,789.90","70,109.12",
06-Dec-20,Cheque,00.00,"17,527.28","52,581.84",
06-Dec-20,Bill,44.28,00.00,"52,626.12",
06-Dec-20,Purchase,00.00,"5,847.35","46,778.77",
06-Dec-20,NEFT,287.2,00.00,"47,065.97",
07-Dec-20,Reversal,00.00,"23,532.99","23,532.98",
07-Dec-20,IMPS,00.00,"11,766.49","11,766.49",
08-Dec-20,RTGS,00.00,"1,176.65","10,589.84",
08-Dec-20,NEFT,08.00,00.00,"10,597.84",
08-Dec-20,Interest,37,00.00,"10,634.84",
08-Dec-20,Transfer,470.7,00.00,"11,105.54",
08-Dec-20,ATM,00.00,"2,221.11","8,884.43",
08-Dec-20,RTGS,00.00,"2,961.48","5,922.95",
08-Dec-20,RTGS,00.00,592.3,"5,330.66",
08-Dec-20,Cash,"2,102.70",00.00,"7,433.36",
08-Dec-20,Transfer,74.29,00.00,"7,507.65",
08-Dec-20,ATM,00.00,938.46,"6,569.19",
08-Dec-20,Cash,00.00,"1,313.84","5,255.35",
08-Dec-20,Bill,60,00.00,"5,315.35",
08-Dec-20,Tax,06.60,00.00,"5,321.95",
08-Dec-20,Commission,"28,589.00",00.00,"33,910.95",
08-Dec-20,Cheque,240.9,00.00,"34,151.85",
09-Dec-20,Tax,"2,65,595.50",00.00,"2,99,747.35",
09-Dec-20,Commission,00.00,"1,49,873.68","1,49,873.67",
09-Dec-20,Cash,02.40,00.00,"1,49,876.07",
09-Dec-20,RTGS,"10,257.64",00.00,"1,60,133.71",
09-Dec-20,ATM,41,00.00,"1,60,174.71",
09-Dec-20,ATM,00.00,"53,391.57","1,06,783.14",
09-Dec-20,Cash,517.25,00.00,"1,07,300.39",
09-Dec-20,Interest,37.81,00.00,"1,07,338.20",
09-Dec-20,Interest,07.70,00.00,"1,07,345.90",
09-Dec-20,Interest,"2,542.30",00.00,"1,09,888.20",
09-Dec-20,Commission,07.90,00.00,"1,09,896.10",
09-Dec-20,Purchase,"15,57,295.00",00.00,"16,67,191.10",
09-Dec-20,Debit Card,00.00,"16,67,191.10",00.00,
09-Dec-20,NEFT,433,00.00,433,
09-Dec-20,Commission,00.00,61.86,371.14,
09-Dec-20,Interest,34,00.00,405.14,
09-Dec-20,NEFT,00.00,135.05,270.09,
09-Dec-20,Reversal,00.00,33.76,236.33,
09-Dec-20,RTGS,00.00,59.08,177.25,
09-Dec-20,Purchase,00.00,29.54,147.71,
09-Dec-20,Tax,00.00,36.93,110.78,
09-Dec-20,Purchase,00.00,11.08,99.7,
09-Dec-20,Commission,"3,552.40",00.00,"3,652.10",
09-Dec-20,Purchase,00.00,456.51,"3,195.59",
09-Dec-20,RTGS,00.00,639.12,"2,556.47",
09-Dec-20,RTGS,00.00,365.21,"2,191.26",
09-Dec-20,Tax,00.00,"2,191.26",00.00,
09-Dec-20,Bill,06.84,00.00,06.84,
09-Dec-20,Purchase,"9,92,248.50",00.00,"9,92,255.34",
09-Dec-20,Transfer,00.00,"1,10,250.59","8,82,004.75",
09-Dec-20,ATM,00.00,"4,41,002.38","4,41,002.38",
09-Dec-20,Transportellaneous,"2,47,906.00",00.00,"6,88,908.38",
09-Dec-20,Purchase,02.87,00.00,"6,88,911.25",
09-Dec-20,NEFT,00.00,"76,545.69","6,12,365.56",
09-Dec-20,Debit Card,00.00,"1,53,091.39","4,59,274.17",
09-Dec-20,Cheque,00.00,"45,927.42","4,13,346.75",
09-Dec-20,Bill,00.00,"45,927.42","3,67,419.33",
09-Dec-20,Commission,"23,228.80",00.00,"3,90,648.13",
09-Dec-20,Cash,"3,67,144.00",00.00,"7,57,792.13",
09-Dec-20,Transportellaneous,00.00,"7,57,792.13",00.00,
09-Dec-20,Transfer,"18,65,578.00",00.00,"18,65,578.00",
09-Dec-20,Transportellaneous,00.00,"6,21,859.33","12,43,718.67",
09-Dec-20,Tax,"10,826.30",00.00,"12,54,544.97",
09-Dec-20,Tax,"1,00,073.00",00.00,"13,54,617.97",
09-Dec-20,Debit Card,00.00,"13,54,617.97",00.00,
10-Dec-20,IMPS,27.23,00.00,27.23,
10-Dec-20,Commission,"17,32,766.00",00.00,"17,32,793.23",
10-Dec-20,Interest,150.79,00.00,"17,32,944.02",
10-Dec-20,Tax,"6,18,111.50",00.00,"23,51,055.52",
10-Dec-20,Bill,375.48,00.00,"23,51,431.00",
10-Dec-20,IMPS,"13,84,521.00",00.00,"37,35,952.00",
10-Dec-20,ATM,09.16,00.00,"37,35,961.16",
10-Dec-20,Purchase,"9,455.00",00.00,"37,45,416.16",
10-Dec-20,RTGS,00.00,"7,49,083.23","29,96,332.93",
10-Dec-20,Debit Card,18,00.00,"29,96,350.93",
10-Dec-20,Transfer,00.00,"14,98,175.47","14,98,175.46",
10-Dec-20,Bill,"14,466.70",00.00,"15,12,642.16",
10-Dec-20,Bill,00.00,"2,52,107.03","12,60,535.13",
10-Dec-20,Bill,"25,743.88",00.00,"12,86,279.01",
10-Dec-20,Commission,"30,081.29",00.00,"13,16,360.30",
10-Dec-20,Cash,"16,67,152.50",00.00,"29,83,512.80",
10-Dec-20,Transfer,00.00,"2,98,351.28","26,85,161.52",
10-Dec-20,Cash,00.00,"2,68,516.15","24,16,645.37",
10-Dec-20,Cash,"5,760.60",00.00,"24,22,405.97",
10-Dec-20,Debit Card,"29,536.70",00.00,"24,51,942.67",
10-Dec-20,RTGS,00.00,"6,12,985.67","18,38,957.00",
10-Dec-20,Transportellaneous,00.00,"2,62,708.14","15,76,248.86",
10-Dec-20,Transportellaneous,26,00.00,"15,76,274.86",
10-Dec-20,Tax,"1,89,684.80",00.00,"17,65,959.66",
10-Dec-20,ATM,00.00,"3,53,191.93","14,12,767.73",
10-Dec-20,Commission,"17,516.00",00.00,"14,30,283.73",
10-Dec-20,Reversal,00.00,"2,86,056.75","11,44,226.98",
10-Dec-20,Interest,"17,06,689.50",00.00,"28,50,916.48",
10-Dec-20,Debit Card,00.00,"3,56,364.56","24,94,551.92",
10-Dec-20,NEFT,369,00.00,"24,94,920.92",
10-Dec-20,ATM,"1,19,646.80",00.00,"26,14,567.72",
10-Dec-20,Purchase,00.00,"5,22,913.54","20,91,654.18",
10-Dec-20,Purchase,00.00,"4,18,330.84","16,73,323.34",
10-Dec-20,Reversal,468.72,00.00,"16,73,792.06",
10-Dec-20,Commission,"48,054.00",00.00,"17,21,846.06",
10-Dec-20,ATM,"48,087.50",00.00,"17,69,933.56",
10-Dec-20,Purchase,00.00,"1,96,659.28","15,73,274.28",
10-Dec-20,Interest,00.00,"1,96,659.29","13,76,615.00",
10-Dec-20,Cash,"14,56,293.00",00.00,"28,32,908.00",
10-Dec-20,Cash,00.00,"3,54,113.50","24,78,794.50",
10-Dec-20,Bill,40,00.00,"24,78,834.50",
10-Dec-20,NEFT,17.52,00.00,"24,78,852.02",
11-Dec-20,Tax,48.9,00.00,"24,78,900.92",
11-Dec-20,Tax,00.00,"24,78,900.92",00.00,
11-Dec-20,Cheque,"2,10,223.66",00.00,"2,10,223.66",
11-Dec-20,Bill,"2,219.17",00.00,"2,12,442.83",
11-Dec-20,Commission,00.00,"53,110.71","1,59,332.12",
11-Dec-20,Transportellaneous,00.00,"17,703.57","1,41,628.55",
11-Dec-20,RTGS,"3,349.30",00.00,"1,44,977.85",
11-Dec-20,Cheque,00.00,"1,44,977.85",00.00,
11-Dec-20,ATM,"29,845.00",00.00,"29,845.00",
11-Dec-20,IMPS,"16,486.00",00.00,"46,331.00",
11-Dec-20,NEFT,00.00,"15,443.67","30,887.33",
11-Dec-20,Bill,678,00.00,"31,565.33",
11-Dec-20,Interest,"1,24,758.10",00.00,"1,56,323.43",
11-Dec-20,Debit Card,00.00,"15,632.34","1,40,691.09",
11-Dec-20,NEFT,00.00,"70,345.55","70,345.54",
11-Dec-20,Cash,54.03,00.00,"70,399.57",
11-Dec-20,Cash,"18,803.06",00.00,"89,202.63",
11-Dec-20,Interest,00.00,"17,840.53","71,362.10",
11-Dec-20,Transfer,00.00,"7,929.12","63,432.98",
11-Dec-20,RTGS,"29,657.00",00.00,"93,089.98",
11-Dec-20,Commission,00.00,"15,515.00","77,574.98",
11-Dec-20,Transfer,"27,991.30",00.00,"1,05,566.28",
11-Dec-20,RTGS,00.58,00.00,"1,05,566.86",
11-Dec-20,Commission,00.00,"15,080.98","90,485.88",
11-Dec-20,Bill,487.4,00.00,"90,973.28",
11-Dec-20,Interest,11.88,00.00,"90,985.16",
11-Dec-20,IMPS,44,00.00,"91,029.16",
12-Dec-20,IMPS,155.5,00.00,"91,184.66",
12-Dec-20,Transfer,00.00,"22,796.17","68,388.50",
12-Dec-20,Cheque,"69,765.31",00.00,"1,38,153.81",
12-Dec-20,Interest,"5,198.79",00.00,"1,43,352.60",
12-Dec-20,Transfer,00.00,"23,892.10","1,19,460.50",
12-Dec-20,NEFT,00.00,"23,892.10","95,568.40",
12-Dec-20,NEFT,"2,795.10",00.00,"98,363.50",
12-Dec-20,Bill,63.96,00.00,"98,427.46",
12-Dec-20,Bill,00.00,"49,213.73","49,213.73",
12-Dec-20,IMPS,00.23,00.00,"49,213.96",
12-Dec-20,Transfer,02.69,00.00,"49,216.65",
12-Dec-20,Debit Card,20.3,00.00,"49,236.95",
12-Dec-20,Transfer,00.00,"24,618.48","24,618.48",
12-Dec-20,Debit Card,"3,689.20",00.00,"28,307.68",
13-Dec-20,Commission,00.00,"2,830.77","25,476.91",
13-Dec-20,IMPS,149.11,00.00,"25,626.02",
13-Dec-20,Commission,00.00,"5,125.20","20,500.82",
13-Dec-20,ATM,457.8,00.00,"20,958.62",
13-Dec-20,Tax,00.00,"4,191.72","16,766.90",
13-Dec-20,Tax,"22,372.00",00.00,"39,138.90",
14-Dec-20,Transportellaneous,00.00,"4,348.77","34,790.13",
14-Dec-20,NEFT,08.00,00.00,"34,798.13",
14-Dec-20,Tax,"1,71,310.00",00.00,"2,06,108.13",
14-Dec-20,Cash,"1,345.00",00.00,"2,07,453.13",
14-Dec-20,Reversal,00.00,"29,636.16","1,77,816.97",
14-Dec-20,Cash,00.00,"29,636.16","1,48,180.81",
14-Dec-20,NEFT,00.00,"74,090.41","74,090.40",
14-Dec-20,Transfer,"21,101.57",00.00,"95,191.97",
14-Dec-20,Cash,388,00.00,"95,579.97",
14-Dec-20,Reversal,"11,488.00",00.00,"1,07,067.97",
14-Dec-20,Reversal,00.00,"17,844.66","89,223.31",
14-Dec-20,Reversal,00.00,"44,611.66","44,611.66",
14-Dec-20,Reversal,"3,199.30",00.00,"47,810.96",
14-Dec-20,Bill,"1,88,314.59",00.00,"2,36,125.55",
14-Dec-20,NEFT,00.00,"78,708.52","1,57,417.03",
14-Dec-20,Tax,00.00,"17,490.78","1,39,926.25",
14-Dec-20,Cheque,502.3,00.00,"1,40,428.55",
14-Dec-20,Purchase,00.00,"1,40,428.55",00.00,
14-Dec-20,NEFT,"1,096.46",00.00,"1,096.46",
14-Dec-20,Transfer,"2,45,398.00",00.00,"2,46,494.46",
14-Dec-20,ATM,00.00,"35,213.49","2,11,280.97",
14-Dec-20,Cheque,00.00,"35,213.50","1,76,067.48",
14-Dec-20,ATM,"1,813.38",00.00,"1,77,880.86",
14-Dec-20,Tax,607.84,00.00,"1,78,488.70",
14-Dec-20,Reversal,00.00,"17,848.87","1,60,639.83",
14-Dec-20,Transportellaneous,00.00,"17,848.87","1,42,790.96",
14-Dec-20,NEFT,"3,626.10",00.00,"1,46,417.06",
14-Dec-20,RTGS,"9,173.00",00.00,"1,55,590.06",
14-Dec-20,Cash,00.00,"31,118.01","1,24,472.05",
14-Dec-20,ATM,"1,683.40",00.00,"1,26,155.45",
14-Dec-20,Debit Card,"1,95,925.80",00.00,"3,22,081.25",
14-Dec-20,NEFT,00.00,"40,260.16","2,81,821.09",
14-Dec-20,ATM,"1,286.80",00.00,"2,83,107.89",
14-Dec-20,Debit Card,00.00,"31,456.43","2,51,651.46",
14-Dec-20,Cash,04.41,00.00,"2,51,655.87",
14-Dec-20,Transfer,"19,21,145.20",00.00,"21,72,801.07",
14-Dec-20,IMPS,"21,479.80",00.00,"21,94,280.87",
14-Dec-20,Purchase,00.00,"2,74,285.11","19,19,995.76",
15-Dec-20,Debit Card,08.00,00.00,"19,20,003.76",
15-Dec-20,Commission,00.00,"1,92,000.38","17,28,003.38",
15-Dec-20,IMPS,00.00,"17,28,003.38",00.00,
15-Dec-20,Cash,528,00.00,528,
15-Dec-20,Cash,00.00,58.67,469.33,
15-Dec-20,Interest,00.00,52.15,417.18,
15-Dec-20,ATM,00.00,46.35,370.83,
15-Dec-20,Cheque,00.00,61.81,309.02,
15-Dec-20,Tax,00.00,44.15,264.87,
15-Dec-20,Cheque,"1,07,676.00",00.00,"1,07,940.87",
15-Dec-20,Debit Card,12.63,00.00,"1,07,953.50",
15-Dec-20,ATM,00.00,"53,976.75","53,976.75",
15-Dec-20,Cash,00.00,"7,710.96","46,265.79",
15-Dec-20,Transfer,23.17,00.00,"46,288.96",
15-Dec-20,ATM,"3,629.94",00.00,"49,918.90",
15-Dec-20,Reversal,50.13,00.00,"49,969.03",
15-Dec-20,Cash,"3,033.00",00.00,"53,002.03",
15-Dec-20,Transfer,00.50,00.00,"53,002.53",
15-Dec-20,Purchase,00.00,"17,667.51","35,335.02",
15-Dec-20,IMPS,41.29,00.00,"35,376.31",
15-Dec-20,Bill,00.00,"17,688.16","17,688.16",
16-Dec-20,IMPS,00.00,"1,768.82","15,919.34",
16-Dec-20,Cheque,47,00.00,"15,966.34",
16-Dec-20,IMPS,06.20,00.00,"15,972.54",
16-Dec-20,ATM,00.00,"1,996.57","13,975.97",
16-Dec-20,Interest,00.00,"13,975.97",00.00,
16-Dec-20,Commission,"31,929.50",00.00,"31,929.50",
16-Dec-20,Commission,00.00,"5,321.58","26,607.92",
16-Dec-20,Bill,"15,776.52",00.00,"42,384.44",
16-Dec-20,Bill,23.5,00.00,"42,407.94",
16-Dec-20,Bill,00.00,"5,300.99","37,106.95",
16-Dec-20,Debit Card,"31,352.00",00.00,"68,458.95",
16-Dec-20,IMPS,00.00,"34,229.48","34,229.48",
16-Dec-20,Interest,00.00,"4,889.93","29,339.55",
16-Dec-20,Cash,10,00.00,"29,349.55",
16-Dec-20,Reversal,00.00,"29,349.55",00.00,
16-Dec-20,Debit Card,"25,604.87",00.00,"25,604.87",
16-Dec-20,Commission,00.00,"3,657.84","21,947.03",
16-Dec-20,Transportellaneous,"7,96,545.00",00.00,"8,18,492.03",
16-Dec-20,Debit Card,"1,66,944.60",00.00,"9,85,436.63",
16-Dec-20,Debit Card,00.00,"98,543.66","8,86,892.97",
17-Dec-20,Interest,00.00,"1,26,699.00","7,60,193.97",
17-Dec-20,Cheque,08.00,00.00,"7,60,201.97",
18-Dec-20,Cheque,00.00,"1,26,700.33","6,33,501.64",
18-Dec-20,IMPS,00.00,"1,05,583.61","5,27,918.03",
18-Dec-20,IMPS,01.75,00.00,"5,27,919.78",
18-Dec-20,Cash,00.00,"87,986.63","4,39,933.15",
18-Dec-20,RTGS,00.00,"87,986.63","3,51,946.52",
18-Dec-20,NEFT,579,00.00,"3,52,525.52",
18-Dec-20,Interest,00.00,"39,169.50","3,13,356.02",
18-Dec-20,Interest,07.30,00.00,"3,13,363.32",
18-Dec-20,Debit Card,461,00.00,"3,13,824.32",
18-Dec-20,Cash,"16,572.00",00.00,"3,30,396.32",
18-Dec-20,Interest,19.3,00.00,"3,30,415.62",
18-Dec-20,Bill,581.21,00.00,"3,30,996.83",
18-Dec-20,RTGS,"24,268.00",00.00,"3,55,264.83",
18-Dec-20,Interest,01.00,00.00,"3,55,265.83",
18-Dec-20,Commission,02.73,00.00,"3,55,268.56",
18-Dec-20,Tax,"1,53,319.00",00.00,"5,08,587.56",
18-Dec-20,Cheque,00.00,"50,858.76","4,57,728.80",
18-Dec-20,Transfer,00.00,"65,389.83","3,92,338.97",
18-Dec-20,Reversal,00.00,"78,467.79","3,13,871.18",
18-Dec-20,Cash,"2,383.00",00.00,"3,16,254.18",
18-Dec-20,Reversal,00.00,"1,05,418.06","2,10,836.12",
18-Dec-20,Bill,00.00,"42,167.22","1,68,668.90",
18-Dec-20,RTGS,00.00,"24,095.56","1,44,573.34",
18-Dec-20,IMPS,00.00,"14,457.33","1,30,116.01",
18-Dec-20,Debit Card,"2,16,421.00",00.00,"3,46,537.01",
18-Dec-20,Commission,00.00,"1,73,268.51","1,73,268.50",
18-Dec-20,Commission,00.00,"57,756.17","1,15,512.33",
18-Dec-20,Reversal,188.46,00.00,"1,15,700.79",
18-Dec-20,Purchase,00.00,"16,528.68","99,172.11",
18-Dec-20,IMPS,00.00,"99,172.11",00.00,
18-Dec-20,Cash,"1,003.00",00.00,"1,003.00",
18-Dec-20,Purchase,00.00,501.5,501.5,
18-Dec-20,Reversal,00.00,501.5,00.00,
18-Dec-20,Reversal,"20,000.59",00.00,"20,000.59",
18-Dec-20,Commission,"2,792.73",00.00,"22,793.32",
18-Dec-20,RTGS,00.00,"7,597.77","15,195.55",
18-Dec-20,Purchase,11.69,00.00,"15,207.24",
18-Dec-20,Bill,00.00,"15,207.24",00.00,
18-Dec-20,Bill,09.10,00.00,09.10,
18-Dec-20,Debit Card,00.00,01.52,07.58,
18-Dec-20,Transfer,"1,675.40",00.00,"1,682.98",
18-Dec-20,Purchase,335.5,00.00,"2,018.48",
18-Dec-20,RTGS,19.6,00.00,"2,038.08",
18-Dec-20,Tax,"1,05,416.62",00.00,"1,07,454.70",
18-Dec-20,IMPS,00.00,"1,07,454.70",00.00,
18-Dec-20,IMPS,"1,70,678.81",00.00,"1,70,678.81",
18-Dec-20,NEFT,"14,253.50",00.00,"1,84,932.31",
18-Dec-20,RTGS,00.00,"20,548.03","1,64,384.28",
18-Dec-20,Bill,"1,90,471.47",00.00,"3,54,855.75",
18-Dec-20,Cash,00.00,"1,18,285.25","2,36,570.50",
18-Dec-20,Tax,"2,26,600.16",00.00,"4,63,170.66",
18-Dec-20,Cash,00.00,"46,317.07","4,16,853.59",
18-Dec-20,Purchase,"2,27,454.00",00.00,"6,44,307.59",
18-Dec-20,Tax,00.00,"92,043.94","5,52,263.65",
18-Dec-20,Interest,"1,33,816.53",00.00,"6,86,080.18",
18-Dec-20,Transportellaneous,"24,208.80",00.00,"7,10,288.98",
18-Dec-20,Reversal,00.00,"2,36,762.99","4,73,525.99",
18-Dec-20,Debit Card,"25,167.60",00.00,"4,98,693.59",
18-Dec-20,Cash,00.00,"1,24,673.40","3,74,020.19",
18-Dec-20,Commission,00.00,"62,336.70","3,11,683.49",
18-Dec-20,Transfer,"1,17,927.00",00.00,"4,29,610.49",
18-Dec-20,Cheque,00.00,"53,701.31","3,75,909.18",
18-Dec-20,Reversal,00.00,"3,75,909.18",00.00,
18-Dec-20,NEFT,"1,220.00",00.00,"1,220.00",
18-Dec-20,IMPS,00.00,244,976,
18-Dec-20,Commission,"1,43,343.70",00.00,"1,44,319.70",
18-Dec-20,Cheque,00.00,"1,44,319.70",00.00,
18-Dec-20,ATM,00.10,00.00,00.10,
18-Dec-20,Reversal,"18,33,210.75",00.00,"18,33,210.85",
18-Dec-20,Debit Card,00.00,"18,33,210.85",00.00,
18-Dec-20,RTGS,413,00.00,413,
18-Dec-20,Purchase,476.06,00.00,889.06,
18-Dec-20,Interest,00.00,88.91,800.15,
18-Dec-20,Interest,00.00,200.04,600.11,
18-Dec-20,ATM,00.00,100.02,500.09,
18-Dec-20,Debit Card,"70,467.62",00.00,"70,967.71",
18-Dec-20,Bill,238,00.00,"71,205.71",
18-Dec-20,Commission,378,00.00,"71,583.71",
18-Dec-20,Reversal,"12,926.80",00.00,"84,510.51",
18-Dec-20,Reversal,00.00,"12,072.93","72,437.58",
19-Dec-20,ATM,"1,92,490.47",00.00,"2,64,928.05",
19-Dec-20,RTGS,00.00,"88,309.35","1,76,618.70",
19-Dec-20,Tax,00.00,"35,323.74","1,41,294.96",
19-Dec-20,Purchase,350.1,00.00,"1,41,645.06",
19-Dec-20,Commission,50.9,00.00,"1,41,695.96",
19-Dec-20,IMPS,00.00,"35,423.99","1,06,271.97",
19-Dec-20,Cash,00.00,"53,135.99","53,135.98",
19-Dec-20,Reversal,00.00,"13,284.00","39,851.98",
19-Dec-20,Commission,02.67,00.00,"39,854.65",
19-Dec-20,Reversal,00.00,"13,284.88","26,569.77",
19-Dec-20,RTGS,"26,450.00",00.00,"53,019.77",
20-Dec-20,RTGS,00.00,"6,627.47","46,392.30",
20-Dec-20,NEFT,44,00.00,"46,436.30",
20-Dec-20,Transfer,"2,605.11",00.00,"49,041.41",
20-Dec-20,Commission,"1,73,288.30",00.00,"2,22,329.71",
21-Dec-20,Debit Card,00.00,"55,582.43","1,66,747.28",
21-Dec-20,ATM,02.40,00.00,"1,66,749.68",
21-Dec-20,Commission,00.00,"83,374.84","83,374.84",
21-Dec-20,Transfer,08.00,00.00,"83,382.84",
21-Dec-20,NEFT,00.00,"20,845.71","62,537.13",
21-Dec-20,NEFT,"4,75,411.00",00.00,"5,37,948.13",
21-Dec-20,Bill,00.00,"2,68,974.07","2,68,974.06",
21-Dec-20,Cheque,"18,115.00",00.00,"2,87,089.06",
21-Dec-20,Tax,00.00,"31,898.78","2,55,190.28",
21-Dec-20,Debit Card,98.56,00.00,"2,55,288.84",
21-Dec-20,Interest,00.00,"63,822.21","1,91,466.63",
21-Dec-20,Interest,"98,281.40",00.00,"2,89,748.03",
21-Dec-20,Tax,251.87,00.00,"2,89,999.90",
22-Dec-20,Debit Card,00.00,"36,249.99","2,53,749.91",
22-Dec-20,Transfer,00.00,"1,26,874.96","1,26,874.96",
22-Dec-20,IMPS,60,00.00,"1,26,934.96",
22-Dec-20,Commission,"12,94,784.00",00.00,"14,21,718.96",
22-Dec-20,Bill,00.00,"2,03,102.71","12,18,616.25",
22-Dec-20,Debit Card,52.34,00.00,"12,18,668.59",
22-Dec-20,Tax,00.00,"1,35,407.62","10,83,260.97",
22-Dec-20,Cash,00.00,"2,16,652.19","8,66,608.78",
22-Dec-20,RTGS,00.00,"1,08,326.10","7,58,282.68",
22-Dec-20,IMPS,00.00,"1,89,570.67","5,68,712.01",
22-Dec-20,Cheque,00.00,"2,84,356.01","2,84,356.00",
22-Dec-20,Transportellaneous,38,00.00,"2,84,394.00",
22-Dec-20,Commission,07.80,00.00,"2,84,401.80",
22-Dec-20,Interest,00.00,"56,880.36","2,27,521.44",
22-Dec-20,Tax,00.00,"75,840.48","1,51,680.96",
22-Dec-20,Purchase,"2,955.00",00.00,"1,54,635.96",
22-Dec-20,ATM,"3,30,084.80",00.00,"4,84,720.76",
22-Dec-20,Transfer,"2,410.29",00.00,"4,87,131.05",
23-Dec-20,Transfer,07.70,00.00,"4,87,138.75",
23-Dec-20,Interest,00.00,"48,713.88","4,38,424.88",
23-Dec-20,NEFT,"2,036.48",00.00,"4,40,461.36",
23-Dec-20,Tax,00.30,00.00,"4,40,461.66",
23-Dec-20,ATM,00.00,"4,40,461.66",00.00,
23-Dec-20,Bill,"45,219.00",00.00,"45,219.00",
23-Dec-20,Cash,00.00,"4,521.90","40,697.10",
23-Dec-20,Commission,00.00,"4,069.71","36,627.39",
24-Dec-20,Transfer,00.00,"18,313.70","18,313.70",
24-Dec-20,IMPS,00.00,"1,831.37","16,482.33",
24-Dec-20,Reversal,00.00,"1,648.23","14,834.10",
24-Dec-20,NEFT,00.00,"2,966.82","11,867.28",
24-Dec-20,Reversal,00.00,"1,695.33","10,171.95",
24-Dec-20,Transfer,00.00,"1,130.22","9,041.73",
24-Dec-20,Bill,00.00,"1,506.96","7,534.78",
24-Dec-20,Purchase,00.00,"1,076.40","6,458.38",
24-Dec-20,Cash,00.00,717.6,"5,740.78",
24-Dec-20,Reversal,00.00,956.8,"4,783.98",
24-Dec-20,Purchase,00.00,"1,196.00","3,587.98",
24-Dec-20,Transportellaneous,06.00,00.00,"3,593.98",
24-Dec-20,IMPS,54,00.00,"3,647.98",
24-Dec-20,Interest,07.69,00.00,"3,655.67",
24-Dec-20,NEFT,00.00,609.28,"3,046.39",
24-Dec-20,IMPS,00.00,507.73,"2,538.66",
24-Dec-20,Purchase,00.00,507.73,"2,030.93",
25-Dec-20,Commission,00.00,406.19,"1,624.74",
25-Dec-20,RTGS,"16,30,089.75",00.00,"16,31,714.49",
25-Dec-20,Bill,08.50,00.00,"16,31,722.99",
25-Dec-20,Commission,"12,44,079.20",00.00,"28,75,802.19",
25-Dec-20,Reversal,09.00,00.00,"28,75,811.19",
25-Dec-20,Cash,"2,443.74",00.00,"28,78,254.93",
25-Dec-20,Commission,"6,69,418.00",00.00,"35,47,672.93",
25-Dec-20,ATM,338,00.00,"35,48,010.93",
25-Dec-20,Transportellaneous,00.00,"3,94,223.44","31,53,787.49",
25-Dec-20,NEFT,00.00,"3,94,223.44","27,59,564.05",
25-Dec-20,ATM,00.00,"27,59,564.05",00.00,
25-Dec-20,Purchase,01.54,00.00,01.54,
25-Dec-20,Interest,00.00,00.77,00.77,
25-Dec-20,Cheque,00.00,00.08,00.69,
25-Dec-20,Cash,01.10,00.00,01.79,
25-Dec-20,ATM,18.92,00.00,20.71,
25-Dec-20,ATM,00.00,10.36,10.36,
25-Dec-20,Interest,00.00,01.04,09.32,
25-Dec-20,Cheque,02.79,00.00,12.11,
25-Dec-20,ATM,77,00.00,89.11,
25-Dec-20,Transfer,00.00,00.00,89.11,
25-Dec-20,Interest,00.00,11.14,77.97,
25-Dec-20,ATM,00.00,19.49,58.48,
25-Dec-20,Reversal,00.00,09.75,48.73,
25-Dec-20,Reversal,09.00,00.00,57.73,
25-Dec-20,Interest,"8,63,388.00",00.00,"8,63,445.73",
25-Dec-20,Interest,57.3,00.00,"8,63,503.03",
25-Dec-20,Purchase,935.8,00.00,"8,64,438.83",
25-Dec-20,Cash,00.00,"8,64,438.83",00.00,
25-Dec-20,Transfer,408,00.00,408,
25-Dec-20,NEFT,34,00.00,442,
25-Dec-20,Bill,00.00,55.25,386.75,
25-Dec-20,Cash,"2,584.00",00.00,"2,970.75",
25-Dec-20,Tax,880.32,00.00,"3,851.07",
25-Dec-20,Cheque,"20,05,320.00",00.00,"20,09,171.07",
25-Dec-20,Bill,00.00,"4,01,834.21","16,07,336.86",
25-Dec-20,ATM,"2,04,754.00",00.00,"18,12,090.86",
25-Dec-20,Tax,"15,92,725.00",00.00,"34,04,815.86",
25-Dec-20,Cheque,00.00,"5,67,469.31","28,37,346.55",
25-Dec-20,Debit Card,257,00.00,"28,37,603.55",
25-Dec-20,RTGS,00.00,"3,15,289.28","25,22,314.27",
25-Dec-20,Transfer,07.00,00.00,"25,22,321.27",
25-Dec-20,Transfer,"27,869.50",00.00,"25,50,190.77",
25-Dec-20,Interest,22.1,00.00,"25,50,212.87",
25-Dec-20,Bill,00.00,"25,50,212.87",00.00,
25-Dec-20,Transfer,"3,076.68",00.00,"3,076.68",
25-Dec-20,NEFT,296.51,00.00,"3,373.19",
25-Dec-20,IMPS,00.00,421.65,"2,951.54",
25-Dec-20,Debit Card,"31,114.20",00.00,"34,065.74",
25-Dec-20,RTGS,"61,486.00",00.00,"95,551.74",
25-Dec-20,Transportellaneous,00.00,"11,943.97","83,607.77",
25-Dec-20,Bill,"11,59,699.25",00.00,"12,43,307.02",
25-Dec-20,NEFT,00.00,"1,55,413.38","10,87,893.64",
25-Dec-20,IMPS,00.00,"10,87,893.64",00.00,
25-Dec-20,Interest,"29,173.73",00.00,"29,173.73",
25-Dec-20,RTGS,00.00,"3,646.72","25,527.01",
25-Dec-20,Bill,13,00.00,"25,540.01",
25-Dec-20,Cheque,"1,80,598.50",00.00,"2,06,138.51",
25-Dec-20,IMPS,"9,406.00",00.00,"2,15,544.51",
25-Dec-20,Transportellaneous,"1,91,399.16",00.00,"4,06,943.67",
25-Dec-20,Debit Card,00.00,"81,388.73","3,25,554.94",
25-Dec-20,IMPS,"1,516.00",00.00,"3,27,070.94",
25-Dec-20,Interest,00.00,"1,63,535.47","1,63,535.47",
25-Dec-20,Transfer,05.20,00.00,"1,63,540.67",
26-Dec-20,IMPS,00.00,"16,354.07","1,47,186.60",
26-Dec-20,Cheque,00.00,"1,47,186.60",00.00,
26-Dec-20,Transfer,366,00.00,366,
26-Dec-20,Commission,"1,53,692.00",00.00,"1,54,058.00",
26-Dec-20,ATM,03.00,00.00,"1,54,061.00",
26-Dec-20,Commission,00.00,"38,515.25","1,15,545.75",
26-Dec-20,Bill,00.00,"57,772.88","57,772.88",
26-Dec-20,Bill,980.82,00.00,"58,753.70",
26-Dec-20,Cheque,00.00,"8,393.39","50,360.31",
26-Dec-20,Cheque,"16,681.00",00.00,"67,041.31",
26-Dec-20,Transportellaneous,35.8,00.00,"67,077.11",
26-Dec-20,Purchase,"1,570.00",00.00,"68,647.11",
26-Dec-20,Reversal,292.7,00.00,"68,939.81",
26-Dec-20,Transfer,"5,20,562.80",00.00,"5,89,502.61",
26-Dec-20,Transfer,00.00,"58,950.26","5,30,552.35",
26-Dec-20,ATM,02.96,00.00,"5,30,555.31",
26-Dec-20,Interest,"18,765.00",00.00,"5,49,320.31",
26-Dec-20,Interest,00.00,"61,035.59","4,88,284.72",
27-Dec-20,Bill,283.5,00.00,"4,88,568.22",
27-Dec-20,Interest,40.48,00.00,"4,88,608.70",
27-Dec-20,Tax,60.7,00.00,"4,88,669.40",
27-Dec-20,ATM,00.00,"1,62,889.80","3,25,779.60",
27-Dec-20,Transportellaneous,"25,720.81",00.00,"3,51,500.41",
27-Dec-20,Transfer,01.40,00.00,"3,51,501.81",
27-Dec-20,Interest,00.00,"70,300.36","2,81,201.45",
27-Dec-20,Debit Card,00.00,"28,120.15","2,53,081.31",
27-Dec-20,IMPS,05.41,00.00,"2,53,086.72",
27-Dec-20,NEFT,00.00,"2,53,086.72",00.00,
27-Dec-20,Bill,"27,290.00",00.00,"27,290.00",
27-Dec-20,Cheque,00.00,"2,729.00","24,561.00",
27-Dec-20,RTGS,"90,524.50",00.00,"1,15,085.50",
27-Dec-20,RTGS,"1,653.30",00.00,"1,16,738.80",
27-Dec-20,IMPS,926.8,00.00,"1,17,665.60",
27-Dec-20,Purchase,00.00,"11,766.56","1,05,899.04",
27-Dec-20,Cheque,00.00,"52,949.52","52,949.52",
27-Dec-20,Debit Card,"16,47,223.20",00.00,"17,00,172.72",
27-Dec-20,Tax,00.00,"2,12,521.59","14,87,651.13",
27-Dec-20,Purchase,02.00,00.00,"14,87,653.13",
27-Dec-20,Debit Card,43.61,00.00,"14,87,696.74",
27-Dec-20,NEFT,00.00,"2,12,528.11","12,75,168.63",
27-Dec-20,Cash,"7,569.50",00.00,"12,82,738.13",
27-Dec-20,IMPS,00.00,"2,56,547.63","10,26,190.50",
27-Dec-20,Commission,00.00,"2,05,238.10","8,20,952.40",
27-Dec-20,Tax,61.6,00.00,"8,21,014.00",
27-Dec-20,ATM,"11,37,783.00",00.00,"19,58,797.00",
27-Dec-20,Interest,00.00,"9,79,398.50","9,79,398.50",
27-Dec-20,RTGS,00.00,"4,89,699.25","4,89,699.25",
27-Dec-20,RTGS,06.00,00.00,"4,89,705.25",
27-Dec-20,Transportellaneous,00.00,"1,63,235.08","3,26,470.17",
28-Dec-20,RTGS,"29,259.70",00.00,"3,55,729.87",
28-Dec-20,Commission,00.00,"88,932.47","2,66,797.40",
28-Dec-20,RTGS,00.00,"1,33,398.70","1,33,398.70",
28-Dec-20,Transportellaneous,00.00,"44,466.23","88,932.47",
28-Dec-20,Transfer,00.00,"88,932.47",00.00,
28-Dec-20,Purchase,363,00.00,363,
28-Dec-20,Cheque,"13,96,614.00",00.00,"13,96,977.00",
28-Dec-20,Transfer,00.00,"1,99,568.14","11,97,408.86",
28-Dec-20,Commission,00.00,"1,33,045.43","10,64,363.43",
29-Dec-20,Bill,415.89,00.00,"10,64,779.32",
29-Dec-20,IMPS,00.60,00.00,"10,64,779.92",
29-Dec-20,Bill,00.00,"10,64,779.92",00.00,
29-Dec-20,Transfer,"12,258.36",00.00,"12,258.36",
29-Dec-20,IMPS,00.00,"12,258.36",00.00,
29-Dec-20,Interest,42.25,00.00,42.25,
29-Dec-20,NEFT,00.00,21.13,21.12,
29-Dec-20,Tax,"26,447.70",00.00,"26,468.82",
29-Dec-20,Cheque,02.26,00.00,"26,471.08",
30-Dec-20,Cash,403,00.00,"26,874.08",
30-Dec-20,IMPS,00.00,"3,839.15","23,034.93",
30-Dec-20,Bill,00.00,"23,034.93",00.00,
30-Dec-20,RTGS,"53,322.50",00.00,"53,322.50",
30-Dec-20,Transfer,25.71,00.00,"53,348.21",
30-Dec-20,IMPS,00.00,"6,668.53","46,679.68",
30-Dec-20,Bill,00.00,"7,779.95","38,899.73",
30-Dec-20,ATM,"10,90,277.50",00.00,"11,29,177.23",
30-Dec-20,Transportellaneous,00.00,"1,88,196.21","9,40,981.02",
30-Dec-20,Purchase,00.00,"1,34,425.86","8,06,555.16",
30-Dec-20,Transfer,02.00,00.00,"8,06,557.16",
30-Dec-20,Cash,00.00,"1,00,819.65","7,05,737.52",
30-Dec-20,Reversal,00.00,"88,217.19","6,17,520.33",
30-Dec-20,NEFT,"4,891.20",00.00,"6,22,411.53",
30-Dec-20,NEFT,00.00,"88,915.93","5,33,495.60",
30-Dec-20,NEFT,"2,61,215.40",00.00,"7,94,711.00",
30-Dec-20,RTGS,00.00,"88,301.22","7,06,409.78",
30-Dec-20,Interest,00.00,"1,76,602.45","5,29,807.34",
30-Dec-20,RTGS,54.37,00.00,"5,29,861.71",
30-Dec-20,NEFT,00.00,"1,05,972.34","4,23,889.37",
30-Dec-20,Bill,00.00,"42,388.94","3,81,500.43",
30-Dec-20,NEFT,"12,32,592.00",00.00,"16,14,092.43",
31-Dec-20,Interest,00.00,"8,07,046.22","8,07,046.22",
31-Dec-20,Reversal,00.00,"1,61,409.24","6,45,636.98",
31-Dec-20,Transportellaneous,"13,784.00",00.00,"6,59,420.98",
31-Dec-20,Reversal,"3,277.00",00.00,"6,62,697.98",
31-Dec-20,Commission,00.00,"1,65,674.50","4,97,023.48",
31-Dec-20,Cheque,00.00,"49,702.35","4,47,321.13",
31-Dec-20,Purchase,933.3,00.00,"4,48,254.43",
31-Dec-20,Commission,190.7,00.00,"4,48,445.13",
31-Dec-20,IMPS,00.00,"1,49,481.71","2,98,963.42",
31-Dec-20,Interest,00.00,"2,98,963.42",00.00,
31-Dec-20,IMPS,"7,11,079.25",00.00,"7,11,079.25",
31-Dec-20,Transfer,00.00,"1,01,582.75","6,09,496.50",
31-Dec-20,Interest,41,00.00,"6,09,537.50",
31-Dec-20,NEFT,"29,418.50",00.00,"6,38,956.00",
31-Dec-20,RTGS,02.60,00.00,"6,38,958.60",
31-Dec-20,Bill,00.00,"1,06,493.10","5,32,465.50",
31-Dec-20,RTGS,"7,91,432.00",00.00,"13,23,897.50",
31-Dec-20,Transportellaneous,00.00,"2,64,779.50","10,59,118.00",
31-Dec-20,Transfer,00.00,"1,17,679.78","9,41,438.22",
31-Dec-20,RTGS,00.00,"1,17,679.78","8,23,758.44",
31-Dec-20,RTGS,00.00,"2,74,586.15","5,49,172.29",
31-Dec-20,Purchase,00.00,"91,528.72","4,57,643.58",
31-Dec-20,NEFT,431.41,00.00,"4,58,074.99",
31-Dec-20,Tax,00.00,"76,345.83","3,81,729.16",
31-Dec-20,Transportellaneous,109,00.00,"3,81,838.16",
31-Dec-20,Commission,00.00,"1,90,919.08","1,90,919.08",
31-Dec-20,Purchase,03.50,00.00,"1,90,922.58",
31-Dec-20,Transportellaneous,00.00,"1,90,922.58",00.00,
31-Dec-20,RTGS,"10,048.01",00.00,"10,048.01",
31-Dec-20,Reversal,00.00,"5,024.01","5,024.00",
31-Dec-20,ATM,00.00,628,"4,396.00",
31-Dec-20,ATM,00.00,439.6,"3,956.40",
31-Dec-20,Interest,"2,956.00",00.00,"6,912.40",
31-Dec-20,Commission,"6,83,241.50",00.00,"6,90,153.90",
31-Dec-20,Interest,56.3,00.00,"6,90,210.20",
31-Dec-20,ATM,"17,81,779.00",00.00,"24,71,989.20",
31-Dec-20,ATM,00.00,"4,11,998.20","20,59,991.00",
31-Dec-20,IMPS,"11,978.60",00.00,"20,71,969.60",
31-Dec-20,Interest,04.03,00.00,"20,71,973.63",
31-Dec-20,Interest,397.9,00.00,"20,72,371.53",
31-Dec-20,ATM,"26,563.20",00.00,"20,98,934.73",
31-Dec-20,Commission,"24,703.94",00.00,"21,23,638.67",
31-Dec-20,Tax,793,00.00,"21,24,431.67",
31-Dec-20,Cash,00.00,"2,65,553.96","18,58,877.71",
31-Dec-20,Tax,"1,77,794.00",00.00,"20,36,671.71",
31-Dec-20,IMPS,00.00,"20,36,671.71",00.00,
31-Dec-20,RTGS,09.34,00.00,09.34,
31-Dec-20,Transportellaneous,654,00.00,663.34,
31-Dec-20,Interest,00.00,73.7,589.64,
31-Dec-20,Commission,496,00.00,"1,085.64",
31-Dec-20,Tax,00.00,155.09,930.55,
31-Dec-20,Commission,"1,921.00",00.00,"2,851.55",
31-Dec-20,Transfer,"17,78,130.80",00.00,"17,80,982.35",
31-Dec-20,Bill,00.00,"5,93,660.78","11,87,321.57",
31-Dec-20,Cash,00.00,"1,97,886.93","9,89,434.64",
31-Dec-20,Commission,32.99,00.00,"9,89,467.63",
31-Dec-20,ATM,"1,36,756.72",00.00,"11,26,224.35",
31-Dec-20,Debit Card,"2,774.80",00.00,"11,28,999.15",
31-Dec-20,IMPS,"15,06,315.00",00.00,"26,35,314.15",
31-Dec-20,ATM,00.00,"13,17,657.08","13,17,657.08",
31-Dec-20,Bill,00.00,"3,29,414.27","9,88,242.81",
31-Dec-20,Cheque,00.00,"1,97,648.56","7,90,594.25",
31-Dec-20,Interest,"15,75,246.20",00.00,"23,65,840.45",
31-Dec-20,Bill,00.00,"3,94,306.74","19,71,533.71",
31-Dec-20,Purchase,00.00,"6,57,177.90","13,14,355.81",
31-Dec-20,NEFT,"4,26,050.00",00.00,"17,40,405.81",
31-Dec-20,RTGS,00.00,"5,80,135.27","11,60,270.54",
31-Dec-20,NEFT,00.00,"1,16,027.05","10,44,243.49",
31-Dec-20,Cheque,00.00,"1,30,530.44","9,13,713.05",
31-Dec-20,Reversal,01.20,00.00,"9,13,714.25",
01-Jan-21,Transportellaneous,00.00,"3,04,571.42","6,09,142.83",
01-Jan-21,Interest,00.60,00.00,"6,09,143.43",
01-Jan-21,Cheque,00.00,"6,09,143.43",00.00,
01-Jan-21,Cheque,"16,26,456.00",00.00,"16,26,456.00",
01-Jan-21,Debit Card,00.00,"16,26,456.00",00.00,
01-Jan-21,ATM,"10,78,689.00",00.00,"10,78,689.00",
01-Jan-21,NEFT,"3,821.10",00.00,"10,82,510.10",
01-Jan-21,RTGS,00.00,"3,60,836.70","7,21,673.40",
01-Jan-21,Tax,"20,034.40",00.00,"7,41,707.80",
01-Jan-21,Cheque,00.00,"1,85,426.95","5,56,280.85",
01-Jan-21,NEFT,00.00,"92,713.48","4,63,567.38",
01-Jan-21,Purchase,448,00.00,"4,64,015.38",
01-Jan-21,Interest,00.00,"66,287.91","3,97,727.47",
01-Jan-21,IMPS,00.00,"56,818.21","3,40,909.26",
01-Jan-21,IMPS,"2,36,093.00",00.00,"5,77,002.26",
01-Jan-21,Cash,"25,768.63",00.00,"6,02,770.89",
01-Jan-21,Transportellaneous,00.00,"75,346.36","5,27,424.53",
02-Jan-21,Cash,400.8,00.00,"5,27,825.33",
02-Jan-21,Reversal,00.00,"1,31,956.33","3,95,869.00",
02-Jan-21,Transfer,00.00,"1,31,956.33","2,63,912.67",
02-Jan-21,Interest,00.00,"52,782.53","2,11,130.14",
02-Jan-21,NEFT,00.00,"70,376.71","1,40,753.43",
02-Jan-21,Interest,"7,216.80",00.00,"1,47,970.23",
02-Jan-21,Interest,00.00,"73,985.12","73,985.12",
02-Jan-21,Reversal,53,00.00,"74,038.12",
02-Jan-21,Debit Card,00.00,"74,038.12",00.00,
02-Jan-21,Transportellaneous,03.10,00.00,03.10,
02-Jan-21,Transportellaneous,00.00,00.34,02.76,
02-Jan-21,Transfer,00.00,01.38,01.38,
02-Jan-21,Reversal,00.00,00.15,01.23,
03-Jan-21,Transfer,"2,13,791.00",00.00,"2,13,792.23",
03-Jan-21,Purchase,18,00.00,"2,13,810.23",
03-Jan-21,Transportellaneous,"46,922.00",00.00,"2,60,732.23",
04-Jan-21,Tax,00.00,"26,073.22","2,34,659.01",
04-Jan-21,Tax,00.00,"23,465.90","2,11,193.11",
04-Jan-21,NEFT,57.05,00.00,"2,11,250.16",
04-Jan-21,Bill,00.00,"23,472.24","1,87,777.92",
04-Jan-21,NEFT,06.20,00.00,"1,87,784.12",
04-Jan-21,Debit Card,10,00.00,"1,87,794.12",
04-Jan-21,NEFT,11.8,00.00,"1,87,805.92",
04-Jan-21,Transportellaneous,00.00,"37,561.18","1,50,244.74",
04-Jan-21,Interest,"28,595.06",00.00,"1,78,839.80",
04-Jan-21,Tax,00.00,"44,709.95","1,34,129.85",
04-Jan-21,Reversal,00.00,"13,412.99","1,20,716.86",
04-Jan-21,Reversal,00.00,"17,245.27","1,03,471.59",
04-Jan-21,Interest,00.00,"10,347.16","93,124.43",
04-Jan-21,ATM,00.00,"46,562.22","46,562.22",
04-Jan-21,Tax,05.90,00.00,"46,568.12",
04-Jan-21,Tax,00.00,"7,761.35","38,806.77",
04-Jan-21,NEFT,00.00,"38,806.77",00.00,
04-Jan-21,Bill,03.00,00.00,03.00,
04-Jan-21,Debit Card,"2,444.18",00.00,"2,447.18",
04-Jan-21,IMPS,02.57,00.00,"2,449.75",
04-Jan-21,Transfer,"1,342.20",00.00,"3,791.95",
04-Jan-21,Purchase,"32,761.00",00.00,"36,552.95",
04-Jan-21,RTGS,"1,35,638.00",00.00,"1,72,190.95",
04-Jan-21,Cash,00.00,"24,598.71","1,47,592.24",
04-Jan-21,Bill,00.00,"49,197.41","98,394.83",
04-Jan-21,Bill,00.00,"98,394.83",00.00,
04-Jan-21,Tax,"2,48,798.20",00.00,"2,48,798.20",
04-Jan-21,Transportellaneous,00.00,"49,759.64","1,99,038.56",
04-Jan-21,Commission,00.00,"66,346.19","1,32,692.37",
04-Jan-21,Reversal,"8,20,494.75",00.00,"9,53,187.12",
04-Jan-21,Transfer,387,00.00,"9,53,574.12",
04-Jan-21,Purchase,00.00,"9,53,574.12",00.00,
04-Jan-21,ATM,"10,395.00",00.00,"10,395.00",
04-Jan-21,Commission,00.00,"2,598.75","7,796.25",
04-Jan-21,Cheque,00.00,"3,898.13","3,898.12",
04-Jan-21,Tax,"1,41,319.25",00.00,"1,45,217.37",
04-Jan-21,NEFT,00.00,"48,405.79","96,811.58",
04-Jan-21,Cheque,"3,705.00",00.00,"1,00,516.58",
04-Jan-21,Tax,05.00,00.00,"1,00,521.58",
04-Jan-21,Reversal,"15,687.20",00.00,"1,16,208.78",
04-Jan-21,Interest,00.00,"23,241.76","92,967.02",
04-Jan-21,Interest,00.00,"9,296.70","83,670.32",
04-Jan-21,Bill,00.00,"9,296.70","74,373.62",
04-Jan-21,Commission,00.00,"14,874.72","59,498.90",
04-Jan-21,Commission,00.00,"29,749.45","29,749.45",
04-Jan-21,NEFT,15.3,00.00,"29,764.75",
04-Jan-21,Cheque,07.00,00.00,"29,771.75",
04-Jan-21,IMPS,"15,67,024.00",00.00,"15,96,795.75",
04-Jan-21,Debit Card,00.00,"7,98,397.88","7,98,397.88",
04-Jan-21,NEFT,00.00,"1,59,679.58","6,38,718.30",
04-Jan-21,Cash,00.00,"1,06,453.05","5,32,265.25",
05-Jan-21,Cheque,00.00,"2,66,132.63","2,66,132.62",
05-Jan-21,Transfer,00.00,"26,613.26","2,39,519.36",
05-Jan-21,Reversal,00.00,"2,39,519.36",00.00,
05-Jan-21,Debit Card,"3,464.10",00.00,"3,464.10",
05-Jan-21,Transfer,00.00,"3,464.10",00.00,
05-Jan-21,Commission,07.21,00.00,07.21,
05-Jan-21,NEFT,"17,46,036.00",00.00,"17,46,043.21",
05-Jan-21,Cheque,20.3,00.00,"17,46,063.51",
05-Jan-21,Debit Card,00.00,"1,94,007.06","15,52,056.45",
05-Jan-21,Tax,00.00,"1,55,205.65","13,96,850.80",
05-Jan-21,Cash,"66,340.80",00.00,"14,63,191.60",
05-Jan-21,Cheque,00.00,"14,63,191.60",00.00,
05-Jan-21,RTGS,05.00,00.00,05.00,
06-Jan-21,Cheque,"16,20,350.00",00.00,"16,20,355.00",
06-Jan-21,Debit Card,00.00,"5,40,118.33","10,80,236.67",
06-Jan-21,IMPS,218.6,00.00,"10,80,455.27",
06-Jan-21,Debit Card,00.00,"1,54,350.75","9,26,104.52",
06-Jan-21,Transfer,00.00,"1,15,763.07","8,10,341.46",
06-Jan-21,Reversal,"17,649.70",00.00,"8,27,991.16",
06-Jan-21,IMPS,00.00,"1,65,598.23","6,62,392.93",
06-Jan-21,Cash,00.00,"1,65,598.23","4,96,794.70",
07-Jan-21,Interest,453.9,00.00,"4,97,248.60",
07-Jan-21,NEFT,00.00,"2,48,624.30","2,48,624.30",
07-Jan-21,Cash,"1,347.00",00.00,"2,49,971.30",
07-Jan-21,Cash,367,00.00,"2,50,338.30",
07-Jan-21,NEFT,00.00,"2,50,338.30",00.00,
07-Jan-21,Cash,00.20,00.00,00.20,
07-Jan-21,RTGS,00.00,00.20,00.00,
07-Jan-21,Tax,"4,055.90",00.00,"4,055.90",
07-Jan-21,Commission,00.00,579.41,"3,476.49",
07-Jan-21,RTGS,00.00,869.12,"2,607.37",
07-Jan-21,Cash,"1,97,729.40",00.00,"2,00,336.77",
07-Jan-21,Purchase,00.00,"28,619.54","1,71,717.23",
07-Jan-21,Debit Card,00.00,"17,171.72","1,54,545.51",
07-Jan-21,IMPS,157,00.00,"1,54,702.51",
07-Jan-21,RTGS,00.00,"51,567.50","1,03,135.01",
07-Jan-21,Purchase,"21,359.00",00.00,"1,24,494.01",
07-Jan-21,Cash,"3,133.94",00.00,"1,27,627.95",
07-Jan-21,Commission,00.00,"21,271.33","1,06,356.62",
07-Jan-21,Transportellaneous,00.00,"15,193.80","91,162.82",
07-Jan-21,NEFT,"4,478.30",00.00,"95,641.12",
07-Jan-21,Cash,"1,98,313.40",00.00,"2,93,954.52",
07-Jan-21,IMPS,"39,591.80",00.00,"3,33,546.32",
07-Jan-21,RTGS,00.00,"41,693.29","2,91,853.03",
07-Jan-21,RTGS,00.00,"36,481.63","2,55,371.40",
07-Jan-21,Debit Card,00.00,"1,27,685.70","1,27,685.70",
07-Jan-21,RTGS,15.03,00.00,"1,27,700.73",
08-Jan-21,Commission,00.00,"31,925.18","95,775.55",
08-Jan-21,Commission,00.00,"31,925.18","63,850.37",
08-Jan-21,ATM,"2,53,088.10",00.00,"3,16,938.47",
08-Jan-21,NEFT,"3,93,860.80",00.00,"7,10,799.27",
08-Jan-21,Transportellaneous,116,00.00,"7,10,915.27",
08-Jan-21,Debit Card,00.00,"71,091.53","6,39,823.74",
08-Jan-21,Bill,"28,877.00",00.00,"6,68,700.74",
08-Jan-21,Transfer,"22,392.37",00.00,"6,91,093.11",
08-Jan-21,Transfer,"7,353.20",00.00,"6,98,446.31",
08-Jan-21,IMPS,00.00,"2,32,815.44","4,65,630.87",
08-Jan-21,Reversal,"1,02,758.90",00.00,"5,68,389.77",
08-Jan-21,IMPS,114.1,00.00,"5,68,503.87",
08-Jan-21,Purchase,07.26,00.00,"5,68,511.13",
08-Jan-21,RTGS,00.00,"5,68,511.13",00.00,
08-Jan-21,Reversal,04.00,00.00,04.00,
08-Jan-21,Debit Card,00.00,00.57,03.43,
08-Jan-21,Transportellaneous,00.00,03.43,00.00,
08-Jan-21,Purchase,04.00,00.00,04.00,
08-Jan-21,Cheque,40,00.00,44,
08-Jan-21,Commission,297.29,00.00,341.29,
08-Jan-21,Debit Card,00.00,170.65,170.64,
08-Jan-21,Interest,00.00,42.66,127.98,
08-Jan-21,ATM,"12,13,624.00",00.00,"12,13,751.98",
08-Jan-21,Reversal,02.70,00.00,"12,13,754.68",
08-Jan-21,Cheque,"16,69,369.50",00.00,"28,83,124.18",
08-Jan-21,Debit Card,"1,013.00",00.00,"28,84,137.18",
08-Jan-21,Bill,164,00.00,"28,84,301.18",
08-Jan-21,Cash,"17,51,383.00",00.00,"46,35,684.18",
09-Jan-21,Transportellaneous,236.79,00.00,"46,35,920.97",
09-Jan-21,NEFT,00.20,00.00,"46,35,921.17",
09-Jan-21,Transfer,396,00.00,"46,36,317.17",
09-Jan-21,Purchase,00.00,"23,18,158.59","23,18,158.58",
09-Jan-21,Debit Card,44.84,00.00,"23,18,203.42",
09-Jan-21,IMPS,336,00.00,"23,18,539.42",
09-Jan-21,Bill,00.00,"3,31,219.92","19,87,319.50",
09-Jan-21,Transfer,00.00,"2,20,813.28","17,66,506.22",
09-Jan-21,IMPS,51,00.00,"17,66,557.22",
09-Jan-21,Reversal,446,00.00,"17,67,003.22",
09-Jan-21,Transfer,00.00,"5,89,001.07","11,78,002.15",
09-Jan-21,Bill,00.00,"3,92,667.38","7,85,334.77",
09-Jan-21,NEFT,124,00.00,"7,85,458.77",
09-Jan-21,IMPS,00.00,"1,12,208.40","6,73,250.37",
10-Jan-21,Cash,00.00,"74,805.60","5,98,444.77",
10-Jan-21,Interest,298,00.00,"5,98,742.77",
10-Jan-21,Cheque,00.00,"1,99,580.92","3,99,161.85",
10-Jan-21,RTGS,371.31,00.00,"3,99,533.16",
10-Jan-21,NEFT,159,00.00,"3,99,692.16",
10-Jan-21,Commission,916.1,00.00,"4,00,608.26",
10-Jan-21,Commission,77,00.00,"4,00,685.26",
10-Jan-21,Commission,00.00,"57,240.75","3,43,444.51",
10-Jan-21,Tax,22,00.00,"3,43,466.51",
10-Jan-21,Transportellaneous,03.80,00.00,"3,43,470.31",
10-Jan-21,Transportellaneous,00.00,"1,71,735.16","1,71,735.16",
10-Jan-21,NEFT,"15,20,862.20",00.00,"16,92,597.36",
10-Jan-21,Transportellaneous,06.00,00.00,"16,92,603.36",
10-Jan-21,NEFT,479.1,00.00,"16,93,082.46",
10-Jan-21,Debit Card,"13,297.27",00.00,"17,06,379.73",
10-Jan-21,Purchase,00.00,"5,68,793.24","11,37,586.49",
10-Jan-21,Debit Card,00.00,"2,27,517.30","9,10,069.19",
10-Jan-21,IMPS,00.00,"9,10,069.19",00.00,
10-Jan-21,ATM,"12,193.56",00.00,"12,193.56",
10-Jan-21,Tax,00.00,"4,064.52","8,129.04",
10-Jan-21,Purchase,03.72,00.00,"8,132.76",
10-Jan-21,Cheque,"19,575.03",00.00,"27,707.79",
10-Jan-21,Debit Card,00.00,"9,235.93","18,471.86",
10-Jan-21,Purchase,40,00.00,"18,511.86",
10-Jan-21,Transfer,00.00,"3,085.31","15,426.55",
10-Jan-21,Commission,10,00.00,"15,436.55",
10-Jan-21,NEFT,00.00,"1,715.17","13,721.38",
10-Jan-21,Cash,08.00,00.00,"13,729.38",
10-Jan-21,Interest,"2,442.00",00.00,"16,171.38",
10-Jan-21,Reversal,"21,553.10",00.00,"37,724.48",
10-Jan-21,Transportellaneous,67.3,00.00,"37,791.78",
10-Jan-21,ATM,59,00.00,"37,850.78",
10-Jan-21,Bill,150,00.00,"38,000.78",
10-Jan-21,Cash,00.00,"4,222.31","33,778.47",
11-Jan-21,Commission,48.85,00.00,"33,827.32",
11-Jan-21,Cash,367.2,00.00,"34,194.52",
11-Jan-21,Bill,00.00,"3,419.45","30,775.07",
11-Jan-21,Cash,00.00,"3,419.45","27,355.62",
11-Jan-21,Tax,00.00,"3,039.51","24,316.11",
11-Jan-21,Debit Card,"22,068.80",00.00,"46,384.91",
12-Jan-21,Purchase,00.00,"6,626.42","39,758.49",
12-Jan-21,Bill,236.05,00.00,"39,994.54",
12-Jan-21,Tax,00.00,"39,994.54",00.00,
12-Jan-21,Transportellaneous,"14,00,182.00",00.00,"14,00,182.00",
12-Jan-21,IMPS,"1,18,376.00",00.00,"15,18,558.00",
12-Jan-21,Tax,00.00,"15,18,558.00",00.00,
12-Jan-21,Transportellaneous,"1,075.83",00.00,"1,075.83",
12-Jan-21,Cheque,00.00,153.69,922.14,
12-Jan-21,Tax,00.00,102.46,819.68,
12-Jan-21,Transportellaneous,00.00,136.61,683.07,
12-Jan-21,Cheque,"7,253.60",00.00,"7,936.67",
12-Jan-21,IMPS,00.00,"3,968.34","3,968.34",
12-Jan-21,Cash,00.00,396.83,"3,571.51",
12-Jan-21,Reversal,"1,24,123.00",00.00,"1,27,694.51",
12-Jan-21,Bill,"1,86,839.94",00.00,"3,14,534.45",
12-Jan-21,ATM,00.00,"34,948.27","2,79,586.18",
12-Jan-21,Cheque,30.97,00.00,"2,79,617.15",
12-Jan-21,Cash,00.00,"27,961.72","2,51,655.44",
12-Jan-21,RTGS,02.20,00.00,"2,51,657.64",
12-Jan-21,Cash,00.00,"25,165.76","2,26,491.88",
12-Jan-21,Purchase,"26,759.30",00.00,"2,53,251.18",
12-Jan-21,Bill,"2,543.69",00.00,"2,55,794.87",
12-Jan-21,Bill,"21,073.30",00.00,"2,76,868.17",
12-Jan-21,Tax,"13,12,293.20",00.00,"15,89,161.37",
12-Jan-21,ATM,00.00,"3,97,290.34","11,91,871.03",
12-Jan-21,Debit Card,00.00,"1,48,983.88","10,42,887.15",
12-Jan-21,RTGS,00.00,"3,47,629.05","6,95,258.10",
12-Jan-21,Cheque,"3,245.00",00.00,"6,98,503.10",
12-Jan-21,Interest,00.00,00.00,"6,98,503.10",
12-Jan-21,Bill,00.00,"3,49,251.55","3,49,251.55",
12-Jan-21,IMPS,00.00,"43,656.44","3,05,595.11",
12-Jan-21,NEFT,"98,073.41",00.00,"4,03,668.52",
12-Jan-21,Purchase,"2,205.70",00.00,"4,05,874.22",
12-Jan-21,Cash,02.40,00.00,"4,05,876.62",
12-Jan-21,Transfer,282,00.00,"4,06,158.62",
12-Jan-21,RTGS,00.00,"45,128.74","3,61,029.88",
12-Jan-21,ATM,00.00,"1,20,343.29","2,40,686.59",
12-Jan-21,Reversal,"1,04,427.75",00.00,"3,45,114.34",
12-Jan-21,NEFT,00.00,"1,72,557.17","1,72,557.17",
12-Jan-21,Tax,00.00,"19,173.02","1,53,384.15",
12-Jan-21,Transfer,02.00,00.00,"1,53,386.15",
12-Jan-21,Transportellaneous,53.35,00.00,"1,53,439.50",
12-Jan-21,NEFT,00.00,"19,179.94","1,34,259.56",
12-Jan-21,Debit Card,00.00,"22,376.59","1,11,882.97",
12-Jan-21,Cash,02.90,00.00,"1,11,885.87",
13-Jan-21,Tax,00.00,"22,377.17","89,508.70",
13-Jan-21,ATM,"3,566.00",00.00,"93,074.70",
13-Jan-21,Transportellaneous,13.6,00.00,"93,088.30",
13-Jan-21,Tax,00.00,"46,544.15","46,544.15",
13-Jan-21,Bill,683.6,00.00,"47,227.75",
13-Jan-21,Tax,"22,248.29",00.00,"69,476.04",
13-Jan-21,Tax,00.00,"11,579.34","57,896.70",
13-Jan-21,Debit Card,"12,83,756.00",00.00,"13,41,652.70",
14-Jan-21,Purchase,"29,545.90",00.00,"13,71,198.60",
14-Jan-21,ATM,"1,38,102.00",00.00,"15,09,300.60",
14-Jan-21,Purchase,00.00,"2,51,550.10","12,57,750.50",
14-Jan-21,Transportellaneous,00.00,"1,39,750.06","11,18,000.44",
14-Jan-21,Bill,"2,58,730.75",00.00,"13,76,731.19",
14-Jan-21,Reversal,"10,10,920.50",00.00,"23,87,651.69",
14-Jan-21,Debit Card,00.00,"2,98,456.46","20,89,195.23",
14-Jan-21,IMPS,00.00,"5,22,298.81","15,66,896.42",
14-Jan-21,ATM,00.00,"15,66,896.42",00.00,
14-Jan-21,Purchase,"3,341.00",00.00,"3,341.00",
14-Jan-21,Reversal,00.00,556.83,"2,784.17",
14-Jan-21,IMPS,37,00.00,"2,821.17",
14-Jan-21,ATM,"15,43,409.00",00.00,"15,46,230.17",
14-Jan-21,Interest,00.00,"2,57,705.03","12,88,525.14",
14-Jan-21,Tax,467.3,00.00,"12,88,992.44",
15-Jan-21,ATM,00.00,"3,22,248.11","9,66,744.33",
15-Jan-21,Tax,00.00,"1,20,843.04","8,45,901.29",
15-Jan-21,Commission,45.9,00.00,"8,45,947.19",
15-Jan-21,Transportellaneous,00.00,"1,05,743.40","7,40,203.79",
15-Jan-21,Commission,00.00,"1,23,367.30","6,16,836.49",
15-Jan-21,Cheque,222,00.00,"6,17,058.49",
16-Jan-21,Purchase,00.00,"1,54,264.62","4,62,793.87",
16-Jan-21,Tax,00.00,"1,54,264.62","3,08,529.25",
17-Jan-21,NEFT,00.00,"77,132.31","2,31,396.94",
17-Jan-21,ATM,00.00,"57,849.24","1,73,547.70",
17-Jan-21,Interest,30,00.00,"1,73,577.70",
18-Jan-21,Tax,00.00,"43,394.43","1,30,183.28",
18-Jan-21,RTGS,"4,96,697.00",00.00,"6,26,880.28",
18-Jan-21,ATM,19.56,00.00,"6,26,899.84",
18-Jan-21,Bill,00.00,"69,655.54","5,57,244.30",
18-Jan-21,Transportellaneous,"1,56,734.28",00.00,"7,13,978.58",
18-Jan-21,NEFT,05.86,00.00,"7,13,984.44",
18-Jan-21,IMPS,00.00,"2,37,994.81","4,75,989.63",
18-Jan-21,Cash,00.00,"79,331.61","3,96,658.02",
18-Jan-21,RTGS,"16,901.30",00.00,"4,13,559.32",
18-Jan-21,Purchase,275.8,00.00,"4,13,835.12",
18-Jan-21,Bill,320.67,00.00,"4,14,155.79",
18-Jan-21,Tax,10.57,00.00,"4,14,166.36",
18-Jan-21,Cash,00.00,"2,07,083.18","2,07,083.18",
18-Jan-21,Debit Card,00.00,"25,885.40","1,81,197.78",
18-Jan-21,Reversal,00.00,"90,598.89","90,598.89",
18-Jan-21,Cheque,00.00,"12,942.70","77,656.19",
18-Jan-21,Commission,51.56,00.00,"77,707.75",
18-Jan-21,Interest,00.00,"15,541.55","62,166.20",
18-Jan-21,Tax,00.00,"10,361.03","51,805.17",
18-Jan-21,Bill,"19,858.40",00.00,"71,663.57",
18-Jan-21,ATM,00.00,"35,831.79","35,831.79",
19-Jan-21,ATM,00.00,"17,915.90","17,915.90",
19-Jan-21,Interest,07.50,00.00,"17,923.40",
19-Jan-21,IMPS,417.6,00.00,"18,341.00",
19-Jan-21,Tax,61.82,00.00,"18,402.82",
19-Jan-21,Transportellaneous,"1,208.00",00.00,"19,610.82",
19-Jan-21,Debit Card,00.00,"6,536.94","13,073.88",
19-Jan-21,Bill,00.00,"1,634.24","11,439.64",
19-Jan-21,Commission,49,00.00,"11,488.64",
19-Jan-21,Commission,00.00,"1,276.52","10,212.12",
19-Jan-21,ATM,00.00,"1,134.68","9,077.44",
19-Jan-21,Transportellaneous,"5,03,495.50",00.00,"5,12,572.94",
19-Jan-21,Transfer,00.00,"5,12,572.94",00.00,
19-Jan-21,ATM,299.75,00.00,299.75,
19-Jan-21,Commission,"16,34,069.00",00.00,"16,34,368.75",
19-Jan-21,Debit Card,"1,50,744.00",00.00,"17,85,112.75",
19-Jan-21,Transfer,00.00,"2,23,139.09","15,61,973.66",
19-Jan-21,Interest,00.00,"1,56,197.37","14,05,776.29",
19-Jan-21,Reversal,00.00,"2,81,155.26","11,24,621.03",
19-Jan-21,Transportellaneous,"13,449.50",00.00,"11,38,070.53",
19-Jan-21,ATM,100,00.00,"11,38,170.53",
19-Jan-21,Reversal,00.00,"5,69,085.27","5,69,085.26",
19-Jan-21,Reversal,00.00,"5,69,085.26",00.00,
19-Jan-21,Interest,"1,34,552.50",00.00,"1,34,552.50",
19-Jan-21,Bill,63,00.00,"1,34,615.50",
19-Jan-21,Transfer,463.6,00.00,"1,35,079.10",
19-Jan-21,Cash,00.00,"45,026.37","90,052.73",
19-Jan-21,Tax,234.23,00.00,"90,286.96",
19-Jan-21,Commission,00.00,"90,286.96",00.00,
19-Jan-21,Purchase,489.44,00.00,489.44,
19-Jan-21,Tax,"8,50,208.75",00.00,"8,50,698.19",
19-Jan-21,Cash,00.00,"1,21,528.31","7,29,169.88",
19-Jan-21,Reversal,00.00,"1,04,167.13","6,25,002.75",
19-Jan-21,Commission,00.00,"1,25,000.55","5,00,002.20",
19-Jan-21,Reversal,00.00,"1,66,667.40","3,33,334.80",
19-Jan-21,Bill,00.00,"1,66,667.40","1,66,667.40",
19-Jan-21,Tax,00.00,"55,555.80","1,11,111.60",
19-Jan-21,Cheque,23.8,00.00,"1,11,135.40",
19-Jan-21,Commission,"1,837.00",00.00,"1,12,972.40",
19-Jan-21,NEFT,00.00,"12,552.49","1,00,419.91",
19-Jan-21,NEFT,"1,200.94",00.00,"1,01,620.85",
19-Jan-21,Tax,"97,799.80",00.00,"1,99,420.65",
19-Jan-21,RTGS,00.00,"24,927.58","1,74,493.07",
19-Jan-21,Purchase,487,00.00,"1,74,980.07",
19-Jan-21,Commission,"32,241.49",00.00,"2,07,221.56",
19-Jan-21,Tax,00.00,"20,722.16","1,86,499.40",
19-Jan-21,NEFT,08.00,00.00,"1,86,507.40",
19-Jan-21,Reversal,00.00,"31,084.57","1,55,422.83",
19-Jan-21,Purchase,00.00,"17,269.20","1,38,153.63",
19-Jan-21,NEFT,00.00,"13,815.36","1,24,338.27",
19-Jan-21,Commission,"38,776.00",00.00,"1,63,114.27",
19-Jan-21,Bill,00.00,"16,311.43","1,46,802.84",
19-Jan-21,Bill,"95,120.70",00.00,"2,41,923.54",
19-Jan-21,Purchase,00.00,"60,480.89","1,81,442.66",
20-Jan-21,Debit Card,00.00,"90,721.33","90,721.33",
20-Jan-21,Tax,07.40,00.00,"90,728.73",
20-Jan-21,RTGS,"3,778.30",00.00,"94,507.03",
20-Jan-21,Bill,"2,304.30",00.00,"96,811.33",
20-Jan-21,Purchase,00.00,"48,405.67","48,405.66",
20-Jan-21,Transfer,00.00,"6,050.71","42,354.95",
20-Jan-21,Purchase,"30,940.68",00.00,"73,295.63",
20-Jan-21,Cash,00.00,"8,143.96","65,151.67",
20-Jan-21,Commission,"4,524.89",00.00,"69,676.56",
20-Jan-21,Commission,17.6,00.00,"69,694.16",
20-Jan-21,RTGS,"14,337.70",00.00,"84,031.86",
20-Jan-21,Transportellaneous,00.00,"9,336.87","74,694.99",
20-Jan-21,Commission,00.00,"12,449.17","62,245.82",
20-Jan-21,IMPS,257.5,00.00,"62,503.32",
20-Jan-21,Bill,00.00,"12,500.66","50,002.66",
20-Jan-21,Transfer,"10,33,227.00",00.00,"10,83,229.66",
20-Jan-21,Reversal,41,00.00,"10,83,270.66",
20-Jan-21,NEFT,00.00,"3,61,090.22","7,22,180.44",
20-Jan-21,Commission,06.10,00.00,"7,22,186.54",
20-Jan-21,Tax,00.00,"80,242.95","6,41,943.59",
20-Jan-21,Interest,"2,10,314.20",00.00,"8,52,257.79",
20-Jan-21,IMPS,22.3,00.00,"8,52,280.09",
20-Jan-21,Interest,00.00,"8,52,280.09",00.00,
21-Jan-21,Purchase,"20,48,961.00",00.00,"20,48,961.00",
21-Jan-21,IMPS,221.2,00.00,"20,49,182.20",
22-Jan-21,Bill,00.00,"3,41,530.37","17,07,651.83",
22-Jan-21,NEFT,"11,44,762.25",00.00,"28,52,414.08",
22-Jan-21,Bill,"2,237.02",00.00,"28,54,651.10",
22-Jan-21,Reversal,101.43,00.00,"28,54,752.53",
22-Jan-21,Cheque,"16,40,718.00",00.00,"44,95,470.53",
22-Jan-21,NEFT,"16,15,389.20",00.00,"61,10,859.73",
22-Jan-21,Cash,"1,767.86",00.00,"61,12,627.59",
22-Jan-21,ATM,00.00,"8,73,232.51","52,39,395.08",
22-Jan-21,Cash,00.00,"8,73,232.51","43,66,162.57",
22-Jan-21,Commission,"2,713.60",00.00,"43,68,876.17",
22-Jan-21,Tax,00.00,"8,73,775.23","34,95,100.94",
22-Jan-21,Cheque,00.00,"6,99,020.19","27,96,080.75",
22-Jan-21,Reversal,00.00,"4,66,013.46","23,30,067.29",
23-Jan-21,Reversal,00.00,"7,76,689.10","15,53,378.19",
23-Jan-21,Cheque,"2,00,917.62",00.00,"17,54,295.81",
23-Jan-21,Transportellaneous,"1,923.00",00.00,"17,56,218.81",
23-Jan-21,Bill,00.00,"4,39,054.70","13,17,164.11",
23-Jan-21,Tax,00.00,"4,39,054.70","8,78,109.41",
23-Jan-21,ATM,02.00,00.00,"8,78,111.41",
23-Jan-21,NEFT,"2,361.70",00.00,"8,80,473.11",
23-Jan-21,NEFT,00.00,"1,46,745.52","7,33,727.59",
23-Jan-21,NEFT,00.00,"2,44,575.86","4,89,151.73",
23-Jan-21,RTGS,00.00,"97,830.35","3,91,321.38",
23-Jan-21,Debit Card,"12,76,439.00",00.00,"16,67,760.38",
23-Jan-21,IMPS,00.00,"2,38,251.48","14,29,508.90",
23-Jan-21,Debit Card,"2,884.71",00.00,"14,32,393.61",
23-Jan-21,Purchase,00.00,"1,43,239.36","12,89,154.25",
23-Jan-21,Tax,00.00,"1,61,144.28","11,28,009.97",
23-Jan-21,Cheque,11.43,00.00,"11,28,021.40",
23-Jan-21,Purchase,"17,62,191.20",00.00,"28,90,212.60",
23-Jan-21,Interest,"2,130.00",00.00,"28,92,342.60",
23-Jan-21,Tax,00.00,"3,21,371.40","25,70,971.20",
23-Jan-21,Cheque,"1,562.90",00.00,"25,72,534.10",
23-Jan-21,Cheque,05.20,00.00,"25,72,539.30",
23-Jan-21,RTGS,"1,22,588.50",00.00,"26,95,127.80",
23-Jan-21,Transportellaneous,00.00,"6,73,781.95","20,21,345.85",
23-Jan-21,ATM,00.00,"2,52,668.23","17,68,677.62",
23-Jan-21,Debit Card,10.69,00.00,"17,68,688.31",
23-Jan-21,Debit Card,"29,391.00",00.00,"17,98,079.31",
23-Jan-21,Commission,00.00,"5,99,359.77","11,98,719.54",
23-Jan-21,Purchase,00.00,"1,99,786.59","9,98,932.95",
23-Jan-21,IMPS,63.1,00.00,"9,98,996.05",
23-Jan-21,Cheque,00.00,"1,99,799.21","7,99,196.84",
23-Jan-21,Interest,00.00,"7,99,196.84",00.00,
23-Jan-21,Cheque,"2,43,835.50",00.00,"2,43,835.50",
23-Jan-21,RTGS,404.4,00.00,"2,44,239.90",
23-Jan-21,IMPS,00.00,"40,706.65","2,03,533.25",
23-Jan-21,Interest,00.00,"1,01,766.63","1,01,766.62",
23-Jan-21,RTGS,00.00,"16,961.10","84,805.52",
23-Jan-21,ATM,"17,59,646.20",00.00,"18,44,451.72",
23-Jan-21,Cash,00.00,"3,68,890.34","14,75,561.38",
23-Jan-21,Transfer,00.00,"14,75,561.38",00.00,
23-Jan-21,ATM,11.43,00.00,11.43,
23-Jan-21,Cash,00.00,02.29,09.14,
23-Jan-21,ATM,443.48,00.00,452.62,
23-Jan-21,NEFT,483,00.00,935.62,
23-Jan-21,ATM,00.00,93.56,842.06,
23-Jan-21,Cheque,00.00,120.29,721.77,
23-Jan-21,Transfer,"7,76,390.00",00.00,"7,77,111.77",
23-Jan-21,ATM,"5,09,569.75",00.00,"12,86,681.52",
23-Jan-21,Cash,00.00,"6,43,340.76","6,43,340.76",
23-Jan-21,Cheque,"4,63,655.20",00.00,"11,06,995.96",
23-Jan-21,Commission,02.00,00.00,"11,06,997.96",
23-Jan-21,Debit Card,"2,56,750.59",00.00,"13,63,748.55",
23-Jan-21,Debit Card,00.00,"1,70,468.57","11,93,279.98",
23-Jan-21,Bill,"2,37,341.28",00.00,"14,30,621.26",
23-Jan-21,Tax,"15,214.90",00.00,"14,45,836.16",
23-Jan-21,Tax,00.00,"4,81,945.39","9,63,890.77",
24-Jan-21,Tax,"1,68,440.00",00.00,"11,32,330.77",
24-Jan-21,Interest,"79,401.70",00.00,"12,11,732.47",
24-Jan-21,Purchase,"13,81,799.00",00.00,"25,93,531.47",
24-Jan-21,Bill,"26,476.92",00.00,"26,20,008.39",
24-Jan-21,Reversal,52,00.00,"26,20,060.39",
24-Jan-21,Reversal,00.00,"3,74,294.34","22,45,766.05",
25-Jan-21,Cash,00.00,"11,22,883.03","11,22,883.02",
25-Jan-21,ATM,00.00,"1,40,360.38","9,82,522.64",
25-Jan-21,IMPS,02.00,00.00,"9,82,524.64",
25-Jan-21,Cheque,00.00,"3,27,508.21","6,55,016.43",
25-Jan-21,Transportellaneous,11,00.00,"6,55,027.43",
25-Jan-21,Transfer,"30,406.00",00.00,"6,85,433.43",
25-Jan-21,IMPS,346.77,00.00,"6,85,780.20",
25-Jan-21,Transportellaneous,00.00,"68,578.02","6,17,202.18",
25-Jan-21,NEFT,499.32,00.00,"6,17,701.50",
25-Jan-21,Reversal,"13,29,555.80",00.00,"19,47,257.30",
25-Jan-21,Transportellaneous,00.00,"19,47,257.30",00.00,
26-Jan-21,Commission,"1,98,563.16",00.00,"1,98,563.16",
26-Jan-21,Transportellaneous,00.00,"28,366.17","1,70,196.99",
27-Jan-21,Transfer,00.00,"17,019.70","1,53,177.29",
27-Jan-21,Tax,00.00,"17,019.70","1,36,157.59",
28-Jan-21,NEFT,00.00,"45,385.86","90,771.73",
28-Jan-21,Reversal,62.59,00.00,"90,834.32",
28-Jan-21,Reversal,81,00.00,"90,915.32",
28-Jan-21,ATM,00.00,"45,457.66","45,457.66",
28-Jan-21,Transfer,00.00,"4,545.77","40,911.89",
29-Jan-21,Tax,00.00,"40,911.89",00.00,
29-Jan-21,RTGS,301.35,00.00,301.35,
29-Jan-21,Cash,00.00,75.34,226.01,
29-Jan-21,Tax,00.00,226.01,00.00,
29-Jan-21,Transportellaneous,"6,00,212.00",00.00,"6,00,212.00",
29-Jan-21,Commission,00.00,"75,026.50","5,25,185.50",
29-Jan-21,NEFT,00.00,"2,62,592.75","2,62,592.75",
29-Jan-21,Transfer,00.00,"26,259.28","2,36,333.48",
29-Jan-21,IMPS,46,00.00,"2,36,379.48",
29-Jan-21,RTGS,00.00,"2,36,379.48",00.00,
30-Jan-21,Debit Card,03.00,00.00,03.00,
30-Jan-21,Transfer,194.9,00.00,197.9,
30-Jan-21,RTGS,02.50,00.00,200.4,
30-Jan-21,IMPS,00.00,100.2,100.2,
30-Jan-21,IMPS,"23,052.70",00.00,"23,152.90",
30-Jan-21,RTGS,03.00,00.00,"23,155.90",
30-Jan-21,Tax,00.00,"2,894.49","20,261.41",
30-Jan-21,Purchase,"2,274.00",00.00,"22,535.41",
30-Jan-21,Interest,"1,849.00",00.00,"24,384.41",
30-Jan-21,Purchase,03.00,00.00,"24,387.41",
30-Jan-21,Bill,"3,035.00",00.00,"27,422.41",
30-Jan-21,RTGS,"52,757.47",00.00,"80,179.88",
30-Jan-21,Cheque,00.00,"8,908.88","71,271.00",
30-Jan-21,Debit Card,"3,721.35",00.00,"74,992.35",
30-Jan-21,Purchase,00.00,"14,998.47","59,993.88",
30-Jan-21,ATM,00.00,"7,499.24","52,494.64",
30-Jan-21,RTGS,540.24,00.00,"53,034.88",
30-Jan-21,Bill,"5,57,364.25",00.00,"6,10,399.13",
30-Jan-21,Reversal,00.00,"1,22,079.83","4,88,319.30",
30-Jan-21,Bill,02.00,00.00,"4,88,321.30",
31-Jan-21,Debit Card,00.00,"61,040.16","4,27,281.14",
31-Jan-21,Cheque,326.65,00.00,"4,27,607.79",
31-Jan-21,Transportellaneous,00.00,"71,267.97","3,56,339.82",
31-Jan-21,IMPS,27,00.00,"3,56,366.82",
31-Jan-21,Interest,"2,47,194.31",00.00,"6,03,561.13",
31-Jan-21,Transfer,54,00.00,"6,03,615.13",
31-Jan-21,Transfer,350,00.00,"6,03,965.13",
31-Jan-21,Cheque,"18,765.00",00.00,"6,22,730.13",
31-Jan-21,Tax,63,00.00,"6,22,793.13",
31-Jan-21,Tax,06.00,00.00,"6,22,799.13",
31-Jan-21,NEFT,00.00,"62,279.91","5,60,519.22",
31-Jan-21,Debit Card,00.00,"80,074.17","4,80,445.05",
31-Jan-21,Debit Card,00.00,"48,044.51","4,32,400.54",
31-Jan-21,Bill,00.00,"43,240.05","3,89,160.49",
31-Jan-21,Transfer,"3,229.44",00.00,"3,92,389.93",
31-Jan-21,Commission,36,00.00,"3,92,425.93",
31-Jan-21,Transportellaneous,00.00,"1,30,808.64","2,61,617.29",
31-Jan-21,Cash,00.00,"29,068.59","2,32,548.70",
31-Jan-21,ATM,00.00,"33,221.24","1,99,327.46",
31-Jan-21,Transfer,00.00,"24,915.93","1,74,411.53",
31-Jan-21,Bill,00.00,"24,915.93","1,49,495.60",
31-Jan-21,Interest,00.00,"18,686.95","1,30,808.65",
31-Jan-21,Debit Card,00.00,"26,161.73","1,04,646.92",
31-Jan-21,Tax,00.00,"20,929.38","83,717.54",
31-Jan-21,RTGS,00.00,"16,743.51","66,974.03",
31-Jan-21,ATM,00.00,"9,567.72","57,406.31",
31-Jan-21,Bill,197,00.00,"57,603.31",
31-Jan-21,RTGS,"1,485.00",00.00,"59,088.31",
31-Jan-21,IMPS,00.00,"11,817.66","47,270.65",
31-Jan-21,Interest,"17,551.19",00.00,"64,821.84",
31-Jan-21,Interest,"2,485.00",00.00,"67,306.84",
31-Jan-21,Transfer,"2,68,746.00",00.00,"3,36,052.84",
31-Jan-21,Cheque,00.00,"37,339.20","2,98,713.64",
31-Jan-21,Cheque,89,00.00,"2,98,802.64",
31-Jan-21,Cash,"10,61,625.00",00.00,"13,60,427.64",
31-Jan-21,Purchase,14.6,00.00,"13,60,442.24",
31-Jan-21,Commission,02.83,00.00,"13,60,445.07",
31-Jan-21,NEFT,00.00,"13,60,445.07",00.00,
31-Jan-21,Tax,"13,289.10",00.00,"13,289.10",
01-Feb-21,IMPS,"1,883.00",00.00,"15,172.10",
01-Feb-21,Interest,"20,41,286.00",00.00,"20,56,458.10",
01-Feb-21,IMPS,41,00.00,"20,56,499.10",
01-Feb-21,Debit Card,"31,404.73",00.00,"20,87,903.83",
01-Feb-21,NEFT,"1,845.80",00.00,"20,89,749.63",
01-Feb-21,Purchase,204.8,00.00,"20,89,954.43",
01-Feb-21,Cash,442,00.00,"20,90,396.43",
01-Feb-21,Reversal,00.00,"6,96,798.81","13,93,597.62",
01-Feb-21,Cash,"40,618.72",00.00,"14,34,216.34",
01-Feb-21,Commission,"1,38,683.40",00.00,"15,72,899.74",
01-Feb-21,Bill,00.00,"2,24,699.96","13,48,199.78",
01-Feb-21,Cash,00.00,"2,69,639.96","10,78,559.82",
01-Feb-21,Debit Card,00.00,"2,69,639.96","8,08,919.86",
01-Feb-21,Bill,00.00,"80,891.99","7,28,027.87",
01-Feb-21,IMPS,00.00,"80,891.99","6,47,135.88",
01-Feb-21,Purchase,00.00,"71,903.99","5,75,231.89",
02-Feb-21,Debit Card,667,00.00,"5,75,898.89",
02-Feb-21,Commission,04.00,00.00,"5,75,902.89",
02-Feb-21,Interest,00.00,"63,989.21","5,11,913.68",
02-Feb-21,Transportellaneous,00.00,"2,55,956.84","2,55,956.84",
02-Feb-21,Tax,"10,83,022.75",00.00,"13,38,979.59",
02-Feb-21,Cheque,00.00,"1,91,282.80","11,47,696.79",
02-Feb-21,Cash,"16,01,124.00",00.00,"27,48,820.79",
02-Feb-21,ATM,08.20,00.00,"27,48,828.99",
02-Feb-21,Transportellaneous,"2,797.44",00.00,"27,51,626.43",
02-Feb-21,Bill,00.00,"13,75,813.22","13,75,813.22",
02-Feb-21,Interest,"1,072.80",00.00,"13,76,886.02",
02-Feb-21,Reversal,00.00,"1,72,110.75","12,04,775.27",
02-Feb-21,Reversal,"1,98,650.59",00.00,"14,03,425.86",
02-Feb-21,IMPS,150,00.00,"14,03,575.86",
02-Feb-21,IMPS,"7,77,034.25",00.00,"21,80,610.11",
02-Feb-21,Bill,00.00,"7,26,870.04","14,53,740.07",
02-Feb-21,NEFT,00.00,"7,26,870.04","7,26,870.04",
02-Feb-21,Debit Card,00.00,"80,763.34","6,46,106.70",
02-Feb-21,Reversal,00.00,"2,15,368.90","4,30,737.80",
02-Feb-21,Tax,00.00,"47,859.76","3,82,878.04",
02-Feb-21,Interest,09.80,00.00,"3,82,887.84",
02-Feb-21,ATM,00.00,"3,82,887.84",00.00,
02-Feb-21,ATM,"19,530.75",00.00,"19,530.75",
02-Feb-21,Tax,33,00.00,"19,563.75",
02-Feb-21,Reversal,"10,026.00",00.00,"29,589.75",
02-Feb-21,Interest,00.00,"5,917.95","23,671.80",
02-Feb-21,Reversal,"5,18,227.25",00.00,"5,41,899.05",
02-Feb-21,Reversal,00.00,"67,737.38","4,74,161.67",
03-Feb-21,Interest,116.9,00.00,"4,74,278.57",
03-Feb-21,RTGS,00.00,"2,37,139.29","2,37,139.28",
03-Feb-21,Cheque,00.00,"39,523.21","1,97,616.07",
03-Feb-21,Tax,"15,50,472.00",00.00,"17,48,088.07",
03-Feb-21,Interest,"15,038.47",00.00,"17,63,126.54",
03-Feb-21,Transportellaneous,"3,343.90",00.00,"17,66,470.44",
04-Feb-21,RTGS,03.00,00.00,"17,66,473.44",
04-Feb-21,NEFT,00.00,"2,94,412.24","14,72,061.20",
04-Feb-21,Purchase,"2,50,709.00",00.00,"17,22,770.20",
04-Feb-21,NEFT,00.00,"3,44,554.04","13,78,216.16",
04-Feb-21,Cash,00.00,"1,96,888.02","11,81,328.14",
04-Feb-21,Cheque,"2,06,047.75",00.00,"13,87,375.89",
04-Feb-21,Debit Card,"20,239.90",00.00,"14,07,615.79",
04-Feb-21,Purchase,"1,183.00",00.00,"14,08,798.79",
04-Feb-21,Interest,"2,669.00",00.00,"14,11,467.79",
04-Feb-21,Cheque,07.00,00.00,"14,11,474.79",
04-Feb-21,Transportellaneous,"15,96,909.00",00.00,"30,08,383.79",
04-Feb-21,ATM,00.00,"5,01,397.30","25,06,986.49",
04-Feb-21,Transportellaneous,04.80,00.00,"25,06,991.29",
04-Feb-21,Bill,"17,31,572.00",00.00,"42,38,563.29",
04-Feb-21,Bill,00.00,"8,47,712.66","33,90,850.63",
04-Feb-21,Bill,156,00.00,"33,91,006.63",
04-Feb-21,Cheque,00.00,"8,47,751.66","25,43,254.97",
04-Feb-21,Bill,32,00.00,"25,43,286.97",
04-Feb-21,ATM,00.00,"4,23,881.16","21,19,405.81",
04-Feb-21,Interest,"1,61,686.00",00.00,"22,81,091.81",
04-Feb-21,Bill,01.34,00.00,"22,81,093.15",
04-Feb-21,NEFT,"5,79,434.00",00.00,"28,60,527.15",
04-Feb-21,Transportellaneous,00.00,"9,53,509.05","19,07,018.10",
04-Feb-21,Cash,00.00,"3,17,836.35","15,89,181.75",
04-Feb-21,Transportellaneous,00.00,"2,64,863.63","13,24,318.12",
04-Feb-21,Cash,"14,950.00",00.00,"13,39,268.12",
04-Feb-21,Bill,00.00,"2,23,211.35","11,16,056.77",
04-Feb-21,Transportellaneous,334,00.00,"11,16,390.77",
04-Feb-21,Tax,274.32,00.00,"11,16,665.09",
04-Feb-21,NEFT,00.00,"1,24,073.90","9,92,591.19",
04-Feb-21,Cheque,"29,300.20",00.00,"10,21,891.39",
04-Feb-21,Purchase,00.00,"5,10,945.70","5,10,945.70",
04-Feb-21,ATM,00.00,"2,55,472.85","2,55,472.85",
04-Feb-21,RTGS,00.00,"2,55,472.85",00.00,
04-Feb-21,Commission,03.50,00.00,03.50,
04-Feb-21,Reversal,33,00.00,36.5,
04-Feb-21,RTGS,00.00,36.5,00.00,
04-Feb-21,Cheque,02.70,00.00,02.70,
04-Feb-21,NEFT,00.00,00.39,02.31,
04-Feb-21,Tax,00.00,01.16,01.16,
04-Feb-21,Transfer,00.70,00.00,01.86,
04-Feb-21,Interest,06.00,00.00,07.86,
04-Feb-21,Tax,506,00.00,513.86,
04-Feb-21,Cheque,00.00,64.23,449.63,
04-Feb-21,Interest,30.5,00.00,480.13,
04-Feb-21,Cash,00.00,480.13,00.00,
04-Feb-21,Debit Card,104,00.00,104,
04-Feb-21,Transfer,78.24,00.00,182.24,
04-Feb-21,Purchase,"2,633.40",00.00,"2,815.64",
04-Feb-21,Tax,"2,164.40",00.00,"4,980.04",
04-Feb-21,Cash,"9,615.00",00.00,"14,595.04",
04-Feb-21,Cheque,"2,42,209.00",00.00,"2,56,804.04",
04-Feb-21,RTGS,00.00,"42,800.67","2,14,003.37",
04-Feb-21,IMPS,00.00,"71,334.46","1,42,668.91",
05-Feb-21,IMPS,318.79,00.00,"1,42,987.70",
05-Feb-21,Tax,00.00,"15,887.52","1,27,100.18",
05-Feb-21,Purchase,20,00.00,"1,27,120.18",
05-Feb-21,Reversal,00.00,"42,373.39","84,746.79",
05-Feb-21,IMPS,00.00,"12,106.68","72,640.11",
05-Feb-21,Commission,"7,80,894.50",00.00,"8,53,534.61",
05-Feb-21,Reversal,00.00,"1,42,255.77","7,11,278.84",
05-Feb-21,Transfer,00.00,"79,030.98","6,32,247.86",
05-Feb-21,Transportellaneous,"1,734.00",00.00,"6,33,981.86",
05-Feb-21,IMPS,00.00,"2,11,327.29","4,22,654.57",
05-Feb-21,Tax,00.00,"46,961.62","3,75,692.95",
05-Feb-21,Debit Card,00.00,"93,923.24","2,81,769.71",
05-Feb-21,Debit Card,355.68,00.00,"2,82,125.39",
05-Feb-21,Purchase,361,00.00,"2,82,486.39",
05-Feb-21,IMPS,"2,847.09",00.00,"2,85,333.48",
05-Feb-21,Reversal,"1,35,318.00",00.00,"4,20,651.48",
05-Feb-21,ATM,"2,567.00",00.00,"4,23,218.48",
05-Feb-21,Interest,240,00.00,"4,23,458.48",
05-Feb-21,Debit Card,00.00,"1,05,864.62","3,17,593.86",
06-Feb-21,Bill,00.00,"1,58,796.93","1,58,796.93",
06-Feb-21,Interest,00.00,"79,398.47","79,398.46",
07-Feb-21,Tax,"16,32,394.50",00.00,"17,11,792.96",
07-Feb-21,Bill,382.6,00.00,"17,12,175.56",
07-Feb-21,Commission,"1,43,284.50",00.00,"18,55,460.06",
07-Feb-21,Bill,00.00,"2,65,065.72","15,90,394.34",
07-Feb-21,Transportellaneous,08.00,00.00,"15,90,402.34",
07-Feb-21,Debit Card,00.00,"1,59,040.23","14,31,362.11",
07-Feb-21,Tax,00.00,"1,78,920.26","12,52,441.85",
07-Feb-21,Debit Card,00.00,"4,17,480.62","8,34,961.23",
07-Feb-21,Commission,00.00,"1,19,280.18","7,15,681.05",
07-Feb-21,Bill,"1,46,383.03",00.00,"8,62,064.08",
07-Feb-21,Bill,00.00,"2,15,516.02","6,46,548.06",
07-Feb-21,Reversal,"75,575.00",00.00,"7,22,123.06",
07-Feb-21,ATM,00.00,"80,235.90","6,41,887.16",
07-Feb-21,Cash,"63,587.00",00.00,"7,05,474.16",
07-Feb-21,Reversal,60,00.00,"7,05,534.16",
07-Feb-21,Reversal,00.00,"3,52,767.08","3,52,767.08",
07-Feb-21,Reversal,00.00,"39,196.34","3,13,570.74",
07-Feb-21,RTGS,00.00,"1,04,523.58","2,09,047.16",
07-Feb-21,Tax,00.00,"34,841.19","1,74,205.97",
07-Feb-21,Debit Card,00.00,"43,551.49","1,30,654.48",
07-Feb-21,Debit Card,00.00,"16,331.81","1,14,322.67",
07-Feb-21,Bill,00.00,"11,432.27","1,02,890.40",
07-Feb-21,Cheque,60.41,00.00,"1,02,950.81",
07-Feb-21,RTGS,00.00,"20,590.16","82,360.65",
07-Feb-21,Cheque,00.00,"10,295.08","72,065.57",
07-Feb-21,Commission,02.04,00.00,"72,067.61",
07-Feb-21,IMPS,"23,025.00",00.00,"95,092.61",
07-Feb-21,Purchase,"52,712.22",00.00,"1,47,804.83",
07-Feb-21,RTGS,00.00,"14,780.48","1,33,024.35",
07-Feb-21,Transportellaneous,00.00,"66,512.18","66,512.18",
07-Feb-21,RTGS,06.60,00.00,"66,518.78",
07-Feb-21,Reversal,"2,39,668.80",00.00,"3,06,187.58",
07-Feb-21,Commission,00.00,"76,546.90","2,29,640.68",
07-Feb-21,ATM,01.00,00.00,"2,29,641.68",
07-Feb-21,RTGS,00.00,"1,14,820.84","1,14,820.84",
08-Feb-21,Interest,00.00,"57,410.42","57,410.42",
08-Feb-21,NEFT,61.8,00.00,"57,472.22",
08-Feb-21,Bill,"7,693.20",00.00,"65,165.42",
08-Feb-21,NEFT,"27,410.00",00.00,"92,575.42",
08-Feb-21,Debit Card,00.00,"92,575.42",00.00,
08-Feb-21,Interest,05.49,00.00,05.49,
08-Feb-21,Bill,"3,598.53",00.00,"3,604.02",
08-Feb-21,Transportellaneous,00.00,"1,802.01","1,802.01",
08-Feb-21,IMPS,"2,51,353.72",00.00,"2,53,155.73",
08-Feb-21,Commission,00.00,"42,192.62","2,10,963.11",
08-Feb-21,NEFT,00.00,"2,10,963.11",00.00,
08-Feb-21,ATM,"53,924.00",00.00,"53,924.00",
08-Feb-21,Commission,"23,177.00",00.00,"77,101.00",
08-Feb-21,Interest,00.00,"38,550.50","38,550.50",
08-Feb-21,NEFT,00.00,"6,425.08","32,125.42",
08-Feb-21,Transfer,00.00,"4,015.68","28,109.74",
08-Feb-21,Cash,00.00,"4,684.96","23,424.78",
08-Feb-21,Tax,00.00,"3,904.13","19,520.65",
08-Feb-21,Interest,00.00,"9,760.33","9,760.33",
08-Feb-21,Cheque,114,00.00,"9,874.33",
08-Feb-21,Cash,00.00,"1,645.72","8,228.61",
08-Feb-21,Debit Card,00.00,"2,057.15","6,171.46",
08-Feb-21,Purchase,04.18,00.00,"6,175.64",
08-Feb-21,ATM,"26,121.50",00.00,"32,297.14",
08-Feb-21,ATM,636.18,00.00,"32,933.32",
08-Feb-21,Bill,00.00,"8,233.33","24,699.99",
08-Feb-21,Debit Card,00.00,"8,233.33","16,466.66",
08-Feb-21,Transfer,"14,056.14",00.00,"30,522.80",
08-Feb-21,Commission,"16,793.20",00.00,"47,316.00",
08-Feb-21,Debit Card,"3,37,210.50",00.00,"3,84,526.50",
08-Feb-21,NEFT,03.80,00.00,"3,84,530.30",
08-Feb-21,ATM,36.4,00.00,"3,84,566.70",
08-Feb-21,NEFT,00.00,"1,92,283.35","1,92,283.35",
08-Feb-21,Tax,00.00,"38,456.67","1,53,826.68",
08-Feb-21,Tax,00.00,"25,637.78","1,28,188.90",
08-Feb-21,IMPS,"12,97,983.00",00.00,"14,26,171.90",
08-Feb-21,ATM,00.00,"2,37,695.32","11,88,476.58",
08-Feb-21,Bill,"13,42,992.50",00.00,"25,31,469.08",
08-Feb-21,NEFT,00.00,"8,43,823.03","16,87,646.05",
08-Feb-21,Transfer,03.50,00.00,"16,87,649.55",
08-Feb-21,IMPS,00.00,"4,21,912.39","12,65,737.16",
08-Feb-21,ATM,00.00,"2,53,147.43","10,12,589.73",
08-Feb-21,Transfer,"13,07,211.00",00.00,"23,19,800.73",
08-Feb-21,Tax,00.00,"2,57,755.64","20,62,045.09",
08-Feb-21,Transportellaneous,00.00,"10,31,022.55","10,31,022.54",
08-Feb-21,IMPS,"3,45,446.50",00.00,"13,76,469.04",
08-Feb-21,Reversal,00.00,"13,76,469.04",00.00,
08-Feb-21,Commission,00.59,00.00,00.59,
08-Feb-21,Cash,00.00,00.08,00.51,
08-Feb-21,Tax,"7,98,849.50",00.00,"7,98,850.01",
08-Feb-21,Reversal,118,00.00,"7,98,968.01",
08-Feb-21,Reversal,00.00,"1,99,742.00","5,99,226.01",
08-Feb-21,Interest,44.7,00.00,"5,99,270.71",
08-Feb-21,RTGS,00.00,"1,49,817.68","4,49,453.03",
08-Feb-21,Cash,15.9,00.00,"4,49,468.93",
08-Feb-21,Debit Card,00.00,"1,12,367.23","3,37,101.70",
08-Feb-21,Commission,00.00,"1,12,367.23","2,24,734.47",
08-Feb-21,Transportellaneous,00.00,"44,946.89","1,79,787.58",
08-Feb-21,RTGS,00.00,"44,946.90","1,34,840.68",
08-Feb-21,Transfer,"2,01,276.12",00.00,"3,36,116.80",
08-Feb-21,IMPS,550.2,00.00,"3,36,667.00",
08-Feb-21,Purchase,00.20,00.00,"3,36,667.20",
08-Feb-21,Bill,00.00,"67,333.44","2,69,333.76",
08-Feb-21,Interest,00.00,"44,888.96","2,24,444.80",
08-Feb-21,Transfer,00.00,"37,407.47","1,87,037.33",
08-Feb-21,Transfer,00.00,"62,345.78","1,24,691.55",
08-Feb-21,Cheque,00.00,"31,172.89","93,518.66",
08-Feb-21,RTGS,00.00,"10,390.96","83,127.70",
08-Feb-21,Transfer,"1,32,741.30",00.00,"2,15,869.00",
08-Feb-21,ATM,00.00,"53,967.25","1,61,901.75",
08-Feb-21,RTGS,"1,35,752.03",00.00,"2,97,653.78",
09-Feb-21,Purchase,00.00,"2,97,653.78",00.00,
09-Feb-21,Interest,"6,59,710.00",00.00,"6,59,710.00",
09-Feb-21,Debit Card,"1,10,056.00",00.00,"7,69,766.00",
09-Feb-21,ATM,00.00,"1,28,294.33","6,41,471.67",
09-Feb-21,Transportellaneous,292,00.00,"6,41,763.67",
09-Feb-21,Cheque,00.00,"3,20,881.84","3,20,881.84",
09-Feb-21,NEFT,"11,92,894.50",00.00,"15,13,776.34",
09-Feb-21,Debit Card,"20,928.60",00.00,"15,34,704.94",
09-Feb-21,Commission,200,00.00,"15,34,904.94",
09-Feb-21,Transfer,00.00,"3,06,980.99","12,27,923.95",
09-Feb-21,Transportellaneous,00.00,"1,22,792.40","11,05,131.56",
09-Feb-21,Interest,58.2,00.00,"11,05,189.76",
09-Feb-21,Debit Card,20,00.00,"11,05,209.76",
09-Feb-21,ATM,309.7,00.00,"11,05,519.46",
09-Feb-21,Transportellaneous,"8,36,500.50",00.00,"19,42,019.96",
09-Feb-21,Cheque,00.00,"9,71,009.98","9,71,009.98",
09-Feb-21,Transfer,40.3,00.00,"9,71,050.28",
09-Feb-21,Debit Card,00.00,"3,23,683.43","6,47,366.85",
09-Feb-21,Debit Card,00.00,"6,47,366.85",00.00,
09-Feb-21,Interest,166.92,00.00,166.92,
09-Feb-21,ATM,00.00,27.82,139.1,
09-Feb-21,ATM,"2,989.00",00.00,"3,128.10",
09-Feb-21,Interest,00.00,446.87,"2,681.23",
09-Feb-21,Transportellaneous,402.72,00.00,"3,083.95",
09-Feb-21,Reversal,57,00.00,"3,140.95",
09-Feb-21,Tax,"2,57,506.00",00.00,"2,60,646.95",
09-Feb-21,Reversal,00.00,"86,882.32","1,73,764.63",
09-Feb-21,Purchase,365.4,00.00,"1,74,130.03",
09-Feb-21,Bill,00.00,"87,065.02","87,065.02",
09-Feb-21,IMPS,38,00.00,"87,103.02",
09-Feb-21,ATM,"1,831.40",00.00,"88,934.42",
09-Feb-21,Commission,00.00,"22,233.61","66,700.82",
09-Feb-21,IMPS,00.00,"11,116.80","55,584.02",
09-Feb-21,ATM,00.00,"11,116.80","44,467.22",
09-Feb-21,IMPS,00.00,"14,822.41","29,644.81",
09-Feb-21,Interest,00.00,"3,705.60","25,939.21",
09-Feb-21,Commission,"42,772.62",00.00,"68,711.83",
09-Feb-21,Reversal,00.00,"11,451.97","57,259.86",
09-Feb-21,IMPS,00.00,"28,629.93","28,629.93",
09-Feb-21,Interest,"3,976.00",00.00,"32,605.93",
09-Feb-21,Interest,00.00,"6,521.19","26,084.74",
09-Feb-21,Transportellaneous,00.00,"3,260.59","22,824.15",
09-Feb-21,Debit Card,"2,58,534.19",00.00,"2,81,358.34",
09-Feb-21,Cheque,61,00.00,"2,81,419.34",
09-Feb-21,Interest,"3,270.93",00.00,"2,84,690.27",
09-Feb-21,Purchase,00.00,"2,84,690.27",00.00,
09-Feb-21,NEFT,19,00.00,19,
09-Feb-21,NEFT,04.80,00.00,23.8,
09-Feb-21,RTGS,"1,029.40",00.00,"1,053.20",
09-Feb-21,Transfer,"26,126.50",00.00,"27,179.70",
09-Feb-21,Cheque,00.00,"3,397.46","23,782.24",
09-Feb-21,Tax,"27,129.11",00.00,"50,911.35",
09-Feb-21,Cash,00.00,"7,273.05","43,638.30",
09-Feb-21,ATM,03.00,00.00,"43,641.30",
09-Feb-21,Cash,06.60,00.00,"43,647.90",
09-Feb-21,Cheque,00.00,"14,549.30","29,098.60",
09-Feb-21,NEFT,00.00,"9,699.53","19,399.07",
09-Feb-21,Transfer,00.00,"6,466.36","12,932.71",
09-Feb-21,Debit Card,236,00.00,"13,168.71",
09-Feb-21,Transportellaneous,"2,442.20",00.00,"15,610.91",
09-Feb-21,IMPS,00.00,"3,122.18","12,488.73",
09-Feb-21,Transportellaneous,00.00,"2,081.46","10,407.28",
09-Feb-21,RTGS,"16,76,056.50",00.00,"16,86,463.78",
09-Feb-21,Cheque,00.00,"3,37,292.76","13,49,171.02",
09-Feb-21,Debit Card,60.3,00.00,"13,49,231.32",
09-Feb-21,Bill,"22,605.00",00.00,"13,71,836.32",
09-Feb-21,Bill,"1,48,798.40",00.00,"15,20,634.72",
09-Feb-21,NEFT,00.00,"1,90,079.34","13,30,555.38",
09-Feb-21,Transfer,02.90,00.00,"13,30,558.28",
09-Feb-21,ATM,00.00,"1,33,055.83","11,97,502.45",
09-Feb-21,NEFT,00.00,"1,99,583.74","9,97,918.71",
09-Feb-21,Purchase,"2,15,850.80",00.00,"12,13,769.51",
09-Feb-21,IMPS,"18,38,920.00",00.00,"30,52,689.51",
09-Feb-21,Reversal,00.00,"15,26,344.76","15,26,344.76",
09-Feb-21,Debit Card,146,00.00,"15,26,490.76",
09-Feb-21,Bill,07.00,00.00,"15,26,497.76",
09-Feb-21,IMPS,"12,13,363.00",00.00,"27,39,860.76",
09-Feb-21,Purchase,"25,453.61",00.00,"27,65,314.37",
09-Feb-21,Debit Card,00.00,"3,45,664.30","24,19,650.07",
09-Feb-21,Commission,00.00,"3,45,664.30","20,73,985.77",
09-Feb-21,NEFT,"2,999.75",00.00,"20,76,985.52",
09-Feb-21,Cheque,06.20,00.00,"20,76,991.72",
09-Feb-21,Cash,"14,374.50",00.00,"20,91,366.22",
09-Feb-21,Cheque,00.00,"2,98,766.60","17,92,599.62",
09-Feb-21,IMPS,"14,11,433.00",00.00,"32,04,032.62",
09-Feb-21,Transportellaneous,00.00,"3,56,003.62","28,48,029.00",
09-Feb-21,IMPS,00.00,"9,49,343.00","18,98,686.00",
09-Feb-21,Tax,05.40,00.00,"18,98,691.40",
09-Feb-21,Interest,00.00,"3,16,448.57","15,82,242.83",
09-Feb-21,Interest,00.00,"15,82,242.83",00.00,
09-Feb-21,RTGS,"1,33,862.69",00.00,"1,33,862.69",
09-Feb-21,Reversal,00.00,"22,310.45","1,11,552.24",
09-Feb-21,RTGS,00.00,"22,310.45","89,241.79",
09-Feb-21,Purchase,00.00,"29,747.26","59,494.53",
09-Feb-21,Bill,479.72,00.00,"59,974.25",
09-Feb-21,Cheque,00.00,"7,496.78","52,477.47",
09-Feb-21,Tax,00.00,"5,830.83","46,646.64",
09-Feb-21,Bill,00.00,"6,663.81","39,982.83",
09-Feb-21,Tax,"7,565.00",00.00,"47,547.83",
10-Feb-21,Bill,"2,072.00",00.00,"49,619.83",
10-Feb-21,IMPS,00.00,"4,961.98","44,657.85",
10-Feb-21,Tax,00.00,"14,885.95","29,771.90",
10-Feb-21,Reversal,00.00,"3,721.49","26,050.41",
10-Feb-21,Debit Card,"3,876.97",00.00,"29,927.38",
10-Feb-21,Cash,"1,42,852.00",00.00,"1,72,779.38",
10-Feb-21,Tax,00.00,"28,796.56","1,43,982.82",
10-Feb-21,Purchase,"1,51,996.20",00.00,"2,95,979.02",
10-Feb-21,Debit Card,"2,80,017.25",00.00,"5,75,996.27",
10-Feb-21,Tax,00.00,"1,15,199.25","4,60,797.02",
10-Feb-21,Transportellaneous,"2,219.70",00.00,"4,63,016.72",
10-Feb-21,IMPS,05.00,00.00,"4,63,021.72",
10-Feb-21,Cash,"1,92,010.53",00.00,"6,55,032.25",
10-Feb-21,NEFT,00.00,"93,576.04","5,61,456.21",
11-Feb-21,Debit Card,"2,29,306.20",00.00,"7,90,762.41",
11-Feb-21,Reversal,00.00,"98,845.30","6,91,917.11",
11-Feb-21,Purchase,"15,958.00",00.00,"7,07,875.11",
11-Feb-21,Interest,28.01,00.00,"7,07,903.12",
11-Feb-21,IMPS,"17,99,364.80",00.00,"25,07,267.92",
11-Feb-21,NEFT,"15,46,482.00",00.00,"40,53,749.92",
11-Feb-21,Purchase,46.01,00.00,"40,53,795.93",
11-Feb-21,Cheque,00.00,"10,13,448.98","30,40,346.95",
11-Feb-21,Tax,84.5,00.00,"30,40,431.45",
11-Feb-21,Tax,"7,04,142.00",00.00,"37,44,573.45",
11-Feb-21,Debit Card,"2,17,076.00",00.00,"39,61,649.45",
11-Feb-21,Commission,00.00,"4,40,183.27","35,21,466.18",
11-Feb-21,Transportellaneous,00.00,"11,73,822.06","23,47,644.12",
11-Feb-21,Purchase,77.2,00.00,"23,47,721.32",
11-Feb-21,RTGS,06.00,00.00,"23,47,727.32",
11-Feb-21,Interest,"3,790.50",00.00,"23,51,517.82",
11-Feb-21,Transportellaneous,00.70,00.00,"23,51,518.52",
11-Feb-21,NEFT,00.00,"2,35,151.85","21,16,366.67",
11-Feb-21,RTGS,00.00,"3,02,338.10","18,14,028.57",
11-Feb-21,RTGS,00.00,"3,02,338.10","15,11,690.48",
11-Feb-21,Debit Card,00.00,"7,55,845.24","7,55,845.24",
11-Feb-21,Reversal,894.6,00.00,"7,56,739.84",
11-Feb-21,Cash,00.72,00.00,"7,56,740.56",
11-Feb-21,Bill,00.00,"3,78,370.28","3,78,370.28",
11-Feb-21,Transportellaneous,00.00,"63,061.71","3,15,308.57",
11-Feb-21,ATM,00.00,"45,044.08","2,70,264.49",
11-Feb-21,Cash,06.16,00.00,"2,70,270.65",
11-Feb-21,Bill,00.00,"2,70,270.65",00.00,
11-Feb-21,Purchase,47.7,00.00,47.7,
12-Feb-21,Bill,00.00,07.95,39.75,
12-Feb-21,Reversal,00.00,03.98,35.78,
12-Feb-21,Cheque,00.00,03.58,32.2,
12-Feb-21,Transfer,00.00,03.58,28.62,
13-Feb-21,NEFT,"18,737.20",00.00,"18,765.82",
13-Feb-21,Transfer,"37,794.00",00.00,"56,559.82",
13-Feb-21,IMPS,"22,404.40",00.00,"78,964.22",
13-Feb-21,Cheque,00.00,"8,773.80","70,190.42",
13-Feb-21,Transfer,"4,045.65",00.00,"74,236.07",
13-Feb-21,Cash,10,00.00,"74,246.07",
14-Feb-21,Reversal,00.00,"14,849.21","59,396.86",
14-Feb-21,Purchase,185,00.00,"59,581.86",
14-Feb-21,RTGS,00.00,"19,860.62","39,721.24",
14-Feb-21,Purchase,"1,732.80",00.00,"41,454.04",
14-Feb-21,Transfer,00.00,"10,363.51","31,090.53",
14-Feb-21,Commission,00.00,"5,181.76","25,908.78",
14-Feb-21,Reversal,00.00,"3,701.25","22,207.53",
14-Feb-21,Cheque,"1,16,327.03",00.00,"1,38,534.56",
14-Feb-21,Transfer,"1,999.00",00.00,"1,40,533.56",
14-Feb-21,Cash,00.00,"17,566.70","1,22,966.86",
14-Feb-21,ATM,31.1,00.00,"1,22,997.96",
14-Feb-21,Tax,00.00,"1,22,997.96",00.00,
14-Feb-21,ATM,06.19,00.00,06.19,
14-Feb-21,NEFT,"1,812.45",00.00,"1,818.64",
14-Feb-21,Transfer,00.00,202.07,"1,616.57",
14-Feb-21,Cheque,00.00,"1,616.57",00.00,
14-Feb-21,Interest,30.8,00.00,30.8,
14-Feb-21,Purchase,00.00,30.8,00.00,
14-Feb-21,Reversal,"42,386.00",00.00,"42,386.00",
14-Feb-21,Debit Card,00.00,"5,298.25","37,087.75",
14-Feb-21,Commission,93.33,00.00,"37,181.08",
14-Feb-21,Transportellaneous,01.40,00.00,"37,182.48",
14-Feb-21,Tax,"81,065.56",00.00,"1,18,248.04",
14-Feb-21,Commission,00.00,"39,416.01","78,832.03",
14-Feb-21,Purchase,00.00,"11,261.72","67,570.31",
14-Feb-21,NEFT,30.19,00.00,"67,600.50",
14-Feb-21,IMPS,"17,703.00",00.00,"85,303.50",
14-Feb-21,Cheque,00.00,"21,325.88","63,977.62",
14-Feb-21,Reversal,00.00,"31,988.81","31,988.81",
14-Feb-21,Reversal,"18,403.82",00.00,"50,392.63",
14-Feb-21,NEFT,00.00,"6,299.08","44,093.55",
14-Feb-21,Cheque,"1,92,589.30",00.00,"2,36,682.85",
14-Feb-21,Cheque,00.00,"33,811.84","2,02,871.01",
14-Feb-21,Cheque,00.00,"50,717.75","1,52,153.26",
14-Feb-21,Tax,"26,792.00",00.00,"1,78,945.26",
14-Feb-21,Commission,00.00,"1,78,945.26",00.00,
14-Feb-21,Commission,423.2,00.00,423.2,
14-Feb-21,Transfer,338,00.00,761.2,
14-Feb-21,Cash,00.00,190.3,570.9,
14-Feb-21,Tax,03.42,00.00,574.32,
14-Feb-21,IMPS,07.70,00.00,582.02,
14-Feb-21,Interest,32,00.00,614.02,
14-Feb-21,Debit Card,296,00.00,910.02,
14-Feb-21,Reversal,00.00,303.34,606.68,
14-Feb-21,NEFT,14.16,00.00,620.84,
14-Feb-21,Reversal,00.00,77.61,543.24,
14-Feb-21,Transfer,00.00,108.65,434.59,
14-Feb-21,Reversal,224.73,00.00,659.32,
14-Feb-21,Bill,00.00,219.77,439.55,
14-Feb-21,ATM,00.00,54.94,384.61,
14-Feb-21,NEFT,"31,072.00",00.00,"31,456.61",
14-Feb-21,Cheque,00.00,"3,495.18","27,961.43",
14-Feb-21,Transfer,326.7,00.00,"28,288.13",
14-Feb-21,Cheque,00.00,"4,714.69","23,573.44",
14-Feb-21,IMPS,"13,92,036.50",00.00,"14,15,609.94",
14-Feb-21,Debit Card,632.1,00.00,"14,16,242.04",
14-Feb-21,IMPS,00.00,"2,83,248.41","11,32,993.63",
14-Feb-21,Commission,00.00,"2,26,598.73","9,06,394.90",
14-Feb-21,Reversal,00.00,"1,81,278.98","7,25,115.92",
14-Feb-21,Purchase,"3,538.12",00.00,"7,28,654.04",
14-Feb-21,Debit Card,00.00,"1,04,093.43","6,24,560.61",
14-Feb-21,RTGS,383.44,00.00,"6,24,944.05",
14-Feb-21,Interest,00.00,"69,438.23","5,55,505.82",
14-Feb-21,Debit Card,"55,264.00",00.00,"6,10,769.82",
14-Feb-21,NEFT,00.00,"87,252.83","5,23,516.99",
14-Feb-21,Cheque,"31,270.50",00.00,"5,54,787.49",
14-Feb-21,Transportellaneous,04.00,00.00,"5,54,791.49",
14-Feb-21,Bill,30.1,00.00,"5,54,821.59",
14-Feb-21,Cheque,00.00,"55,482.16","4,99,339.43",
14-Feb-21,ATM,00.00,"99,867.89","3,99,471.54",
14-Feb-21,Reversal,00.00,"3,99,471.54",00.00,
14-Feb-21,Reversal,"16,226.00",00.00,"16,226.00",
14-Feb-21,IMPS,23.7,00.00,"16,249.70",
15-Feb-21,Tax,"20,20,517.75",00.00,"20,36,767.45",
15-Feb-21,Reversal,07.80,00.00,"20,36,775.25",
15-Feb-21,Commission,111,00.00,"20,36,886.25",
15-Feb-21,Cash,"23,007.00",00.00,"20,59,893.25",
15-Feb-21,Tax,00.00,"20,59,893.25",00.00,
15-Feb-21,Tax,354,00.00,354,
15-Feb-21,Purchase,73.8,00.00,427.8,
15-Feb-21,Reversal,"57,456.00",00.00,"57,883.80",
15-Feb-21,Tax,"9,26,252.00",00.00,"9,84,135.80",
15-Feb-21,Debit Card,"23,981.00",00.00,"10,08,116.80",
15-Feb-21,Transfer,00.00,"1,12,012.98","8,96,103.82",
15-Feb-21,Transfer,09.00,00.00,"8,96,112.82",
15-Feb-21,Purchase,00.00,"89,611.28","8,06,501.54",
15-Feb-21,IMPS,23,00.00,"8,06,524.54",
15-Feb-21,Purchase,34.83,00.00,"8,06,559.37",
16-Feb-21,NEFT,65.25,00.00,"8,06,624.62",
16-Feb-21,IMPS,"19,272.78",00.00,"8,25,897.40",
17-Feb-21,RTGS,126.17,00.00,"8,26,023.57",
17-Feb-21,ATM,"1,746.00",00.00,"8,27,769.57",
17-Feb-21,Reversal,"3,320.31",00.00,"8,31,089.88",
17-Feb-21,Tax,82,00.00,"8,31,171.88",
17-Feb-21,ATM,00.00,"83,117.19","7,48,054.69",
17-Feb-21,Purchase,00.00,"1,87,013.67","5,61,041.02",
18-Feb-21,NEFT,16.8,00.00,"5,61,057.82",
18-Feb-21,ATM,06.82,00.00,"5,61,064.64",
18-Feb-21,Cheque,00.00,"1,40,266.16","4,20,798.48",
18-Feb-21,Commission,00.00,"2,10,399.24","2,10,399.24",
18-Feb-21,Purchase,00.00,"35,066.54","1,75,332.70",
18-Feb-21,ATM,00.00,"25,047.53","1,50,285.17",
18-Feb-21,Cheque,00.00,"30,057.03","1,20,228.14",
18-Feb-21,Bill,25.3,00.00,"1,20,253.44",
18-Feb-21,Reversal,"92,258.00",00.00,"2,12,511.44",
18-Feb-21,Transportellaneous,00.00,"21,251.14","1,91,260.30",
18-Feb-21,Debit Card,00.00,"38,252.06","1,53,008.24",
18-Feb-21,IMPS,"19,211.00",00.00,"1,72,219.24",
18-Feb-21,Cash,00.00,"57,406.41","1,14,812.83",
18-Feb-21,RTGS,00.00,"12,756.98","1,02,055.85",
18-Feb-21,Interest,"10,521.98",00.00,"1,12,577.83",
18-Feb-21,Commission,00.00,"12,508.65","1,00,069.18",
19-Feb-21,IMPS,00.00,"50,034.59","50,034.59",
19-Feb-21,Tax,00.00,"6,254.32","43,780.27",
19-Feb-21,ATM,134.41,00.00,"43,914.68",
19-Feb-21,Tax,235,00.00,"44,149.68",
19-Feb-21,Purchase,"9,04,899.00",00.00,"9,49,048.68",
19-Feb-21,ATM,"5,232.00",00.00,"9,54,280.68",
19-Feb-21,Cash,"4,761.30",00.00,"9,59,041.98",
19-Feb-21,Interest,"4,661.19",00.00,"9,63,703.17",
19-Feb-21,Cheque,04.00,00.00,"9,63,707.17",
19-Feb-21,Bill,00.00,"1,60,617.86","8,03,089.31",
19-Feb-21,Cheque,"13,877.94",00.00,"8,16,967.25",
19-Feb-21,Commission,"2,07,213.90",00.00,"10,24,181.15",
19-Feb-21,Reversal,00.00,"2,04,836.23","8,19,344.92",
20-Feb-21,ATM,278.7,00.00,"8,19,623.62",
20-Feb-21,RTGS,06.00,00.00,"8,19,629.62",
20-Feb-21,Transportellaneous,"17,81,810.00",00.00,"26,01,439.62",
20-Feb-21,Reversal,"49,400.00",00.00,"26,50,839.62",
20-Feb-21,NEFT,"26,783.00",00.00,"26,77,622.62",
20-Feb-21,Commission,"6,13,189.50",00.00,"32,90,812.12",
20-Feb-21,Cheque,54.06,00.00,"32,90,866.18",
20-Feb-21,Commission,00.00,"10,96,955.39","21,93,910.79",
20-Feb-21,Tax,00.00,"21,93,910.79",00.00,
20-Feb-21,Tax,"80,432.06",00.00,"80,432.06",
21-Feb-21,RTGS,"28,790.40",00.00,"1,09,222.46",
21-Feb-21,Tax,00.00,"13,652.81","95,569.65",
21-Feb-21,Cash,"41,178.70",00.00,"1,36,748.35",
21-Feb-21,Interest,46,00.00,"1,36,794.35",
21-Feb-21,Debit Card,01.06,00.00,"1,36,795.41",
21-Feb-21,Transfer,375.46,00.00,"1,37,170.87",
21-Feb-21,Transportellaneous,"20,15,560.75",00.00,"21,52,731.62",
21-Feb-21,Reversal,06.73,00.00,"21,52,738.35",
21-Feb-21,RTGS,00.00,"5,38,184.59","16,14,553.76",
21-Feb-21,Interest,00.00,"2,01,819.22","14,12,734.54",
21-Feb-21,Transfer,00.00,"2,35,455.76","11,77,278.78",
21-Feb-21,NEFT,"9,512.00",00.00,"11,86,790.78",
21-Feb-21,Interest,00.00,"2,37,358.16","9,49,432.62",
21-Feb-21,IMPS,00.00,"3,16,477.54","6,32,955.08",
21-Feb-21,Interest,07.13,00.00,"6,32,962.21",
21-Feb-21,NEFT,00.00,"79,120.28","5,53,841.93",
21-Feb-21,RTGS,"14,64,292.25",00.00,"20,18,134.18",
21-Feb-21,Purchase,"3,93,638.00",00.00,"24,11,772.18",
21-Feb-21,Cash,114.8,00.00,"24,11,886.98",
21-Feb-21,IMPS,"5,44,520.00",00.00,"29,56,406.98",
21-Feb-21,Transfer,00.00,"3,69,550.87","25,86,856.11",
21-Feb-21,Commission,00.00,"6,46,714.03","19,40,142.08",
21-Feb-21,Commission,05.20,00.00,"19,40,147.28",
21-Feb-21,NEFT,00.00,"9,70,073.64","9,70,073.64",
21-Feb-21,Cheque,"2,098.00",00.00,"9,72,171.64",
21-Feb-21,Interest,01.50,00.00,"9,72,173.14",
21-Feb-21,Transfer,00.00,"1,62,028.86","8,10,144.28",
21-Feb-21,Transportellaneous,01.00,00.00,"8,10,145.28",
21-Feb-21,ATM,"5,57,357.25",00.00,"13,67,502.53",
21-Feb-21,Commission,449,00.00,"13,67,951.53",
21-Feb-21,Cash,162.8,00.00,"13,68,114.33",
21-Feb-21,Purchase,"8,08,408.00",00.00,"21,76,522.33",
21-Feb-21,NEFT,00.00,"3,10,931.76","18,65,590.57",
21-Feb-21,RTGS,11,00.00,"18,65,601.57",
21-Feb-21,Tax,00.00,"4,66,400.39","13,99,201.18",
21-Feb-21,IMPS,04.33,00.00,"13,99,205.51",
21-Feb-21,Transfer,"2,480.90",00.00,"14,01,686.41",
21-Feb-21,Transportellaneous,06.30,00.00,"14,01,692.71",
21-Feb-21,Transportellaneous,00.00,"4,67,230.90","9,34,461.81",
21-Feb-21,Transportellaneous,00.00,"1,16,807.73","8,17,654.08",
21-Feb-21,NEFT,"12,536.00",00.00,"8,30,190.08",
21-Feb-21,Commission,00.00,"92,243.34","7,37,946.74",
21-Feb-21,Cash,00.00,"1,22,991.12","6,14,955.62",
21-Feb-21,Cheque,04.52,00.00,"6,14,960.14",
21-Feb-21,Cheque,"1,27,903.16",00.00,"7,42,863.30",
21-Feb-21,Debit Card,00.00,"1,48,572.66","5,94,290.64",
22-Feb-21,Reversal,07.30,00.00,"5,94,297.94",
22-Feb-21,Interest,63,00.00,"5,94,360.94",
22-Feb-21,Purchase,"31,529.90",00.00,"6,25,890.84",
22-Feb-21,IMPS,"12,944.00",00.00,"6,38,834.84",
22-Feb-21,Cash,00.00,"2,12,944.95","4,25,889.89",
22-Feb-21,Transfer,00.00,"85,177.98","3,40,711.91",
22-Feb-21,Tax,00.00,"34,071.19","3,06,640.72",
22-Feb-21,Cash,00.00,"1,02,213.57","2,04,427.15",
22-Feb-21,NEFT,00.00,"68,142.38","1,36,284.77",
22-Feb-21,IMPS,"2,18,667.00",00.00,"3,54,951.77",
22-Feb-21,Interest,00.00,"3,54,951.77",00.00,
22-Feb-21,Interest,485.8,00.00,485.8,
22-Feb-21,ATM,"31,128.00",00.00,"31,613.80",
22-Feb-21,Debit Card,271.1,00.00,"31,884.90",
22-Feb-21,Transportellaneous,721,00.00,"32,605.90",
22-Feb-21,Debit Card,762,00.00,"33,367.90",
22-Feb-21,ATM,00.00,"11,122.63","22,245.27",
22-Feb-21,IMPS,220.14,00.00,"22,465.41",
22-Feb-21,Commission,"12,45,896.20",00.00,"12,68,361.61",
22-Feb-21,Transportellaneous,00.00,"6,34,180.81","6,34,180.81",
22-Feb-21,Purchase,00.00,"1,58,545.20","4,75,635.61",
22-Feb-21,Interest,"2,791.00",00.00,"4,78,426.61",
22-Feb-21,Bill,00.00,"59,803.33","4,18,623.28",
22-Feb-21,Transfer,00.00,"2,09,311.64","2,09,311.64",
22-Feb-21,Cheque,00.00,"52,327.91","1,56,983.73",
22-Feb-21,Tax,00.00,"78,491.87","78,491.87",
23-Feb-21,Transfer,42.86,00.00,"78,534.73",
23-Feb-21,IMPS,00.77,00.00,"78,535.50",
23-Feb-21,Purchase,00.00,"15,707.10","62,828.40",
23-Feb-21,Cash,00.00,"6,980.93","55,847.47",
23-Feb-21,Cash,03.40,00.00,"55,850.87",
23-Feb-21,Interest,00.00,"9,308.48","46,542.39",
23-Feb-21,RTGS,"3,948.10",00.00,"50,490.49",
23-Feb-21,Purchase,00.00,"8,415.08","42,075.41",
23-Feb-21,Tax,"2,802.54",00.00,"44,877.95",
23-Feb-21,NEFT,00.00,"5,609.74","39,268.21",
23-Feb-21,IMPS,00.00,"9,817.05","29,451.16",
23-Feb-21,Reversal,00.00,"9,817.05","19,634.11",
23-Feb-21,RTGS,"6,344.90",00.00,"25,979.01",
23-Feb-21,Purchase,00.00,"2,886.56","23,092.45",
23-Feb-21,IMPS,"83,332.75",00.00,"1,06,425.20",
23-Feb-21,Cash,34.09,00.00,"1,06,459.29",
23-Feb-21,Tax,00.00,"35,486.43","70,972.86",
23-Feb-21,RTGS,212.9,00.00,"71,185.76",
23-Feb-21,Purchase,00.00,"10,169.39","61,016.37",
23-Feb-21,ATM,"1,356.70",00.00,"62,373.07",
23-Feb-21,Cheque,00.00,"15,593.27","46,779.80",
23-Feb-21,Tax,"3,747.10",00.00,"50,526.90",
23-Feb-21,Interest,04.90,00.00,"50,531.80",
23-Feb-21,Commission,00.00,"25,265.90","25,265.90",
23-Feb-21,Commission,21,00.00,"25,286.90",
23-Feb-21,Transfer,"11,983.00",00.00,"37,269.90",
23-Feb-21,Commission,00.00,"4,141.10","33,128.80",
23-Feb-21,Tax,00.00,"3,680.98","29,447.82",
23-Feb-21,Interest,00.00,"7,361.96","22,085.86",
23-Feb-21,Reversal,"1,84,413.62",00.00,"2,06,499.48",
23-Feb-21,Debit Card,00.00,"2,06,499.48",00.00,
23-Feb-21,Interest,56,00.00,56,
24-Feb-21,NEFT,"2,56,233.00",00.00,"2,56,289.00",
24-Feb-21,Transfer,02.50,00.00,"2,56,291.50",
25-Feb-21,NEFT,00.00,"2,56,291.50",00.00,
25-Feb-21,Reversal,"2,24,383.00",00.00,"2,24,383.00",
25-Feb-21,RTGS,00.00,"22,438.30","2,01,944.70",
25-Feb-21,Reversal,00.00,"33,657.45","1,68,287.25",
25-Feb-21,ATM,"16,86,614.75",00.00,"18,54,902.00",
25-Feb-21,Cash,"51,958.56",00.00,"19,06,860.56",
25-Feb-21,Tax,00.00,"2,72,408.65","16,34,451.91",
25-Feb-21,Cheque,00.00,"8,17,225.96","8,17,225.96",
25-Feb-21,Cheque,00.00,"1,63,445.19","6,53,780.77",
25-Feb-21,Bill,"10,21,711.50",00.00,"16,75,492.27",
25-Feb-21,Debit Card,02.00,00.00,"16,75,494.27",
25-Feb-21,Reversal,00.00,"1,67,549.43","15,07,944.84",
25-Feb-21,Tax,"3,353.80",00.00,"15,11,298.64",
25-Feb-21,ATM,00.10,00.00,"15,11,298.74",
25-Feb-21,Purchase,00.00,"1,67,922.08","13,43,376.66",
25-Feb-21,Commission,00.00,"6,71,688.33","6,71,688.33",
25-Feb-21,Commission,"1,442.09",00.00,"6,73,130.42",
25-Feb-21,Reversal,16,00.00,"6,73,146.42",
25-Feb-21,ATM,00.00,"1,34,629.28","5,38,517.14",
25-Feb-21,Debit Card,00.00,"59,835.24","4,78,681.90",
25-Feb-21,Commission,526.69,00.00,"4,79,208.59",
25-Feb-21,Interest,27,00.00,"4,79,235.59",
25-Feb-21,Transportellaneous,328.5,00.00,"4,79,564.09",
25-Feb-21,NEFT,00.00,"68,509.16","4,11,054.93",
25-Feb-21,ATM,308.7,00.00,"4,11,363.63",
25-Feb-21,Transportellaneous,07.00,00.00,"4,11,370.63",
25-Feb-21,ATM,00.00,"4,11,370.63",00.00,
25-Feb-21,IMPS,37,00.00,37,
25-Feb-21,Transfer,236.8,00.00,273.8,
25-Feb-21,Transfer,"3,171.10",00.00,"3,444.90",
25-Feb-21,Transfer,00.45,00.00,"3,445.35",
25-Feb-21,Tax,"61,970.00",00.00,"65,415.35",
25-Feb-21,NEFT,06.66,00.00,"65,422.01",
25-Feb-21,Cash,00.00,"16,355.50","49,066.51",
25-Feb-21,Transportellaneous,00.00,"5,451.83","43,614.68",
25-Feb-21,NEFT,242,00.00,"43,856.68",
25-Feb-21,Commission,11.6,00.00,"43,868.28",
25-Feb-21,Debit Card,44.1,00.00,"43,912.38",
25-Feb-21,ATM,"16,457.00",00.00,"60,369.38",
25-Feb-21,RTGS,00.00,"6,036.94","54,332.44",
26-Feb-21,NEFT,00.40,00.00,"54,332.84",
26-Feb-21,Transfer,00.00,"5,433.28","48,899.56",
26-Feb-21,Purchase,00.00,"5,433.28","43,466.28",
26-Feb-21,Debit Card,00.00,"10,866.57","32,599.71",
26-Feb-21,Debit Card,"84,279.00",00.00,"1,16,878.71",
26-Feb-21,Purchase,00.10,00.00,"1,16,878.81",
26-Feb-21,ATM,39.6,00.00,"1,16,918.41",
26-Feb-21,Cash,483,00.00,"1,17,401.41",
26-Feb-21,Interest,00.00,"11,740.14","1,05,661.27",
26-Feb-21,Reversal,00.00,"1,05,661.27",00.00,
26-Feb-21,NEFT,"89,842.00",00.00,"89,842.00",
26-Feb-21,ATM,00.00,"12,834.57","77,007.43",
26-Feb-21,ATM,"18,165.92",00.00,"95,173.35",
26-Feb-21,Reversal,55,00.00,"95,228.35",
26-Feb-21,Transfer,00.00,"31,742.78","63,485.57",
26-Feb-21,Purchase,00.00,"9,069.37","54,416.20",
26-Feb-21,RTGS,03.00,00.00,"54,419.20",
26-Feb-21,ATM,"15,016.30",00.00,"69,435.50",
27-Feb-21,Tax,00.00,"8,679.44","60,756.06",
27-Feb-21,Debit Card,00.00,"60,756.06",00.00,
27-Feb-21,NEFT,01.60,00.00,01.60,
27-Feb-21,Debit Card,00.00,00.27,01.33,
27-Feb-21,Commission,"13,72,278.25",00.00,"13,72,279.58",
27-Feb-21,Transportellaneous,04.85,00.00,"13,72,284.43",
27-Feb-21,IMPS,22,00.00,"13,72,306.43",
27-Feb-21,Bill,553.3,00.00,"13,72,859.73",
27-Feb-21,Tax,07.30,00.00,"13,72,867.03",
27-Feb-21,Interest,00.00,"1,52,540.78","12,20,326.25",
27-Feb-21,Cheque,00.00,"1,35,591.81","10,84,734.44",
27-Feb-21,Cash,00.00,"1,35,591.81","9,49,142.64",
27-Feb-21,Transfer,402,00.00,"9,49,544.64",
27-Feb-21,NEFT,00.00,"1,05,504.96","8,44,039.68",
27-Feb-21,Interest,00.00,"8,44,039.68",00.00,
27-Feb-21,Reversal,"10,215.00",00.00,"10,215.00",
27-Feb-21,IMPS,52,00.00,"10,267.00",
27-Feb-21,Debit Card,00.00,"1,466.71","8,800.29",
27-Feb-21,Cash,"9,759.00",00.00,"18,559.29",
27-Feb-21,Debit Card,00.00,"6,186.43","12,372.86",
27-Feb-21,Cash,16.5,00.00,"12,389.36",
27-Feb-21,Debit Card,00.00,"2,064.89","10,324.47",
27-Feb-21,Debit Card,12,00.00,"10,336.47",
27-Feb-21,Transfer,"15,357.30",00.00,"25,693.77",
27-Feb-21,Reversal,45.45,00.00,"25,739.22",
27-Feb-21,Tax,00.00,"12,869.61","12,869.61",
27-Feb-21,Purchase,00.00,"1,838.52","11,031.09",
27-Feb-21,Transportellaneous,00.00,"3,677.03","7,354.06",
28-Feb-21,Commission,00.17,00.00,"7,354.23",
28-Feb-21,Purchase,59,00.00,"7,413.23",
28-Feb-21,IMPS,06.84,00.00,"7,420.07",
28-Feb-21,IMPS,"7,05,387.50",00.00,"7,12,807.57",
28-Feb-21,Transportellaneous,502,00.00,"7,13,309.57",
28-Feb-21,Transfer,"1,563.20",00.00,"7,14,872.77",
28-Feb-21,Interest,00.00,"3,57,436.39","3,57,436.38",
28-Feb-21,Reversal,"7,516.81",00.00,"3,64,953.19",
28-Feb-21,Purchase,"10,97,998.25",00.00,"14,62,951.44",
28-Feb-21,Interest,725.12,00.00,"14,63,676.56",
28-Feb-21,ATM,"2,173.46",00.00,"14,65,850.02",
28-Feb-21,IMPS,00.00,"1,62,872.22","13,02,977.80",
28-Feb-21,Cash,00.00,"1,44,775.31","11,58,202.49",
28-Feb-21,Transportellaneous,00.00,"1,44,775.31","10,13,427.18",
28-Feb-21,Interest,34.7,00.00,"10,13,461.88",
28-Feb-21,Transfer,00.00,"5,06,730.94","5,06,730.94",
28-Feb-21,Transportellaneous,00.00,"2,53,365.47","2,53,365.47",
28-Feb-21,ATM,"22,059.00",00.00,"2,75,424.47",
28-Feb-21,ATM,00.00,"91,808.16","1,83,616.31",
28-Feb-21,Reversal,00.00,"45,904.08","1,37,712.23",
28-Feb-21,NEFT,00.00,"17,214.03","1,20,498.20",
28-Feb-21,Bill,43,00.00,"1,20,541.20",
28-Feb-21,NEFT,"1,30,493.00",00.00,"2,51,034.20",
28-Feb-21,Interest,"19,988.29",00.00,"2,71,022.49",
01-Mar-21,Commission,00.00,"45,170.42","2,25,852.08",
01-Mar-21,Bill,"2,02,293.50",00.00,"4,28,145.58",
01-Mar-21,Interest,00.00,"85,629.12","3,42,516.46",
01-Mar-21,Transfer,"67,797.69",00.00,"4,10,314.15",
01-Mar-21,Reversal,20,00.00,"4,10,334.15",
01-Mar-21,IMPS,01.20,00.00,"4,10,335.35",
01-Mar-21,Tax,00.00,"2,05,167.68","2,05,167.68",
01-Mar-21,Interest,00.00,"51,291.92","1,53,875.76",
01-Mar-21,Transfer,00.00,"25,645.96","1,28,229.80",
01-Mar-21,Cheque,00.00,"14,247.76","1,13,982.04",
01-Mar-21,Purchase,442,00.00,"1,14,424.04",
01-Mar-21,Transportellaneous,00.00,"38,141.35","76,282.69",
01-Mar-21,Commission,"2,37,548.40",00.00,"3,13,831.09",
01-Mar-21,Interest,00.00,"34,870.12","2,78,960.97",
02-Mar-21,ATM,00.00,"34,870.12","2,44,090.85",
02-Mar-21,Transfer,00.00,"27,121.21","2,16,969.64",
02-Mar-21,Reversal,"8,66,726.00",00.00,"10,83,695.64",
02-Mar-21,Tax,00.00,"1,54,813.66","9,28,881.98",
03-Mar-21,Tax,"1,06,816.00",00.00,"10,35,697.98",
03-Mar-21,NEFT,25.8,00.00,"10,35,723.78",
03-Mar-21,Commission,03.00,00.00,"10,35,726.78",
03-Mar-21,Tax,"11,894.05",00.00,"10,47,620.83",
03-Mar-21,Purchase,110.4,00.00,"10,47,731.23",
03-Mar-21,Tax,00.00,"1,30,966.40","9,16,764.83",
03-Mar-21,Tax,00.00,"1,83,352.97","7,33,411.86",
03-Mar-21,Transportellaneous,"2,32,846.00",00.00,"9,66,257.86",
03-Mar-21,Cash,02.30,00.00,"9,66,260.16",
03-Mar-21,Commission,07.00,00.00,"9,66,267.16",
03-Mar-21,Debit Card,00.00,"1,61,044.53","8,05,222.63",
03-Mar-21,NEFT,12.1,00.00,"8,05,234.73",
03-Mar-21,Purchase,00.00,"1,15,033.53","6,90,201.20",
03-Mar-21,Cheque,00.00,"86,275.15","6,03,926.05",
03-Mar-21,ATM,00.00,"2,01,308.68","4,02,617.37",
03-Mar-21,Tax,"1,223.00",00.00,"4,03,840.37",
03-Mar-21,ATM,00.00,"40,384.04","3,63,456.33",
03-Mar-21,Bill,00.00,"1,81,728.17","1,81,728.16",
03-Mar-21,Transportellaneous,"3,738.17",00.00,"1,85,466.33",
03-Mar-21,Reversal,00.00,"1,85,466.33",00.00,
03-Mar-21,IMPS,"3,271.00",00.00,"3,271.00",
03-Mar-21,Transfer,00.00,327.1,"2,943.90",
03-Mar-21,RTGS,"15,36,600.25",00.00,"15,39,544.15",
03-Mar-21,Commission,"2,779.00",00.00,"15,42,323.15",
04-Mar-21,Reversal,00.00,"7,71,161.58","7,71,161.58",
04-Mar-21,Reversal,00.00,"7,71,161.58",00.00,
04-Mar-21,Reversal,"3,549.49",00.00,"3,549.49",
04-Mar-21,Cheque,"2,43,237.00",00.00,"2,46,786.49",
04-Mar-21,IMPS,46.9,00.00,"2,46,833.39",
04-Mar-21,NEFT,00.00,"27,425.93","2,19,407.46",
04-Mar-21,Purchase,"19,272.00",00.00,"2,38,679.46",
04-Mar-21,Purchase,470.25,00.00,"2,39,149.71",
04-Mar-21,Cash,00.00,"29,893.71","2,09,256.00",
04-Mar-21,ATM,00.00,"41,851.20","1,67,404.80",
04-Mar-21,Interest,782,00.00,"1,68,186.80",
04-Mar-21,Interest,"1,44,747.38",00.00,"3,12,934.18",
04-Mar-21,ATM,00.00,"3,12,934.18",00.00,
04-Mar-21,Debit Card,03.70,00.00,03.70,
04-Mar-21,Transfer,40.6,00.00,44.3,
04-Mar-21,Cash,"3,836.20",00.00,"3,880.50",
04-Mar-21,Cheque,"3,946.57",00.00,"7,827.07",
04-Mar-21,Cash,"1,46,232.94",00.00,"1,54,060.01",
04-Mar-21,Bill,"3,675.89",00.00,"1,57,735.90",
04-Mar-21,Transportellaneous,60.4,00.00,"1,57,796.30",
04-Mar-21,Commission,00.00,"26,299.38","1,31,496.92",
04-Mar-21,Transportellaneous,"83,512.30",00.00,"2,15,009.22",
04-Mar-21,Cash,00.00,"2,15,009.22",00.00,
04-Mar-21,Cheque,"18,89,116.00",00.00,"18,89,116.00",
04-Mar-21,IMPS,00.00,"6,29,705.33","12,59,410.67",
04-Mar-21,Purchase,00.00,"1,25,941.07","11,33,469.60",
04-Mar-21,Reversal,00.00,"3,77,823.20","7,55,646.40",
04-Mar-21,Cheque,"2,789.10",00.00,"7,58,435.50",
04-Mar-21,NEFT,00.00,"1,89,608.88","5,68,826.62",
04-Mar-21,Cash,00.00,"71,103.33","4,97,723.29",
04-Mar-21,Commission,00.00,"1,65,907.76","3,31,815.53",
04-Mar-21,Purchase,00.00,"1,10,605.18","2,21,210.35",
04-Mar-21,Cheque,00.00,"55,302.59","1,65,907.76",
04-Mar-21,Reversal,168,00.00,"1,66,075.76",
04-Mar-21,Transfer,00.00,"20,759.47","1,45,316.29",
04-Mar-21,Interest,00.00,"1,45,316.29",00.00,
04-Mar-21,Transportellaneous,"2,02,628.10",00.00,"2,02,628.10",
04-Mar-21,RTGS,00.00,"22,514.23","1,80,113.87",
04-Mar-21,Cash,00.00,"60,037.96","1,20,075.91",
04-Mar-21,Cheque,00.00,"20,012.65","1,00,063.26",
04-Mar-21,ATM,"4,99,764.00",00.00,"5,99,827.26",
04-Mar-21,Reversal,"13,80,361.50",00.00,"19,80,188.76",
05-Mar-21,Reversal,00.00,"9,90,094.38","9,90,094.38",
05-Mar-21,Commission,00.00,"9,90,094.38",00.00,
05-Mar-21,Purchase,02.84,00.00,02.84,
05-Mar-21,ATM,09.00,00.00,11.84,
05-Mar-21,Bill,00.00,01.97,09.87,
05-Mar-21,Debit Card,"18,87,038.00",00.00,"18,87,047.87",
05-Mar-21,Transportellaneous,00.00,"18,87,047.87",00.00,
05-Mar-21,RTGS,11,00.00,11,
05-Mar-21,Purchase,00.00,01.83,09.17,
05-Mar-21,NEFT,"1,78,397.12",00.00,"1,78,406.29",
05-Mar-21,Transportellaneous,00.00,"17,840.63","1,60,565.66",
05-Mar-21,Cheque,"56,451.00",00.00,"2,17,016.66",
05-Mar-21,Cheque,"25,369.00",00.00,"2,42,385.66",
05-Mar-21,RTGS,"10,753.00",00.00,"2,53,138.66",
05-Mar-21,Transportellaneous,"46,040.00",00.00,"2,99,178.66",
05-Mar-21,Bill,"7,56,917.50",00.00,"10,56,096.16",
05-Mar-21,Cash,04.60,00.00,"10,56,100.76",
05-Mar-21,Tax,00.00,"1,32,012.60","9,24,088.16",
05-Mar-21,ATM,"1,57,374.34",00.00,"10,81,462.50",
05-Mar-21,Commission,36,00.00,"10,81,498.50",
05-Mar-21,Reversal,49.7,00.00,"10,81,548.20",
05-Mar-21,Cheque,"76,661.00",00.00,"11,58,209.20",
05-Mar-21,Reversal,"13,703.09",00.00,"11,71,912.29",
05-Mar-21,Bill,60,00.00,"11,71,972.29",
05-Mar-21,Transportellaneous,"1,301.08",00.00,"11,73,273.37",
05-Mar-21,RTGS,00.00,"3,91,091.12","7,82,182.25",
05-Mar-21,Interest,00.00,"1,11,740.32","6,70,441.93",
05-Mar-21,NEFT,"98,953.00",00.00,"7,69,394.93",
05-Mar-21,Debit Card,00.00,"96,174.37","6,73,220.56",
05-Mar-21,Cheque,00.00,"1,34,644.11","5,38,576.45",
05-Mar-21,Interest,06.00,00.00,"5,38,582.45",
05-Mar-21,Transfer,"3,713.70",00.00,"5,42,296.15",
05-Mar-21,Transfer,"57,169.25",00.00,"5,99,465.40",
05-Mar-21,Bill,00.00,"99,910.90","4,99,554.50",
05-Mar-21,NEFT,00.00,"71,364.93","4,28,189.57",
05-Mar-21,Bill,"6,02,652.50",00.00,"10,30,842.07",
05-Mar-21,NEFT,"31,079.30",00.00,"10,61,921.37",
05-Mar-21,Cheque,06.00,00.00,"10,61,927.37",
05-Mar-21,Reversal,01.60,00.00,"10,61,928.97",
05-Mar-21,Tax,00.00,"2,12,385.79","8,49,543.18",
05-Mar-21,Tax,108.94,00.00,"8,49,652.12",
05-Mar-21,Debit Card,00.00,"4,24,826.06","4,24,826.06",
05-Mar-21,Bill,00.00,"70,804.34","3,54,021.72",
05-Mar-21,NEFT,00.00,"1,77,010.86","1,77,010.86",
05-Mar-21,Cheque,"4,651.00",00.00,"1,81,661.86",
05-Mar-21,Interest,"1,354.52",00.00,"1,83,016.38",
05-Mar-21,Interest,"1,564.92",00.00,"1,84,581.30",
05-Mar-21,Purchase,00.00,"92,290.65","92,290.65",
05-Mar-21,NEFT,00.00,"46,145.33","46,145.32",
06-Mar-21,Cash,00.00,"5,127.26","41,018.06",
06-Mar-21,Transportellaneous,00.00,"13,672.69","27,345.37",
06-Mar-21,Reversal,00.00,"27,345.37",00.00,
06-Mar-21,Cash,"3,62,016.00",00.00,"3,62,016.00",
06-Mar-21,Cheque,05.00,00.00,"3,62,021.00",
06-Mar-21,Cheque,07.60,00.00,"3,62,028.60",
06-Mar-21,Transportellaneous,"2,541.00",00.00,"3,64,569.60",
06-Mar-21,IMPS,"1,263.00",00.00,"3,65,832.60",
06-Mar-21,Cheque,00.00,"52,261.80","3,13,570.80",
06-Mar-21,Purchase,00.00,"1,56,785.40","1,56,785.40",
06-Mar-21,RTGS,"7,29,758.00",00.00,"8,86,543.40",
06-Mar-21,RTGS,00.00,"4,43,271.70","4,43,271.70",
06-Mar-21,NEFT,"1,155.20",00.00,"4,44,426.90",
06-Mar-21,Reversal,00.00,"49,380.77","3,95,046.13",
06-Mar-21,Cash,00.00,"39,504.61","3,55,541.52",
06-Mar-21,Commission,"2,014.00",00.00,"3,57,555.52",
06-Mar-21,Transportellaneous,00.00,"39,728.39","3,17,827.13",
06-Mar-21,Debit Card,00.00,"35,314.13","2,82,513.00",
07-Mar-21,Cheque,00.00,"40,359.00","2,42,154.00",
07-Mar-21,Commission,00.00,"40,359.00","2,01,795.00",
07-Mar-21,Commission,"62,749.80",00.00,"2,64,544.80",
07-Mar-21,Purchase,00.00,"88,181.60","1,76,363.20",
07-Mar-21,Interest,13.76,00.00,"1,76,376.96",
07-Mar-21,Tax,"14,63,951.00",00.00,"16,40,327.96",
07-Mar-21,ATM,"2,04,441.00",00.00,"18,44,768.96",
07-Mar-21,Tax,06.50,00.00,"18,44,775.46",
07-Mar-21,ATM,"27,651.00",00.00,"18,72,426.46",
07-Mar-21,Transfer,00.00,"1,87,242.65","16,85,183.81",
07-Mar-21,Purchase,337,00.00,"16,85,520.81",
07-Mar-21,Cash,00.00,"2,40,788.69","14,44,732.12",
07-Mar-21,Transfer,00.00,"14,44,732.12",00.00,
07-Mar-21,ATM,12.1,00.00,12.1,
07-Mar-21,Cheque,00.00,12.1,00.00,
07-Mar-21,Debit Card,"1,529.00",00.00,"1,529.00",
07-Mar-21,RTGS,00.00,152.9,"1,376.10",
07-Mar-21,Cheque,00.00,688.05,688.05,
07-Mar-21,NEFT,"3,921.00",00.00,"4,609.05",
07-Mar-21,IMPS,00.00,576.13,"4,032.92",
07-Mar-21,Purchase,00.00,"2,016.46","2,016.46",
07-Mar-21,Cheque,00.00,403.29,"1,613.17",
07-Mar-21,NEFT,"3,530.80",00.00,"5,143.97",
07-Mar-21,Transfer,"20,67,048.80",00.00,"20,72,192.77",
07-Mar-21,Commission,"1,932.50",00.00,"20,74,125.27",
07-Mar-21,ATM,215,00.00,"20,74,340.27",
07-Mar-21,IMPS,411.46,00.00,"20,74,751.73",
07-Mar-21,IMPS,"14,005.90",00.00,"20,88,757.63",
07-Mar-21,Interest,"1,617.00",00.00,"20,90,374.63",
07-Mar-21,Cheque,20.52,00.00,"20,90,395.15",
07-Mar-21,Bill,"24,523.00",00.00,"21,14,918.15",
07-Mar-21,Transportellaneous,00.00,"4,22,983.63","16,91,934.52",
07-Mar-21,IMPS,00.00,"1,87,992.72","15,03,941.80",
07-Mar-21,Reversal,"24,800.53",00.00,"15,28,742.33",
08-Mar-21,ATM,"3,791.09",00.00,"15,32,533.42",
08-Mar-21,Bill,"31,142.03",00.00,"15,63,675.45",
08-Mar-21,Purchase,00.00,"7,81,837.73","7,81,837.72",
08-Mar-21,IMPS,"1,92,709.00",00.00,"9,74,546.72",
08-Mar-21,ATM,02.00,00.00,"9,74,548.72",
08-Mar-21,Interest,00.00,"2,43,637.18","7,30,911.54",
08-Mar-21,Bill,"1,58,498.00",00.00,"8,89,409.54",
09-Mar-21,Tax,07.00,00.00,"8,89,416.54",
09-Mar-21,Bill,00.00,"8,89,416.54",00.00,
09-Mar-21,Interest,"1,95,841.00",00.00,"1,95,841.00",
09-Mar-21,Reversal,06.49,00.00,"1,95,847.49",
09-Mar-21,Cheque,00.00,"19,584.75","1,76,262.74",
09-Mar-21,Cash,01.95,00.00,"1,76,264.69",
09-Mar-21,Tax,00.00,"22,033.09","1,54,231.60",
09-Mar-21,ATM,00.00,"77,115.80","77,115.80",
09-Mar-21,Tax,00.00,"15,423.16","61,692.64",
09-Mar-21,Purchase,04.00,00.00,"61,696.64",
09-Mar-21,RTGS,"2,116.53",00.00,"63,813.17",
09-Mar-21,Debit Card,00.00,"31,906.59","31,906.58",
09-Mar-21,Reversal,00.00,"5,317.76","26,588.82",
09-Mar-21,Commission,44.1,00.00,"26,632.92",
09-Mar-21,Transportellaneous,00.00,"2,663.29","23,969.63",
09-Mar-21,Transfer,"10,46,350.50",00.00,"10,70,320.13",
09-Mar-21,Cheque,00.00,"5,35,160.07","5,35,160.06",
09-Mar-21,Debit Card,00.00,"66,895.01","4,68,265.05",
09-Mar-21,Commission,00.00,"1,56,088.35","3,12,176.70",
09-Mar-21,Commission,550.7,00.00,"3,12,727.40",
10-Mar-21,Bill,"5,52,985.00",00.00,"8,65,712.40",
10-Mar-21,NEFT,464.54,00.00,"8,66,176.94",
10-Mar-21,IMPS,00.00,"1,73,235.39","6,92,941.55",
10-Mar-21,ATM,352.2,00.00,"6,93,293.75",
10-Mar-21,ATM,03.00,00.00,"6,93,296.75",
10-Mar-21,Transfer,66.4,00.00,"6,93,363.15",
10-Mar-21,Transfer,11,00.00,"6,93,374.15",
10-Mar-21,Interest,00.00,"69,337.42","6,24,036.74",
10-Mar-21,Cash,00.00,"6,24,036.74",00.00,
10-Mar-21,Transportellaneous,"9,23,209.00",00.00,"9,23,209.00",
10-Mar-21,Interest,00.00,"4,61,604.50","4,61,604.50",
10-Mar-21,NEFT,00.00,"76,934.08","3,84,670.42",
10-Mar-21,Transportellaneous,04.90,00.00,"3,84,675.32",
10-Mar-21,Commission,00.00,"1,28,225.11","2,56,450.21",
10-Mar-21,Purchase,00.00,"51,290.04","2,05,160.17",
10-Mar-21,Reversal,106,00.00,"2,05,266.17",
10-Mar-21,RTGS,00.00,"68,422.06","1,36,844.11",
10-Mar-21,Cheque,00.65,00.00,"1,36,844.76",
10-Mar-21,ATM,563,00.00,"1,37,407.76",
10-Mar-21,Reversal,152.39,00.00,"1,37,560.15",
10-Mar-21,Transfer,07.00,00.00,"1,37,567.15",
10-Mar-21,Purchase,"22,044.16",00.00,"1,59,611.31",
10-Mar-21,NEFT,"1,24,453.75",00.00,"2,84,065.06",
10-Mar-21,Bill,00.00,"47,344.18","2,36,720.88",
10-Mar-21,Cash,00.00,"59,180.22","1,77,540.66",
10-Mar-21,Cash,"3,579.00",00.00,"1,81,119.66",
10-Mar-21,Debit Card,00.00,"22,639.96","1,58,479.70",
10-Mar-21,Reversal,00.00,"79,239.85","79,239.85",
10-Mar-21,Commission,00.00,"26,413.28","52,826.57",
10-Mar-21,Cash,485.06,00.00,"53,311.63",
10-Mar-21,Debit Card,00.00,"5,331.16","47,980.47",
10-Mar-21,Cash,00.00,"5,331.16","42,649.31",
10-Mar-21,Debit Card,36.4,00.00,"42,685.71",
10-Mar-21,Interest,00.00,"21,342.86","21,342.86",
10-Mar-21,ATM,03.00,00.00,"21,345.86",
10-Mar-21,Cash,00.00,"2,371.76","18,974.10",
11-Mar-21,Tax,"2,384.80",00.00,"21,358.90",
11-Mar-21,Reversal,00.00,"21,358.90",00.00,
11-Mar-21,IMPS,114.23,00.00,114.23,
11-Mar-21,Cheque,04.27,00.00,118.5,
11-Mar-21,Bill,"1,21,770.90",00.00,"1,21,889.40",
11-Mar-21,Debit Card,00.00,"30,472.35","91,417.05",
11-Mar-21,NEFT,00.00,"45,708.53","45,708.52",
12-Mar-21,Transfer,00.00,"22,854.26","22,854.26",
12-Mar-21,IMPS,00.50,00.00,"22,854.76",
12-Mar-21,Commission,380.21,00.00,"23,234.97",
12-Mar-21,Purchase,"8,00,311.75",00.00,"8,23,546.72",
12-Mar-21,Interest,00.00,"82,354.67","7,41,192.05",
12-Mar-21,ATM,00.00,"92,649.01","6,48,543.04",
12-Mar-21,Transportellaneous,00.00,"1,62,135.76","4,86,407.28",
12-Mar-21,RTGS,"2,42,381.34",00.00,"7,28,788.62",
12-Mar-21,NEFT,00.00,"3,64,394.31","3,64,394.31",
12-Mar-21,Commission,00.00,"3,64,394.31",00.00,
12-Mar-21,Transfer,"18,008.00",00.00,"18,008.00",
12-Mar-21,Cash,00.00,"9,004.00","9,004.00",
12-Mar-21,Bill,"2,41,136.44",00.00,"2,50,140.44",
12-Mar-21,Purchase,00.00,"41,690.07","2,08,450.37",
12-Mar-21,Reversal,01.30,00.00,"2,08,451.67",
12-Mar-21,ATM,00.00,"2,08,451.67",00.00,
12-Mar-21,Cheque,02.00,00.00,02.00,
12-Mar-21,ATM,00.00,00.67,01.33,
13-Mar-21,Commission,00.56,00.00,01.89,
13-Mar-21,Transportellaneous,"11,403.00",00.00,"11,404.89",
13-Mar-21,ATM,00.00,"2,851.22","8,553.67",
13-Mar-21,IMPS,252,00.00,"8,805.67",
13-Mar-21,Tax,438.13,00.00,"9,243.80",
13-Mar-21,Debit Card,00.00,"3,081.27","6,162.53",
13-Mar-21,Tax,01.00,00.00,"6,163.53",
13-Mar-21,Transportellaneous,00.00,616.35,"5,547.18",
13-Mar-21,Tax,"1,49,642.00",00.00,"1,55,189.18",
13-Mar-21,RTGS,"1,246.39",00.00,"1,56,435.57",
13-Mar-21,Cash,260.4,00.00,"1,56,695.97",
13-Mar-21,Interest,00.00,"22,385.14","1,34,310.83",
13-Mar-21,Purchase,"2,903.00",00.00,"1,37,213.83",
14-Mar-21,Debit Card,00.00,"68,606.92","68,606.91",
14-Mar-21,RTGS,00.00,"13,721.38","54,885.53",
14-Mar-21,Commission,00.00,"5,488.55","49,396.98",
14-Mar-21,IMPS,113.33,00.00,"49,510.31",
14-Mar-21,Cash,03.40,00.00,"49,513.71",
14-Mar-21,Debit Card,55.13,00.00,"49,568.84",
14-Mar-21,Cheque,150.1,00.00,"49,718.94",
14-Mar-21,Interest,00.00,"6,214.87","43,504.07",
14-Mar-21,NEFT,00.00,"4,833.79","38,670.28",
14-Mar-21,Cheque,00.00,"7,734.06","30,936.22",
14-Mar-21,Interest,00.00,"3,437.36","27,498.86",
14-Mar-21,Interest,"9,20,762.00",00.00,"9,48,260.86",
14-Mar-21,Tax,00.00,"1,89,652.17","7,58,608.69",
14-Mar-21,Reversal,"37,659.40",00.00,"7,96,268.09",
14-Mar-21,Transportellaneous,467.5,00.00,"7,96,735.59",
14-Mar-21,Transportellaneous,"10,195.58",00.00,"8,06,931.17",
14-Mar-21,Transfer,"17,12,841.00",00.00,"25,19,772.17",
14-Mar-21,RTGS,32.02,00.00,"25,19,804.19",
14-Mar-21,Transportellaneous,00.00,"25,19,804.19",00.00,
14-Mar-21,Debit Card,"3,653.30",00.00,"3,653.30",
14-Mar-21,Cheque,00.00,"1,217.77","2,435.53",
14-Mar-21,Transfer,172,00.00,"2,607.53",
14-Mar-21,Cheque,142.6,00.00,"2,750.13",
14-Mar-21,Transportellaneous,331.63,00.00,"3,081.76",
14-Mar-21,Transfer,00.00,513.63,"2,568.13",
14-Mar-21,Commission,00.00,"1,284.07","1,284.06",
15-Mar-21,Commission,56.5,00.00,"1,340.56",
15-Mar-21,Cheque,04.00,00.00,"1,344.56",
15-Mar-21,Cheque,00.00,"1,344.56",00.00,
15-Mar-21,IMPS,"21,906.00",00.00,"21,906.00",
15-Mar-21,Purchase,205.28,00.00,"22,111.28",
15-Mar-21,Reversal,"82,618.00",00.00,"1,04,729.28",
15-Mar-21,Cheque,00.00,"13,091.16","91,638.12",
15-Mar-21,RTGS,"9,362.04",00.00,"1,01,000.16",
15-Mar-21,Cheque,00.00,"10,100.02","90,900.14",
15-Mar-21,Debit Card,00.00,"18,180.03","72,720.11",
15-Mar-21,Transfer,00.00,"24,240.04","48,480.07",
15-Mar-21,Transportellaneous,00.00,"6,925.72","41,554.35",
15-Mar-21,Commission,00.00,"6,925.73","34,628.62",
15-Mar-21,Debit Card,00.00,"17,314.31","17,314.31",
15-Mar-21,Cash,00.00,"2,164.29","15,150.02",
15-Mar-21,Debit Card,63.7,00.00,"15,213.72",
15-Mar-21,Tax,00.00,"15,213.72",00.00,
15-Mar-21,RTGS,47,00.00,47,
15-Mar-21,Interest,00.00,05.88,41.12,
15-Mar-21,Debit Card,00.00,04.11,37.01,
15-Mar-21,IMPS,13.7,00.00,50.71,
15-Mar-21,IMPS,00.00,50.71,00.00,
15-Mar-21,IMPS,"21,172.00",00.00,"21,172.00",
15-Mar-21,Interest,328,00.00,"21,500.00",
15-Mar-21,Commission,00.00,"4,300.00","17,200.00",
15-Mar-21,ATM,674,00.00,"17,874.00",
15-Mar-21,NEFT,131.6,00.00,"18,005.60",
15-Mar-21,RTGS,00.00,"3,000.93","15,004.67",
15-Mar-21,Transportellaneous,00.00,"7,502.34","7,502.34",
15-Mar-21,ATM,"15,807.80",00.00,"23,310.14",
15-Mar-21,Purchase,00.00,"11,655.07","11,655.07",
15-Mar-21,RTGS,00.00,"1,295.01","10,360.06",
15-Mar-21,Transportellaneous,"1,24,543.53",00.00,"1,34,903.59",
15-Mar-21,Commission,04.50,00.00,"1,34,908.09",
15-Mar-21,Reversal,"27,871.22",00.00,"1,62,779.31",
15-Mar-21,Interest,"24,999.50",00.00,"1,87,778.81",
15-Mar-21,Commission,04.00,00.00,"1,87,782.81",
15-Mar-21,Transfer,00.00,"18,778.28","1,69,004.53",
15-Mar-21,Reversal,61.26,00.00,"1,69,065.79",
15-Mar-21,Tax,00.00,"33,813.16","1,35,252.63",
15-Mar-21,Commission,00.00,"16,906.58","1,18,346.05",
15-Mar-21,Cheque,"14,875.80",00.00,"1,33,221.85",
15-Mar-21,Transfer,365,00.00,"1,33,586.85",
15-Mar-21,Reversal,00.00,"1,33,586.85",00.00,
15-Mar-21,Debit Card,"1,150.10",00.00,"1,150.10",
15-Mar-21,Transfer,00.00,575.05,575.05,
15-Mar-21,RTGS,129.42,00.00,704.47,
15-Mar-21,Debit Card,00.00,140.89,563.58,
15-Mar-21,NEFT,00.00,187.86,375.72,
15-Mar-21,Transportellaneous,"8,394.00",00.00,"8,769.72",
15-Mar-21,RTGS,"2,04,112.72",00.00,"2,12,882.44",
15-Mar-21,NEFT,01.30,00.00,"2,12,883.74",
15-Mar-21,Purchase,"4,03,179.25",00.00,"6,16,062.99",
15-Mar-21,Commission,00.00,"3,08,031.50","3,08,031.50",
15-Mar-21,Commission,00.00,"77,007.88","2,31,023.62",
15-Mar-21,Tax,222.44,00.00,"2,31,246.06",
15-Mar-21,Bill,00.00,"2,31,246.06",00.00,
15-Mar-21,Tax,"20,881.50",00.00,"20,881.50",
15-Mar-21,NEFT,00.00,"6,960.50","13,921.00",
15-Mar-21,RTGS,403.9,00.00,"14,324.90",
15-Mar-21,Reversal,60,00.00,"14,384.90",
16-Mar-21,NEFT,00.00,"3,596.23","10,788.68",
16-Mar-21,Cash,47.7,00.00,"10,836.38",
16-Mar-21,RTGS,00.00,"1,204.04","9,632.34",
16-Mar-21,ATM,00.00,"1,605.39","8,026.95",
16-Mar-21,Tax,"10,80,534.00",00.00,"10,88,560.95",
16-Mar-21,Tax,00.00,"2,72,140.24","8,16,420.71",
16-Mar-21,NEFT,04.00,00.00,"8,16,424.71",
16-Mar-21,Debit Card,"2,229.86",00.00,"8,18,654.57",
16-Mar-21,Purchase,14,00.00,"8,18,668.57",
16-Mar-21,ATM,00.00,"2,04,667.14","6,14,001.43",
16-Mar-21,Transportellaneous,"11,75,858.50",00.00,"17,89,859.93",
16-Mar-21,Interest,00.00,"4,47,464.98","13,42,394.95",
16-Mar-21,Commission,00.00,"13,42,394.95",00.00,
16-Mar-21,ATM,"9,63,223.80",00.00,"9,63,223.80",
16-Mar-21,Tax,"1,99,129.70",00.00,"11,62,353.50",
16-Mar-21,Commission,00.00,"3,87,451.17","7,74,902.33",
16-Mar-21,Transportellaneous,00.00,"1,29,150.39","6,45,751.94",
16-Mar-21,IMPS,00.00,"3,22,875.97","3,22,875.97",
16-Mar-21,Commission,45.22,00.00,"3,22,921.19",
16-Mar-21,NEFT,00.00,"80,730.30","2,42,190.89",
16-Mar-21,Transportellaneous,350.08,00.00,"2,42,540.97",
16-Mar-21,Purchase,00.00,"60,635.24","1,81,905.73",
16-Mar-21,Transportellaneous,00.00,"90,952.87","90,952.86",
16-Mar-21,NEFT,04.80,00.00,"90,957.66",
16-Mar-21,Debit Card,200,00.00,"91,157.66",
16-Mar-21,ATM,00.00,"13,022.52","78,135.14",
16-Mar-21,Transportellaneous,"1,65,547.81",00.00,"2,43,682.95",
16-Mar-21,Transportellaneous,00.00,"34,811.85","2,08,871.10",
16-Mar-21,NEFT,00.00,"2,08,871.10",00.00,
16-Mar-21,Commission,"3,831.57",00.00,"3,831.57",
16-Mar-21,Tax,"24,934.00",00.00,"28,765.57",
16-Mar-21,RTGS,00.00,"7,191.39","21,574.18",
16-Mar-21,Reversal,00.00,"21,574.18",00.00,
16-Mar-21,RTGS,"42,939.00",00.00,"42,939.00",
16-Mar-21,Purchase,00.00,"4,293.90","38,645.10",
16-Mar-21,ATM,06.30,00.00,"38,651.40",
16-Mar-21,RTGS,06.75,00.00,"38,658.15",
16-Mar-21,ATM,27.4,00.00,"38,685.55",
16-Mar-21,Interest,00.00,"4,835.69","33,849.86",
16-Mar-21,RTGS,227.21,00.00,"34,077.07",
16-Mar-21,IMPS,00.00,"34,077.07",00.00,
16-Mar-21,Transportellaneous,"2,858.60",00.00,"2,858.60",
16-Mar-21,Transfer,251,00.00,"3,109.60",
16-Mar-21,Interest,02.00,00.00,"3,111.60",
16-Mar-21,Cheque,00.00,311.16,"2,800.44",
16-Mar-21,NEFT,"8,919.00",00.00,"11,719.44",
16-Mar-21,Transfer,"20,856.60",00.00,"32,576.04",
16-Mar-21,Purchase,00.00,"10,858.68","21,717.36",
16-Mar-21,Reversal,00.00,"10,858.68","10,858.68",
16-Mar-21,Interest,"1,135.00",00.00,"11,993.68",
16-Mar-21,Transportellaneous,03.09,00.00,"11,996.77",
16-Mar-21,Purchase,00.00,"1,199.68","10,797.09",
16-Mar-21,Debit Card,00.00,"5,398.55","5,398.54",
16-Mar-21,Commission,00.00,"2,699.27","2,699.27",
16-Mar-21,Reversal,00.00,"1,349.64","1,349.64",
16-Mar-21,NEFT,00.00,674.82,674.82,
16-Mar-21,Transfer,"15,185.10",00.00,"15,859.92",
17-Mar-21,Cash,02.00,00.00,"15,861.92",
18-Mar-21,Cash,00.00,"1,586.19","14,275.73",
18-Mar-21,Interest,00.80,00.00,"14,276.53",
18-Mar-21,Reversal,"3,84,528.00",00.00,"3,98,804.53",
18-Mar-21,Tax,259,00.00,"3,99,063.53",
18-Mar-21,Transportellaneous,00.00,"1,33,021.18","2,66,042.35",
18-Mar-21,Purchase,"1,34,977.00",00.00,"4,01,019.35",
18-Mar-21,Interest,00.00,"1,33,673.12","2,67,346.23",
18-Mar-21,Cash,07.60,00.00,"2,67,353.83",
18-Mar-21,Cash,56.6,00.00,"2,67,410.43",
18-Mar-21,Commission,00.00,"26,741.04","2,40,669.39",
18-Mar-21,Commission,"2,730.00",00.00,"2,43,399.39",
18-Mar-21,NEFT,"41,544.00",00.00,"2,84,943.39",
18-Mar-21,Reversal,01.20,00.00,"2,84,944.59",
18-Mar-21,Cash,458.2,00.00,"2,85,402.79",
18-Mar-21,Cheque,00.00,"2,85,402.79",00.00,
18-Mar-21,Tax,"16,33,076.75",00.00,"16,33,076.75",
18-Mar-21,Purchase,"19,90,114.50",00.00,"36,23,191.25",
18-Mar-21,RTGS,00.00,"9,05,797.81","27,17,393.44",
18-Mar-21,Tax,07.94,00.00,"27,17,401.38",
18-Mar-21,Cheque,"18,92,551.75",00.00,"46,09,953.13",
19-Mar-21,Interest,"1,01,039.70",00.00,"47,10,992.83",
19-Mar-21,Debit Card,"2,44,258.00",00.00,"49,55,250.83",
20-Mar-21,Cash,"14,08,871.00",00.00,"63,64,121.83",
20-Mar-21,Cash,"9,212.00",00.00,"63,73,333.83",
20-Mar-21,NEFT,00.00,"21,24,444.61","42,48,889.22",
20-Mar-21,Tax,"2,49,346.00",00.00,"44,98,235.22",
20-Mar-21,IMPS,00.00,"11,24,558.81","33,73,676.42",
20-Mar-21,Reversal,"4,072.90",00.00,"33,77,749.32",
20-Mar-21,Reversal,335.97,00.00,"33,78,085.29",
20-Mar-21,IMPS,00.00,"4,82,583.61","28,95,501.68",
20-Mar-21,NEFT,00.00,"14,47,750.84","14,47,750.84",
20-Mar-21,Transfer,00.00,"1,44,775.08","13,02,975.76",
20-Mar-21,Tax,00.00,"4,34,325.25","8,68,650.51",
20-Mar-21,Bill,00.00,"8,68,650.51",00.00,
20-Mar-21,Debit Card,"3,099.00",00.00,"3,099.00",
20-Mar-21,Bill,00.00,774.75,"2,324.25",
20-Mar-21,Reversal,00.00,232.43,"2,091.82",
20-Mar-21,Reversal,471.8,00.00,"2,563.62",
20-Mar-21,Bill,00.00,320.45,"2,243.17",
20-Mar-21,Transfer,22.98,00.00,"2,266.15",
20-Mar-21,Reversal,00.00,453.23,"1,812.92",
20-Mar-21,Interest,59.1,00.00,"1,872.02",
20-Mar-21,Purchase,01.60,00.00,"1,873.62",
20-Mar-21,Purchase,00.00,624.54,"1,249.08",
20-Mar-21,Cash,249,00.00,"1,498.08",
20-Mar-21,Interest,41,00.00,"1,539.08",
20-Mar-21,Purchase,35,00.00,"1,574.08",
20-Mar-21,IMPS,00.00,393.52,"1,180.56",
20-Mar-21,NEFT,351.01,00.00,"1,531.57",
20-Mar-21,Interest,"1,190.60",00.00,"2,722.17",
20-Mar-21,NEFT,06.57,00.00,"2,728.74",
20-Mar-21,NEFT,00.00,"1,364.37","1,364.37",
20-Mar-21,Purchase,06.10,00.00,"1,370.47",
20-Mar-21,IMPS,00.00,685.24,685.24,
20-Mar-21,IMPS,00.00,76.14,609.1,
20-Mar-21,Debit Card,484,00.00,"1,093.10",
20-Mar-21,Bill,00.00,546.55,546.55,
20-Mar-21,Purchase,"2,773.00",00.00,"3,319.55",
20-Mar-21,IMPS,00.00,"3,319.55",00.00,
20-Mar-21,Purchase,36.87,00.00,36.87,
20-Mar-21,Tax,00.00,07.37,29.5,
20-Mar-21,ATM,00.00,03.28,26.22,
20-Mar-21,Bill,91,00.00,117.22,
20-Mar-21,Commission,00.00,19.54,97.68,
20-Mar-21,Tax,"2,99,110.50",00.00,"2,99,208.18",
20-Mar-21,Cash,00.00,"99,736.06","1,99,472.12",
20-Mar-21,Reversal,00.00,"33,245.35","1,66,226.77",
20-Mar-21,NEFT,05.00,00.00,"1,66,231.77",
20-Mar-21,NEFT,00.00,"23,747.40","1,42,484.37",
20-Mar-21,Debit Card,00.00,"20,354.91","1,22,129.46",
20-Mar-21,NEFT,00.00,"30,532.37","91,597.10",
20-Mar-21,Transportellaneous,00.00,"13,085.30","78,511.80",
20-Mar-21,Tax,150,00.00,"78,661.80",
20-Mar-21,Interest,00.00,"19,665.45","58,996.35",
21-Mar-21,Cash,13,00.00,"59,009.35",
21-Mar-21,Commission,32.6,00.00,"59,041.95",
21-Mar-21,Debit Card,00.00,"9,840.33","49,201.62",
21-Mar-21,NEFT,00.00,"9,840.32","39,361.30",
21-Mar-21,RTGS,06.50,00.00,"39,367.80",
21-Mar-21,Purchase,07.00,00.00,"39,374.80",
21-Mar-21,Debit Card,00.00,"7,874.96","31,499.84",
21-Mar-21,NEFT,463.12,00.00,"31,962.96",
21-Mar-21,Interest,14.5,00.00,"31,977.46",
21-Mar-21,Tax,"20,155.90",00.00,"52,133.36",
21-Mar-21,NEFT,32,00.00,"52,165.36",
21-Mar-21,Reversal,04.50,00.00,"52,169.86",
21-Mar-21,Cash,"1,918.00",00.00,"54,087.86",
21-Mar-21,Bill,01.40,00.00,"54,089.26",
21-Mar-21,Bill,367.84,00.00,"54,457.10",
21-Mar-21,Reversal,"29,589.00",00.00,"84,046.10",
21-Mar-21,Commission,86,00.00,"84,132.10",
21-Mar-21,Bill,05.30,00.00,"84,137.40",
21-Mar-21,Transfer,24.21,00.00,"84,161.61",
21-Mar-21,Bill,"10,13,987.25",00.00,"10,98,148.86",
21-Mar-21,Commission,163.99,00.00,"10,98,312.85",
21-Mar-21,Purchase,00.00,"1,56,901.84","9,41,411.01",
21-Mar-21,Transfer,"9,49,950.00",00.00,"18,91,361.01",
21-Mar-21,Commission,"14,348.60",00.00,"19,05,709.61",
21-Mar-21,Interest,02.00,00.00,"19,05,711.61",
21-Mar-21,Purchase,00.00,"2,72,244.52","16,33,467.09",
21-Mar-21,Transportellaneous,07.68,00.00,"16,33,474.77",
21-Mar-21,Debit Card,00.00,"1,63,347.48","14,70,127.29",
21-Mar-21,RTGS,00.00,"2,10,018.18","12,60,109.11",
21-Mar-21,Cheque,00.00,"1,80,015.59","10,80,093.52",
21-Mar-21,Purchase,00.00,"3,60,031.17","7,20,062.35",
21-Mar-21,Purchase,07.17,00.00,"7,20,069.52",
21-Mar-21,ATM,"2,21,025.75",00.00,"9,41,095.27",
21-Mar-21,Reversal,"2,578.77",00.00,"9,43,674.04",
21-Mar-21,Interest,"2,50,429.94",00.00,"11,94,103.98",
21-Mar-21,Interest,"1,927.00",00.00,"11,96,030.98",
21-Mar-21,Bill,00.00,"11,96,030.98",00.00,
21-Mar-21,Cheque,442,00.00,442,
21-Mar-21,Tax,08.00,00.00,450,
21-Mar-21,Interest,00.00,45,405,
21-Mar-21,Interest,00.00,40.5,364.5,
21-Mar-21,Transfer,00.00,182.25,182.25,
21-Mar-21,Purchase,"7,64,806.00",00.00,"7,64,988.25",
21-Mar-21,Purchase,00.00,"76,498.83","6,88,489.42",
21-Mar-21,Cash,00.00,"2,29,496.47","4,58,992.95",
21-Mar-21,Purchase,02.00,00.00,"4,58,994.95",
21-Mar-21,Transfer,06.10,00.00,"4,59,001.05",
21-Mar-21,Cash,00.00,"1,14,750.26","3,44,250.79",
21-Mar-21,RTGS,00.00,"3,44,250.79",00.00,
21-Mar-21,Interest,"8,470.00",00.00,"8,470.00",
21-Mar-21,Tax,"20,595.40",00.00,"29,065.40",
21-Mar-21,NEFT,00.00,"9,688.47","19,376.93",
21-Mar-21,Bill,163.23,00.00,"19,540.16",
21-Mar-21,Cheque,109.22,00.00,"19,649.38",
21-Mar-21,RTGS,00.00,"1,964.94","17,684.44",
21-Mar-21,Bill,27.3,00.00,"17,711.74",
21-Mar-21,Bill,00.00,"2,530.25","15,181.49",
21-Mar-21,Cheque,00.00,"1,518.15","13,663.34",
21-Mar-21,Purchase,00.00,"13,663.34",00.00,
21-Mar-21,Tax,"14,22,753.00",00.00,"14,22,753.00",
21-Mar-21,Transfer,36,00.00,"14,22,789.00",
21-Mar-21,Debit Card,02.39,00.00,"14,22,791.39",
21-Mar-21,NEFT,00.00,"14,22,791.39",00.00,
21-Mar-21,Transportellaneous,"14,553.00",00.00,"14,553.00",
21-Mar-21,Purchase,00.00,"1,617.00","12,936.00",
21-Mar-21,IMPS,00.00,"3,234.00","9,702.00",
21-Mar-21,Cheque,"19,389.10",00.00,"29,091.10",
21-Mar-21,Commission,"56,872.90",00.00,"85,964.00",
21-Mar-21,Tax,00.00,"17,192.80","68,771.20",
21-Mar-21,Tax,173,00.00,"68,944.20",
21-Mar-21,Interest,00.00,"68,944.20",00.00,
21-Mar-21,Transfer,"2,252.16",00.00,"2,252.16",
21-Mar-21,Cheque,00.00,281.52,"1,970.64",
21-Mar-21,Transfer,00.00,328.44,"1,642.20",
21-Mar-21,ATM,06.52,00.00,"1,648.72",
21-Mar-21,Cheque,"4,893.70",00.00,"6,542.42",
21-Mar-21,Cheque,"30,811.00",00.00,"37,353.42",
21-Mar-21,Commission,"1,671.70",00.00,"39,025.12",
21-Mar-21,Tax,00.00,"39,025.12",00.00,
21-Mar-21,Commission,"48,974.03",00.00,"48,974.03",
21-Mar-21,ATM,00.00,"6,121.75","42,852.28",
21-Mar-21,Interest,00.00,"10,713.07","32,139.21",
21-Mar-21,IMPS,02.70,00.00,"32,141.91",
21-Mar-21,Transportellaneous,00.00,"3,214.19","28,927.72",
21-Mar-21,Interest,59,00.00,"28,986.72",
21-Mar-21,Transfer,00.00,"3,220.75","25,765.97",
21-Mar-21,Reversal,"74,350.00",00.00,"1,00,115.97",
21-Mar-21,Purchase,"3,830.20",00.00,"1,03,946.17",
21-Mar-21,Cheque,"1,44,713.00",00.00,"2,48,659.17",
21-Mar-21,Interest,00.00,"41,443.20","2,07,215.98",
21-Mar-21,Reversal,"5,91,241.50",00.00,"7,98,457.48",
21-Mar-21,IMPS,"16,140.90",00.00,"8,14,598.38",
21-Mar-21,RTGS,47,00.00,"8,14,645.38",
22-Mar-21,Commission,00.00,"4,07,322.69","4,07,322.69",
22-Mar-21,Purchase,00.00,"81,464.54","3,25,858.15",
22-Mar-21,Bill,00.00,"40,732.27","2,85,125.88",
22-Mar-21,NEFT,00.00,"2,85,125.88",00.00,
22-Mar-21,Cheque,"2,088.00",00.00,"2,088.00",
22-Mar-21,Commission,00.00,"1,044.00","1,044.00",
22-Mar-21,IMPS,"22,179.00",00.00,"23,223.00",
22-Mar-21,Purchase,"2,45,901.10",00.00,"2,69,124.10",
22-Mar-21,Cheque,00.00,"89,708.03","1,79,416.07",
22-Mar-21,Debit Card,00.00,"35,883.21","1,43,532.86",
22-Mar-21,Commission,00.00,"71,766.43","71,766.43",
22-Mar-21,RTGS,"1,02,838.50",00.00,"1,74,604.93",
22-Mar-21,Cash,"18,497.00",00.00,"1,93,101.93",
22-Mar-21,Transportellaneous,00.00,"38,620.39","1,54,481.54",
22-Mar-21,Debit Card,51,00.00,"1,54,532.54",
22-Mar-21,Debit Card,156,00.00,"1,54,688.54",
22-Mar-21,Cheque,00.00,"51,562.85","1,03,125.69",
22-Mar-21,NEFT,00.00,"34,375.23","68,750.46",
22-Mar-21,Transportellaneous,40,00.00,"68,790.46",
22-Mar-21,Bill,16.6,00.00,"68,807.06",
22-Mar-21,Cash,00.00,"13,761.41","55,045.65",
22-Mar-21,Commission,07.26,00.00,"55,052.91",
22-Mar-21,RTGS,00.00,"13,763.23","41,289.68",
22-Mar-21,Transportellaneous,"3,626.00",00.00,"44,915.68",
22-Mar-21,Debit Card,00.00,"14,971.89","29,943.79",
22-Mar-21,Reversal,"6,37,382.50",00.00,"6,67,326.29",
22-Mar-21,IMPS,"1,87,294.00",00.00,"8,54,620.29",
22-Mar-21,Transfer,00.00,"1,22,088.61","7,32,531.68",
22-Mar-21,Debit Card,62,00.00,"7,32,593.68",
23-Mar-21,Interest,00.00,"1,46,518.74","5,86,074.94",
23-Mar-21,Cheque,10.9,00.00,"5,86,085.84",
23-Mar-21,Commission,62.2,00.00,"5,86,148.04",
23-Mar-21,Reversal,"2,19,775.00",00.00,"8,05,923.04",
23-Mar-21,Debit Card,13,00.00,"8,05,936.04",
23-Mar-21,Cash,00.00,"1,61,187.21","6,44,748.83",
23-Mar-21,Debit Card,00.00,"6,44,748.83",00.00,
23-Mar-21,Commission,"3,152.41",00.00,"3,152.41",
23-Mar-21,Tax,00.00,630.48,"2,521.93",
23-Mar-21,Transfer,96.5,00.00,"2,618.43",
23-Mar-21,Commission,"3,569.00",00.00,"6,187.43",
23-Mar-21,Debit Card,"15,071.10",00.00,"21,258.53",
23-Mar-21,RTGS,"3,250.00",00.00,"24,508.53",
23-Mar-21,Commission,"3,338.11",00.00,"27,846.64",
23-Mar-21,Tax,"12,54,028.00",00.00,"12,81,874.64",
23-Mar-21,Transfer,00.00,"1,42,430.52","11,39,444.12",
23-Mar-21,Bill,00.00,"5,69,722.06","5,69,722.06",
23-Mar-21,Bill,"2,841.00",00.00,"5,72,563.06",
23-Mar-21,IMPS,00.00,"5,72,563.06",00.00,
23-Mar-21,Debit Card,"14,366.00",00.00,"14,366.00",
23-Mar-21,Purchase,"3,84,712.50",00.00,"3,99,078.50",
23-Mar-21,Purchase,00.00,"44,342.06","3,54,736.44",
23-Mar-21,Bill,"11,77,602.00",00.00,"15,32,338.44",
23-Mar-21,Cash,29.5,00.00,"15,32,367.94",
23-Mar-21,Commission,274.98,00.00,"15,32,642.92",
23-Mar-21,RTGS,13,00.00,"15,32,655.92",
23-Mar-21,Transportellaneous,00.00,"1,53,265.59","13,79,390.33",
23-Mar-21,ATM,00.00,"3,44,847.58","10,34,542.75",
23-Mar-21,NEFT,00.00,"1,29,317.84","9,05,224.91",
24-Mar-21,Interest,00.00,"1,50,870.82","7,54,354.09",
24-Mar-21,Debit Card,"2,666.00",00.00,"7,57,020.09",
25-Mar-21,Cheque,22.1,00.00,"7,57,042.19",
25-Mar-21,Commission,"14,161.00",00.00,"7,71,203.19",
25-Mar-21,RTGS,00.00,"1,54,240.64","6,16,962.55",
25-Mar-21,Bill,"20,89,571.00",00.00,"27,06,533.55",
25-Mar-21,Cheque,06.00,00.00,"27,06,539.55",
25-Mar-21,Commission,02.00,00.00,"27,06,541.55",
25-Mar-21,Transportellaneous,00.00,"6,76,635.39","20,29,906.16",
25-Mar-21,Reversal,00.00,"2,53,738.27","17,76,167.89",
25-Mar-21,NEFT,"3,725.00",00.00,"17,79,892.89",
25-Mar-21,RTGS,00.00,"8,89,946.45","8,89,946.44",
25-Mar-21,Purchase,00.00,"1,48,324.41","7,41,622.03",
25-Mar-21,NEFT,00.00,"92,702.75","6,48,919.28",
25-Mar-21,RTGS,00.00,"92,702.75","5,56,216.53",
25-Mar-21,Bill,00.00,"55,621.65","5,00,594.88",
25-Mar-21,Commission,00.00,"50,059.49","4,50,535.39",
25-Mar-21,Cash,"2,70,180.00",00.00,"7,20,715.39",
25-Mar-21,Purchase,00.00,"2,40,238.46","4,80,476.93",
25-Mar-21,Commission,23.6,00.00,"4,80,500.53",
25-Mar-21,Debit Card,00.00,"80,083.42","4,00,417.11",
26-Mar-21,Cash,00.00,"4,00,417.11",00.00,
26-Mar-21,Tax,"2,15,028.00",00.00,"2,15,028.00",
26-Mar-21,NEFT,00.00,"35,838.00","1,79,190.00",
26-Mar-21,NEFT,451.1,00.00,"1,79,641.10",
26-Mar-21,Commission,"3,387.40",00.00,"1,83,028.50",
26-Mar-21,Purchase,00.00,"18,302.85","1,64,725.65",
26-Mar-21,Cheque,00.00,"16,472.57","1,48,253.08",
26-Mar-21,Commission,00.00,"74,126.54","74,126.54",
26-Mar-21,Bill,"18,39,877.00",00.00,"19,14,003.54",
26-Mar-21,Cheque,00.00,"2,39,250.44","16,74,753.10",
26-Mar-21,Commission,00.00,"4,18,688.28","12,56,064.83",
26-Mar-21,Bill,43.4,00.00,"12,56,108.23",
26-Mar-21,ATM,"12,307.20",00.00,"12,68,415.43",
26-Mar-21,IMPS,00.00,"12,68,415.43",00.00,
27-Mar-21,Reversal,"3,596.00",00.00,"3,596.00",
27-Mar-21,IMPS,00.00,"1,798.00","1,798.00",
27-Mar-21,Tax,00.00,299.67,"1,498.33",
27-Mar-21,Debit Card,00.45,00.00,"1,498.78",
27-Mar-21,NEFT,00.00,187.35,"1,311.43",
27-Mar-21,Debit Card,"56,848.53",00.00,"58,159.96",
27-Mar-21,ATM,"2,26,344.80",00.00,"2,84,504.76",
27-Mar-21,NEFT,00.00,"40,643.54","2,43,861.22",
27-Mar-21,Transportellaneous,00.00,"24,386.12","2,19,475.10",
27-Mar-21,Commission,00.00,"54,868.78","1,64,606.33",
27-Mar-21,Interest,"2,642.00",00.00,"1,67,248.33",
27-Mar-21,Transportellaneous,"9,98,388.80",00.00,"11,65,637.13",
27-Mar-21,ATM,"13,31,362.50",00.00,"24,96,999.63",
28-Mar-21,Bill,00.00,"12,48,499.82","12,48,499.82",
28-Mar-21,RTGS,00.00,"1,56,062.48","10,92,437.34",
28-Mar-21,Interest,"1,516.77",00.00,"10,93,954.11",
28-Mar-21,Cash,"3,160.00",00.00,"10,97,114.11",
28-Mar-21,Purchase,00.00,"5,48,557.06","5,48,557.06",
28-Mar-21,ATM,00.00,"54,855.71","4,93,701.35",
28-Mar-21,Purchase,463.9,00.00,"4,94,165.25",
28-Mar-21,ATM,"55,279.00",00.00,"5,49,444.25",
28-Mar-21,Transfer,00.00,"68,680.53","4,80,763.72",
28-Mar-21,Transfer,00.00,"96,152.74","3,84,610.98",
28-Mar-21,Purchase,06.28,00.00,"3,84,617.26",
28-Mar-21,RTGS,00.00,"38,461.73","3,46,155.53",
28-Mar-21,Debit Card,475.23,00.00,"3,46,630.76",
28-Mar-21,Bill,00.00,"69,326.15","2,77,304.61",
28-Mar-21,IMPS,00.00,"92,434.87","1,84,869.74",
28-Mar-21,ATM,"25,715.20",00.00,"2,10,584.94",
28-Mar-21,Purchase,00.00,"1,05,292.47","1,05,292.47",
28-Mar-21,Transfer,35.2,00.00,"1,05,327.67",
28-Mar-21,Tax,00.00,"11,703.07","93,624.60",
28-Mar-21,Tax,"2,337.46",00.00,"95,962.06",
28-Mar-21,Cash,00.00,"10,662.45","85,299.61",
28-Mar-21,Commission,"13,976.30",00.00,"99,275.91",
28-Mar-21,Transportellaneous,00.00,"16,545.99","82,729.92",
28-Mar-21,Cash,00.00,"8,272.99","74,456.93",
28-Mar-21,Bill,"16,88,348.00",00.00,"17,62,804.93",
28-Mar-21,Transportellaneous,"1,68,990.00",00.00,"19,31,794.93",
28-Mar-21,Cash,"2,17,219.00",00.00,"21,49,013.93",
28-Mar-21,Reversal,00.00,"2,68,626.74","18,80,387.19",
28-Mar-21,RTGS,00.00,"3,13,397.87","15,66,989.32",
28-Mar-21,Transportellaneous,00.00,"2,61,164.89","13,05,824.43",
28-Mar-21,ATM,"17,18,796.80",00.00,"30,24,621.23",
28-Mar-21,Debit Card,00.00,"5,04,103.54","25,20,517.69",
28-Mar-21,Reversal,00.00,"8,40,172.56","16,80,345.13",
29-Mar-21,Bill,"5,444.30",00.00,"16,85,789.43",
29-Mar-21,IMPS,00.00,"8,42,894.72","8,42,894.72",
29-Mar-21,Cheque,"31,218.69",00.00,"8,74,113.41",
29-Mar-21,Purchase,00.00,"2,18,528.35","6,55,585.06",
29-Mar-21,IMPS,"14,816.00",00.00,"6,70,401.06",
29-Mar-21,Cash,00.00,"6,70,401.06",00.00,
29-Mar-21,Debit Card,408.74,00.00,408.74,
29-Mar-21,Cash,"9,94,152.20",00.00,"9,94,560.94",
29-Mar-21,Transportellaneous,00.00,"3,31,520.31","6,63,040.63",
29-Mar-21,Debit Card,03.20,00.00,"6,63,043.83",
29-Mar-21,Bill,00.00,"2,21,014.61","4,42,029.22",
29-Mar-21,NEFT,"14,99,659.00",00.00,"19,41,688.22",
29-Mar-21,Tax,00.00,"6,47,229.41","12,94,458.81",
29-Mar-21,Commission,00.00,"1,84,922.69","11,09,536.12",
29-Mar-21,NEFT,00.00,"1,10,953.61","9,98,582.51",
29-Mar-21,IMPS,"11,26,222.20",00.00,"21,24,804.71",
29-Mar-21,Debit Card,00.00,"2,12,480.47","19,12,324.24",
29-Mar-21,Commission,43.04,00.00,"19,12,367.28",
29-Mar-21,Transportellaneous,"1,067.13",00.00,"19,13,434.41",
29-Mar-21,Purchase,33.74,00.00,"19,13,468.15",
29-Mar-21,Tax,21,00.00,"19,13,489.15",
29-Mar-21,Cheque,00.00,"9,56,744.58","9,56,744.58",
29-Mar-21,Commission,"2,308.49",00.00,"9,59,053.07",
29-Mar-21,Debit Card,436,00.00,"9,59,489.07",
29-Mar-21,Commission,"6,075.80",00.00,"9,65,564.87",
29-Mar-21,Bill,00.00,"4,82,782.44","4,82,782.44",
29-Mar-21,Transportellaneous,"5,99,896.00",00.00,"10,82,678.44",
29-Mar-21,NEFT,385.4,00.00,"10,83,063.84",
29-Mar-21,Bill,00.00,"5,41,531.92","5,41,531.92",
29-Mar-21,Cheque,24.8,00.00,"5,41,556.72",
29-Mar-21,Transfer,00.00,"90,259.45","4,51,297.27",
29-Mar-21,Cash,27.41,00.00,"4,51,324.68",
29-Mar-21,Purchase,00.00,"2,25,662.34","2,25,662.34",
29-Mar-21,Debit Card,00.00,"1,12,831.17","1,12,831.17",
29-Mar-21,Bill,00.00,"12,536.80","1,00,294.37",
29-Mar-21,Reversal,334.56,00.00,"1,00,628.93",
29-Mar-21,Tax,00.00,"20,125.79","80,503.14",
29-Mar-21,Transfer,00.00,"16,100.63","64,402.51",
29-Mar-21,Tax,00.81,00.00,"64,403.32",
30-Mar-21,NEFT,00.00,"64,403.32",00.00,
30-Mar-21,IMPS,"1,250.00",00.00,"1,250.00",
30-Mar-21,Cheque,00.00,208.33,"1,041.67",
30-Mar-21,NEFT,00.00,148.81,892.86,
30-Mar-21,Transportellaneous,00.00,111.61,781.25,
30-Mar-21,Purchase,00.00,260.42,520.83,
30-Mar-21,ATM,00.00,74.4,446.43,
30-Mar-21,Interest,"9,54,750.50",00.00,"9,55,196.93",
30-Mar-21,Commission,"2,40,892.78",00.00,"11,96,089.71",
30-Mar-21,Purchase,00.00,"3,98,696.57","7,97,393.14",
30-Mar-21,RTGS,00.00,"3,98,696.57","3,98,696.57",
31-Mar-21,Cash,00.00,"56,956.65","3,41,739.92",
31-Mar-21,IMPS,00.00,"42,717.49","2,99,022.43",
31-Mar-21,Debit Card,00.00,"2,99,022.43",00.00,
31-Mar-21,IMPS,"2,063.50",00.00,"2,063.50",
31-Mar-21,NEFT,"5,36,916.50",00.00,"5,38,980.00",
31-Mar-21,RTGS,"3,457.00",00.00,"5,42,437.00",
31-Mar-21,RTGS,"19,46,062.00",00.00,"24,88,499.00",
31-Mar-21,Purchase,17.1,00.00,"24,88,516.10",
31-Mar-21,Transportellaneous,110,00.00,"24,88,626.10",
31-Mar-21,Transfer,396,00.00,"24,89,022.10",
31-Mar-21,RTGS,01.48,00.00,"24,89,023.58",
31-Mar-21,NEFT,00.00,"2,48,902.36","22,40,121.22",
31-Mar-21,Tax,00.00,"5,60,030.31","16,80,090.92",
01-Apr-21,Transfer,02.00,00.00,"16,80,092.92",
01-Apr-21,Transfer,04.00,00.00,"16,80,096.92",
01-Apr-21,Reversal,"74,074.00",00.00,"17,54,170.92",
01-Apr-21,Interest,"1,78,377.00",00.00,"19,32,547.92",
01-Apr-21,IMPS,00.00,"1,93,254.79","17,39,293.13",
01-Apr-21,Reversal,"2,210.00",00.00,"17,41,503.13",
01-Apr-21,Debit Card,"31,424.04",00.00,"17,72,927.17",
01-Apr-21,Interest,"28,530.00",00.00,"18,01,457.17",
01-Apr-21,NEFT,696.3,00.00,"18,02,153.47",
01-Apr-21,Cheque,03.00,00.00,"18,02,156.47",
01-Apr-21,Debit Card,"3,733.00",00.00,"18,05,889.47",
01-Apr-21,NEFT,00.00,"2,00,654.39","16,05,235.08",
01-Apr-21,Transportellaneous,07.50,00.00,"16,05,242.58",
02-Apr-21,Cheque,00.00,"8,02,621.29","8,02,621.29",
03-Apr-21,IMPS,00.00,"80,262.13","7,22,359.16",
03-Apr-21,NEFT,596,00.00,"7,22,955.16",
03-Apr-21,Bill,00.00,"7,22,955.16",00.00,
03-Apr-21,Commission,"72,454.00",00.00,"72,454.00",
03-Apr-21,Cash,00.00,"36,227.00","36,227.00",
04-Apr-21,Transportellaneous,00.00,"5,175.29","31,051.71",
04-Apr-21,Bill,00.00,"7,762.93","23,288.78",
04-Apr-21,Commission,02.20,00.00,"23,290.98",
04-Apr-21,Purchase,25,00.00,"23,315.98",
04-Apr-21,Purchase,"16,55,212.00",00.00,"16,78,527.98",
04-Apr-21,Cash,00.00,"4,19,632.00","12,58,895.98",
04-Apr-21,Commission,00.00,"12,58,895.98",00.00,
04-Apr-21,Transportellaneous,"1,853.50",00.00,"1,853.50",
04-Apr-21,Bill,00.00,463.38,"1,390.12",
04-Apr-21,IMPS,00.00,347.53,"1,042.59",
04-Apr-21,NEFT,00.00,208.52,834.07,
04-Apr-21,Purchase,00.00,417.04,417.04,
04-Apr-21,Reversal,00.00,59.58,357.46,
04-Apr-21,NEFT,"2,235.90",00.00,"2,593.36",
04-Apr-21,Commission,"2,38,835.50",00.00,"2,41,428.86",
04-Apr-21,NEFT,113.4,00.00,"2,41,542.26",
04-Apr-21,NEFT,"8,26,782.00",00.00,"10,68,324.26",
04-Apr-21,Bill,04.00,00.00,"10,68,328.26",
04-Apr-21,Commission,00.00,"1,78,054.71","8,90,273.55",
04-Apr-21,Bill,"12,992.40",00.00,"9,03,265.95",
04-Apr-21,Transfer,"28,035.38",00.00,"9,31,301.33",
04-Apr-21,NEFT,41.1,00.00,"9,31,342.43",
04-Apr-21,Interest,00.00,"3,10,447.48","6,20,894.95",
04-Apr-21,Cheque,18.99,00.00,"6,20,913.94",
04-Apr-21,NEFT,00.00,"1,03,485.66","5,17,428.28",
04-Apr-21,Transportellaneous,00.00,"5,17,428.28",00.00,
05-Apr-21,Transportellaneous,304.89,00.00,304.89,
05-Apr-21,Transportellaneous,02.64,00.00,307.53,
05-Apr-21,Commission,00.00,38.44,269.09,
05-Apr-21,Purchase,00.00,33.64,235.45,
05-Apr-21,Commission,00.00,29.43,206.02,
05-Apr-21,RTGS,00.00,68.67,137.35,
05-Apr-21,Debit Card,00.00,15.26,122.09,
05-Apr-21,Cheque,00.00,61.05,61.04,
06-Apr-21,Purchase,00.00,06.78,54.26,
06-Apr-21,IMPS,"2,319.60",00.00,"2,373.86",
06-Apr-21,Cash,00.00,237.39,"2,136.47",
06-Apr-21,Bill,00.00,712.16,"1,424.31",
06-Apr-21,Purchase,00.00,356.08,"1,068.23",
06-Apr-21,Bill,"7,393.90",00.00,"8,462.13",
06-Apr-21,Tax,"12,285.49",00.00,"20,747.62",
06-Apr-21,Debit Card,00.00,"6,915.87","13,831.75",
06-Apr-21,Commission,"16,47,401.00",00.00,"16,61,232.75",
06-Apr-21,Tax,00.00,"1,66,123.28","14,95,109.48",
06-Apr-21,IMPS,958.18,00.00,"14,96,067.66",
06-Apr-21,Cheque,48.7,00.00,"14,96,116.36",
06-Apr-21,Tax,"3,00,148.00",00.00,"17,96,264.36",
06-Apr-21,Cheque,372.56,00.00,"17,96,636.92",
06-Apr-21,Reversal,00.00,"2,24,579.62","15,72,057.30",
06-Apr-21,Purchase,00.00,"2,24,579.61","13,47,477.69",
06-Apr-21,Cheque,"79,339.88",00.00,"14,26,817.57",
06-Apr-21,Transfer,00.00,"2,85,363.51","11,41,454.06",
06-Apr-21,ATM,51.6,00.00,"11,41,505.66",
06-Apr-21,Transportellaneous,101.4,00.00,"11,41,607.06",
06-Apr-21,Debit Card,00.00,"1,63,086.72","9,78,520.34",
06-Apr-21,Tax,"1,790.01",00.00,"9,80,310.35",
06-Apr-21,Cheque,00.00,"1,40,044.34","8,40,266.01",
06-Apr-21,Tax,00.00,"93,362.89","7,46,903.12",
07-Apr-21,Reversal,03.30,00.00,"7,46,906.42",
08-Apr-21,Commission,00.00,"1,24,484.40","6,22,422.02",
08-Apr-21,Reversal,"32,306.10",00.00,"6,54,728.12",
08-Apr-21,Cash,"1,80,278.00",00.00,"8,35,006.12",
08-Apr-21,ATM,00.00,"1,67,001.22","6,68,004.90",
08-Apr-21,NEFT,"79,409.00",00.00,"7,47,413.90",
08-Apr-21,Commission,"4,057.82",00.00,"7,51,471.72",
08-Apr-21,Purchase,"23,318.30",00.00,"7,74,790.02",
08-Apr-21,Cheque,"1,03,785.00",00.00,"8,78,575.02",
08-Apr-21,Bill,49.7,00.00,"8,78,624.72",
08-Apr-21,Bill,193.6,00.00,"8,78,818.32",
09-Apr-21,Transportellaneous,00.00,"1,25,545.47","7,53,272.85",
09-Apr-21,Cash,00.00,"1,50,654.57","6,02,618.28",
09-Apr-21,NEFT,04.20,00.00,"6,02,622.48",
09-Apr-21,Reversal,"2,24,440.00",00.00,"8,27,062.48",
09-Apr-21,Debit Card,00.00,"4,13,531.24","4,13,531.24",
09-Apr-21,Commission,00.00,"45,947.92","3,67,583.32",
09-Apr-21,IMPS,00.00,"40,842.59","3,26,740.73",
09-Apr-21,Commission,07.00,00.00,"3,26,747.73",
09-Apr-21,Debit Card,00.00,"46,678.25","2,80,069.48",
09-Apr-21,IMPS,00.00,"28,006.95","2,52,062.53",
09-Apr-21,Cheque,"18,064.40",00.00,"2,70,126.93",
09-Apr-21,IMPS,224.27,00.00,"2,70,351.20",
09-Apr-21,Interest,"1,807.68",00.00,"2,72,158.88",
09-Apr-21,RTGS,224,00.00,"2,72,382.88",
09-Apr-21,ATM,"10,315.00",00.00,"2,82,697.88",
09-Apr-21,Cheque,"1,23,953.00",00.00,"4,06,650.88",
09-Apr-21,Cheque,00.00,"67,775.15","3,38,875.73",
09-Apr-21,Cheque,00.00,"1,12,958.58","2,25,917.15",
09-Apr-21,Purchase,00.00,"2,25,917.15",00.00,
09-Apr-21,RTGS,"14,97,699.50",00.00,"14,97,699.50",
09-Apr-21,Transfer,"2,34,499.00",00.00,"17,32,198.50",
09-Apr-21,Bill,21,00.00,"17,32,219.50",
09-Apr-21,Purchase,00.00,"3,46,443.90","13,85,775.60",
09-Apr-21,Cash,00.00,"1,97,967.94","11,87,807.66",
09-Apr-21,Reversal,42,00.00,"11,87,849.66",
09-Apr-21,Commission,00.40,00.00,"11,87,850.06",
09-Apr-21,Tax,00.00,"11,87,850.06",00.00,
09-Apr-21,Interest,"2,40,095.20",00.00,"2,40,095.20",
09-Apr-21,Interest,470.2,00.00,"2,40,565.40",
09-Apr-21,Debit Card,00.00,"30,070.68","2,10,494.72",
09-Apr-21,Transportellaneous,"16,21,846.75",00.00,"18,32,341.47",
09-Apr-21,Reversal,07.47,00.00,"18,32,348.94",
09-Apr-21,Transfer,00.00,"6,10,782.98","12,21,565.96",
09-Apr-21,Cheque,00.00,"4,07,188.65","8,14,377.31",
09-Apr-21,Tax,360.17,00.00,"8,14,737.48",
09-Apr-21,Cheque,"8,968.20",00.00,"8,23,705.68",
09-Apr-21,Transfer,00.00,"91,522.85","7,32,182.83",
09-Apr-21,Cheque,"1,277.42",00.00,"7,33,460.25",
09-Apr-21,Cash,"2,16,787.60",00.00,"9,50,247.85",
09-Apr-21,Transfer,"4,65,162.50",00.00,"14,15,410.35",
09-Apr-21,ATM,"18,36,434.20",00.00,"32,51,844.55",
09-Apr-21,Purchase,00.00,"32,51,844.55",00.00,
09-Apr-21,Transfer,"1,15,942.00",00.00,"1,15,942.00",
09-Apr-21,Cash,00.00,"38,647.33","77,294.67",
09-Apr-21,Cheque,"61,982.66",00.00,"1,39,277.33",
09-Apr-21,Commission,"3,037.53",00.00,"1,42,314.86",
09-Apr-21,Transportellaneous,"22,145.54",00.00,"1,64,460.40",
09-Apr-21,Cash,00.00,"23,494.34","1,40,966.06",
09-Apr-21,Cash,285.7,00.00,"1,41,251.76",
09-Apr-21,NEFT,00.00,"15,694.64","1,25,557.12",
09-Apr-21,Bill,00.00,"12,555.71","1,13,001.41",
10-Apr-21,Cheque,00.00,"16,143.06","96,858.35",
10-Apr-21,Bill,00.00,"16,143.06","80,715.29",
10-Apr-21,Transfer,00.00,"40,357.65","40,357.64",
10-Apr-21,Transfer,00.00,"5,765.38","34,592.26",
10-Apr-21,Transfer,00.00,"6,918.45","27,673.81",
10-Apr-21,Interest,00.00,"6,918.45","20,755.36",
10-Apr-21,Cash,00.00,"5,188.84","15,566.52",
10-Apr-21,IMPS,00.00,"5,188.84","10,377.68",
10-Apr-21,Tax,"1,385.00",00.00,"11,762.68",
10-Apr-21,Cash,00.00,"2,352.54","9,410.14",
10-Apr-21,Cash,"22,651.90",00.00,"32,062.04",
11-Apr-21,ATM,"1,254.00",00.00,"33,316.04",
11-Apr-21,Transfer,"10,828.00",00.00,"44,144.04",
11-Apr-21,Interest,"3,058.63",00.00,"47,202.67",
11-Apr-21,Cash,04.00,00.00,"47,206.67",
11-Apr-21,Purchase,00.00,"7,867.78","39,338.89",
11-Apr-21,Reversal,00.00,"5,619.84","33,719.05",
11-Apr-21,Purchase,09.70,00.00,"33,728.75",
12-Apr-21,NEFT,00.00,"33,728.75",00.00,
12-Apr-21,RTGS,248.79,00.00,248.79,
12-Apr-21,Interest,01.10,00.00,249.89,
12-Apr-21,Transfer,17.7,00.00,267.59,
12-Apr-21,Debit Card,00.00,89.2,178.39,
12-Apr-21,Tax,00.00,89.2,89.2,
12-Apr-21,Reversal,497,00.00,586.2,
12-Apr-21,NEFT,49,00.00,635.2,
12-Apr-21,Commission,00.00,63.52,571.68,
12-Apr-21,Transportellaneous,"5,40,794.80",00.00,"5,41,366.48",
12-Apr-21,Transportellaneous,00.00,"54,136.65","4,87,229.83",
12-Apr-21,Bill,00.00,"54,136.65","4,33,093.18",
13-Apr-21,Cash,154,00.00,"4,33,247.18",
13-Apr-21,RTGS,07.00,00.00,"4,33,254.18",
13-Apr-21,Commission,53.32,00.00,"4,33,307.50",
13-Apr-21,NEFT,"3,514.00",00.00,"4,36,821.50",
13-Apr-21,Tax,03.90,00.00,"4,36,825.40",
13-Apr-21,Transportellaneous,"2,48,024.10",00.00,"6,84,849.50",
13-Apr-21,Purchase,00.00,"3,42,424.75","3,42,424.75",
13-Apr-21,Interest,00.00,"48,917.82","2,93,506.93",
13-Apr-21,Bill,00.00,"1,46,753.47","1,46,753.46",
13-Apr-21,Cheque,343,00.00,"1,47,096.46",
13-Apr-21,NEFT,00.00,"1,47,096.46",00.00,
13-Apr-21,NEFT,"3,66,169.20",00.00,"3,66,169.20",
13-Apr-21,Commission,"18,97,683.00",00.00,"22,63,852.20",
13-Apr-21,Debit Card,00.00,"11,31,926.10","11,31,926.10",
13-Apr-21,Tax,"1,302.00",00.00,"11,33,228.10",
13-Apr-21,Interest,00.00,"1,13,322.81","10,19,905.29",
13-Apr-21,Debit Card,"2,03,099.80",00.00,"12,23,005.09",
13-Apr-21,Bill,00.00,"1,52,875.64","10,70,129.45",
13-Apr-21,Debit Card,466,00.00,"10,70,595.45",
13-Apr-21,RTGS,"3,002.00",00.00,"10,73,597.45",
13-Apr-21,Debit Card,00.00,"1,34,199.68","9,39,397.77",
13-Apr-21,RTGS,00.00,"1,34,199.68","8,05,198.09",
13-Apr-21,Interest,"6,77,306.50",00.00,"14,82,504.59",
13-Apr-21,IMPS,00.00,"2,47,084.10","12,35,420.49",
13-Apr-21,Tax,00.00,"3,08,855.12","9,26,565.37",
13-Apr-21,Tax,00.00,"1,85,313.07","7,41,252.30",
13-Apr-21,Cash,00.00,"2,47,084.10","4,94,168.20",
13-Apr-21,Cheque,00.00,"61,771.03","4,32,397.18",
13-Apr-21,ATM,00.00,"48,044.13","3,84,353.05",
13-Apr-21,Transportellaneous,"1,31,346.34",00.00,"5,15,699.39",
13-Apr-21,RTGS,00.00,"1,71,899.80","3,43,799.59",
13-Apr-21,Purchase,00.00,"1,14,599.86","2,29,199.73",
13-Apr-21,IMPS,"7,213.00",00.00,"2,36,412.73",
13-Apr-21,Transfer,00.00,"39,402.12","1,97,010.61",
13-Apr-21,NEFT,00.00,"21,890.07","1,75,120.54",
13-Apr-21,Tax,00.00,"19,457.84","1,55,662.70",
13-Apr-21,RTGS,920.73,00.00,"1,56,583.43",
13-Apr-21,Cheque,00.00,"1,56,583.43",00.00,
13-Apr-21,Tax,32,00.00,32,
13-Apr-21,Purchase,"5,456.22",00.00,"5,488.22",
13-Apr-21,NEFT,08.50,00.00,"5,496.72",
13-Apr-21,Bill,00.00,"5,496.72",00.00,
13-Apr-21,Cash,"2,761.00",00.00,"2,761.00",
13-Apr-21,Debit Card,"2,966.00",00.00,"5,727.00",
13-Apr-21,Transportellaneous,83.17,00.00,"5,810.17",
13-Apr-21,RTGS,07.84,00.00,"5,818.01",
13-Apr-21,Tax,"21,166.95",00.00,"26,984.96",
13-Apr-21,Commission,00.00,"3,373.12","23,611.84",
13-Apr-21,Transportellaneous,07.85,00.00,"23,619.69",
13-Apr-21,Interest,00.00,"23,619.69",00.00,
13-Apr-21,Bill,07.00,00.00,07.00,
13-Apr-21,Purchase,187.2,00.00,194.2,
13-Apr-21,Purchase,00.00,64.73,129.47,
13-Apr-21,Transportellaneous,00.00,12.95,116.52,
13-Apr-21,Interest,00.00,19.42,97.1,
13-Apr-21,Transportellaneous,00.00,16.18,80.92,
13-Apr-21,Debit Card,00.00,08.09,72.83,
13-Apr-21,Reversal,00.00,72.83,00.00,
13-Apr-21,Commission,"20,77,101.50",00.00,"20,77,101.50",
13-Apr-21,ATM,00.00,"20,77,101.50",00.00,
13-Apr-21,Interest,01.00,00.00,01.00,
13-Apr-21,Interest,00.00,00.50,00.50,
13-Apr-21,Tax,00.00,00.17,00.33,
13-Apr-21,Transportellaneous,"1,927.38",00.00,"1,927.71",
13-Apr-21,Interest,00.00,385.54,"1,542.17",
13-Apr-21,Reversal,00.00,192.77,"1,349.40",
13-Apr-21,IMPS,00.00,168.68,"1,180.73",
13-Apr-21,Tax,159,00.00,"1,339.73",
13-Apr-21,Debit Card,00.00,"1,339.73",00.00,
13-Apr-21,ATM,"3,465.50",00.00,"3,465.50",
13-Apr-21,NEFT,"70,792.00",00.00,"74,257.50",
13-Apr-21,Cheque,00.00,"9,282.19","64,975.31",
13-Apr-21,Cheque,00.00,"64,975.31",00.00,
13-Apr-21,Tax,"1,460.00",00.00,"1,460.00",
13-Apr-21,Commission,44.77,00.00,"1,504.77",
13-Apr-21,Interest,"3,637.00",00.00,"5,141.77",
13-Apr-21,Purchase,109.5,00.00,"5,251.27",
13-Apr-21,Transportellaneous,00.00,750.18,"4,501.09",
13-Apr-21,Interest,00.00,"4,501.09",00.00,
13-Apr-21,Tax,"1,64,513.50",00.00,"1,64,513.50",
13-Apr-21,Bill,00.00,"18,279.28","1,46,234.22",
13-Apr-21,Purchase,111,00.00,"1,46,345.22",
13-Apr-21,Transportellaneous,"5,99,920.00",00.00,"7,46,265.22",
13-Apr-21,Purchase,"2,09,765.91",00.00,"9,56,031.13",
13-Apr-21,Debit Card,00.00,"4,78,015.57","4,78,015.56",
13-Apr-21,Commission,19,00.00,"4,78,034.56",
13-Apr-21,Purchase,00.00,"79,672.43","3,98,362.13",
13-Apr-21,Purchase,"3,492.00",00.00,"4,01,854.13",
13-Apr-21,Cheque,00.00,"44,650.46","3,57,203.67",
13-Apr-21,Transfer,00.00,"51,029.10","3,06,174.57",
13-Apr-21,Commission,"26,500.00",00.00,"3,32,674.57",
14-Apr-21,Cash,158.46,00.00,"3,32,833.03",
14-Apr-21,ATM,41.39,00.00,"3,32,874.42",
14-Apr-21,Cheque,00.00,"33,287.44","2,99,586.98",
14-Apr-21,NEFT,50.74,00.00,"2,99,637.72",
14-Apr-21,Purchase,02.00,00.00,"2,99,639.72",
14-Apr-21,Cash,00.00,"49,939.95","2,49,699.77",
14-Apr-21,Reversal,537,00.00,"2,50,236.77",
14-Apr-21,Tax,00.00,"62,559.19","1,87,677.58",
14-Apr-21,Reversal,00.00,"18,767.76","1,68,909.82",
14-Apr-21,IMPS,00.00,"21,113.73","1,47,796.09",
14-Apr-21,Transfer,00.00,"14,779.61","1,33,016.48",
14-Apr-21,Transportellaneous,00.00,"66,508.24","66,508.24",
14-Apr-21,Transportellaneous,00.00,00.00,"66,508.24",
15-Apr-21,Reversal,05.50,00.00,"66,513.74",
15-Apr-21,Cheque,04.00,00.00,"66,517.74",
15-Apr-21,Debit Card,00.00,"6,651.77","59,865.97",
15-Apr-21,Commission,00.00,"11,973.19","47,892.78",
15-Apr-21,RTGS,"16,97,371.00",00.00,"17,45,263.78",
15-Apr-21,NEFT,"16,74,191.00",00.00,"34,19,454.78",
15-Apr-21,Tax,"10,642.00",00.00,"34,30,096.78",
15-Apr-21,Debit Card,32.25,00.00,"34,30,129.03",
15-Apr-21,Transportellaneous,00.50,00.00,"34,30,129.53",
15-Apr-21,Reversal,03.00,00.00,"34,30,132.53",
15-Apr-21,Transportellaneous,"28,691.00",00.00,"34,58,823.53",
15-Apr-21,NEFT,00.00,"4,32,352.94","30,26,470.59",
15-Apr-21,Tax,02.42,00.00,"30,26,473.01",
15-Apr-21,Commission,00.00,"7,56,618.25","22,69,854.76",
15-Apr-21,Commission,"16,280.31",00.00,"22,86,135.07",
15-Apr-21,Reversal,00.00,"5,71,533.77","17,14,601.30",
15-Apr-21,IMPS,"18,30,492.00",00.00,"35,45,093.30",
15-Apr-21,Reversal,00.00,"17,72,546.65","17,72,546.65",
15-Apr-21,Debit Card,"1,30,827.69",00.00,"19,03,374.34",
15-Apr-21,Purchase,"1,232.50",00.00,"19,04,606.84",
15-Apr-21,NEFT,00.00,"19,04,606.84",00.00,
15-Apr-21,Tax,357.1,00.00,357.1,
16-Apr-21,Debit Card,04.00,00.00,361.1,
16-Apr-21,Cheque,00.00,72.22,288.88,
16-Apr-21,Cheque,00.00,48.15,240.73,
16-Apr-21,Interest,"18,206.71",00.00,"18,447.44",
16-Apr-21,Transfer,00.00,"3,074.57","15,372.87",
16-Apr-21,ATM,30.1,00.00,"15,402.97",
16-Apr-21,Transportellaneous,"2,611.95",00.00,"18,014.92",
16-Apr-21,NEFT,"4,604.51",00.00,"22,619.43",
16-Apr-21,Purchase,228,00.00,"22,847.43",
16-Apr-21,Transportellaneous,06.93,00.00,"22,854.36",
16-Apr-21,IMPS,"3,132.00",00.00,"25,986.36",
16-Apr-21,RTGS,00.00,"12,993.18","12,993.18",
16-Apr-21,ATM,00.00,"6,496.59","6,496.59",
16-Apr-21,Cheque,"15,255.16",00.00,"21,751.75",
16-Apr-21,RTGS,"1,83,174.38",00.00,"2,04,926.13",
16-Apr-21,NEFT,00.00,"68,308.71","1,36,617.42",
16-Apr-21,Debit Card,00.00,"68,308.71","68,308.71",
16-Apr-21,Reversal,05.64,00.00,"68,314.35",
16-Apr-21,Bill,03.40,00.00,"68,317.75",
16-Apr-21,RTGS,00.00,"22,772.58","45,545.17",
16-Apr-21,IMPS,00.00,"11,386.29","34,158.88",
16-Apr-21,IMPS,00.00,"34,158.88",00.00,
16-Apr-21,Transportellaneous,03.60,00.00,03.60,
16-Apr-21,Purchase,"18,56,300.80",00.00,"18,56,304.40",
16-Apr-21,IMPS,00.00,"2,06,256.04","16,50,048.36",
16-Apr-21,Tax,00.00,"2,06,256.05","14,43,792.32",
16-Apr-21,Tax,05.65,00.00,"14,43,797.97",
16-Apr-21,Cheque,"6,663.00",00.00,"14,50,460.97",
16-Apr-21,Bill,00.00,"1,61,162.33","12,89,298.64",
16-Apr-21,ATM,"25,610.10",00.00,"13,14,908.74",
16-Apr-21,Commission,00.00,"6,57,454.37","6,57,454.37",
16-Apr-21,NEFT,348.47,00.00,"6,57,802.84",
16-Apr-21,Transportellaneous,93,00.00,"6,57,895.84",
16-Apr-21,NEFT,00.00,"93,985.12","5,63,910.72",
16-Apr-21,RTGS,01.43,00.00,"5,63,912.15",
16-Apr-21,ATM,00.00,"70,489.02","4,93,423.13",
16-Apr-21,ATM,00.00,"2,46,711.57","2,46,711.56",
16-Apr-21,NEFT,00.00,"35,244.51","2,11,467.05",
16-Apr-21,Bill,00.00,"26,433.38","1,85,033.67",
16-Apr-21,Interest,"3,89,432.80",00.00,"5,74,466.47",
16-Apr-21,Interest,246,00.00,"5,74,712.47",
16-Apr-21,Commission,00.00,"57,471.25","5,17,241.22",
16-Apr-21,NEFT,00.00,"5,17,241.22",00.00,
17-Apr-21,Interest,"2,09,225.47",00.00,"2,09,225.47",
17-Apr-21,Interest,00.00,"52,306.37","1,56,919.10",
17-Apr-21,IMPS,"18,505.00",00.00,"1,75,424.10",
17-Apr-21,ATM,00.00,"25,060.59","1,50,363.51",
17-Apr-21,Tax,00.00,"18,795.44","1,31,568.07",
17-Apr-21,Transportellaneous,00.00,"32,892.02","98,676.05",
17-Apr-21,Interest,08.40,00.00,"98,684.45",
17-Apr-21,RTGS,"1,79,234.75",00.00,"2,77,919.20",
17-Apr-21,Transfer,37.9,00.00,"2,77,957.10",
17-Apr-21,Transportellaneous,04.90,00.00,"2,77,962.00",
17-Apr-21,Purchase,00.00,"55,592.40","2,22,369.60",
17-Apr-21,Tax,"10,471.00",00.00,"2,32,840.60",
17-Apr-21,Transportellaneous,"13,33,573.00",00.00,"15,66,413.60",
17-Apr-21,Transportellaneous,"22,821.80",00.00,"15,89,235.40",
17-Apr-21,Commission,"3,022.86",00.00,"15,92,258.26",
17-Apr-21,Commission,472,00.00,"15,92,730.26",
17-Apr-21,Purchase,"1,48,378.97",00.00,"17,41,109.23",
17-Apr-21,Transportellaneous,00.00,"3,48,221.85","13,92,887.38",
18-Apr-21,ATM,32.1,00.00,"13,92,919.48",
18-Apr-21,RTGS,00.00,"2,32,153.25","11,60,766.23",
18-Apr-21,Bill,"2,31,713.00",00.00,"13,92,479.23",
18-Apr-21,Cash,"18,833.00",00.00,"14,11,312.23",
18-Apr-21,Transportellaneous,00.00,"2,01,616.03","12,09,696.20",
18-Apr-21,Cash,00.00,"1,51,212.03","10,58,484.18",
18-Apr-21,Transfer,00.00,"2,11,696.84","8,46,787.34",
18-Apr-21,Transportellaneous,00.00,"1,05,848.42","7,40,938.92",
18-Apr-21,Reversal,03.00,00.00,"7,40,941.92",
18-Apr-21,Cheque,00.00,"1,23,490.32","6,17,451.60",
18-Apr-21,Debit Card,424.71,00.00,"6,17,876.31",
18-Apr-21,IMPS,"11,702.48",00.00,"6,29,578.79",
18-Apr-21,IMPS,"3,324.10",00.00,"6,32,902.89",
18-Apr-21,IMPS,"70,703.00",00.00,"7,03,605.89",
18-Apr-21,Purchase,51.6,00.00,"7,03,657.49",
18-Apr-21,RTGS,00.00,"2,34,552.50","4,69,104.99",
18-Apr-21,IMPS,05.48,00.00,"4,69,110.47",
18-Apr-21,RTGS,03.00,00.00,"4,69,113.47",
18-Apr-21,ATM,00.00,"4,69,113.47",00.00,
18-Apr-21,Commission,05.19,00.00,05.19,
18-Apr-21,Cash,24.4,00.00,29.59,
18-Apr-21,Debit Card,00.00,04.93,24.66,
18-Apr-21,IMPS,00.00,02.74,21.92,
18-Apr-21,RTGS,00.00,07.31,14.61,
18-Apr-21,Interest,"11,65,711.20",00.00,"11,65,725.81",
19-Apr-21,Tax,345.6,00.00,"11,66,071.41",
19-Apr-21,Bill,00.00,"2,91,517.85","8,74,553.56",
19-Apr-21,NEFT,00.00,"2,18,638.39","6,55,915.17",
19-Apr-21,Transportellaneous,00.00,"3,27,957.59","3,27,957.59",
19-Apr-21,Purchase,00.00,"36,439.73","2,91,517.86",
19-Apr-21,Reversal,00.00,"29,151.79","2,62,366.07",
19-Apr-21,Commission,00.00,"65,591.52","1,96,774.55",
19-Apr-21,IMPS,13.5,00.00,"1,96,788.05",
19-Apr-21,Transfer,00.00,"65,596.02","1,31,192.03",
19-Apr-21,RTGS,00.00,"14,576.89","1,16,615.14",
19-Apr-21,IMPS,"1,13,684.10",00.00,"2,30,299.24",
19-Apr-21,Interest,00.00,"57,574.81","1,72,724.43",
19-Apr-21,Purchase,00.00,"34,544.89","1,38,179.54",
19-Apr-21,Transportellaneous,"1,467.48",00.00,"1,39,647.02",
19-Apr-21,Transportellaneous,00.00,"1,39,647.02",00.00,
19-Apr-21,Interest,01.30,00.00,01.30,
20-Apr-21,ATM,"4,674.10",00.00,"4,675.40",
21-Apr-21,NEFT,00.00,519.49,"4,155.91",
22-Apr-21,Cheque,00.00,"1,038.98","3,116.93",
22-Apr-21,ATM,00.00,311.69,"2,805.24",
22-Apr-21,IMPS,00.00,"1,402.62","1,402.62",
22-Apr-21,Bill,00.00,155.85,"1,246.77",
22-Apr-21,NEFT,00.00,178.11,"1,068.66",
22-Apr-21,Commission,"5,590.02",00.00,"6,658.68",
22-Apr-21,Transfer,00.00,951.24,"5,707.44",
22-Apr-21,Bill,"3,558.00",00.00,"9,265.44",
22-Apr-21,RTGS,00.00,"1,158.18","8,107.26",
22-Apr-21,Bill,"12,35,460.20",00.00,"12,43,567.46",
22-Apr-21,Cash,440.9,00.00,"12,44,008.36",
22-Apr-21,Cheque,336.78,00.00,"12,44,345.14",
22-Apr-21,Tax,00.00,"12,44,345.14",00.00,
22-Apr-21,Purchase,"1,021.00",00.00,"1,021.00",
22-Apr-21,Purchase,00.00,340.33,680.67,
22-Apr-21,IMPS,"3,311.00",00.00,"3,991.67",
23-Apr-21,Cheque,28.4,00.00,"4,020.07",
23-Apr-21,Interest,00.00,502.51,"3,517.56",
23-Apr-21,Purchase,"1,72,599.50",00.00,"1,76,117.06",
23-Apr-21,Reversal,00.00,"58,705.69","1,17,411.37",
23-Apr-21,Debit Card,00.00,"11,741.14","1,05,670.23",
23-Apr-21,IMPS,00.00,"15,095.75","90,574.48",
23-Apr-21,NEFT,07.00,00.00,"90,581.48",
23-Apr-21,Tax,"14,99,450.80",00.00,"15,90,032.28",
23-Apr-21,Purchase,"2,082.50",00.00,"15,92,114.78",
23-Apr-21,Purchase,"9,401.25",00.00,"16,01,516.03",
23-Apr-21,Tax,00.00,00.00,"16,01,516.03",
23-Apr-21,Commission,00.00,"4,00,379.01","12,01,137.02",
23-Apr-21,Transfer,00.00,"12,01,137.02",00.00,
23-Apr-21,Tax,58.4,00.00,58.4,
23-Apr-21,Bill,"7,89,597.00",00.00,"7,89,655.40",
23-Apr-21,Reversal,"29,918.00",00.00,"8,19,573.40",
23-Apr-21,Tax,00.00,"2,04,893.35","6,14,680.05",
23-Apr-21,ATM,00.00,"1,22,936.01","4,91,744.04",
23-Apr-21,Cheque,00.00,"81,957.34","4,09,786.70",
24-Apr-21,Interest,"2,05,298.47",00.00,"6,15,085.17",
24-Apr-21,Interest,00.00,"2,05,028.39","4,10,056.78",
25-Apr-21,RTGS,06.20,00.00,"4,10,062.98",
25-Apr-21,Bill,00.00,"2,05,031.49","2,05,031.49",
26-Apr-21,Interest,07.80,00.00,"2,05,039.29",
26-Apr-21,Interest,03.89,00.00,"2,05,043.18",
26-Apr-21,Debit Card,00.00,"34,173.86","1,70,869.32",
26-Apr-21,Debit Card,"9,222.50",00.00,"1,80,091.82",
26-Apr-21,Debit Card,453,00.00,"1,80,544.82",
26-Apr-21,NEFT,"17,65,248.00",00.00,"19,45,792.82",
26-Apr-21,Commission,"5,12,191.20",00.00,"24,57,984.02",
26-Apr-21,ATM,00.00,"2,73,109.34","21,84,874.68",
26-Apr-21,Transfer,"23,918.00",00.00,"22,08,792.68",
26-Apr-21,ATM,440.5,00.00,"22,09,233.18",
26-Apr-21,Debit Card,01.50,00.00,"22,09,234.68",
26-Apr-21,Bill,00.00,"7,36,411.56","14,72,823.12",
27-Apr-21,IMPS,00.00,"14,72,823.12",00.00,
27-Apr-21,Purchase,"9,236.34",00.00,"9,236.34",
27-Apr-21,Reversal,04.77,00.00,"9,241.11",
27-Apr-21,Reversal,"2,390.00",00.00,"11,631.11",
27-Apr-21,Reversal,00.00,"3,877.04","7,754.07",
27-Apr-21,Bill,00.00,"1,292.35","6,461.72",
27-Apr-21,Cheque,00.00,"1,615.43","4,846.29",
27-Apr-21,Bill,00.00,"4,846.29",00.00,
27-Apr-21,ATM,05.00,00.00,05.00,
27-Apr-21,Commission,"80,677.44",00.00,"80,682.44",
27-Apr-21,Cash,"7,11,563.00",00.00,"7,92,245.44",
27-Apr-21,Debit Card,"31,680.80",00.00,"8,23,926.24",
27-Apr-21,Tax,"17,88,313.00",00.00,"26,12,239.24",
27-Apr-21,Transportellaneous,00.00,"2,61,223.92","23,51,015.32",
27-Apr-21,Debit Card,01.00,00.00,"23,51,016.32",
27-Apr-21,ATM,09.80,00.00,"23,51,026.12",
27-Apr-21,Interest,42,00.00,"23,51,068.12",
27-Apr-21,Interest,"2,35,896.20",00.00,"25,86,964.32",
27-Apr-21,Debit Card,00.00,"8,62,321.44","17,24,642.88",
27-Apr-21,Transportellaneous,"3,297.00",00.00,"17,27,939.88",
27-Apr-21,ATM,07.72,00.00,"17,27,947.60",
27-Apr-21,IMPS,"11,34,204.00",00.00,"28,62,151.60",
27-Apr-21,Commission,450.45,00.00,"28,62,602.05",
27-Apr-21,Transportellaneous,"19,313.80",00.00,"28,81,915.85",
27-Apr-21,Debit Card,"7,962.80",00.00,"28,89,878.65",
27-Apr-21,Transfer,00.00,"9,63,292.88","19,26,585.77",
28-Apr-21,Debit Card,00.00,"6,42,195.26","12,84,390.51",
28-Apr-21,IMPS,01.00,00.00,"12,84,391.51",
28-Apr-21,Debit Card,07.00,00.00,"12,84,398.51",
28-Apr-21,NEFT,19.52,00.00,"12,84,418.03",
28-Apr-21,Interest,00.00,"4,28,139.34","8,56,278.69",
28-Apr-21,Purchase,00.00,"1,42,713.12","7,13,565.58",
28-Apr-21,Transfer,97.6,00.00,"7,13,663.18",
28-Apr-21,Interest,00.00,"71,366.32","6,42,296.86",
28-Apr-21,Commission,"25,354.00",00.00,"6,67,650.86",
29-Apr-21,Bill,06.00,00.00,"6,67,656.86",
30-Apr-21,Commission,00.00,"3,33,828.43","3,33,828.43",
30-Apr-21,Cash,00.00,"83,457.11","2,50,371.32",
30-Apr-21,Transportellaneous,00.00,"83,457.11","1,66,914.21",
30-Apr-21,Transportellaneous,"10,179.50",00.00,"1,77,093.71",
30-Apr-21,Transfer,104.9,00.00,"1,77,198.61",
30-Apr-21,ATM,"1,64,688.40",00.00,"3,41,887.01",
30-Apr-21,Tax,00.00,"1,70,943.51","1,70,943.50",
30-Apr-21,Purchase,00.00,"24,420.50","1,46,523.00",
30-Apr-21,RTGS,200.2,00.00,"1,46,723.20",
30-Apr-21,Bill,00.00,"16,302.58","1,30,420.62",
30-Apr-21,Bill,00.00,"14,491.18","1,15,929.44",
30-Apr-21,RTGS,"2,794.42",00.00,"1,18,723.86",
30-Apr-21,ATM,00.00,"39,574.62","79,149.24",
30-Apr-21,Transportellaneous,"1,187.55",00.00,"80,336.79",
30-Apr-21,Purchase,"6,52,873.20",00.00,"7,33,209.99",
30-Apr-21,Commission,851.6,00.00,"7,34,061.59",
30-Apr-21,Commission,03.30,00.00,"7,34,064.89",
30-Apr-21,Cheque,"14,39,444.50",00.00,"21,73,509.39",
30-Apr-21,ATM,"1,892.90",00.00,"21,75,402.29",
30-Apr-21,Bill,00.00,"3,62,567.05","18,12,835.24",
30-Apr-21,Reversal,03.80,00.00,"18,12,839.04",
30-Apr-21,Interest,697,00.00,"18,13,536.04",
30-Apr-21,RTGS,00.00,"9,06,768.02","9,06,768.02",
30-Apr-21,Bill,07.00,00.00,"9,06,775.02",
30-Apr-21,Tax,00.00,"90,677.50","8,16,097.52",
30-Apr-21,ATM,"2,162.58",00.00,"8,18,260.10",
30-Apr-21,IMPS,"25,906.79",00.00,"8,44,166.89",
30-Apr-21,Transportellaneous,00.00,"8,44,166.89",00.00,
30-Apr-21,Purchase,"1,02,282.00",00.00,"1,02,282.00",
30-Apr-21,Bill,"24,559.10",00.00,"1,26,841.10",
30-Apr-21,Commission,00.00,"12,684.11","1,14,156.99",
30-Apr-21,IMPS,00.00,"19,026.17","95,130.83",
30-Apr-21,NEFT,"1,208.76",00.00,"96,339.59",
30-Apr-21,Tax,"1,38,304.06",00.00,"2,34,643.65",
30-Apr-21,Cheque,353.6,00.00,"2,34,997.25",
30-Apr-21,Bill,"2,484.00",00.00,"2,37,481.25",
30-Apr-21,Reversal,42.46,00.00,"2,37,523.71",
30-Apr-21,Reversal,00.00,"29,690.46","2,07,833.25",
30-Apr-21,ATM,00.00,"69,277.75","1,38,555.50",
30-Apr-21,RTGS,"4,54,629.00",00.00,"5,93,184.50",
30-Apr-21,Transportellaneous,"72,889.00",00.00,"6,66,073.50",
30-Apr-21,Cash,00.00,"6,66,073.50",00.00,
30-Apr-21,Purchase,19,00.00,19,
30-Apr-21,Interest,00.00,01.90,17.1,
30-Apr-21,Transfer,02.00,00.00,19.1,
30-Apr-21,Debit Card,"46,414.00",00.00,"46,433.10",
30-Apr-21,IMPS,"15,80,001.25",00.00,"16,26,434.35",
30-Apr-21,Transportellaneous,00.00,"8,13,217.18","8,13,217.18",
30-Apr-21,IMPS,04.14,00.00,"8,13,221.32",
30-Apr-21,Purchase,00.00,"1,16,174.47","6,97,046.85",
30-Apr-21,ATM,00.00,"6,97,046.85",00.00,
30-Apr-21,Reversal,"2,27,652.75",00.00,"2,27,652.75",
30-Apr-21,Debit Card,00.00,"56,913.19","1,70,739.56",
30-Apr-21,Cheque,"61,936.90",00.00,"2,32,676.46",
30-Apr-21,Cash,00.00,"38,779.41","1,93,897.05",
30-Apr-21,Transportellaneous,"19,37,617.00",00.00,"21,31,514.05",
30-Apr-21,NEFT,"27,415.00",00.00,"21,58,929.05",
30-Apr-21,Purchase,"5,85,602.50",00.00,"27,44,531.55",
30-Apr-21,Interest,00.00,"5,48,906.31","21,95,625.24",
30-Apr-21,Interest,05.20,00.00,"21,95,630.44",
30-Apr-21,Interest,00.00,"4,39,126.09","17,56,504.35",
30-Apr-21,Commission,"1,09,155.69",00.00,"18,65,660.04",
30-Apr-21,Tax,432.85,00.00,"18,66,092.89",
30-Apr-21,Bill,00.00,"4,66,523.22","13,99,569.67",
30-Apr-21,Transfer,"10,182.40",00.00,"14,09,752.07",
30-Apr-21,Cheque,00.00,"1,40,975.21","12,68,776.86",
30-Apr-21,Debit Card,00.00,"2,53,755.37","10,15,021.49",
30-Apr-21,NEFT,"2,723.29",00.00,"10,17,744.78",
30-Apr-21,Tax,00.00,"5,08,872.39","5,08,872.39",
30-Apr-21,Bill,00.00,"1,01,774.48","4,07,097.91",
30-Apr-21,Interest,"5,945.00",00.00,"4,13,042.91",
30-Apr-21,Interest,00.00,"1,03,260.73","3,09,782.18",
30-Apr-21,Reversal,00.00,"1,03,260.73","2,06,521.45",
30-Apr-21,Cheque,00.00,"2,06,521.45",00.00,
01-May-21,Bill,19,00.00,19,
01-May-21,Tax,00.00,03.17,15.83,
01-May-21,Reversal,00.00,03.17,12.66,
01-May-21,Transfer,00.00,03.17,09.50,
01-May-21,RTGS,00.00,02.38,07.12,
01-May-21,Debit Card,00.00,01.78,05.34,
01-May-21,RTGS,"8,835.00",00.00,"8,840.34",
01-May-21,Bill,00.00,"2,946.78","5,893.56",
01-May-21,Purchase,"65,759.53",00.00,"71,653.09",
01-May-21,Purchase,"1,390.50",00.00,"73,043.59",
01-May-21,Bill,"12,47,738.00",00.00,"13,20,781.59",
01-May-21,Reversal,"62,107.90",00.00,"13,82,889.49",
01-May-21,Commission,00.00,"4,60,963.16","9,21,926.33",
01-May-21,Reversal,470.04,00.00,"9,22,396.37",
01-May-21,Interest,00.00,"4,61,198.19","4,61,198.18",
01-May-21,ATM,00.00,"1,15,299.55","3,45,898.64",
01-May-21,Bill,00.00,"34,589.86","3,11,308.78",
01-May-21,Purchase,42,00.00,"3,11,350.78",
01-May-21,Cash,"32,490.00",00.00,"3,43,840.78",
01-May-21,Debit Card,06.00,00.00,"3,43,846.78",
01-May-21,Debit Card,00.00,"1,14,615.59","2,29,231.19",
01-May-21,IMPS,00.00,"28,653.90","2,00,577.29",
01-May-21,Commission,00.00,"20,057.73","1,80,519.56",
01-May-21,RTGS,"1,513.00",00.00,"1,82,032.56",
01-May-21,Reversal,"7,86,248.25",00.00,"9,68,280.81",
01-May-21,Bill,00.00,"3,22,760.27","6,45,520.54",
01-May-21,Cheque,"1,414.80",00.00,"6,46,935.34",
01-May-21,Debit Card,228.91,00.00,"6,47,164.25",
01-May-21,Debit Card,00.00,"71,907.14","5,75,257.11",
01-May-21,Debit Card,"3,656.00",00.00,"5,78,913.11",
01-May-21,Transfer,00.80,00.00,"5,78,913.91",
01-May-21,IMPS,00.00,"72,364.24","5,06,549.67",
01-May-21,RTGS,"2,341.59",00.00,"5,08,891.26",
01-May-21,Cheque,00.00,"1,01,778.25","4,07,113.01",
01-May-21,Purchase,00.00,"58,159.00","3,48,954.01",
01-May-21,Cash,00.00,"69,790.80","2,79,163.21",
01-May-21,RTGS,373.94,00.00,"2,79,537.15",
02-May-21,Debit Card,00.00,"39,933.88","2,39,603.27",
02-May-21,Transfer,00.00,"2,39,603.27",00.00,
02-May-21,Transfer,"3,52,220.00",00.00,"3,52,220.00",
02-May-21,Reversal,61,00.00,"3,52,281.00",
02-May-21,IMPS,"1,83,034.80",00.00,"5,35,315.80",
02-May-21,Cheque,"20,38,545.80",00.00,"25,73,861.60",
02-May-21,Commission,59,00.00,"25,73,920.60",
02-May-21,IMPS,08.00,00.00,"25,73,928.60",
02-May-21,IMPS,330,00.00,"25,74,258.60",
02-May-21,Interest,00.00,"3,67,751.23","22,06,507.37",
02-May-21,Reversal,00.00,"5,51,626.84","16,54,880.53",
02-May-21,Interest,00.00,"8,27,440.27","8,27,440.26",
02-May-21,Debit Card,"1,94,252.00",00.00,"10,21,692.26",
02-May-21,NEFT,"3,658.80",00.00,"10,25,351.06",
02-May-21,NEFT,00.00,"2,56,337.77","7,69,013.30",
02-May-21,Transfer,00.00,"85,445.92","6,83,567.38",
02-May-21,NEFT,05.00,00.00,"6,83,572.38",
02-May-21,IMPS,05.00,00.00,"6,83,577.38",
02-May-21,Bill,"2,003.50",00.00,"6,85,580.88",
02-May-21,Cheque,00.00,"6,85,580.88",00.00,
02-May-21,RTGS,"2,289.03",00.00,"2,289.03",
02-May-21,Commission,281.3,00.00,"2,570.33",
02-May-21,ATM,04.00,00.00,"2,574.33",
02-May-21,Transfer,"18,38,467.00",00.00,"18,41,041.33",
02-May-21,Cash,00.00,"3,06,840.22","15,34,201.11",
02-May-21,Cheque,"17,392.26",00.00,"15,51,593.37",
02-May-21,Cheque,"29,185.50",00.00,"15,80,778.87",
02-May-21,Cheque,00.00,"1,75,642.10","14,05,136.77",
02-May-21,Bill,"1,220.10",00.00,"14,06,356.87",
02-May-21,Interest,00.00,"2,81,271.37","11,25,085.50",
02-May-21,Cheque,03.00,00.00,"11,25,088.50",
02-May-21,NEFT,00.00,"1,40,636.06","9,84,452.44",
02-May-21,Bill,00.00,"1,23,056.56","8,61,395.88",
02-May-21,Interest,40.5,00.00,"8,61,436.38",
02-May-21,RTGS,11,00.00,"8,61,447.38",
02-May-21,Cheque,00.00,"95,716.38","7,65,731.00",
02-May-21,Transfer,00.00,"1,09,390.14","6,56,340.86",
02-May-21,NEFT,00.00,"2,18,780.29","4,37,560.57",
02-May-21,Tax,"10,993.94",00.00,"4,48,554.51",
02-May-21,Commission,00.00,"74,759.09","3,73,795.42",
02-May-21,Cheque,435.5,00.00,"3,74,230.92",
02-May-21,Debit Card,105.51,00.00,"3,74,336.43",
02-May-21,NEFT,00.00,"1,24,778.81","2,49,557.62",
02-May-21,Transportellaneous,"15,76,722.25",00.00,"18,26,279.87",
02-May-21,IMPS,219,00.00,"18,26,498.87",
02-May-21,Transfer,441.5,00.00,"18,26,940.37",
02-May-21,Cheque,01.20,00.00,"18,26,941.57",
02-May-21,Reversal,03.98,00.00,"18,26,945.55",
02-May-21,Cheque,04.65,00.00,"18,26,950.20",
02-May-21,Cash,00.00,"4,56,737.55","13,70,212.65",
02-May-21,Debit Card,306,00.00,"13,70,518.65",
02-May-21,RTGS,"1,02,543.00",00.00,"14,73,061.65",
02-May-21,Bill,58.65,00.00,"14,73,120.30",
02-May-21,Tax,00.00,"14,73,120.30",00.00,
03-May-21,Purchase,"7,84,699.50",00.00,"7,84,699.50",
03-May-21,ATM,01.00,00.00,"7,84,700.50",
03-May-21,ATM,00.00,"78,470.05","7,06,230.45",
03-May-21,Reversal,"6,54,888.80",00.00,"13,61,119.25",
03-May-21,Transportellaneous,00.00,"6,80,559.63","6,80,559.62",
03-May-21,Transfer,"2,42,827.80",00.00,"9,23,387.42",
03-May-21,Debit Card,07.00,00.00,"9,23,394.42",
03-May-21,ATM,"15,34,267.75",00.00,"24,57,662.17",
03-May-21,Tax,"14,60,178.00",00.00,"39,17,840.17",
03-May-21,Purchase,00.00,"19,58,920.09","19,58,920.08",
03-May-21,Cash,"1,566.24",00.00,"19,60,486.32",
03-May-21,IMPS,"15,59,790.75",00.00,"35,20,277.07",
03-May-21,Commission,01.70,00.00,"35,20,278.77",
03-May-21,Reversal,00.00,"4,40,034.85","30,80,243.92",
03-May-21,NEFT,"2,582.09",00.00,"30,82,826.01",
03-May-21,Transfer,00.00,"15,41,413.01","15,41,413.00",
03-May-21,ATM,177.3,00.00,"15,41,590.30",
03-May-21,Reversal,337.4,00.00,"15,41,927.70",
03-May-21,Tax,"1,184.10",00.00,"15,43,111.80",
03-May-21,Purchase,00.00,"3,08,622.36","12,34,489.44",
03-May-21,ATM,290.6,00.00,"12,34,780.04",
03-May-21,Commission,00.00,"2,46,956.01","9,87,824.03",
03-May-21,Commission,"3,436.00",00.00,"9,91,260.03",
03-May-21,RTGS,"13,60,839.75",00.00,"23,52,099.78",
03-May-21,ATM,00.00,"2,61,344.42","20,90,755.36",
03-May-21,Tax,"2,25,409.70",00.00,"23,16,165.06",
03-May-21,RTGS,259.7,00.00,"23,16,424.76",
03-May-21,Tax,"1,985.00",00.00,"23,18,409.76",
03-May-21,Reversal,00.00,"2,57,601.08","20,60,808.68",
03-May-21,Commission,00.00,00.00,"20,60,808.68",
03-May-21,Interest,00.00,"3,43,468.11","17,17,340.57",
03-May-21,Cash,00.00,"17,17,340.57",00.00,
03-May-21,Transportellaneous,"26,282.00",00.00,"26,282.00",
03-May-21,Cash,142.8,00.00,"26,424.80",
03-May-21,IMPS,00.00,"26,424.80",00.00,
03-May-21,Debit Card,02.00,00.00,02.00,
03-May-21,Bill,20,00.00,22,
03-May-21,Transfer,00.00,03.67,18.33,
03-May-21,NEFT,00.00,02.04,16.29,
03-May-21,Commission,"54,538.50",00.00,"54,554.79",
04-May-21,Transfer,"6,68,457.50",00.00,"7,23,012.29",
04-May-21,Transfer,"1,77,659.20",00.00,"9,00,671.49",
04-May-21,ATM,00.00,"3,00,223.83","6,00,447.66",
04-May-21,Bill,00.00,"3,00,223.83","3,00,223.83",
04-May-21,Tax,00.00,"60,044.77","2,40,179.06",
04-May-21,Transportellaneous,166.09,00.00,"2,40,345.15",
04-May-21,Transportellaneous,00.00,"34,335.02","2,06,010.13",
04-May-21,Transportellaneous,03.06,00.00,"2,06,013.19",
04-May-21,Debit Card,"19,177.00",00.00,"2,25,190.19",
04-May-21,Cash,00.00,"2,25,190.19",00.00,
04-May-21,Cheque,45.38,00.00,45.38,
04-May-21,Commission,00.00,22.69,22.69,
04-May-21,Cash,"55,143.31",00.00,"55,166.00",
04-May-21,ATM,"27,656.30",00.00,"82,822.30",
04-May-21,IMPS,"1,57,012.00",00.00,"2,39,834.30",
05-May-21,IMPS,"5,855.80",00.00,"2,45,690.10",
05-May-21,RTGS,336,00.00,"2,46,026.10",
05-May-21,Transfer,364.4,00.00,"2,46,390.50",
05-May-21,IMPS,00.00,"1,23,195.25","1,23,195.25",
05-May-21,Cheque,"1,253.00",00.00,"1,24,448.25",
05-May-21,Purchase,00.00,"17,778.32","1,06,669.93",
05-May-21,Commission,00.00,"13,333.74","93,336.19",
05-May-21,Bill,"21,219.20",00.00,"1,14,555.39",
05-May-21,Interest,00.00,"14,319.42","1,00,235.97",
05-May-21,Debit Card,00.00,"16,706.00","83,529.98",
05-May-21,Cash,00.00,"41,764.99","41,764.99",
06-May-21,Bill,00.00,"6,960.83","34,804.16",
06-May-21,Bill,00.00,"3,480.42","31,323.74",
06-May-21,Transfer,00.00,"15,661.87","15,661.87",
06-May-21,Transportellaneous,"7,61,230.20",00.00,"7,76,892.07",
06-May-21,Reversal,00.00,"77,689.21","6,99,202.86",
06-May-21,Debit Card,05.00,00.00,"6,99,207.86",
06-May-21,Reversal,"19,67,745.50",00.00,"26,66,953.36",
06-May-21,Cash,"1,814.00",00.00,"26,68,767.36",
06-May-21,Interest,00.00,"8,89,589.12","17,79,178.24",
06-May-21,ATM,"1,50,435.80",00.00,"19,29,614.04",
06-May-21,Reversal,127.08,00.00,"19,29,741.12",
07-May-21,Cheque,00.00,"4,82,435.28","14,47,305.84",
07-May-21,Tax,00.00,"14,47,305.84",00.00,
07-May-21,Reversal,"25,533.80",00.00,"25,533.80",
07-May-21,NEFT,33,00.00,"25,566.80",
07-May-21,Cheque,00.00,"4,261.13","21,305.67",
07-May-21,Reversal,55.1,00.00,"21,360.77",
07-May-21,Tax,00.00,"21,360.77",00.00,
07-May-21,Tax,"18,48,722.50",00.00,"18,48,722.50",
07-May-21,Reversal,00.00,"4,62,180.63","13,86,541.88",
07-May-21,Interest,00.00,"1,54,060.21","12,32,481.67",
07-May-21,IMPS,345.1,00.00,"12,32,826.77",
07-May-21,Purchase,00.00,"1,54,103.35","10,78,723.42",
07-May-21,Interest,"26,300.96",00.00,"11,05,024.38",
08-May-21,IMPS,"2,43,223.00",00.00,"13,48,247.38",
08-May-21,Debit Card,00.00,"2,24,707.90","11,23,539.48",
08-May-21,Transportellaneous,"33,037.00",00.00,"11,56,576.48",
08-May-21,NEFT,"1,180.13",00.00,"11,57,756.61",
08-May-21,Transfer,00.00,"11,57,756.61",00.00,
08-May-21,Cash,00.68,00.00,00.68,
08-May-21,Reversal,00.00,00.17,00.51,
08-May-21,Transportellaneous,"8,14,051.25",00.00,"8,14,051.76",
08-May-21,Interest,00.00,"8,14,051.76",00.00,
08-May-21,Cheque,"5,21,329.00",00.00,"5,21,329.00",
08-May-21,Interest,"7,07,006.50",00.00,"12,28,335.50",
08-May-21,Purchase,00.00,"4,09,445.17","8,18,890.33",
08-May-21,Tax,00.00,"4,09,445.17","4,09,445.16",
08-May-21,Cheque,377.9,00.00,"4,09,823.06",
08-May-21,Reversal,00.00,"1,02,455.77","3,07,367.30",
08-May-21,Bill,00.00,"3,07,367.30",00.00,
08-May-21,Reversal,472,00.00,472,
08-May-21,Transfer,00.00,59,413,
08-May-21,Debit Card,"2,52,308.50",00.00,"2,52,721.50",
08-May-21,Cheque,"1,59,697.53",00.00,"4,12,419.03",
08-May-21,IMPS,29,00.00,"4,12,448.03",
08-May-21,Purchase,00.00,"4,12,448.03",00.00,
08-May-21,IMPS,55.48,00.00,55.48,
08-May-21,Tax,00.00,06.94,48.54,
08-May-21,Transportellaneous,"16,158.89",00.00,"16,207.43",
08-May-21,Reversal,510,00.00,"16,717.43",
08-May-21,Bill,"1,355.96",00.00,"18,073.39",
08-May-21,Purchase,00.00,"18,073.39",00.00,
08-May-21,Tax,00.20,00.00,00.20,
08-May-21,IMPS,00.00,00.04,00.16,
08-May-21,NEFT,00.00,00.03,00.13,
08-May-21,Purchase,07.06,00.00,07.19,
08-May-21,ATM,00.00,02.40,04.79,
08-May-21,Commission,00.00,00.48,04.31,
08-May-21,Commission,"2,451.00",00.00,"2,455.31",
08-May-21,Transportellaneous,03.36,00.00,"2,458.67",
08-May-21,Bill,00.00,491.73,"1,966.94",
08-May-21,NEFT,260.3,00.00,"2,227.24",
08-May-21,Transportellaneous,00.00,222.72,"2,004.52",
08-May-21,Commission,"2,18,351.40",00.00,"2,20,355.92",
08-May-21,Cash,"9,94,981.00",00.00,"12,15,336.92",
09-May-21,ATM,473.41,00.00,"12,15,810.33",
09-May-21,Bill,00.00,"1,51,976.29","10,63,834.04",
09-May-21,RTGS,00.00,"1,18,203.78","9,45,630.26",
09-May-21,Cash,"2,48,206.00",00.00,"11,93,836.26",
09-May-21,NEFT,00.00,"3,97,945.42","7,95,890.84",
09-May-21,Transportellaneous,00.00,"3,97,945.42","3,97,945.42",
09-May-21,ATM,"13,219.00",00.00,"4,11,164.42",
09-May-21,NEFT,00.00,"1,02,791.11","3,08,373.32",
09-May-21,Tax,"11,50,286.80",00.00,"14,58,660.12",
09-May-21,NEFT,426.6,00.00,"14,59,086.72",
09-May-21,Bill,52.07,00.00,"14,59,138.79",
09-May-21,Bill,00.00,"2,91,827.76","11,67,311.03",
09-May-21,Tax,"2,52,212.00",00.00,"14,19,523.03",
09-May-21,Cheque,"8,58,696.00",00.00,"22,78,219.03",
09-May-21,Transportellaneous,"12,70,855.00",00.00,"35,49,074.03",
09-May-21,Transportellaneous,"93,682.00",00.00,"36,42,756.03",
09-May-21,Debit Card,"20,570.00",00.00,"36,63,326.03",
09-May-21,Debit Card,00.00,"9,15,831.51","27,47,494.52",
09-May-21,Transportellaneous,00.00,"3,05,277.17","24,42,217.35",
09-May-21,Reversal,00.00,"8,14,072.45","16,28,144.90",
09-May-21,Transfer,"3,968.10",00.00,"16,32,113.00",
09-May-21,NEFT,"38,332.00",00.00,"16,70,445.00",
09-May-21,ATM,"23,017.71",00.00,"16,93,462.71",
09-May-21,Commission,03.20,00.00,"16,93,465.91",
09-May-21,Interest,969,00.00,"16,94,434.91",
09-May-21,Reversal,00.00,"5,64,811.64","11,29,623.27",
09-May-21,Purchase,07.00,00.00,"11,29,630.27",
09-May-21,ATM,"12,36,306.00",00.00,"23,65,936.27",
09-May-21,Transportellaneous,00.00,"23,65,936.27",00.00,
09-May-21,Transfer,448,00.00,448,
09-May-21,Tax,837.54,00.00,"1,285.54",
09-May-21,Cash,00.00,257.11,"1,028.43",
09-May-21,Commission,00.00,146.92,881.51,
09-May-21,Cash,00.00,88.15,793.36,
09-May-21,Purchase,00.00,793.36,00.00,
09-May-21,Reversal,930.64,00.00,930.64,
09-May-21,Purchase,00.00,930.64,00.00,
09-May-21,Tax,"1,144.27",00.00,"1,144.27",
09-May-21,Cheque,00.00,127.14,"1,017.13",
09-May-21,Tax,"3,708.80",00.00,"4,725.93",
09-May-21,Transfer,00.00,787.66,"3,938.28",
09-May-21,Transportellaneous,08.80,00.00,"3,947.08",
09-May-21,Cash,00.00,493.39,"3,453.70",
09-May-21,NEFT,"1,36,126.00",00.00,"1,39,579.70",
09-May-21,Cheque,"65,111.22",00.00,"2,04,690.92",
09-May-21,ATM,00.00,"22,743.44","1,81,947.48",
09-May-21,Bill,"23,663.50",00.00,"2,05,610.98",
09-May-21,Tax,"6,653.64",00.00,"2,12,264.62",
09-May-21,NEFT,00.00,"26,533.08","1,85,731.54",
09-May-21,Reversal,00.00,"30,955.26","1,54,776.28",
09-May-21,Reversal,00.00,"25,796.05","1,28,980.23",
09-May-21,Debit Card,"70,934.00",00.00,"1,99,914.23",
09-May-21,Cheque,00.00,"1,99,914.23",00.00,
09-May-21,RTGS,03.00,00.00,03.00,
09-May-21,RTGS,00.00,03.00,00.00,
09-May-21,Interest,87.73,00.00,87.73,
09-May-21,Tax,"53,070.30",00.00,"53,158.03",
09-May-21,Reversal,"12,118.00",00.00,"65,276.03",
09-May-21,Commission,"1,770.02",00.00,"67,046.05",
09-May-21,Bill,00.00,"22,348.68","44,697.37",
09-May-21,ATM,00.00,"14,899.12","29,798.25",
09-May-21,Reversal,"2,396.60",00.00,"32,194.85",
09-May-21,NEFT,00.00,"10,731.62","21,463.23",
09-May-21,Purchase,00.00,"2,384.80","19,078.43",
09-May-21,Bill,00.00,"4,769.61","14,308.82",
09-May-21,Commission,00.00,"1,430.88","12,877.94",
09-May-21,Purchase,00.00,"2,575.59","10,302.35",
09-May-21,Tax,00.00,"1,287.79","9,014.56",
09-May-21,Bill,371.7,00.00,"9,386.26",
09-May-21,Transportellaneous,00.00,"2,346.57","7,039.70",
09-May-21,Transportellaneous,00.00,"2,346.57","4,693.13",
09-May-21,Reversal,04.34,00.00,"4,697.47",
09-May-21,Interest,00.00,671.07,"4,026.40",
09-May-21,Transportellaneous,50,00.00,"4,076.40",
09-May-21,IMPS,"2,02,324.25",00.00,"2,06,400.65",
09-May-21,Transfer,"11,01,462.00",00.00,"13,07,862.65",
09-May-21,RTGS,05.30,00.00,"13,07,867.95",
09-May-21,RTGS,24.81,00.00,"13,07,892.76",
10-May-21,Cash,00.00,"1,45,321.42","11,62,571.34",
10-May-21,Reversal,06.20,00.00,"11,62,577.54",
10-May-21,Transportellaneous,32,00.00,"11,62,609.54",
10-May-21,Bill,00.00,"1,29,178.84","10,33,430.70",
10-May-21,Cheque,00.00,"1,03,343.07","9,30,087.63",
10-May-21,NEFT,00.00,"1,03,343.07","8,26,744.56",
10-May-21,NEFT,"1,39,722.97",00.00,"9,66,467.53",
10-May-21,RTGS,00.00,"9,66,467.53",00.00,
10-May-21,Cheque,36,00.00,36,
10-May-21,Reversal,"11,829.90",00.00,"11,865.90",
10-May-21,IMPS,37.1,00.00,"11,903.00",
10-May-21,Purchase,00.00,"3,967.67","7,935.33",
10-May-21,Purchase,00.00,881.7,"7,053.63",
10-May-21,Cash,13,00.00,"7,066.63",
10-May-21,Reversal,"1,005.46",00.00,"8,072.09",
10-May-21,NEFT,"31,572.00",00.00,"39,644.09",
10-May-21,RTGS,00.00,"4,955.51","34,688.58",
10-May-21,RTGS,168,00.00,"34,856.58",
10-May-21,IMPS,00.00,"5,809.43","29,047.15",
10-May-21,Bill,00.00,"9,682.38","19,364.77",
10-May-21,Cheque,480.5,00.00,"19,845.27",
10-May-21,Interest,00.00,"9,922.64","9,922.64",
10-May-21,ATM,"3,499.60",00.00,"13,422.24",
10-May-21,Cash,00.00,"4,474.08","8,948.16",
11-May-21,RTGS,00.00,"4,474.08","4,474.08",
11-May-21,Bill,00.00,447.41,"4,026.67",
11-May-21,Bill,00.00,671.11,"3,355.56",
11-May-21,Transfer,00.00,559.26,"2,796.30",
11-May-21,Cheque,00.00,399.47,"2,396.83",
11-May-21,Tax,00.00,342.4,"2,054.43",
11-May-21,Bill,00.00,205.44,"1,848.99",
11-May-21,Tax,00.00,264.14,"1,584.85",
11-May-21,Debit Card,"18,03,023.00",00.00,"18,04,607.85",
11-May-21,NEFT,"3,436.00",00.00,"18,08,043.85",
12-May-21,Transportellaneous,00.00,"4,52,010.96","13,56,032.89",
12-May-21,Debit Card,00.00,"1,35,603.29","12,20,429.60",
12-May-21,ATM,00.00,"1,74,347.09","10,46,082.51",
12-May-21,Transportellaneous,06.60,00.00,"10,46,089.11",
12-May-21,RTGS,168.72,00.00,"10,46,257.83",
12-May-21,Debit Card,00.00,"1,16,250.87","9,30,006.96",
12-May-21,Commission,396,00.00,"9,30,402.96",
12-May-21,Reversal,00.00,"1,16,300.37","8,14,102.59",
12-May-21,Purchase,00.00,"4,07,051.30","4,07,051.30",
12-May-21,Tax,00.00,"67,841.88","3,39,209.42",
12-May-21,RTGS,00.00,"42,401.18","2,96,808.24",
12-May-21,Purchase,00.00,"1,48,404.12","1,48,404.12",
12-May-21,Tax,00.00,"1,48,404.12",00.00,
12-May-21,Transfer,29.8,00.00,29.8,
12-May-21,Transportellaneous,00.00,07.45,22.35,
12-May-21,Transfer,"21,560.00",00.00,"21,582.35",
12-May-21,Commission,00.00,"10,791.18","10,791.18",
12-May-21,Purchase,00.00,"1,348.90","9,442.28",
12-May-21,Cheque,84.6,00.00,"9,526.88",
12-May-21,Tax,"5,65,200.00",00.00,"5,74,726.88",
12-May-21,Debit Card,00.00,"57,472.69","5,17,254.19",
12-May-21,Reversal,00.00,"86,209.03","4,31,045.16",
12-May-21,Purchase,04.00,00.00,"4,31,049.16",
12-May-21,Bill,00.00,"43,104.92","3,87,944.24",
12-May-21,IMPS,07.50,00.00,"3,87,951.74",
12-May-21,Transportellaneous,00.70,00.00,"3,87,952.44",
12-May-21,Cash,00.00,"1,29,317.48","2,58,634.96",
12-May-21,Transportellaneous,00.90,00.00,"2,58,635.86",
12-May-21,ATM,"29,048.00",00.00,"2,87,683.86",
12-May-21,Bill,00.00,"57,536.77","2,30,147.09",
12-May-21,Purchase,"99,924.91",00.00,"3,30,072.00",
12-May-21,Bill,"2,70,065.00",00.00,"6,00,137.00",
12-May-21,Cheque,25,00.00,"6,00,162.00",
12-May-21,ATM,00.00,"1,00,027.00","5,00,135.00",
12-May-21,ATM,"2,260.00",00.00,"5,02,395.00",
12-May-21,Reversal,00.00,"55,821.67","4,46,573.33",
12-May-21,IMPS,00.00,"1,11,643.33","3,34,930.00",
12-May-21,Cheque,00.00,"66,986.00","2,67,944.00",
12-May-21,IMPS,00.00,"66,986.00","2,00,958.00",
12-May-21,Purchase,00.00,"20,095.80","1,80,862.20",
12-May-21,Cheque,"18,570.92",00.00,"1,99,433.12",
12-May-21,Cheque,229,00.00,"1,99,662.12",
12-May-21,IMPS,00.59,00.00,"1,99,662.71",
12-May-21,Bill,"17,96,274.00",00.00,"19,95,936.71",
13-May-21,NEFT,"1,46,829.75",00.00,"21,42,766.46",
13-May-21,Interest,189,00.00,"21,42,955.46",
13-May-21,RTGS,00.00,"2,14,295.55","19,28,659.91",
13-May-21,Transportellaneous,"19,495.00",00.00,"19,48,154.91",
13-May-21,Interest,"16,44,800.75",00.00,"35,92,955.66",
13-May-21,Cash,"2,23,182.50",00.00,"38,16,138.16",
13-May-21,Debit Card,"2,39,159.00",00.00,"40,55,297.16",
13-May-21,IMPS,06.81,00.00,"40,55,303.97",
13-May-21,Debit Card,00.00,"4,05,530.40","36,49,773.57",
13-May-21,Cheque,00.00,"18,24,886.79","18,24,886.78",
13-May-21,Commission,07.00,00.00,"18,24,893.78",
13-May-21,Bill,01.70,00.00,"18,24,895.48",
13-May-21,Interest,"12,94,790.75",00.00,"31,19,686.23",
13-May-21,Cash,00.00,"10,39,895.41","20,79,790.82",
13-May-21,Transfer,233.38,00.00,"20,80,024.20",
13-May-21,Purchase,00.00,"2,60,003.03","18,20,021.18",
13-May-21,Cheque,00.00,"9,10,010.59","9,10,010.59",
13-May-21,Reversal,72.3,00.00,"9,10,082.89",
13-May-21,IMPS,00.00,"3,03,360.96","6,06,721.93",
14-May-21,Interest,00.00,"1,21,344.39","4,85,377.54",
14-May-21,Transfer,"3,647.00",00.00,"4,89,024.54",
14-May-21,RTGS,191,00.00,"4,89,215.54",
14-May-21,Bill,00.00,"1,22,303.89","3,66,911.66",
14-May-21,Transportellaneous,"1,75,490.00",00.00,"5,42,401.66",
14-May-21,Bill,"68,084.00",00.00,"6,10,485.66",
14-May-21,ATM,"22,762.34",00.00,"6,33,248.00",
14-May-21,RTGS,09.00,00.00,"6,33,257.00",
14-May-21,Bill,00.00,"63,325.70","5,69,931.30",
14-May-21,Purchase,00.00,"81,418.76","4,88,512.54",
15-May-21,IMPS,00.00,"81,418.76","4,07,093.78",
15-May-21,Transportellaneous,28.99,00.00,"4,07,122.77",
15-May-21,RTGS,05.00,00.00,"4,07,127.77",
15-May-21,Purchase,54,00.00,"4,07,181.77",
15-May-21,IMPS,00.00,"67,863.63","3,39,318.14",
15-May-21,Interest,109,00.00,"3,39,427.14",
15-May-21,Reversal,00.00,"37,714.13","3,01,713.01",
15-May-21,Reversal,00.00,"75,428.25","2,26,284.76",
15-May-21,Reversal,00.00,"1,13,142.38","1,13,142.38",
15-May-21,Debit Card,476.1,00.00,"1,13,618.48",
15-May-21,RTGS,"20,710.00",00.00,"1,34,328.48",
15-May-21,Reversal,462.5,00.00,"1,34,790.98",
15-May-21,Interest,00.00,"16,848.87","1,17,942.11",
15-May-21,Transfer,"6,217.00",00.00,"1,24,159.11",
15-May-21,Cash,04.00,00.00,"1,24,163.11",
15-May-21,Purchase,03.00,00.00,"1,24,166.11",
15-May-21,ATM,00.00,"15,520.76","1,08,645.35",
15-May-21,Tax,00.00,"54,322.68","54,322.68",
15-May-21,NEFT,00.00,"18,107.56","36,215.12",
15-May-21,Reversal,40,00.00,"36,255.12",
15-May-21,IMPS,"2,217.17",00.00,"38,472.29",
15-May-21,IMPS,00.00,"38,472.29",00.00,
15-May-21,NEFT,"1,651.31",00.00,"1,651.31",
15-May-21,RTGS,00.00,235.9,"1,415.41",
15-May-21,Commission,00.00,471.8,943.61,
15-May-21,IMPS,"2,03,059.30",00.00,"2,04,002.91",
15-May-21,Interest,00.00,"2,04,002.91",00.00,
15-May-21,Cheque,"1,23,223.00",00.00,"1,23,223.00",
15-May-21,Debit Card,"84,029.69",00.00,"2,07,252.69",
15-May-21,Transfer,01.20,00.00,"2,07,253.89",
15-May-21,Reversal,"6,48,407.00",00.00,"8,55,660.89",
16-May-21,Reversal,00.00,"4,27,830.45","4,27,830.44",
16-May-21,IMPS,00.00,"53,478.81","3,74,351.64",
16-May-21,Transportellaneous,340.81,00.00,"3,74,692.45",
16-May-21,Commission,05.00,00.00,"3,74,697.45",
16-May-21,Debit Card,00.00,"1,87,348.73","1,87,348.72",
16-May-21,Cash,00.00,"20,816.52","1,66,532.20",
16-May-21,Bill,07.16,00.00,"1,66,539.36",
16-May-21,Interest,00.00,"55,513.12","1,11,026.24",
17-May-21,Transportellaneous,00.00,"22,205.25","88,820.99",
18-May-21,Interest,00.00,"14,803.50","74,017.49",
18-May-21,Interest,00.00,"7,401.75","66,615.74",
18-May-21,Interest,02.91,00.00,"66,618.65",
18-May-21,ATM,"2,268.00",00.00,"68,886.65",
18-May-21,Tax,00.00,"34,443.33","34,443.32",
18-May-21,Transportellaneous,"3,135.10",00.00,"37,578.42",
18-May-21,Interest,"1,66,040.38",00.00,"2,03,618.80",
18-May-21,Purchase,54.3,00.00,"2,03,673.10",
18-May-21,Cheque,00.00,"50,918.28","1,52,754.83",
18-May-21,ATM,00.00,"1,52,754.83",00.00,
18-May-21,Transportellaneous,"12,851.00",00.00,"12,851.00",
18-May-21,RTGS,00.00,"1,285.10","11,565.90",
18-May-21,Interest,00.00,"2,891.48","8,674.42",
18-May-21,ATM,00.00,"1,084.30","7,590.12",
18-May-21,Cheque,00.00,843.35,"6,746.77",
18-May-21,IMPS,00.00,"1,686.69","5,060.08",
18-May-21,Reversal,00.00,506.01,"4,554.07",
18-May-21,Transfer,00.00,650.58,"3,903.49",
18-May-21,Debit Card,00.00,433.72,"3,469.77",
18-May-21,RTGS,00.00,433.72,"3,036.05",
18-May-21,Tax,00.00,"3,036.05",00.00,
18-May-21,Bill,70.8,00.00,70.8,
18-May-21,Transportellaneous,"27,642.70",00.00,"27,713.50",
18-May-21,Tax,"28,876.00",00.00,"56,589.50",
18-May-21,Commission,00.00,"11,317.90","45,271.60",
18-May-21,Debit Card,236.22,00.00,"45,507.82",
18-May-21,Cash,04.20,00.00,"45,512.02",
18-May-21,Reversal,42.6,00.00,"45,554.62",
18-May-21,Commission,00.00,"4,555.46","40,999.16",
18-May-21,Interest,06.00,00.00,"41,005.16",
18-May-21,Debit Card,00.00,"6,834.19","34,170.97",
18-May-21,Interest,00.00,"3,796.77","30,374.20",
18-May-21,Interest,00.00,"15,187.10","15,187.10",
18-May-21,Interest,00.00,"1,898.39","13,288.71",
18-May-21,Transportellaneous,00.00,"1,661.09","11,627.62",
18-May-21,Reversal,"2,647.20",00.00,"14,274.82",
18-May-21,Purchase,498,00.00,"14,772.82",
18-May-21,Cash,00.00,"3,693.21","11,079.62",
19-May-21,IMPS,"5,94,587.00",00.00,"6,05,666.62",
19-May-21,IMPS,457,00.00,"6,06,123.62",
19-May-21,Commission,00.00,"67,347.07","5,38,776.55",
19-May-21,NEFT,00.00,"53,877.66","4,84,898.90",
19-May-21,Debit Card,00.00,"48,489.89","4,36,409.01",
19-May-21,Purchase,00.00,"48,489.89","3,87,919.12",
20-May-21,Commission,25,00.00,"3,87,944.12",
20-May-21,Interest,07.88,00.00,"3,87,952.00",
20-May-21,Commission,00.00,"55,421.71","3,32,530.29",
20-May-21,NEFT,00.00,"41,566.29","2,90,964.00",
20-May-21,RTGS,618.5,00.00,"2,91,582.50",
20-May-21,RTGS,00.00,"48,597.08","2,42,985.42",
21-May-21,Reversal,"2,593.30",00.00,"2,45,578.72",
21-May-21,Purchase,00.00,"27,286.52","2,18,292.20",
21-May-21,Bill,00.00,"31,184.60","1,87,107.60",
21-May-21,Transfer,"28,572.70",00.00,"2,15,680.30",
21-May-21,Interest,"77,841.00",00.00,"2,93,521.30",
21-May-21,Interest,"9,96,122.80",00.00,"12,89,644.10",
21-May-21,RTGS,"1,333.92",00.00,"12,90,978.02",
21-May-21,NEFT,00.00,"2,15,163.00","10,75,815.02",
21-May-21,Transfer,167.3,00.00,"10,75,982.32",
21-May-21,RTGS,13,00.00,"10,75,995.32",
21-May-21,ATM,37,00.00,"10,76,032.32",
21-May-21,Reversal,04.32,00.00,"10,76,036.64",
22-May-21,Reversal,"1,06,792.00",00.00,"11,82,828.64",
22-May-21,Transfer,"14,662.00",00.00,"11,97,490.64",
22-May-21,Bill,00.00,"1,71,070.09","10,26,420.55",
22-May-21,Reversal,54.3,00.00,"10,26,474.85",
22-May-21,Commission,05.40,00.00,"10,26,480.25",
22-May-21,Purchase,00.00,"1,02,648.03","9,23,832.22",
22-May-21,ATM,00.00,"9,23,832.22",00.00,
22-May-21,Cheque,48.02,00.00,48.02,
22-May-21,Transfer,00.00,16.01,32.01,
22-May-21,Commission,"4,67,494.80",00.00,"4,67,526.81",
22-May-21,Cheque,"17,54,372.50",00.00,"22,21,899.31",
22-May-21,Tax,00.00,"3,70,316.55","18,51,582.76",
22-May-21,Commission,"2,469.25",00.00,"18,54,052.01",
22-May-21,Reversal,00.00,"6,18,017.34","12,36,034.67",
22-May-21,NEFT,00.00,"3,09,008.67","9,27,026.00",
22-May-21,Tax,04.12,00.00,"9,27,030.12",
22-May-21,ATM,02.40,00.00,"9,27,032.52",
22-May-21,Cheque,"13,12,108.80",00.00,"22,39,141.32",
22-May-21,IMPS,00.00,"3,19,877.33","19,19,263.99",
22-May-21,Cash,00.00,"3,83,852.80","15,35,411.19",
22-May-21,Bill,00.00,"5,11,803.73","10,23,607.46",
22-May-21,Transfer,00.00,"1,70,601.24","8,53,006.22",
22-May-21,Bill,00.00,"85,300.62","7,67,705.60",
22-May-21,Cheque,"24,856.66",00.00,"7,92,562.26",
22-May-21,Transportellaneous,00.00,"1,58,512.45","6,34,049.81",
22-May-21,Commission,00.00,"79,256.23","5,54,793.58",
22-May-21,Cheque,01.46,00.00,"5,54,795.04",
22-May-21,Cheque,"2,10,201.00",00.00,"7,64,996.04",
22-May-21,IMPS,51.7,00.00,"7,65,047.74",
22-May-21,Interest,"1,32,064.70",00.00,"8,97,112.44",
22-May-21,Cash,00.00,"1,49,518.74","7,47,593.70",
22-May-21,Commission,00.00,"7,47,593.70",00.00,
23-May-21,Interest,05.01,00.00,05.01,
23-May-21,RTGS,55.03,00.00,60.04,
23-May-21,Cheque,"17,59,110.50",00.00,"17,59,170.54",
23-May-21,Commission,00.00,"2,19,896.32","15,39,274.22",
23-May-21,Debit Card,06.08,00.00,"15,39,280.30",
23-May-21,Transfer,01.30,00.00,"15,39,281.60",
23-May-21,NEFT,73.9,00.00,"15,39,355.50",
23-May-21,Tax,64,00.00,"15,39,419.50",
23-May-21,Cash,"4,52,171.00",00.00,"19,91,590.50",
23-May-21,Interest,"12,36,543.00",00.00,"32,28,133.50",
23-May-21,Tax,"6,805.45",00.00,"32,34,938.95",
23-May-21,Debit Card,00.00,"5,39,156.49","26,95,782.46",
23-May-21,Purchase,00.00,"13,47,891.23","13,47,891.23",
23-May-21,Debit Card,"14,04,050.00",00.00,"27,51,941.23",
23-May-21,Transportellaneous,"32,351.00",00.00,"27,84,292.23",
24-May-21,Commission,00.00,"27,84,292.23",00.00,
24-May-21,Debit Card,"1,91,168.00",00.00,"1,91,168.00",
24-May-21,Cash,00.00,"23,896.00","1,67,272.00",
24-May-21,ATM,00.00,"83,636.00","83,636.00",
24-May-21,Tax,00.00,"8,363.60","75,272.40",
24-May-21,ATM,00.00,"15,054.48","60,217.92",
24-May-21,Tax,"15,900.40",00.00,"76,118.32",
24-May-21,RTGS,00.00,"12,686.39","63,431.93",
24-May-21,RTGS,"2,281.00",00.00,"65,712.93",
24-May-21,NEFT,08.00,00.00,"65,720.93",
24-May-21,Tax,"1,03,785.00",00.00,"1,69,505.93",
24-May-21,IMPS,00.00,"21,188.24","1,48,317.69",
24-May-21,IMPS,"27,742.00",00.00,"1,76,059.69",
24-May-21,Debit Card,00.00,"88,029.85","88,029.84",
24-May-21,NEFT,156.26,00.00,"88,186.10",
24-May-21,ATM,00.00,"14,697.68","73,488.42",
24-May-21,NEFT,00.00,"8,165.38","65,323.04",
24-May-21,Cash,00.00,"6,532.30","58,790.74",
24-May-21,Transportellaneous,"2,28,274.09",00.00,"2,87,064.83",
24-May-21,Transfer,"8,28,894.50",00.00,"11,15,959.33",
24-May-21,RTGS,00.00,"2,78,989.83","8,36,969.50",
24-May-21,Tax,00.00,"1,04,621.19","7,32,348.31",
24-May-21,Cheque,00.60,00.00,"7,32,348.91",
24-May-21,Bill,"31,975.90",00.00,"7,64,324.81",
24-May-21,Transfer,00.00,"84,924.98","6,79,399.83",
24-May-21,IMPS,07.98,00.00,"6,79,407.81",
24-May-21,Interest,"15,57,078.80",00.00,"22,36,486.61",
24-May-21,IMPS,"2,742.85",00.00,"22,39,229.46",
24-May-21,Cash,404.85,00.00,"22,39,634.31",
24-May-21,Debit Card,23.3,00.00,"22,39,657.61",
24-May-21,ATM,150.65,00.00,"22,39,808.26",
24-May-21,Purchase,03.90,00.00,"22,39,812.16",
24-May-21,Commission,00.00,"4,47,962.43","17,91,849.73",
24-May-21,NEFT,00.00,"2,55,978.53","15,35,871.20",
24-May-21,Cheque,00.00,"1,70,652.36","13,65,218.84",
25-May-21,Commission,00.00,"2,73,043.77","10,92,175.07",
25-May-21,Reversal,56,00.00,"10,92,231.07",
25-May-21,IMPS,00.00,"10,92,231.07",00.00,
25-May-21,NEFT,04.30,00.00,04.30,
25-May-21,Transfer,17.99,00.00,22.29,
25-May-21,Transportellaneous,34,00.00,56.29,
25-May-21,Purchase,00.00,08.04,48.25,
25-May-21,Cheque,"58,476.30",00.00,"58,524.55",
25-May-21,Cheque,06.35,00.00,"58,530.90",
25-May-21,Commission,243,00.00,"58,773.90",
25-May-21,NEFT,"3,93,370.00",00.00,"4,52,143.90",
25-May-21,Transfer,00.00,"1,13,035.98","3,39,107.93",
25-May-21,NEFT,00.00,"84,776.98","2,54,330.95",
25-May-21,Transfer,"2,50,963.40",00.00,"5,05,294.35",
25-May-21,Tax,08.60,00.00,"5,05,302.95",
25-May-21,Cheque,00.00,"1,68,434.32","3,36,868.63",
25-May-21,Cheque,00.00,"1,68,434.32","1,68,434.32",
25-May-21,RTGS,00.00,"21,054.29","1,47,380.03",
25-May-21,Cheque,00.00,"24,563.34","1,22,816.69",
25-May-21,Cash,00.00,"24,563.34","98,253.35",
25-May-21,Transportellaneous,00.00,"24,563.34","73,690.01",
25-May-21,Reversal,00.00,"73,690.01",00.00,
25-May-21,Bill,"10,599.90",00.00,"10,599.90",
25-May-21,Tax,"1,13,101.84",00.00,"1,23,701.74",
25-May-21,Reversal,00.00,"12,370.17","1,11,331.57",
25-May-21,NEFT,508,00.00,"1,11,839.57",
25-May-21,IMPS,00.00,"11,183.96","1,00,655.61",
25-May-21,Interest,00.00,"10,065.56","90,590.05",
25-May-21,Interest,"83,276.90",00.00,"1,73,866.95",
25-May-21,RTGS,00.00,"34,773.39","1,39,093.56",
25-May-21,Cash,00.00,"17,386.70","1,21,706.86",
25-May-21,Reversal,"13,63,892.75",00.00,"14,85,599.61",
25-May-21,Transfer,00.00,"4,95,199.87","9,90,399.74",
25-May-21,Reversal,478.8,00.00,"9,90,878.54",
26-May-21,Commission,05.10,00.00,"9,90,883.64",
26-May-21,Purchase,203.3,00.00,"9,91,086.94",
26-May-21,Commission,00.00,"1,10,120.77","8,80,966.17",
26-May-21,NEFT,"6,518.00",00.00,"8,87,484.17",
26-May-21,Cash,"78,588.90",00.00,"9,66,073.07",
26-May-21,Interest,492,00.00,"9,66,565.07",
26-May-21,Cheque,00.00,"9,66,565.07",00.00,
26-May-21,ATM,"14,258.00",00.00,"14,258.00",
26-May-21,IMPS,00.00,"1,425.80","12,832.20",
26-May-21,Purchase,00.00,"2,566.44","10,265.76",
26-May-21,IMPS,00.00,"1,283.22","8,982.54",
26-May-21,Commission,"3,891.10",00.00,"12,873.64",
26-May-21,NEFT,00.00,"1,287.36","11,586.28",
26-May-21,Bill,"2,820.90",00.00,"14,407.18",
26-May-21,Transfer,00.00,"1,800.90","12,606.28",
26-May-21,Bill,"1,64,558.80",00.00,"1,77,165.08",
26-May-21,ATM,45.2,00.00,"1,77,210.28",
26-May-21,Interest,00.00,"17,721.03","1,59,489.25",
26-May-21,Transfer,"3,604.00",00.00,"1,63,093.25",
26-May-21,Reversal,00.00,"32,618.65","1,30,474.60",
27-May-21,Reversal,"3,863.90",00.00,"1,34,338.50",
27-May-21,NEFT,00.00,"26,867.70","1,07,470.80",
27-May-21,Transportellaneous,00.00,"11,941.20","95,529.60",
27-May-21,Cash,00.00,"10,614.40","84,915.20",
27-May-21,Transfer,"1,77,339.75",00.00,"2,62,254.95",
27-May-21,RTGS,00.00,"65,563.74","1,96,691.21",
27-May-21,Cash,00.00,"32,781.87","1,63,909.34",
27-May-21,Bill,"1,71,232.00",00.00,"3,35,141.34",
27-May-21,ATM,"18,95,817.00",00.00,"22,30,958.34",
28-May-21,RTGS,00.00,"2,23,095.83","20,07,862.51",
28-May-21,Cash,00.00,"5,01,965.63","15,05,896.88",
28-May-21,IMPS,"2,32,760.30",00.00,"17,38,657.18",
28-May-21,NEFT,"20,058.50",00.00,"17,58,715.68",
28-May-21,ATM,00.00,"1,95,412.85","15,63,302.83",
28-May-21,Interest,00.00,"7,81,651.42","7,81,651.42",
28-May-21,NEFT,00.00,"86,850.16","6,94,801.26",
28-May-21,Interest,04.78,00.00,"6,94,806.04",
28-May-21,Cash,"1,478.00",00.00,"6,96,284.04",
28-May-21,Transportellaneous,00.00,"2,32,094.68","4,64,189.36",
28-May-21,IMPS,00.00,"92,837.87","3,71,351.49",
28-May-21,Debit Card,"6,81,546.00",00.00,"10,52,897.49",
28-May-21,Tax,00.00,"3,50,965.83","7,01,931.66",
28-May-21,NEFT,225.59,00.00,"7,02,157.25",
28-May-21,Cash,00.00,"1,00,308.18","6,01,849.07",
28-May-21,Transfer,278.23,00.00,"6,02,127.30",
28-May-21,Cash,07.96,00.00,"6,02,135.26",
28-May-21,Purchase,00.00,"60,213.53","5,41,921.73",
28-May-21,Bill,414,00.00,"5,42,335.73",
29-May-21,Commission,00.00,"5,42,335.73",00.00,
29-May-21,Transportellaneous,252.1,00.00,252.1,
29-May-21,RTGS,"14,832.00",00.00,"15,084.10",
29-May-21,Transportellaneous,40.74,00.00,"15,124.84",
30-May-21,Reversal,00.00,"2,160.69","12,964.15",
30-May-21,ATM,00.00,"2,592.83","10,371.32",
30-May-21,IMPS,06.43,00.00,"10,377.75",
30-May-21,Bill,00.00,"3,459.25","6,918.50",
30-May-21,Tax,"9,474.80",00.00,"16,393.30",
30-May-21,NEFT,404.06,00.00,"16,797.36",
30-May-21,NEFT,"1,01,282.94",00.00,"1,18,080.30",
30-May-21,Reversal,00.00,"11,808.03","1,06,272.27",
30-May-21,RTGS,"1,98,828.10",00.00,"3,05,100.37",
30-May-21,Bill,"9,47,172.75",00.00,"12,52,273.12",
30-May-21,Commission,00.00,"2,50,454.62","10,01,818.50",
30-May-21,Cheque,00.00,"2,00,363.70","8,01,454.80",
30-May-21,Bill,00.00,"8,01,454.80",00.00,
30-May-21,Cheque,"12,13,303.75",00.00,"12,13,303.75",
30-May-21,Purchase,"15,14,669.50",00.00,"27,27,973.25",
30-May-21,Purchase,51.07,00.00,"27,28,024.32",
30-May-21,Debit Card,02.50,00.00,"27,28,026.82",
30-May-21,Commission,00.00,"13,64,013.41","13,64,013.41",
30-May-21,Purchase,"4,29,544.00",00.00,"17,93,557.41",
30-May-21,Reversal,00.00,"4,48,389.35","13,45,168.06",
30-May-21,RTGS,467.32,00.00,"13,45,635.38",
30-May-21,ATM,00.00,"2,24,272.56","11,21,362.82",
30-May-21,Interest,"4,00,067.50",00.00,"15,21,430.32",
30-May-21,Purchase,00.00,"1,90,178.79","13,31,251.53",
30-May-21,Purchase,"83,721.62",00.00,"14,14,973.15",
30-May-21,ATM,"29,528.00",00.00,"14,44,501.15",
30-May-21,RTGS,00.00,"2,06,357.31","12,38,143.84",
30-May-21,NEFT,00.00,"12,38,143.84",00.00,
30-May-21,Purchase,"1,733.00",00.00,"1,733.00",
30-May-21,Tax,00.00,247.57,"1,485.43",
30-May-21,NEFT,395.46,00.00,"1,880.89",
30-May-21,Tax,00.00,376.18,"1,504.71",
30-May-21,Cash,00.00,"1,504.71",00.00,
30-May-21,IMPS,"7,050.90",00.00,"7,050.90",
30-May-21,Commission,217.94,00.00,"7,268.84",
30-May-21,Tax,00.00,807.65,"6,461.19",
30-May-21,NEFT,04.30,00.00,"6,465.49",
30-May-21,Interest,"4,712.20",00.00,"11,177.69",
30-May-21,Transfer,00.00,"1,596.81","9,580.88",
30-May-21,Transfer,"1,080.74",00.00,"10,661.62",
30-May-21,Transfer,00.00,"10,661.62",00.00,
30-May-21,Debit Card,"30,727.95",00.00,"30,727.95",
30-May-21,Transfer,00.00,"7,681.99","23,045.96",
30-May-21,Commission,00.00,"4,609.19","18,436.77",
30-May-21,RTGS,00.00,"3,687.35","14,749.42",
30-May-21,Reversal,"8,29,071.75",00.00,"8,43,821.17",
30-May-21,Transportellaneous,"1,17,120.70",00.00,"9,60,941.87",
30-May-21,Transportellaneous,06.00,00.00,"9,60,947.87",
30-May-21,Purchase,"6,581.70",00.00,"9,67,529.57",
30-May-21,Commission,00.00,"4,83,764.79","4,83,764.78",
30-May-21,Bill,00.00,"69,109.25","4,14,655.53",
30-May-21,Bill,52.2,00.00,"4,14,707.73",
30-May-21,Cheque,04.11,00.00,"4,14,711.84",
30-May-21,Reversal,00.00,"2,07,355.92","2,07,355.92",
30-May-21,RTGS,00.00,"25,919.49","1,81,436.43",
30-May-21,Transportellaneous,"20,72,827.25",00.00,"22,54,263.68",
30-May-21,Tax,03.00,00.00,"22,54,266.68",
30-May-21,Tax,09.94,00.00,"22,54,276.62",
30-May-21,Bill,31,00.00,"22,54,307.62",
30-May-21,NEFT,00.00,"2,25,430.76","20,28,876.86",
30-May-21,ATM,00.00,"4,05,775.37","16,23,101.49",
30-May-21,Interest,03.00,00.00,"16,23,104.49",
30-May-21,Transfer,"19,306.77",00.00,"16,42,411.26",
30-May-21,Reversal,00.00,"2,34,630.18","14,07,781.08",
30-May-21,NEFT,01.00,00.00,"14,07,782.08",
30-May-21,IMPS,35.1,00.00,"14,07,817.18",
30-May-21,Debit Card,37.9,00.00,"14,07,855.08",
30-May-21,NEFT,23.9,00.00,"14,07,878.98",
30-May-21,Purchase,00.00,"7,03,939.49","7,03,939.49",
30-May-21,Interest,"33,636.20",00.00,"7,37,575.69",
30-May-21,Cash,792,00.00,"7,38,367.69",
30-May-21,Reversal,"14,16,647.20",00.00,"21,55,014.89",
30-May-21,RTGS,"1,73,474.10",00.00,"23,28,488.99",
30-May-21,Interest,01.18,00.00,"23,28,490.17",
30-May-21,Tax,00.00,"2,58,721.13","20,69,769.04",
30-May-21,NEFT,00.00,"2,95,681.29","17,74,087.75",
31-May-21,Tax,00.00,"1,97,120.86","15,76,966.89",
31-May-21,IMPS,120.83,00.00,"15,77,087.72",
31-May-21,Interest,00.00,"15,77,087.72",00.00,
31-May-21,Debit Card,03.00,00.00,03.00,
31-May-21,Purchase,00.00,03.00,00.00,
31-May-21,Transfer,"54,234.75",00.00,"54,234.75",
31-May-21,Reversal,02.00,00.00,"54,236.75",
31-May-21,NEFT,38.93,00.00,"54,275.68",
31-May-21,Bill,00.00,"6,030.63","48,245.05",
31-May-21,Cash,00.00,"6,030.63","42,214.42",
31-May-21,ATM,00.00,"4,690.49","37,523.93",
31-May-21,Cash,12,00.00,"37,535.93",
31-May-21,Debit Card,09.10,00.00,"37,545.03",
31-May-21,Purchase,00.00,"6,257.51","31,287.52",
31-May-21,Purchase,13,00.00,"31,300.52",
31-May-21,RTGS,31,00.00,"31,331.52",
31-May-21,Bill,00.00,"3,133.15","28,198.37",
31-May-21,Commission,563.1,00.00,"28,761.47",
31-May-21,RTGS,41.8,00.00,"28,803.27",
31-May-21,IMPS,"2,46,263.16",00.00,"2,75,066.43",
01-Jun-21,Debit Card,"1,483.60",00.00,"2,76,550.03",
01-Jun-21,Transfer,00.00,"1,38,275.02","1,38,275.02",
01-Jun-21,Transfer,00.00,"34,568.76","1,03,706.26",
01-Jun-21,ATM,00.00,"14,815.18","88,891.08",
01-Jun-21,Debit Card,61.01,00.00,"88,952.09",
01-Jun-21,Transportellaneous,00.00,"17,790.42","71,161.67",
01-Jun-21,NEFT,04.99,00.00,"71,166.66",
01-Jun-21,Cheque,00.00,"10,166.67","60,999.99",
01-Jun-21,Bill,00.00,"20,333.33","40,666.66",
01-Jun-21,ATM,00.00,"4,518.52","36,148.14",
01-Jun-21,Bill,"10,79,834.00",00.00,"11,15,982.14",
01-Jun-21,NEFT,00.00,"1,59,426.02","9,56,556.12",
01-Jun-21,Reversal,00.00,"9,56,556.12",00.00,
01-Jun-21,NEFT,"7,571.00",00.00,"7,571.00",
01-Jun-21,Bill,17,00.00,"7,588.00",
01-Jun-21,Transfer,"10,29,509.20",00.00,"10,37,097.20",
01-Jun-21,Transportellaneous,00.00,"2,07,419.44","8,29,677.76",
01-Jun-21,NEFT,00.00,"1,38,279.63","6,91,398.13",
01-Jun-21,Cheque,413.68,00.00,"6,91,811.81",
01-Jun-21,Tax,00.00,"1,38,362.36","5,53,449.45",
01-Jun-21,Transportellaneous,"24,646.70",00.00,"5,78,096.15",
01-Jun-21,Purchase,00.00,"5,78,096.15",00.00,
01-Jun-21,Commission,02.40,00.00,02.40,
01-Jun-21,Bill,04.10,00.00,06.50,
01-Jun-21,Interest,00.00,02.17,04.33,
01-Jun-21,Tax,00.00,00.54,03.79,
01-Jun-21,ATM,"12,23,238.00",00.00,"12,23,241.79",
01-Jun-21,RTGS,15,00.00,"12,23,256.79",
01-Jun-21,Cash,"1,63,444.00",00.00,"13,86,700.79",
01-Jun-21,Interest,463,00.00,"13,87,163.79",
01-Jun-21,Cash,00.00,"1,73,395.47","12,13,768.32",
01-Jun-21,Interest,00.00,"6,06,884.16","6,06,884.16",
01-Jun-21,Commission,"1,83,969.00",00.00,"7,90,853.16",
01-Jun-21,Transfer,"17,28,254.80",00.00,"25,19,107.96",
01-Jun-21,ATM,00.00,"5,03,821.59","20,15,286.37",
02-Jun-21,ATM,"81,914.50",00.00,"20,97,200.87",
02-Jun-21,Commission,316,00.00,"20,97,516.87",
02-Jun-21,Debit Card,505.33,00.00,"20,98,022.20",
02-Jun-21,NEFT,00.00,"2,62,252.78","18,35,769.43",
02-Jun-21,RTGS,"1,61,438.91",00.00,"19,97,208.34",
02-Jun-21,NEFT,00.00,"3,99,441.67","15,97,766.67",
02-Jun-21,ATM,00.00,"1,99,720.83","13,98,045.84",
02-Jun-21,Bill,00.00,"4,66,015.28","9,32,030.56",
02-Jun-21,Purchase,21,00.00,"9,32,051.56",
02-Jun-21,Transportellaneous,"29,484.00",00.00,"9,61,535.56",
02-Jun-21,IMPS,"15,72,823.75",00.00,"25,34,359.31",
02-Jun-21,IMPS,00.00,"2,81,595.48","22,52,763.83",
02-Jun-21,ATM,00.00,"2,50,307.09","20,02,456.74",
02-Jun-21,RTGS,"97,631.00",00.00,"21,00,087.74",
02-Jun-21,IMPS,"11,00,811.00",00.00,"32,00,898.74",
02-Jun-21,Transportellaneous,"28,137.06",00.00,"32,29,035.80",
02-Jun-21,RTGS,"50,564.00",00.00,"32,79,599.80",
02-Jun-21,Interest,00.00,"3,64,399.98","29,15,199.82",
03-Jun-21,Transfer,"29,235.50",00.00,"29,44,435.32",
03-Jun-21,Transportellaneous,403,00.00,"29,44,838.32",
03-Jun-21,IMPS,"96,376.40",00.00,"30,41,214.72",
03-Jun-21,Debit Card,"1,02,133.60",00.00,"31,43,348.32",
03-Jun-21,Commission,00.00,"5,23,891.39","26,19,456.93",
03-Jun-21,ATM,00.00,"6,54,864.23","19,64,592.70",
03-Jun-21,Debit Card,13.1,00.00,"19,64,605.80",
03-Jun-21,Cash,00.00,"6,54,868.60","13,09,737.20",
03-Jun-21,Debit Card,00.00,"3,27,434.30","9,82,302.90",
03-Jun-21,Bill,00.00,"1,63,717.15","8,18,585.75",
03-Jun-21,Reversal,00.00,"90,953.97","7,27,631.78",
03-Jun-21,Transportellaneous,"2,18,972.00",00.00,"9,46,603.78",
03-Jun-21,ATM,"1,090.00",00.00,"9,47,693.78",
03-Jun-21,Purchase,"1,66,414.56",00.00,"11,14,108.34",
03-Jun-21,Transfer,00.00,"3,71,369.45","7,42,738.89",
03-Jun-21,Cash,07.00,00.00,"7,42,745.89",
03-Jun-21,Debit Card,184.9,00.00,"7,42,930.79",
03-Jun-21,ATM,00.00,"2,47,643.60","4,95,287.19",
03-Jun-21,Commission,"8,67,471.25",00.00,"13,62,758.44",
03-Jun-21,Debit Card,"66,195.12",00.00,"14,28,953.56",
03-Jun-21,Purchase,317,00.00,"14,29,270.56",
03-Jun-21,IMPS,00.00,"1,78,658.82","12,50,611.74",
03-Jun-21,Commission,"13,429.00",00.00,"12,64,040.74",
03-Jun-21,Purchase,20,00.00,"12,64,060.74",
03-Jun-21,IMPS,00.00,"3,16,015.19","9,48,045.56",
03-Jun-21,Tax,00.00,"1,58,007.59","7,90,037.97",
03-Jun-21,RTGS,02.00,00.00,"7,90,039.97",
03-Jun-21,Transfer,222.3,00.00,"7,90,262.27",
03-Jun-21,Reversal,00.00,"1,12,894.61","6,77,367.66",
03-Jun-21,NEFT,00.00,"75,263.07","6,02,104.59",
03-Jun-21,RTGS,"10,16,504.20",00.00,"16,18,608.79",
03-Jun-21,Commission,00.00,"16,18,608.79",00.00,
03-Jun-21,Bill,"32,360.00",00.00,"32,360.00",
03-Jun-21,IMPS,00.00,"32,360.00",00.00,
03-Jun-21,Cash,"3,472.00",00.00,"3,472.00",
03-Jun-21,Debit Card,00.00,694.4,"2,777.60",
03-Jun-21,Bill,337.03,00.00,"3,114.63",
03-Jun-21,IMPS,"79,326.81",00.00,"82,441.44",
03-Jun-21,ATM,37.1,00.00,"82,478.54",
03-Jun-21,IMPS,00.00,"13,746.42","68,732.12",
03-Jun-21,Transportellaneous,"5,53,851.80",00.00,"6,22,583.92",
03-Jun-21,Commission,00.00,"69,175.99","5,53,407.93",
03-Jun-21,RTGS,00.00,"5,53,407.93",00.00,
03-Jun-21,Cash,262.55,00.00,262.55,
03-Jun-21,IMPS,"5,11,790.75",00.00,"5,12,053.30",
03-Jun-21,Bill,00.00,"73,150.47","4,38,902.83",
03-Jun-21,Cash,01.00,00.00,"4,38,903.83",
03-Jun-21,Bill,00.00,"62,700.55","3,76,203.28",
03-Jun-21,Purchase,02.90,00.00,"3,76,206.18",
03-Jun-21,Interest,00.00,"3,76,206.18",00.00,
03-Jun-21,Commission,391,00.00,391,
03-Jun-21,Transportellaneous,00.00,130.33,260.67,
03-Jun-21,Transfer,00.00,86.89,173.78,
03-Jun-21,Purchase,416.1,00.00,589.88,
03-Jun-21,Commission,00.00,84.27,505.61,
04-Jun-21,RTGS,00.00,168.54,337.07,
04-Jun-21,Transfer,00.00,42.13,294.94,
04-Jun-21,IMPS,00.00,147.47,147.47,
04-Jun-21,Bill,"7,07,149.00",00.00,"7,07,296.47",
04-Jun-21,Cheque,00.00,"1,41,459.29","5,65,837.18",
05-Jun-21,Tax,"21,904.90",00.00,"5,87,742.08",
05-Jun-21,Reversal,00.00,"65,304.68","5,22,437.40",
05-Jun-21,Cash,"3,589.00",00.00,"5,26,026.40",
05-Jun-21,Commission,07.60,00.00,"5,26,034.00",
05-Jun-21,Cheque,05.60,00.00,"5,26,039.60",
05-Jun-21,Commission,00.00,"52,603.96","4,73,435.64",
05-Jun-21,RTGS,00.00,"1,57,811.88","3,15,623.76",
05-Jun-21,RTGS,"2,077.45",00.00,"3,17,701.21",
05-Jun-21,Commission,00.00,"31,770.12","2,85,931.09",
05-Jun-21,IMPS,00.00,"1,42,965.55","1,42,965.55",
05-Jun-21,IMPS,00.00,"20,423.65","1,22,541.90",
05-Jun-21,Transportellaneous,192.38,00.00,"1,22,734.28",
06-Jun-21,Interest,00.00,"30,683.57","92,050.71",
06-Jun-21,Tax,"7,95,497.50",00.00,"8,87,548.21",
07-Jun-21,IMPS,00.00,"2,95,849.40","5,91,698.81",
07-Jun-21,Reversal,03.87,00.00,"5,91,702.68",
07-Jun-21,Cheque,00.00,"98,617.11","4,93,085.57",
07-Jun-21,NEFT,00.00,"1,64,361.86","3,28,723.71",
07-Jun-21,Cheque,"13,76,156.20",00.00,"17,04,879.91",
07-Jun-21,ATM,"9,08,446.00",00.00,"26,13,325.91",
07-Jun-21,ATM,383.54,00.00,"26,13,709.45",
07-Jun-21,Commission,"14,48,575.50",00.00,"40,62,284.95",
07-Jun-21,Debit Card,"1,697.87",00.00,"40,63,982.82",
07-Jun-21,RTGS,"4,61,897.00",00.00,"45,25,879.82",
07-Jun-21,ATM,00.00,"11,31,469.96","33,94,409.86",
07-Jun-21,Cheque,"4,430.00",00.00,"33,98,839.86",
07-Jun-21,IMPS,00.00,"4,24,854.98","29,73,984.88",
07-Jun-21,RTGS,00.00,"9,91,328.29","19,82,656.59",
07-Jun-21,Debit Card,"14,91,232.00",00.00,"34,73,888.59",
07-Jun-21,Debit Card,"7,49,590.00",00.00,"42,23,478.59",
07-Jun-21,IMPS,"30,511.60",00.00,"42,53,990.19",
07-Jun-21,Bill,00.00,"42,53,990.19",00.00,
07-Jun-21,Purchase,182.77,00.00,182.77,
07-Jun-21,IMPS,00.00,20.31,162.46,
08-Jun-21,Cheque,"26,783.63",00.00,"26,946.09",
08-Jun-21,Bill,00.00,"6,736.52","20,209.57",
08-Jun-21,Debit Card,00.00,"2,020.96","18,188.61",
08-Jun-21,Cheque,"28,805.44",00.00,"46,994.05",
08-Jun-21,IMPS,00.00,"11,748.51","35,245.54",
08-Jun-21,Reversal,"1,25,749.00",00.00,"1,60,994.54",
08-Jun-21,NEFT,00.00,"1,60,994.54",00.00,
08-Jun-21,Transfer,"1,66,516.81",00.00,"1,66,516.81",
08-Jun-21,Cash,00.00,"1,66,516.81",00.00,
08-Jun-21,Transportellaneous,02.90,00.00,02.90,
08-Jun-21,IMPS,"8,25,771.80",00.00,"8,25,774.70",
08-Jun-21,Cheque,00.00,"82,577.47","7,43,197.23",
08-Jun-21,Debit Card,25,00.00,"7,43,222.23",
08-Jun-21,Debit Card,00.00,"1,48,644.45","5,94,577.78",
08-Jun-21,ATM,00.00,"66,064.20","5,28,513.58",
08-Jun-21,IMPS,00.00,"1,76,171.19","3,52,342.39",
08-Jun-21,Reversal,05.50,00.00,"3,52,347.89",
08-Jun-21,Transportellaneous,00.00,"1,76,173.95","1,76,173.94",
08-Jun-21,Reversal,00.00,"58,724.65","1,17,449.29",
08-Jun-21,Transportellaneous,03.00,00.00,"1,17,452.29",
08-Jun-21,Interest,00.00,"58,726.15","58,726.14",
08-Jun-21,RTGS,07.41,00.00,"58,733.55",
08-Jun-21,Cheque,00.00,"8,390.51","50,343.04",
08-Jun-21,Bill,00.00,"10,068.61","40,274.43",
08-Jun-21,Debit Card,00.00,"6,712.41","33,562.02",
08-Jun-21,NEFT,00.00,"3,356.20","30,205.82",
08-Jun-21,Cash,00.00,"3,020.58","27,185.24",
08-Jun-21,Commission,07.50,00.00,"27,192.74",
08-Jun-21,Cash,"16,02,941.00",00.00,"16,30,133.74",
08-Jun-21,NEFT,00.00,"8,15,066.87","8,15,066.87",
08-Jun-21,Debit Card,29.2,00.00,"8,15,096.07",
08-Jun-21,Purchase,00.00,"1,63,019.21","6,52,076.86",
09-Jun-21,Debit Card,00.00,"1,63,019.22","4,89,057.64",
09-Jun-21,Transportellaneous,00.00,"4,89,057.64",00.00,
09-Jun-21,Bill,155.1,00.00,155.1,
09-Jun-21,Reversal,00.00,38.78,116.32,
09-Jun-21,Commission,00.00,12.92,103.4,
09-Jun-21,Debit Card,"5,340.20",00.00,"5,443.60",
09-Jun-21,Interest,00.00,777.66,"4,665.94",
09-Jun-21,Cheque,"17,416.00",00.00,"22,081.94",
09-Jun-21,Cheque,00.00,"5,520.49","16,561.45",
09-Jun-21,ATM,00.00,"5,520.48","11,040.97",
09-Jun-21,RTGS,"4,003.10",00.00,"15,044.07",
09-Jun-21,Tax,"58,947.20",00.00,"73,991.27",
09-Jun-21,Tax,"4,261.14",00.00,"78,252.41",
09-Jun-21,Transportellaneous,158.1,00.00,"78,410.51",
09-Jun-21,RTGS,"29,326.00",00.00,"1,07,736.51",
09-Jun-21,Cash,00.00,"35,912.17","71,824.34",
09-Jun-21,RTGS,00.00,"7,182.43","64,641.91",
09-Jun-21,RTGS,"2,045.20",00.00,"66,687.11",
09-Jun-21,IMPS,"21,515.15",00.00,"88,202.26",
09-Jun-21,Cheque,00.00,"9,800.25","78,402.01",
09-Jun-21,Debit Card,"1,63,165.90",00.00,"2,41,567.91",
09-Jun-21,Interest,"3,727.89",00.00,"2,45,295.80",
09-Jun-21,NEFT,56,00.00,"2,45,351.80",
09-Jun-21,Reversal,"1,61,285.31",00.00,"4,06,637.11",
09-Jun-21,Transportellaneous,43,00.00,"4,06,680.11",
09-Jun-21,Bill,"27,949.00",00.00,"4,34,629.11",
09-Jun-21,Bill,181.96,00.00,"4,34,811.07",
09-Jun-21,Cheque,"13,37,030.00",00.00,"17,71,841.07",
09-Jun-21,Bill,00.00,"2,95,306.85","14,76,534.22",
09-Jun-21,Reversal,"12,144.70",00.00,"14,88,678.92",
09-Jun-21,NEFT,00.00,"1,86,084.87","13,02,594.06",
09-Jun-21,ATM,04.73,00.00,"13,02,598.79",
09-Jun-21,Cash,00.00,"2,60,519.76","10,42,079.03",
09-Jun-21,RTGS,00.00,"1,30,259.88","9,11,819.15",
09-Jun-21,Debit Card,00.00,"91,181.92","8,20,637.24",
09-Jun-21,Transportellaneous,00.00,"2,05,159.31","6,15,477.93",
09-Jun-21,RTGS,"2,191.00",00.00,"6,17,668.93",
09-Jun-21,Transfer,00.00,"3,08,834.47","3,08,834.47",
09-Jun-21,Reversal,00.00,"38,604.31","2,70,230.16",
09-Jun-21,NEFT,00.00,"45,038.36","2,25,191.80",
09-Jun-21,Debit Card,00.00,"37,531.97","1,87,659.83",
09-Jun-21,IMPS,476.04,00.00,"1,88,135.87",
09-Jun-21,Transportellaneous,00.00,"62,711.96","1,25,423.91",
10-Jun-21,NEFT,00.00,"1,25,423.91",00.00,
10-Jun-21,Tax,116.9,00.00,116.9,
10-Jun-21,Transfer,00.00,16.7,100.2,
10-Jun-21,Bill,"1,35,665.80",00.00,"1,35,766.00",
10-Jun-21,NEFT,12.14,00.00,"1,35,778.14",
10-Jun-21,Bill,00.00,"67,889.07","67,889.07",
10-Jun-21,Tax,"7,828.59",00.00,"75,717.66",
10-Jun-21,ATM,00.00,"10,816.81","64,900.85",
10-Jun-21,Commission,"16,86,151.50",00.00,"17,51,052.35",
10-Jun-21,NEFT,00.00,"2,50,150.34","15,00,902.01",
10-Jun-21,Transportellaneous,00.00,"2,50,150.34","12,50,751.68",
10-Jun-21,Purchase,"28,707.00",00.00,"12,79,458.68",
10-Jun-21,Tax,140,00.00,"12,79,598.68",
10-Jun-21,RTGS,497.3,00.00,"12,80,095.98",
10-Jun-21,NEFT,00.00,"1,42,232.89","11,37,863.09",
10-Jun-21,Purchase,"1,38,573.00",00.00,"12,76,436.09",
10-Jun-21,Tax,02.00,00.00,"12,76,438.09",
10-Jun-21,Bill,00.00,"6,38,219.05","6,38,219.05",
10-Jun-21,Debit Card,00.00,"1,06,369.84","5,31,849.21",
10-Jun-21,Tax,"3,642.00",00.00,"5,35,491.21",
10-Jun-21,Cheque,"2,45,291.00",00.00,"7,80,782.21",
10-Jun-21,Bill,00.00,"78,078.22","7,02,703.99",
10-Jun-21,Transfer,976.8,00.00,"7,03,680.79",
10-Jun-21,Bill,04.30,00.00,"7,03,685.09",
10-Jun-21,Cheque,00.00,"70,368.51","6,33,316.58",
10-Jun-21,ATM,"3,11,635.25",00.00,"9,44,951.83",
10-Jun-21,ATM,00.00,"1,34,993.12","8,09,958.71",
10-Jun-21,Cash,"2,31,004.10",00.00,"10,40,962.81",
10-Jun-21,IMPS,04.30,00.00,"10,40,967.11",
10-Jun-21,IMPS,"5,302.35",00.00,"10,46,269.46",
10-Jun-21,ATM,00.00,"10,46,269.46",00.00,
10-Jun-21,RTGS,"2,687.50",00.00,"2,687.50",
10-Jun-21,Bill,"1,923.10",00.00,"4,610.60",
10-Jun-21,Transportellaneous,00.00,922.12,"3,688.48",
10-Jun-21,Cheque,"1,267.00",00.00,"4,955.48",
10-Jun-21,RTGS,"1,745.83",00.00,"6,701.31",
10-Jun-21,Commission,00.00,957.33,"5,743.98",
10-Jun-21,Cheque,00.00,"5,743.98",00.00,
10-Jun-21,NEFT,"2,43,710.00",00.00,"2,43,710.00",
10-Jun-21,IMPS,00.00,"2,43,710.00",00.00,
10-Jun-21,Transfer,"14,90,911.50",00.00,"14,90,911.50",
10-Jun-21,Commission,153.06,00.00,"14,91,064.56",
10-Jun-21,Commission,07.46,00.00,"14,91,072.02",
10-Jun-21,Bill,00.00,"3,72,768.01","11,18,304.02",
10-Jun-21,Interest,"6,835.00",00.00,"11,25,139.02",
11-Jun-21,RTGS,00.00,"5,62,569.51","5,62,569.51",
11-Jun-21,Transfer,45,00.00,"5,62,614.51",
11-Jun-21,Commission,"70,576.00",00.00,"6,33,190.51",
11-Jun-21,Cash,"1,663.00",00.00,"6,34,853.51",
11-Jun-21,ATM,"52,296.66",00.00,"6,87,150.17",
11-Jun-21,Interest,"1,443.94",00.00,"6,88,594.11",
11-Jun-21,Cheque,369.79,00.00,"6,88,963.90",
11-Jun-21,Reversal,"64,438.00",00.00,"7,53,401.90",
11-Jun-21,Purchase,00.00,"1,50,680.38","6,02,721.52",
11-Jun-21,IMPS,"56,589.00",00.00,"6,59,310.52",
11-Jun-21,Bill,00.00,"65,931.05","5,93,379.47",
11-Jun-21,Transfer,"3,581.00",00.00,"5,96,960.47",
11-Jun-21,Interest,03.51,00.00,"5,96,963.98",
11-Jun-21,Purchase,"1,60,083.00",00.00,"7,57,046.98",
11-Jun-21,ATM,"3,570.00",00.00,"7,60,616.98",
11-Jun-21,Cheque,00.00,"3,80,308.49","3,80,308.49",
11-Jun-21,Cash,00.00,"3,80,308.49",00.00,
11-Jun-21,RTGS,"9,833.50",00.00,"9,833.50",
11-Jun-21,Interest,07.69,00.00,"9,841.19",
11-Jun-21,Cash,06.00,00.00,"9,847.19",
11-Jun-21,Debit Card,00.00,"1,641.20","8,205.99",
12-Jun-21,Transportellaneous,121.4,00.00,"8,327.39",
12-Jun-21,Tax,"12,159.00",00.00,"20,486.39",
12-Jun-21,Bill,"1,30,395.56",00.00,"1,50,881.95",
12-Jun-21,Bill,03.10,00.00,"1,50,885.05",
12-Jun-21,Transportellaneous,00.00,"16,765.01","1,34,120.04",
12-Jun-21,RTGS,39.48,00.00,"1,34,159.52",
12-Jun-21,IMPS,00.00,"33,539.88","1,00,619.64",
12-Jun-21,Purchase,"1,832.90",00.00,"1,02,452.54",
12-Jun-21,ATM,00.00,"1,02,452.54",00.00,
12-Jun-21,NEFT,"93,444.75",00.00,"93,444.75",
12-Jun-21,Commission,"5,660.79",00.00,"99,105.54",
12-Jun-21,Commission,07.34,00.00,"99,112.88",
12-Jun-21,Purchase,08.00,00.00,"99,120.88",
12-Jun-21,IMPS,"6,86,232.00",00.00,"7,85,352.88",
12-Jun-21,Transportellaneous,"31,891.21",00.00,"8,17,244.09",
12-Jun-21,ATM,"1,28,379.70",00.00,"9,45,623.79",
12-Jun-21,Purchase,00.00,"1,57,603.97","7,88,019.82",
12-Jun-21,NEFT,00.00,"78,801.98","7,09,217.84",
12-Jun-21,IMPS,"5,69,864.00",00.00,"12,79,081.84",
12-Jun-21,Reversal,00.00,"1,42,120.20","11,36,961.64",
12-Jun-21,Cheque,00.00,"2,27,392.33","9,09,569.31",
12-Jun-21,Transfer,"3,243.00",00.00,"9,12,812.31",
12-Jun-21,RTGS,00.00,"1,01,423.59","8,11,388.72",
12-Jun-21,Interest,00.00,"4,05,694.36","4,05,694.36",
12-Jun-21,Tax,40.9,00.00,"4,05,735.26",
12-Jun-21,Transportellaneous,29.5,00.00,"4,05,764.76",
12-Jun-21,ATM,613.7,00.00,"4,06,378.46",
12-Jun-21,Debit Card,00.00,"4,06,378.46",00.00,
12-Jun-21,Transportellaneous,04.00,00.00,04.00,
12-Jun-21,Bill,00.00,00.40,03.60,
12-Jun-21,Cash,00.00,00.40,03.20,
12-Jun-21,Cheque,00.00,01.07,02.13,
12-Jun-21,IMPS,00.00,00.43,01.70,
12-Jun-21,Transfer,00.00,00.85,00.85,
12-Jun-21,RTGS,00.00,00.17,00.68,
12-Jun-21,Transportellaneous,00.00,00.07,00.61,
13-Jun-21,Purchase,00.00,00.20,00.41,
13-Jun-21,IMPS,00.00,00.41,00.00,
14-Jun-21,Bill,03.00,00.00,03.00,
14-Jun-21,Debit Card,"13,82,735.00",00.00,"13,82,738.00",
14-Jun-21,Interest,05.43,00.00,"13,82,743.43",
14-Jun-21,IMPS,05.70,00.00,"13,82,749.13",
14-Jun-21,Bill,58.6,00.00,"13,82,807.73",
14-Jun-21,Cheque,00.00,"4,60,935.91","9,21,871.82",
14-Jun-21,Bill,00.00,"1,02,430.20","8,19,441.62",
14-Jun-21,Interest,00.00,"1,63,888.32","6,55,553.30",
14-Jun-21,Debit Card,00.00,"93,650.47","5,61,902.83",
14-Jun-21,NEFT,49.23,00.00,"5,61,952.06",
14-Jun-21,NEFT,"2,674.00",00.00,"5,64,626.06",
14-Jun-21,Transfer,00.00,"1,41,156.52","4,23,469.55",
14-Jun-21,NEFT,"2,00,140.10",00.00,"6,23,609.65",
15-Jun-21,Cash,00.00,"69,289.96","5,54,319.69",
15-Jun-21,Debit Card,"14,86,362.00",00.00,"20,40,681.69",
15-Jun-21,Purchase,"2,42,775.00",00.00,"22,83,456.69",
15-Jun-21,ATM,00.00,"3,26,208.10","19,57,248.59",
15-Jun-21,Debit Card,"13,187.00",00.00,"19,70,435.59",
15-Jun-21,Cash,00.00,"3,28,405.93","16,42,029.66",
15-Jun-21,Cash,00.00,"4,10,507.42","12,31,522.24",
15-Jun-21,Cash,160.11,00.00,"12,31,682.35",
15-Jun-21,ATM,00.00,"1,53,960.29","10,77,722.06",
15-Jun-21,IMPS,00.00,"2,15,544.41","8,62,177.65",
15-Jun-21,Commission,00.00,"2,15,544.41","6,46,633.24",
15-Jun-21,Cash,83.18,00.00,"6,46,716.42",
15-Jun-21,RTGS,16.92,00.00,"6,46,733.34",
15-Jun-21,Transfer,00.00,"1,07,788.89","5,38,944.45",
15-Jun-21,NEFT,00.00,"1,34,736.11","4,04,208.34",
15-Jun-21,ATM,00.00,"2,02,104.17","2,02,104.17",
15-Jun-21,Reversal,31.26,00.00,"2,02,135.43",
15-Jun-21,Interest,"2,434.10",00.00,"2,04,569.53",
15-Jun-21,Tax,00.00,"2,04,569.53",00.00,
15-Jun-21,Bill,"17,663.62",00.00,"17,663.62",
15-Jun-21,IMPS,216.56,00.00,"17,880.18",
15-Jun-21,IMPS,00.00,"2,980.03","14,900.15",
15-Jun-21,Cash,00.00,"7,450.08","7,450.08",
15-Jun-21,Transportellaneous,00.00,"3,725.04","3,725.04",
15-Jun-21,Debit Card,"1,67,637.00",00.00,"1,71,362.04",
15-Jun-21,Transfer,"1,79,823.50",00.00,"3,51,185.54",
15-Jun-21,Commission,00.00,"87,796.39","2,63,389.15",
15-Jun-21,Tax,00.00,"87,796.38","1,75,592.77",
15-Jun-21,ATM,00.00,"21,949.10","1,53,643.67",
15-Jun-21,Bill,"11,222.00",00.00,"1,64,865.67",
15-Jun-21,Transportellaneous,00.00,"23,552.24","1,41,313.43",
15-Jun-21,RTGS,241.17,00.00,"1,41,554.60",
15-Jun-21,Transportellaneous,49,00.00,"1,41,603.60",
15-Jun-21,Debit Card,46,00.00,"1,41,649.60",
15-Jun-21,Transportellaneous,00.00,"1,41,649.60",00.00,
15-Jun-21,Transfer,"19,87,987.50",00.00,"19,87,987.50",
15-Jun-21,RTGS,"2,28,342.41",00.00,"22,16,329.91",
15-Jun-21,RTGS,536.45,00.00,"22,16,866.36",
16-Jun-21,IMPS,00.00,"4,43,373.27","17,73,493.09",
16-Jun-21,Purchase,00.00,"4,43,373.27","13,30,119.82",
16-Jun-21,Cash,"32,639.85",00.00,"13,62,759.67",
16-Jun-21,Cash,00.00,"1,51,417.74","12,11,341.93",
16-Jun-21,Transfer,134,00.00,"12,11,475.93",
16-Jun-21,ATM,353.89,00.00,"12,11,829.82",
16-Jun-21,Cheque,28,00.00,"12,11,857.82",
16-Jun-21,Interest,"2,19,562.40",00.00,"14,31,420.22",
16-Jun-21,Debit Card,59,00.00,"14,31,479.22",
16-Jun-21,RTGS,00.00,"2,38,579.87","11,92,899.35",
16-Jun-21,Debit Card,00.00,"1,49,112.42","10,43,786.93",
16-Jun-21,NEFT,00.00,00.00,"10,43,786.93",
16-Jun-21,NEFT,254.08,00.00,"10,44,041.01",
16-Jun-21,Transportellaneous,"14,34,943.50",00.00,"24,78,984.51",
16-Jun-21,Cheque,"10,24,127.00",00.00,"35,03,111.51",
16-Jun-21,Bill,00.00,"8,75,777.88","26,27,333.63",
16-Jun-21,IMPS,00.00,"2,62,733.36","23,64,600.27",
16-Jun-21,Bill,00.00,"2,95,575.03","20,69,025.24",
16-Jun-21,Tax,58.9,00.00,"20,69,084.14",
16-Jun-21,RTGS,"86,026.50",00.00,"21,55,110.64",
16-Jun-21,IMPS,463.6,00.00,"21,55,574.24",
16-Jun-21,IMPS,00.00,"4,31,114.85","17,24,459.39",
16-Jun-21,Interest,00.00,"5,74,819.80","11,49,639.59",
16-Jun-21,IMPS,"11,261.00",00.00,"11,60,900.59",
16-Jun-21,Transfer,00.00,"1,65,842.94","9,95,057.65",
16-Jun-21,Purchase,73.9,00.00,"9,95,131.55",
16-Jun-21,Cheque,00.00,"1,99,026.31","7,96,105.24",
16-Jun-21,Transportellaneous,00.00,"2,65,368.41","5,30,736.83",
16-Jun-21,Transportellaneous,"20,12,389.75",00.00,"25,43,126.58",
16-Jun-21,Bill,00.00,"4,23,854.43","21,19,272.15",
16-Jun-21,Tax,"12,077.20",00.00,"21,31,349.35",
16-Jun-21,Bill,"3,541.00",00.00,"21,34,890.35",
16-Jun-21,RTGS,"6,71,065.00",00.00,"28,05,955.35",
16-Jun-21,IMPS,"25,804.80",00.00,"28,31,760.15",
16-Jun-21,Purchase,00.00,"4,71,960.03","23,59,800.12",
16-Jun-21,Transportellaneous,"1,815.00",00.00,"23,61,615.12",
16-Jun-21,Transfer,"12,74,475.75",00.00,"36,36,090.87",
17-Jun-21,Cash,00.00,"12,12,030.29","24,24,060.58",
17-Jun-21,Tax,"1,22,638.20",00.00,"25,46,698.78",
17-Jun-21,ATM,00.00,"8,48,899.59","16,97,799.19",
17-Jun-21,RTGS,04.10,00.00,"16,97,803.29",
17-Jun-21,Cheque,00.00,"5,65,934.43","11,31,868.86",
17-Jun-21,Cash,03.36,00.00,"11,31,872.22",
17-Jun-21,Transportellaneous,418.9,00.00,"11,32,291.12",
17-Jun-21,Reversal,00.00,"11,32,291.12",00.00,
17-Jun-21,RTGS,"16,842.37",00.00,"16,842.37",
17-Jun-21,Reversal,00.00,"2,406.05","14,436.32",
18-Jun-21,IMPS,"3,713.00",00.00,"18,149.32",
18-Jun-21,Reversal,00.00,"18,149.32",00.00,
18-Jun-21,ATM,"1,280.30",00.00,"1,280.30",
18-Jun-21,RTGS,"27,743.40",00.00,"29,023.70",
18-Jun-21,Interest,"11,44,108.00",00.00,"11,73,131.70",
19-Jun-21,Cheque,00.00,"1,46,641.46","10,26,490.24",
19-Jun-21,Commission,493.14,00.00,"10,26,983.38",
19-Jun-21,Bill,00.00,00.00,"10,26,983.38",
19-Jun-21,NEFT,00.00,"1,28,372.92","8,98,610.46",
19-Jun-21,Interest,00.00,00.00,"8,98,610.46",
19-Jun-21,IMPS,00.00,"1,49,768.41","7,48,842.05",
19-Jun-21,Interest,345,00.00,"7,49,187.05",
19-Jun-21,ATM,00.00,"7,49,187.05",00.00,
19-Jun-21,NEFT,"1,469.00",00.00,"1,469.00",
19-Jun-21,Commission,"77,320.00",00.00,"78,789.00",
19-Jun-21,IMPS,00.00,"26,263.00","52,526.00",
19-Jun-21,Bill,00.00,"5,836.22","46,689.78",
19-Jun-21,Purchase,"2,10,670.10",00.00,"2,57,359.88",
19-Jun-21,RTGS,00.00,"85,786.63","1,71,573.25",
19-Jun-21,NEFT,00.00,"1,71,573.25",00.00,
19-Jun-21,Tax,501.41,00.00,501.41,
19-Jun-21,Bill,"3,584.76",00.00,"4,086.17",
19-Jun-21,Reversal,251,00.00,"4,337.17",
19-Jun-21,Transfer,00.00,"2,168.59","2,168.58",
19-Jun-21,NEFT,"95,776.00",00.00,"97,944.58",
19-Jun-21,Transportellaneous,07.10,00.00,"97,951.68",
19-Jun-21,Interest,00.00,"9,795.17","88,156.51",
19-Jun-21,Purchase,"1,321.00",00.00,"89,477.51",
19-Jun-21,Purchase,"5,69,614.00",00.00,"6,59,091.51",
19-Jun-21,ATM,00.00,"1,31,818.30","5,27,273.21",
19-Jun-21,Transportellaneous,00.00,"65,909.15","4,61,364.06",
19-Jun-21,Bill,"2,147.84",00.00,"4,63,511.90",
19-Jun-21,NEFT,00.00,"46,351.19","4,17,160.71",
19-Jun-21,Tax,08.30,00.00,"4,17,169.01",
19-Jun-21,Bill,00.00,"59,595.57","3,57,573.44",
20-Jun-21,IMPS,00.00,"1,78,786.72","1,78,786.72",
21-Jun-21,Purchase,00.70,00.00,"1,78,787.42",
21-Jun-21,Tax,"2,572.03",00.00,"1,81,359.45",
21-Jun-21,Transportellaneous,00.00,"25,908.49","1,55,450.96",
21-Jun-21,Purchase,"3,193.90",00.00,"1,58,644.86",
21-Jun-21,Cheque,00.00,"39,661.22","1,18,983.64",
21-Jun-21,Cheque,"2,474.63",00.00,"1,21,458.27",
21-Jun-21,Bill,03.10,00.00,"1,21,461.37",
21-Jun-21,Purchase,00.00,"24,292.27","97,169.10",
21-Jun-21,Interest,00.00,"10,796.57","86,372.53",
21-Jun-21,Interest,"3,298.72",00.00,"89,671.25",
21-Jun-21,ATM,414,00.00,"90,085.25",
21-Jun-21,IMPS,"1,613.00",00.00,"91,698.25",
21-Jun-21,ATM,"2,580.82",00.00,"94,279.07",
21-Jun-21,IMPS,325.6,00.00,"94,604.67",
21-Jun-21,Commission,254.69,00.00,"94,859.36",
21-Jun-21,IMPS,00.00,"23,714.84","71,144.52",
21-Jun-21,NEFT,01.73,00.00,"71,146.25",
21-Jun-21,RTGS,00.00,"11,857.71","59,288.54",
21-Jun-21,IMPS,"8,512.77",00.00,"67,801.31",
21-Jun-21,Commission,66,00.00,"67,867.31",
22-Jun-21,Purchase,"2,299.40",00.00,"70,166.71",
22-Jun-21,NEFT,00.00,"8,770.84","61,395.87",
22-Jun-21,NEFT,307.3,00.00,"61,703.17",
22-Jun-21,ATM,00.00,"30,851.59","30,851.58",
22-Jun-21,Tax,00.00,"15,425.79","15,425.79",
22-Jun-21,Transfer,00.00,"2,570.97","12,854.82",
22-Jun-21,Transfer,00.00,"4,284.94","8,569.88",
22-Jun-21,Transfer,07.96,00.00,"8,577.84",
22-Jun-21,ATM,00.00,"2,859.28","5,718.56",
23-Jun-21,Bill,00.00,571.86,"5,146.70",
23-Jun-21,RTGS,"1,44,808.30",00.00,"1,49,955.00",
23-Jun-21,Reversal,05.00,00.00,"1,49,960.00",
23-Jun-21,Tax,00.00,"18,745.00","1,31,215.00",
23-Jun-21,Transfer,00.00,"32,803.75","98,411.25",
23-Jun-21,Cash,97.55,00.00,"98,508.80",
23-Jun-21,IMPS,"66,989.66",00.00,"1,65,498.46",
23-Jun-21,Purchase,"3,526.39",00.00,"1,69,024.85",
23-Jun-21,Bill,00.00,"1,69,024.85",00.00,
23-Jun-21,Cheque,"1,882.00",00.00,"1,882.00",
23-Jun-21,NEFT,"2,384.20",00.00,"4,266.20",
23-Jun-21,NEFT,26.4,00.00,"4,292.60",
23-Jun-21,Cheque,00.00,613.23,"3,679.37",
23-Jun-21,Tax,"18,46,003.50",00.00,"18,49,682.87",
23-Jun-21,IMPS,00.00,"3,69,936.57","14,79,746.30",
23-Jun-21,Debit Card,00.00,"14,79,746.30",00.00,
23-Jun-21,Bill,"1,48,596.10",00.00,"1,48,596.10",
23-Jun-21,Transfer,00.00,"21,228.01","1,27,368.09",
23-Jun-21,Bill,"5,193.00",00.00,"1,32,561.09",
23-Jun-21,Bill,58,00.00,"1,32,619.09",
23-Jun-21,IMPS,00.00,"26,523.82","1,06,095.27",
23-Jun-21,RTGS,00.00,"35,365.09","70,730.18",
23-Jun-21,Commission,00.00,"23,576.73","47,153.45",
23-Jun-21,Reversal,00.00,"47,153.45",00.00,
23-Jun-21,ATM,64,00.00,64,
23-Jun-21,IMPS,51.85,00.00,115.85,
23-Jun-21,NEFT,00.00,14.48,101.37,
23-Jun-21,ATM,00.00,101.37,00.00,
23-Jun-21,Cheque,63.2,00.00,63.2,
23-Jun-21,Purchase,00.00,09.03,54.17,
23-Jun-21,Reversal,00.00,06.77,47.4,
23-Jun-21,Commission,00.00,09.48,37.92,
23-Jun-21,Cash,"46,837.60",00.00,"46,875.52",
23-Jun-21,Bill,00.00,"5,859.44","41,016.08",
23-Jun-21,Transfer,00.00,"4,101.61","36,914.47",
23-Jun-21,Reversal,00.00,"18,457.24","18,457.24",
23-Jun-21,Tax,00.00,"2,636.75","15,820.49",
23-Jun-21,Transportellaneous,00.00,"3,955.12","11,865.37",
23-Jun-21,Interest,02.00,00.00,"11,867.37",
23-Jun-21,Cash,19,00.00,"11,886.37",
23-Jun-21,ATM,00.00,"5,943.19","5,943.18",
23-Jun-21,RTGS,00.00,"1,188.64","4,754.54",
23-Jun-21,Interest,00.00,594.32,"4,160.22",
23-Jun-21,Purchase,31.49,00.00,"4,191.71",
23-Jun-21,Cheque,00.00,"4,191.71",00.00,
23-Jun-21,Transfer,"5,49,964.00",00.00,"5,49,964.00",
23-Jun-21,Debit Card,00.00,"2,74,982.00","2,74,982.00",
23-Jun-21,Debit Card,"2,15,338.60",00.00,"4,90,320.60",
23-Jun-21,Cheque,00.00,"1,22,580.15","3,67,740.45",
23-Jun-21,Commission,04.10,00.00,"3,67,744.55",
23-Jun-21,Tax,00.00,"1,22,581.52","2,45,163.03",
23-Jun-21,IMPS,"25,860.50",00.00,"2,71,023.53",
23-Jun-21,Cheque,"1,359.40",00.00,"2,72,382.93",
23-Jun-21,Debit Card,"76,252.00",00.00,"3,48,634.93",
23-Jun-21,Commission,"64,474.16",00.00,"4,13,109.09",
23-Jun-21,Transportellaneous,"29,265.40",00.00,"4,42,374.49",
23-Jun-21,Bill,00.00,"1,47,458.16","2,94,916.33",
23-Jun-21,Interest,184.9,00.00,"2,95,101.23",
23-Jun-21,IMPS,00.00,"36,887.65","2,58,213.58",
23-Jun-21,Transportellaneous,00.00,"25,821.36","2,32,392.22",
23-Jun-21,Debit Card,00.00,"38,732.04","1,93,660.18",
23-Jun-21,NEFT,"1,77,918.94",00.00,"3,71,579.12",
23-Jun-21,Commission,00.00,"61,929.85","3,09,649.27",
23-Jun-21,Transportellaneous,00.00,"61,929.85","2,47,719.42",
23-Jun-21,Interest,42,00.00,"2,47,761.42",
23-Jun-21,Commission,00.00,"24,776.14","2,22,985.28",
23-Jun-21,IMPS,"14,906.25",00.00,"2,37,891.53",
23-Jun-21,Reversal,"3,50,348.00",00.00,"5,88,239.53",
23-Jun-21,Bill,00.00,"1,96,079.84","3,92,159.69",
23-Jun-21,Cash,"19,00,429.50",00.00,"22,92,589.19",
23-Jun-21,Purchase,"1,11,379.66",00.00,"24,03,968.85",
23-Jun-21,Cash,05.00,00.00,"24,03,973.85",
23-Jun-21,Purchase,00.00,"3,00,496.73","21,03,477.12",
23-Jun-21,Bill,16,00.00,"21,03,493.12",
23-Jun-21,Bill,"17,25,856.20",00.00,"38,29,349.32",
23-Jun-21,NEFT,00.00,"4,25,483.26","34,03,866.06",
23-Jun-21,IMPS,"7,773.75",00.00,"34,11,639.81",
23-Jun-21,Commission,45,00.00,"34,11,684.81",
23-Jun-21,RTGS,131.8,00.00,"34,11,816.61",
23-Jun-21,Transfer,"2,874.60",00.00,"34,14,691.21",
23-Jun-21,RTGS,00.00,"4,26,836.40","29,87,854.81",
23-Jun-21,Transfer,"15,64,190.50",00.00,"45,52,045.31",
23-Jun-21,Cash,00.00,"11,38,011.33","34,14,033.98",
23-Jun-21,NEFT,00.00,"4,87,719.14","29,26,314.84",
23-Jun-21,IMPS,"18,22,179.80",00.00,"47,48,494.64",
23-Jun-21,Cheque,00.40,00.00,"47,48,495.04",
23-Jun-21,Purchase,54,00.00,"47,48,549.04",
23-Jun-21,Bill,"31,073.55",00.00,"47,79,622.59",
23-Jun-21,Debit Card,00.00,"15,93,207.53","31,86,415.06",
23-Jun-21,NEFT,00.00,"31,86,415.06",00.00,
23-Jun-21,ATM,432,00.00,432,
23-Jun-21,RTGS,00.00,86.4,345.6,
23-Jun-21,Reversal,06.00,00.00,351.6,
23-Jun-21,Reversal,"3,80,239.50",00.00,"3,80,591.10",
23-Jun-21,Interest,00.00,"1,26,863.70","2,53,727.40",
23-Jun-21,ATM,00.00,"25,372.74","2,28,354.66",
23-Jun-21,Cash,00.00,"1,14,177.33","1,14,177.33",
23-Jun-21,Interest,447.8,00.00,"1,14,625.13",
23-Jun-21,Tax,00.00,"22,925.03","91,700.10",
23-Jun-21,RTGS,04.00,00.00,"91,704.10",
23-Jun-21,RTGS,"3,610.20",00.00,"95,314.30",
23-Jun-21,Cash,"1,49,980.70",00.00,"2,45,295.00",
23-Jun-21,Cash,00.00,"35,042.14","2,10,252.86",
23-Jun-21,IMPS,00.00,"52,563.22","1,57,689.64",
23-Jun-21,Cash,"1,699.00",00.00,"1,59,388.64",
23-Jun-21,Debit Card,00.00,"31,877.73","1,27,510.91",
23-Jun-21,Tax,00.00,"25,502.18","1,02,008.73",
23-Jun-21,NEFT,00.00,"51,004.37","51,004.36",
23-Jun-21,Commission,00.00,"25,502.18","25,502.18",
23-Jun-21,Transportellaneous,00.00,"2,550.22","22,951.96",
23-Jun-21,Debit Card,00.00,"3,825.33","19,126.63",
23-Jun-21,RTGS,224.6,00.00,"19,351.23",
23-Jun-21,Bill,00.00,"3,870.25","15,480.98",
23-Jun-21,IMPS,00.00,"7,740.49","7,740.49",
23-Jun-21,Purchase,15.72,00.00,"7,756.21",
23-Jun-21,ATM,10.5,00.00,"7,766.71",
23-Jun-21,Transportellaneous,00.00,862.97,"6,903.74",
23-Jun-21,Transportellaneous,"6,50,641.50",00.00,"6,57,545.24",
23-Jun-21,Interest,"17,20,833.20",00.00,"23,78,378.44",
23-Jun-21,RTGS,"6,89,723.00",00.00,"30,68,101.44",
23-Jun-21,Purchase,00.00,"3,40,900.16","27,27,201.28",
23-Jun-21,Purchase,00.00,"5,45,440.26","21,81,761.02",
23-Jun-21,Tax,00.00,"7,27,253.67","14,54,507.35",
23-Jun-21,Bill,00.00,"3,63,626.84","10,90,880.51",
23-Jun-21,Debit Card,00.00,"10,90,880.51",00.00,
23-Jun-21,ATM,07.00,00.00,07.00,
23-Jun-21,NEFT,03.00,00.00,10,
23-Jun-21,Purchase,00.00,01.43,08.57,
23-Jun-21,Debit Card,"1,248.98",00.00,"1,257.55",
23-Jun-21,ATM,23.8,00.00,"1,281.35",
23-Jun-21,Interest,491.71,00.00,"1,773.06",
23-Jun-21,IMPS,"2,43,528.00",00.00,"2,45,301.06",
23-Jun-21,Transportellaneous,02.90,00.00,"2,45,303.96",
23-Jun-21,Commission,00.00,"1,22,651.98","1,22,651.98",
23-Jun-21,Cheque,00.00,"20,442.00","1,02,209.98",
23-Jun-21,Reversal,05.28,00.00,"1,02,215.26",
23-Jun-21,Purchase,00.00,"1,02,215.26",00.00,
23-Jun-21,Reversal,57.7,00.00,57.7,
23-Jun-21,Interest,"12,971.25",00.00,"13,028.95",
23-Jun-21,NEFT,00.00,"3,257.24","9,771.71",
23-Jun-21,Cheque,"93,201.70",00.00,"1,02,973.41",
23-Jun-21,Cheque,00.00,"12,871.68","90,101.73",
23-Jun-21,Commission,"2,09,806.41",00.00,"2,99,908.14",
23-Jun-21,NEFT,"16,39,645.00",00.00,"19,39,553.14",
23-Jun-21,Debit Card,141.8,00.00,"19,39,694.94",
23-Jun-21,Bill,03.00,00.00,"19,39,697.94",
23-Jun-21,Commission,00.00,"2,77,099.71","16,62,598.23",
23-Jun-21,Interest,"3,16,328.00",00.00,"19,78,926.23",
23-Jun-21,Purchase,00.00,"19,78,926.23",00.00,
23-Jun-21,Purchase,"17,10,313.50",00.00,"17,10,313.50",
23-Jun-21,Debit Card,00.00,"1,71,031.35","15,39,282.15",
23-Jun-21,Cash,01.80,00.00,"15,39,283.95",
23-Jun-21,Bill,42,00.00,"15,39,325.95",
23-Jun-21,RTGS,"2,287.32",00.00,"15,41,613.27",
23-Jun-21,RTGS,00.00,"7,70,806.64","7,70,806.64",
23-Jun-21,Debit Card,197,00.00,"7,71,003.64",
23-Jun-21,Tax,"1,45,731.22",00.00,"9,16,734.86",
23-Jun-21,Transportellaneous,00.00,"1,83,346.97","7,33,387.89",
23-Jun-21,ATM,"2,29,288.00",00.00,"9,62,675.89",
23-Jun-21,RTGS,00.00,"3,20,891.96","6,41,783.93",
23-Jun-21,Interest,61.5,00.00,"6,41,845.43",
23-Jun-21,Reversal,01.20,00.00,"6,41,846.63",
23-Jun-21,IMPS,00.00,"1,28,369.33","5,13,477.30",
23-Jun-21,NEFT,00.00,"2,56,738.65","2,56,738.65",
23-Jun-21,Reversal,00.00,"51,347.73","2,05,390.92",
23-Jun-21,IMPS,138.3,00.00,"2,05,529.22",
23-Jun-21,Cash,62,00.00,"2,05,591.22",
23-Jun-21,Reversal,"9,12,895.00",00.00,"11,18,486.22",
23-Jun-21,Interest,"9,399.29",00.00,"11,27,885.51",
23-Jun-21,Bill,00.00,"2,81,971.38","8,45,914.13",
23-Jun-21,Cash,"1,769.00",00.00,"8,47,683.13",
23-Jun-21,Cheque,60,00.00,"8,47,743.13",
23-Jun-21,Transfer,147.85,00.00,"8,47,890.98",
23-Jun-21,Transfer,00.00,"94,210.11","7,53,680.87",
23-Jun-21,ATM,"1,86,625.00",00.00,"9,40,305.87",
23-Jun-21,Debit Card,"10,09,845.00",00.00,"19,50,150.87",
23-Jun-21,Transportellaneous,61,00.00,"19,50,211.87",
23-Jun-21,RTGS,"7,84,678.50",00.00,"27,34,890.37",
23-Jun-21,Transportellaneous,"6,77,198.00",00.00,"34,12,088.37",
23-Jun-21,Interest,00.00,"8,53,022.09","25,59,066.28",
23-Jun-21,Transfer,"4,396.70",00.00,"25,63,462.98",
24-Jun-21,Bill,00.00,"6,40,865.75","19,22,597.24",
24-Jun-21,Purchase,06.80,00.00,"19,22,604.04",
24-Jun-21,Debit Card,00.00,"2,40,325.51","16,82,278.54",
24-Jun-21,Cheque,"17,283.50",00.00,"16,99,562.04",
24-Jun-21,Tax,00.00,"1,69,956.20","15,29,605.84",
24-Jun-21,NEFT,"1,21,975.00",00.00,"16,51,580.84",
24-Jun-21,Commission,00.00,"4,12,895.21","12,38,685.63",
24-Jun-21,Debit Card,00.00,"6,19,342.82","6,19,342.81",
24-Jun-21,Commission,00.00,"77,417.85","5,41,924.96",
24-Jun-21,IMPS,00.00,"1,08,384.99","4,33,539.97",
24-Jun-21,Transportellaneous,05.60,00.00,"4,33,545.57",
24-Jun-21,Transportellaneous,00.00,"48,171.73","3,85,373.84",
24-Jun-21,Bill,"3,898.00",00.00,"3,89,271.84",
24-Jun-21,ATM,00.00,"77,854.37","3,11,417.47",
24-Jun-21,Transfer,63,00.00,"3,11,480.47",
25-Jun-21,Transfer,00.00,"38,935.06","2,72,545.41",
25-Jun-21,Tax,"26,292.00",00.00,"2,98,837.41",
25-Jun-21,Cheque,"13,30,941.25",00.00,"16,29,778.66",
26-Jun-21,Transfer,"6,783.36",00.00,"16,36,562.02",
26-Jun-21,Tax,00.00,"1,63,656.20","14,72,905.82",
26-Jun-21,Transfer,00.00,"2,94,581.16","11,78,324.66",
26-Jun-21,Bill,"1,232.00",00.00,"11,79,556.66",
26-Jun-21,NEFT,"3,389.00",00.00,"11,82,945.66",
26-Jun-21,NEFT,46.5,00.00,"11,82,992.16",
26-Jun-21,Purchase,00.00,"11,82,992.16",00.00,
26-Jun-21,ATM,25.7,00.00,25.7,
26-Jun-21,Reversal,00.00,08.57,17.13,
26-Jun-21,Interest,02.00,00.00,19.13,
26-Jun-21,Interest,370.47,00.00,389.6,
26-Jun-21,Tax,08.87,00.00,398.47,
26-Jun-21,Transportellaneous,"9,98,744.00",00.00,"9,99,142.47",
26-Jun-21,Transfer,07.53,00.00,"9,99,150.00",
26-Jun-21,Transportellaneous,"1,48,723.20",00.00,"11,47,873.20",
26-Jun-21,Bill,00.00,"2,29,574.64","9,18,298.56",
26-Jun-21,IMPS,00.00,"3,06,099.52","6,12,199.04",
26-Jun-21,Tax,01.54,00.00,"6,12,200.58",
26-Jun-21,Transportellaneous,00.00,"1,22,440.12","4,89,760.46",
27-Jun-21,Transportellaneous,00.00,"4,89,760.46",00.00,
27-Jun-21,IMPS,"3,507.90",00.00,"3,507.90",
27-Jun-21,Cash,39.7,00.00,"3,547.60",
27-Jun-21,Bill,00.00,591.27,"2,956.33",
27-Jun-21,Cash,00.00,369.54,"2,586.79",
27-Jun-21,Tax,37.76,00.00,"2,624.55",
27-Jun-21,Cash,00.00,374.94,"2,249.61",
28-Jun-21,Cheque,273.35,00.00,"2,522.96",
28-Jun-21,Cheque,00.00,252.3,"2,270.66",
28-Jun-21,NEFT,00.00,"1,135.33","1,135.33",
28-Jun-21,Cheque,01.70,00.00,"1,137.03",
28-Jun-21,Bill,"1,870.10",00.00,"3,007.13",
28-Jun-21,Commission,"5,98,165.20",00.00,"6,01,172.33",
28-Jun-21,Cheque,"3,09,679.00",00.00,"9,10,851.33",
28-Jun-21,Debit Card,"26,328.00",00.00,"9,37,179.33",
28-Jun-21,Reversal,00.00,"93,717.93","8,43,461.40",
28-Jun-21,Transportellaneous,48.18,00.00,"8,43,509.58",
28-Jun-21,Commission,00.00,"1,05,438.70","7,38,070.88",
28-Jun-21,Tax,00.00,"1,47,614.18","5,90,456.70",
28-Jun-21,IMPS,"1,15,804.00",00.00,"7,06,260.70",
28-Jun-21,RTGS,05.00,00.00,"7,06,265.70",
28-Jun-21,Debit Card,"2,49,100.60",00.00,"9,55,366.30",
28-Jun-21,Debit Card,00.00,"1,06,151.81","8,49,214.49",
28-Jun-21,Debit Card,00.00,"2,83,071.50","5,66,142.99",
28-Jun-21,Reversal,00.00,"1,13,228.60","4,52,914.39",
28-Jun-21,Transfer,00.00,"1,13,228.60","3,39,685.79",
28-Jun-21,NEFT,97,00.00,"3,39,782.79",
28-Jun-21,ATM,00.00,"84,945.70","2,54,837.09",
28-Jun-21,ATM,"7,14,849.00",00.00,"9,69,686.09",
28-Jun-21,Reversal,00.00,"3,23,228.70","6,46,457.39",
28-Jun-21,Debit Card,"1,609.00",00.00,"6,48,066.39",
28-Jun-21,Cheque,"3,371.80",00.00,"6,51,438.19",
28-Jun-21,ATM,36,00.00,"6,51,474.19",
28-Jun-21,RTGS,"16,75,942.00",00.00,"23,27,416.19",
28-Jun-21,Debit Card,369.3,00.00,"23,27,785.49",
28-Jun-21,Cheque,"1,21,344.94",00.00,"24,49,130.43",
28-Jun-21,Cheque,00.00,"3,49,875.78","20,99,254.65",
28-Jun-21,NEFT,364.58,00.00,"20,99,619.23",
28-Jun-21,Transfer,00.00,"6,99,873.08","13,99,746.15",
28-Jun-21,Cheque,00.00,"1,99,963.74","11,99,782.41",
28-Jun-21,Tax,00.00,"1,71,397.49","10,28,384.92",
28-Jun-21,Transportellaneous,00.00,"2,57,096.23","7,71,288.69",
29-Jun-21,Interest,29.7,00.00,"7,71,318.39",
29-Jun-21,Transportellaneous,"32,206.46",00.00,"8,03,524.85",
29-Jun-21,Cash,00.00,"1,14,789.26","6,88,735.59",
29-Jun-21,Interest,00.00,"6,88,735.59",00.00,
29-Jun-21,Reversal,35.4,00.00,35.4,
29-Jun-21,Reversal,407.4,00.00,442.8,
29-Jun-21,NEFT,"2,202.60",00.00,"2,645.40",
29-Jun-21,NEFT,"8,39,442.00",00.00,"8,42,087.40",
29-Jun-21,Transportellaneous,07.54,00.00,"8,42,094.94",
29-Jun-21,Debit Card,"12,67,123.50",00.00,"21,09,218.44",
29-Jun-21,Commission,00.00,"21,09,218.44",00.00,
29-Jun-21,Commission,01.80,00.00,01.80,
29-Jun-21,Cheque,36.2,00.00,38,
29-Jun-21,Cash,00.00,05.43,32.57,
29-Jun-21,Debit Card,29.9,00.00,62.47,
29-Jun-21,Commission,00.00,08.92,53.55,
29-Jun-21,Bill,40.38,00.00,93.93,
30-Jun-21,ATM,"80,585.00",00.00,"80,678.93",
30-Jun-21,Transfer,00.00,"20,169.73","60,509.20",
30-Jun-21,Cash,"13,44,371.00",00.00,"14,04,880.20",
30-Jun-21,IMPS,450.3,00.00,"14,05,330.50",
30-Jun-21,Interest,49,00.00,"14,05,379.50",
30-Jun-21,Interest,00.00,"1,75,672.44","12,29,707.06",
30-Jun-21,Transfer,450.3,00.00,"12,30,157.36",
01-Jul-21,Cheque,00.00,"4,10,052.45","8,20,104.91",
01-Jul-21,Transportellaneous,"84,651.94",00.00,"9,04,756.85",
01-Jul-21,ATM,52,00.00,"9,04,808.85",
01-Jul-21,Tax,52,00.00,"9,04,860.85",
01-Jul-21,RTGS,"10,529.70",00.00,"9,15,390.55",
01-Jul-21,IMPS,02.10,00.00,"9,15,392.65",
01-Jul-21,Commission,00.00,"4,57,696.33","4,57,696.32",
01-Jul-21,Bill,204.7,00.00,"4,57,901.02",
01-Jul-21,Reversal,"74,208.00",00.00,"5,32,109.02",
01-Jul-21,Cash,00.00,"2,66,054.51","2,66,054.51",
01-Jul-21,Bill,"11,62,181.20",00.00,"14,28,235.71",
01-Jul-21,Commission,00.00,"2,38,039.29","11,90,196.42",
01-Jul-21,Bill,00.00,"1,19,019.64","10,71,176.78",
01-Jul-21,Transportellaneous,00.00,"1,78,529.46","8,92,647.32",
01-Jul-21,ATM,00.00,"1,78,529.46","7,14,117.86",
01-Jul-21,Purchase,"2,378.96",00.00,"7,16,496.82",
01-Jul-21,Commission,04.56,00.00,"7,16,501.38",
01-Jul-21,Commission,237,00.00,"7,16,738.38",
01-Jul-21,Reversal,00.00,"3,58,369.19","3,58,369.19",
02-Jul-21,Bill,00.00,"39,818.80","3,18,550.39",
02-Jul-21,ATM,01.07,00.00,"3,18,551.46",
02-Jul-21,IMPS,00.00,"45,507.35","2,73,044.11",
02-Jul-21,NEFT,00.00,"34,130.51","2,38,913.60",
02-Jul-21,Cheque,"2,975.50",00.00,"2,41,889.10",
02-Jul-21,Interest,07.47,00.00,"2,41,896.57",
02-Jul-21,Interest,153,00.00,"2,42,049.57",
02-Jul-21,Commission,"75,122.00",00.00,"3,17,171.57",
02-Jul-21,Interest,00.00,"3,17,171.57",00.00,
02-Jul-21,Reversal,"13,189.00",00.00,"13,189.00",
02-Jul-21,Interest,00.00,00.00,"13,189.00",
02-Jul-21,IMPS,245.88,00.00,"13,434.88",
02-Jul-21,Tax,00.00,"1,492.76","11,942.12",
02-Jul-21,Cheque,00.00,"1,326.90","10,615.22",
02-Jul-21,Transfer,00.00,"1,179.47","9,435.75",
02-Jul-21,RTGS,"1,580.86",00.00,"11,016.61",
02-Jul-21,RTGS,00.00,"1,573.80","9,442.81",
02-Jul-21,RTGS,"12,48,901.00",00.00,"12,58,343.81",
02-Jul-21,Bill,00.00,"2,51,668.76","10,06,675.05",
02-Jul-21,Debit Card,20,00.00,"10,06,695.05",
02-Jul-21,Cheque,"5,098.00",00.00,"10,11,793.05",
02-Jul-21,ATM,00.00,"2,02,358.61","8,09,434.44",
02-Jul-21,Tax,00.00,"1,15,633.49","6,93,800.95",
02-Jul-21,ATM,00.00,"99,114.42","5,94,686.53",
02-Jul-21,Cheque,"10,13,559.00",00.00,"16,08,245.53",
02-Jul-21,Debit Card,"25,785.17",00.00,"16,34,030.70",
02-Jul-21,Bill,155.8,00.00,"16,34,186.50",
02-Jul-21,Tax,00.00,"8,17,093.25","8,17,093.25",
02-Jul-21,NEFT,00.00,"8,17,093.25",00.00,
02-Jul-21,Transfer,"11,07,741.75",00.00,"11,07,741.75",
02-Jul-21,Transportellaneous,00.00,"2,76,935.44","8,30,806.31",
02-Jul-21,Purchase,00.00,"1,18,686.62","7,12,119.69",
02-Jul-21,Debit Card,00.00,"1,18,686.62","5,93,433.07",
02-Jul-21,NEFT,"6,30,929.00",00.00,"12,24,362.07",
02-Jul-21,Bill,00.00,"6,12,181.04","6,12,181.04",
02-Jul-21,Cheque,70,00.00,"6,12,251.04",
02-Jul-21,RTGS,00.00,"1,02,041.84","5,10,209.20",
02-Jul-21,Cash,"23,764.50",00.00,"5,33,973.70",
02-Jul-21,RTGS,"1,171.90",00.00,"5,35,145.60",
02-Jul-21,IMPS,"16,89,897.20",00.00,"22,25,042.80",
02-Jul-21,Bill,00.00,"7,41,680.93","14,83,361.87",
03-Jul-21,Purchase,"14,92,311.00",00.00,"29,75,672.87",
03-Jul-21,Commission,"1,06,262.56",00.00,"30,81,935.43",
03-Jul-21,Interest,"1,552.34",00.00,"30,83,487.77",
03-Jul-21,ATM,29.02,00.00,"30,83,516.79",
03-Jul-21,Interest,00.00,"7,70,879.20","23,12,637.59",
03-Jul-21,Transfer,"17,75,632.00",00.00,"40,88,269.59",
03-Jul-21,Tax,00.00,"40,88,269.59",00.00,
03-Jul-21,RTGS,"2,53,467.00",00.00,"2,53,467.00",
03-Jul-21,Commission,00.00,"28,163.00","2,25,304.00",
03-Jul-21,Tax,00.00,"32,186.29","1,93,117.71",
03-Jul-21,Purchase,00.00,"21,457.52","1,71,660.19",
03-Jul-21,Debit Card,00.00,"17,166.02","1,54,494.17",
03-Jul-21,RTGS,00.00,"22,070.60","1,32,423.57",
03-Jul-21,Purchase,02.40,00.00,"1,32,425.97",
03-Jul-21,Commission,00.00,"16,553.25","1,15,872.72",
03-Jul-21,ATM,00.00,"19,312.12","96,560.60",
03-Jul-21,Debit Card,"2,01,932.00",00.00,"2,98,492.60",
03-Jul-21,Interest,"20,61,280.50",00.00,"23,59,773.10",
03-Jul-21,NEFT,200,00.00,"23,59,973.10",
03-Jul-21,NEFT,00.00,"4,71,994.62","18,87,978.48",
03-Jul-21,IMPS,00.00,"2,35,997.31","16,51,981.17",
03-Jul-21,Cash,00.00,"8,25,990.59","8,25,990.58",
03-Jul-21,Cash,"8,24,731.25",00.00,"16,50,721.83",
03-Jul-21,IMPS,00.00,"8,25,360.92","8,25,360.92",
03-Jul-21,Cheque,"2,14,101.10",00.00,"10,39,462.02",
03-Jul-21,Cheque,"25,244.90",00.00,"10,64,706.92",
03-Jul-21,ATM,00.00,"10,64,706.92",00.00,
03-Jul-21,Commission,"2,737.00",00.00,"2,737.00",
03-Jul-21,Cash,"12,77,372.00",00.00,"12,80,109.00",
03-Jul-21,ATM,"1,108.20",00.00,"12,81,217.20",
04-Jul-21,NEFT,353,00.00,"12,81,570.20",
04-Jul-21,Interest,"2,50,527.38",00.00,"15,32,097.58",
04-Jul-21,Debit Card,"11,67,726.80",00.00,"26,99,824.38",
04-Jul-21,Interest,00.00,"3,85,689.20","23,14,135.18",
05-Jul-21,Interest,00.00,"7,71,378.39","15,42,756.79",
05-Jul-21,IMPS,"9,37,478.00",00.00,"24,80,234.79",
05-Jul-21,Transportellaneous,"1,749.00",00.00,"24,81,983.79",
05-Jul-21,Bill,342,00.00,"24,82,325.79",
05-Jul-21,RTGS,348.15,00.00,"24,82,673.94",
05-Jul-21,Purchase,00.00,"4,13,778.99","20,68,894.95",
05-Jul-21,ATM,"3,337.35",00.00,"20,72,232.30",
05-Jul-21,ATM,"97,068.00",00.00,"21,69,300.30",
05-Jul-21,Tax,00.00,"3,61,550.05","18,07,750.25",
05-Jul-21,RTGS,"20,64,636.00",00.00,"38,72,386.25",
05-Jul-21,Cash,"13,49,704.00",00.00,"52,22,090.25",
05-Jul-21,Commission,414,00.00,"52,22,504.25",
05-Jul-21,IMPS,00.00,"7,46,072.04","44,76,432.21",
05-Jul-21,Transfer,00.00,"6,39,490.32","38,36,941.89",
05-Jul-21,RTGS,"1,74,287.34",00.00,"40,11,229.23",
05-Jul-21,Debit Card,00.00,"20,05,614.62","20,05,614.62",
05-Jul-21,Reversal,00.00,"20,05,614.62",00.00,
05-Jul-21,ATM,"1,83,118.25",00.00,"1,83,118.25",
05-Jul-21,Purchase,00.00,"18,311.83","1,64,806.42",
05-Jul-21,Transportellaneous,"8,30,227.50",00.00,"9,95,033.92",
05-Jul-21,Cash,00.00,"9,95,033.92",00.00,
05-Jul-21,Reversal,03.00,00.00,03.00,
05-Jul-21,IMPS,00.00,00.60,02.40,
05-Jul-21,Cash,00.00,00.80,01.60,
05-Jul-21,RTGS,"1,61,071.00",00.00,"1,61,072.60",
05-Jul-21,Reversal,00.00,"53,690.87","1,07,381.73",
05-Jul-21,RTGS,00.00,"26,845.43","80,536.30",
05-Jul-21,Tax,00.00,"10,067.04","70,469.26",
05-Jul-21,RTGS,"1,80,107.16",00.00,"2,50,576.42",
05-Jul-21,Reversal,00.00,"25,057.64","2,25,518.78",
05-Jul-21,IMPS,"22,550.10",00.00,"2,48,068.88",
05-Jul-21,ATM,212.09,00.00,"2,48,280.97",
05-Jul-21,Cheque,"3,278.93",00.00,"2,51,559.90",
05-Jul-21,Commission,"1,51,579.80",00.00,"4,03,139.70",
05-Jul-21,IMPS,"2,43,291.00",00.00,"6,46,430.70",
05-Jul-21,Tax,00.00,"3,23,215.35","3,23,215.35",
05-Jul-21,Interest,37,00.00,"3,23,252.35",
05-Jul-21,ATM,02.82,00.00,"3,23,255.17",
05-Jul-21,RTGS,16.6,00.00,"3,23,271.77",
05-Jul-21,Transfer,"7,81,242.50",00.00,"11,04,514.27",
05-Jul-21,NEFT,00.00,"3,68,171.42","7,36,342.85",
05-Jul-21,Reversal,00.00,"81,815.87","6,54,526.98",
05-Jul-21,Interest,"4,86,239.75",00.00,"11,40,766.73",
05-Jul-21,Debit Card,"2,47,818.69",00.00,"13,88,585.42",
05-Jul-21,Cash,00.00,"1,38,858.54","12,49,726.88",
05-Jul-21,ATM,174,00.00,"12,49,900.88",
05-Jul-21,Commission,01.76,00.00,"12,49,902.64",
05-Jul-21,Cash,138,00.00,"12,50,040.64",
05-Jul-21,Cheque,00.00,"1,56,255.08","10,93,785.56",
05-Jul-21,Transportellaneous,03.00,00.00,"10,93,788.56",
05-Jul-21,Cash,476.4,00.00,"10,94,264.96",
05-Jul-21,NEFT,00.00,"1,09,426.50","9,84,838.46",
05-Jul-21,Debit Card,"1,506.40",00.00,"9,86,344.86",
05-Jul-21,RTGS,"3,731.73",00.00,"9,90,076.59",
05-Jul-21,Interest,00.00,"1,10,008.51","8,80,068.08",
05-Jul-21,Cash,00.00,"1,76,013.62","7,04,054.46",
05-Jul-21,Tax,00.00,"1,40,810.89","5,63,243.57",
05-Jul-21,IMPS,00.00,"5,63,243.57",00.00,
05-Jul-21,IMPS,"2,55,101.50",00.00,"2,55,101.50",
05-Jul-21,Bill,"7,580.02",00.00,"2,62,681.52",
05-Jul-21,Tax,"1,43,934.00",00.00,"4,06,615.52",
05-Jul-21,Commission,"1,698.67",00.00,"4,08,314.19",
06-Jul-21,Transportellaneous,00.00,"45,368.24","3,62,945.95",
06-Jul-21,Cheque,00.00,"60,490.99","3,02,454.96",
06-Jul-21,RTGS,"17,26,580.00",00.00,"20,29,034.96",
06-Jul-21,RTGS,00.00,"3,38,172.49","16,90,862.47",
06-Jul-21,Interest,286,00.00,"16,91,148.47",
06-Jul-21,Transportellaneous,00.00,"1,87,905.39","15,03,243.08",
06-Jul-21,Debit Card,"16,998.00",00.00,"15,20,241.08",
06-Jul-21,Cash,00.00,"3,80,060.27","11,40,180.81",
06-Jul-21,NEFT,00.00,"1,14,018.08","10,26,162.73",
06-Jul-21,Reversal,"1,651.00",00.00,"10,27,813.73",
06-Jul-21,ATM,00.00,"2,05,562.75","8,22,250.98",
06-Jul-21,Cheque,00.00,"2,74,083.66","5,48,167.32",
06-Jul-21,NEFT,01.00,00.00,"5,48,168.32",
06-Jul-21,IMPS,"9,52,238.00",00.00,"15,00,406.32",
06-Jul-21,Reversal,34.5,00.00,"15,00,440.82",
06-Jul-21,Bill,"9,70,391.00",00.00,"24,70,831.82",
06-Jul-21,Transportellaneous,00.00,"12,35,415.91","12,35,415.91",
06-Jul-21,Cash,00.00,"6,17,707.96","6,17,707.95",
06-Jul-21,Commission,01.93,00.00,"6,17,709.88",
06-Jul-21,ATM,03.00,00.00,"6,17,712.88",
06-Jul-21,Bill,208.72,00.00,"6,17,921.60",
06-Jul-21,Cheque,"1,70,168.44",00.00,"7,88,090.04",
06-Jul-21,Cash,00.00,"3,94,045.02","3,94,045.02",
06-Jul-21,Transportellaneous,291,00.00,"3,94,336.02",
06-Jul-21,ATM,00.00,"39,433.60","3,54,902.42",
06-Jul-21,Interest,"10,056.00",00.00,"3,64,958.42",
06-Jul-21,RTGS,"1,273.00",00.00,"3,66,231.42",
06-Jul-21,Transfer,00.00,"45,778.93","3,20,452.49",
06-Jul-21,Tax,02.55,00.00,"3,20,455.04",
06-Jul-21,Interest,"1,873.17",00.00,"3,22,328.21",
07-Jul-21,Bill,13,00.00,"3,22,341.21",
07-Jul-21,NEFT,00.00,"32,234.12","2,90,107.09",
07-Jul-21,Interest,00.00,"32,234.12","2,57,872.97",
07-Jul-21,Transportellaneous,"2,06,146.60",00.00,"4,64,019.57",
07-Jul-21,Tax,03.00,00.00,"4,64,022.57",
07-Jul-21,Transportellaneous,02.00,00.00,"4,64,024.57",
07-Jul-21,Transportellaneous,00.00,"4,64,024.57",00.00,
07-Jul-21,Cheque,447,00.00,447,
07-Jul-21,RTGS,"1,088.60",00.00,"1,535.60",
07-Jul-21,Commission,00.00,"1,535.60",00.00,
07-Jul-21,RTGS,04.60,00.00,04.60,
07-Jul-21,Cash,00.00,01.53,03.07,
07-Jul-21,Cheque,55,00.00,58.07,
07-Jul-21,Reversal,"2,61,104.00",00.00,"2,61,162.07",
07-Jul-21,Interest,07.00,00.00,"2,61,169.07",
07-Jul-21,Debit Card,00.00,"2,61,169.07",00.00,
07-Jul-21,Cash,"2,16,405.20",00.00,"2,16,405.20",
07-Jul-21,Reversal,00.00,"27,050.65","1,89,354.55",
07-Jul-21,Purchase,20,00.00,"1,89,374.55",
07-Jul-21,Reversal,26.92,00.00,"1,89,401.47",
07-Jul-21,Tax,00.00,"47,350.37","1,42,051.10",
07-Jul-21,Tax,00.00,"28,410.22","1,13,640.88",
07-Jul-21,Reversal,00.00,"56,820.44","56,820.44",
07-Jul-21,ATM,00.00,"28,410.22","28,410.22",
07-Jul-21,Transportellaneous,03.16,00.00,"28,413.38",
07-Jul-21,Transportellaneous,00.00,"28,413.38",00.00,
07-Jul-21,NEFT,"96,097.10",00.00,"96,097.10",
07-Jul-21,NEFT,00.00,"12,012.14","84,084.96",
07-Jul-21,Tax,00.00,"8,408.50","75,676.46",
07-Jul-21,Bill,922.5,00.00,"76,598.96",
07-Jul-21,Cash,00.00,"38,299.48","38,299.48",
07-Jul-21,Reversal,"47,286.19",00.00,"85,585.67",
07-Jul-21,Transportellaneous,00.00,"9,509.52","76,076.15",
07-Jul-21,Cheque,165.77,00.00,"76,241.92",
07-Jul-21,Cash,"9,799.23",00.00,"86,041.15",
07-Jul-21,Tax,"2,25,101.56",00.00,"3,11,142.71",
07-Jul-21,Cash,16,00.00,"3,11,158.71",
07-Jul-21,Cheque,19.1,00.00,"3,11,177.81",
07-Jul-21,Purchase,107.9,00.00,"3,11,285.71",
08-Jul-21,Reversal,00.00,"51,880.95","2,59,404.76",
08-Jul-21,RTGS,"2,312.39",00.00,"2,61,717.15",
08-Jul-21,ATM,00.00,"2,61,717.15",00.00,
08-Jul-21,Interest,"2,45,603.00",00.00,"2,45,603.00",
08-Jul-21,Purchase,00.00,"40,933.83","2,04,669.17",
08-Jul-21,Interest,462.2,00.00,"2,05,131.37",
08-Jul-21,Transportellaneous,"2,14,155.50",00.00,"4,19,286.87",
08-Jul-21,Reversal,57.66,00.00,"4,19,344.53",
08-Jul-21,IMPS,05.00,00.00,"4,19,349.53",
08-Jul-21,Commission,"1,06,717.66",00.00,"5,26,067.19",
08-Jul-21,Interest,"31,657.11",00.00,"5,57,724.30",
08-Jul-21,Cash,"1,451.00",00.00,"5,59,175.30",
08-Jul-21,Purchase,00.00,"55,917.53","5,03,257.77",
08-Jul-21,Purchase,00.00,"55,917.53","4,47,340.24",
08-Jul-21,Debit Card,"52,410.20",00.00,"4,99,750.44",
08-Jul-21,Cheque,07.00,00.00,"4,99,757.44",
08-Jul-21,Cash,00.00,"2,49,878.72","2,49,878.72",
08-Jul-21,Purchase,57.9,00.00,"2,49,936.62",
08-Jul-21,IMPS,00.00,"83,312.21","1,66,624.41",
08-Jul-21,Reversal,448,00.00,"1,67,072.41",
09-Jul-21,Bill,"1,04,925.80",00.00,"2,71,998.21",
09-Jul-21,Transportellaneous,05.70,00.00,"2,72,003.91",
09-Jul-21,Reversal,"2,41,096.00",00.00,"5,13,099.91",
09-Jul-21,Debit Card,"22,822.00",00.00,"5,35,921.91",
09-Jul-21,Interest,00.00,"2,67,960.96","2,67,960.96",
09-Jul-21,Purchase,00.00,"29,773.44","2,38,187.52",
09-Jul-21,Commission,00.00,"2,38,187.52",00.00,
09-Jul-21,Interest,00.60,00.00,00.60,
09-Jul-21,Transportellaneous,33,00.00,33.6,
09-Jul-21,Purchase,"36,615.53",00.00,"36,649.13",
09-Jul-21,Bill,245.77,00.00,"36,894.90",
09-Jul-21,Cash,00.00,"4,611.86","32,283.04",
09-Jul-21,Debit Card,00.00,"3,587.00","28,696.04",
09-Jul-21,Reversal,00.00,"14,348.02","14,348.02",
09-Jul-21,NEFT,"20,45,929.00",00.00,"20,60,277.02",
09-Jul-21,Commission,"16,28,460.80",00.00,"36,88,737.82",
09-Jul-21,Reversal,00.00,"18,44,368.91","18,44,368.91",
09-Jul-21,Reversal,"2,431.60",00.00,"18,46,800.51",
09-Jul-21,Debit Card,00.00,"3,69,360.10","14,77,440.41",
09-Jul-21,Cash,"8,479.00",00.00,"14,85,919.41",
09-Jul-21,Bill,364.86,00.00,"14,86,284.27",
09-Jul-21,Commission,102.5,00.00,"14,86,386.77",
09-Jul-21,Cheque,00.00,"1,65,154.09","13,21,232.68",
09-Jul-21,IMPS,00.00,"13,21,232.68",00.00,
09-Jul-21,Debit Card,"1,779.00",00.00,"1,779.00",
09-Jul-21,Cheque,21.6,00.00,"1,800.60",
09-Jul-21,IMPS,00.00,360.12,"1,440.48",
09-Jul-21,Commission,23.6,00.00,"1,464.08",
09-Jul-21,Cash,00.00,292.82,"1,171.26",
09-Jul-21,Transportellaneous,04.00,00.00,"1,175.26",
09-Jul-21,Commission,05.40,00.00,"1,180.66",
09-Jul-21,Tax,14.9,00.00,"1,195.56",
09-Jul-21,Tax,"2,811.00",00.00,"4,006.56",
09-Jul-21,Debit Card,00.00,667.76,"3,338.80",
09-Jul-21,Purchase,"6,714.00",00.00,"10,052.80",
09-Jul-21,Tax,00.00,"10,052.80",00.00,
09-Jul-21,Debit Card,"2,46,881.50",00.00,"2,46,881.50",
09-Jul-21,Debit Card,00.00,"35,268.79","2,11,612.71",
09-Jul-21,IMPS,00.00,"26,451.59","1,85,161.12",
09-Jul-21,Cash,"18,60,094.75",00.00,"20,45,255.87",
09-Jul-21,Purchase,"1,37,828.00",00.00,"21,83,083.87",
09-Jul-21,Tax,253,00.00,"21,83,336.87",
09-Jul-21,ATM,00.00,"3,63,889.48","18,19,447.39",
09-Jul-21,IMPS,"1,564.16",00.00,"18,21,011.55",
09-Jul-21,Purchase,"18,22,072.00",00.00,"36,43,083.55",
09-Jul-21,Cash,06.54,00.00,"36,43,090.09",
09-Jul-21,Commission,00.00,"5,20,441.44","31,22,648.65",
09-Jul-21,RTGS,429.95,00.00,"31,23,078.60",
09-Jul-21,NEFT,"16,95,602.50",00.00,"48,18,681.10",
09-Jul-21,IMPS,"19,50,650.25",00.00,"67,69,331.35",
09-Jul-21,Cheque,"22,424.00",00.00,"67,91,755.35",
09-Jul-21,Debit Card,59.77,00.00,"67,91,815.12",
09-Jul-21,Interest,"6,868.20",00.00,"67,98,683.32",
09-Jul-21,Debit Card,953,00.00,"67,99,636.32",
09-Jul-21,Purchase,"38,079.00",00.00,"68,37,715.32",
09-Jul-21,Transfer,00.00,"34,18,857.66","34,18,857.66",
09-Jul-21,RTGS,"1,67,753.00",00.00,"35,86,610.66",
09-Jul-21,Transfer,360,00.00,"35,86,970.66",
09-Jul-21,Cheque,"7,024.20",00.00,"35,93,994.86",
09-Jul-21,Transportellaneous,00.00,"8,98,498.72","26,95,496.14",
09-Jul-21,Transportellaneous,445.7,00.00,"26,95,941.84",
09-Jul-21,Reversal,203.42,00.00,"26,96,145.26",
09-Jul-21,Debit Card,00.00,"8,98,715.09","17,97,430.17",
09-Jul-21,Cash,12.1,00.00,"17,97,442.27",
09-Jul-21,Cheque,00.00,"4,49,360.57","13,48,081.70",
09-Jul-21,Transportellaneous,"19,91,942.25",00.00,"33,40,023.95",
09-Jul-21,RTGS,00.00,"11,13,341.32","22,26,682.63",
09-Jul-21,Commission,05.00,00.00,"22,26,687.63",
09-Jul-21,Interest,00.00,"2,47,409.74","19,79,277.89",
09-Jul-21,Cash,00.00,"19,79,277.89",00.00,
09-Jul-21,RTGS,"10,199.50",00.00,"10,199.50",
09-Jul-21,NEFT,"1,27,171.00",00.00,"1,37,370.50",
09-Jul-21,ATM,318,00.00,"1,37,688.50",
09-Jul-21,Tax,"1,20,172.00",00.00,"2,57,860.50",
10-Jul-21,Interest,00.00,"85,953.50","1,71,907.00",
10-Jul-21,Transportellaneous,"2,39,149.20",00.00,"4,11,056.20",
10-Jul-21,Reversal,00.00,"1,02,764.05","3,08,292.15",
10-Jul-21,Reversal,00.00,"1,02,764.05","2,05,528.10",
10-Jul-21,Bill,53.12,00.00,"2,05,581.22",
10-Jul-21,RTGS,00.00,"22,842.36","1,82,738.86",
10-Jul-21,Cash,00.00,"60,912.95","1,21,825.91",
10-Jul-21,Interest,00.00,"17,403.70","1,04,422.21",
10-Jul-21,Bill,"4,84,068.00",00.00,"5,88,490.21",
10-Jul-21,Commission,00.00,"84,070.03","5,04,420.18",
10-Jul-21,RTGS,00.00,"56,046.69","4,48,373.49",
10-Jul-21,Bill,02.00,00.00,"4,48,375.49",
10-Jul-21,Transportellaneous,00.00,"64,053.64","3,84,321.85",
10-Jul-21,ATM,"1,14,916.00",00.00,"4,99,237.85",
10-Jul-21,ATM,02.50,00.00,"4,99,240.35",
10-Jul-21,Debit Card,41.7,00.00,"4,99,282.05",
10-Jul-21,Transfer,"12,25,306.00",00.00,"17,24,588.05",
10-Jul-21,ATM,"20,211.80",00.00,"17,44,799.85",
10-Jul-21,Interest,"19,599.44",00.00,"17,64,399.29",
10-Jul-21,Cheque,00.00,"2,94,066.55","14,70,332.74",
10-Jul-21,Cheque,05.63,00.00,"14,70,338.37",
10-Jul-21,Reversal,04.00,00.00,"14,70,342.37",
10-Jul-21,Bill,00.00,"4,90,114.12","9,80,228.25",
10-Jul-21,Debit Card,00.00,"4,90,114.13","4,90,114.12",
10-Jul-21,NEFT,"2,58,314.00",00.00,"7,48,428.12",
11-Jul-21,ATM,00.00,"1,06,918.30","6,41,509.82",
11-Jul-21,NEFT,00.00,"6,41,509.82",00.00,
11-Jul-21,ATM,55.71,00.00,55.71,
11-Jul-21,Commission,00.00,13.93,41.78,
12-Jul-21,Transfer,00.00,05.97,35.81,
12-Jul-21,Interest,00.00,05.97,29.84,
13-Jul-21,ATM,37,00.00,66.84,
13-Jul-21,Commission,00.00,16.71,50.13,
13-Jul-21,Transfer,"19,024.20",00.00,"19,074.33",
13-Jul-21,Reversal,00.00,"1,907.43","17,166.90",
13-Jul-21,Transfer,02.22,00.00,"17,169.12",
13-Jul-21,IMPS,"4,81,137.00",00.00,"4,98,306.12",
13-Jul-21,Bill,05.10,00.00,"4,98,311.22",
13-Jul-21,Cheque,742.1,00.00,"4,99,053.32",
13-Jul-21,Reversal,00.00,"83,175.55","4,15,877.77",
13-Jul-21,Cash,"17,87,836.00",00.00,"22,03,713.77",
13-Jul-21,Debit Card,00.00,"7,34,571.26","14,69,142.51",
13-Jul-21,Purchase,"83,832.00",00.00,"15,52,974.51",
14-Jul-21,Reversal,00.00,"15,52,974.51",00.00,
14-Jul-21,Transportellaneous,00.00,00.00,00.00,
14-Jul-21,Tax,39.8,00.00,39.8,
14-Jul-21,ATM,"4,16,504.00",00.00,"4,16,543.80",
14-Jul-21,NEFT,00.00,"41,654.38","3,74,889.42",
14-Jul-21,Transfer,07.20,00.00,"3,74,896.62",
14-Jul-21,IMPS,00.00,"41,655.18","3,33,241.44",
14-Jul-21,Bill,00.00,"37,026.83","2,96,214.61",
14-Jul-21,IMPS,00.00,"49,369.10","2,46,845.51",
14-Jul-21,NEFT,384,00.00,"2,47,229.51",
14-Jul-21,Interest,00.00,"27,469.95","2,19,759.56",
14-Jul-21,Cheque,07.70,00.00,"2,19,767.26",
14-Jul-21,RTGS,00.00,"24,418.58","1,95,348.68",
14-Jul-21,Commission,00.00,"97,674.34","97,674.34",
14-Jul-21,Tax,"30,550.30",00.00,"1,28,224.64",
15-Jul-21,Bill,32.1,00.00,"1,28,256.74",
16-Jul-21,ATM,00.00,"16,032.09","1,12,224.65",
16-Jul-21,ATM,"16,20,371.00",00.00,"17,32,595.65",
16-Jul-21,Cash,00.00,"17,32,595.65",00.00,
16-Jul-21,Commission,338,00.00,338,
16-Jul-21,Transfer,00.00,37.56,300.44,
16-Jul-21,IMPS,04.68,00.00,305.12,
16-Jul-21,IMPS,313.73,00.00,618.85,
16-Jul-21,NEFT,"11,31,903.50",00.00,"11,32,522.35",
16-Jul-21,Purchase,00.00,"1,88,753.73","9,43,768.63",
16-Jul-21,Interest,00.00,"1,34,824.09","8,08,944.54",
16-Jul-21,RTGS,"2,28,402.00",00.00,"10,37,346.54",
16-Jul-21,Transportellaneous,00.00,"2,07,469.31","8,29,877.23",
16-Jul-21,Bill,160.09,00.00,"8,30,037.32",
16-Jul-21,NEFT,153,00.00,"8,30,190.32",
16-Jul-21,Reversal,"7,62,911.75",00.00,"15,93,102.07",
16-Jul-21,Interest,00.00,"3,18,620.41","12,74,481.66",
16-Jul-21,Interest,17,00.00,"12,74,498.66",
16-Jul-21,Cash,00.00,"12,74,498.66",00.00,
16-Jul-21,ATM,29.87,00.00,29.87,
16-Jul-21,Cheque,00.00,29.87,00.00,
16-Jul-21,Cheque,"1,213.45",00.00,"1,213.45",
16-Jul-21,Tax,00.00,151.68,"1,061.77",
16-Jul-21,Cheque,"2,31,908.72",00.00,"2,32,970.49",
16-Jul-21,NEFT,00.00,"23,297.05","2,09,673.44",
16-Jul-21,IMPS,00.00,"52,418.36","1,57,255.08",
17-Jul-21,Bill,00.00,"78,627.54","78,627.54",
17-Jul-21,Reversal,77,00.00,"78,704.54",
17-Jul-21,Debit Card,00.00,"19,676.14","59,028.40",
17-Jul-21,Interest,07.00,00.00,"59,035.40",
17-Jul-21,Interest,05.00,00.00,"59,040.40",
17-Jul-21,Transportellaneous,00.00,"29,520.20","29,520.20",
17-Jul-21,Cash,61,00.00,"29,581.20",
17-Jul-21,Debit Card,04.47,00.00,"29,585.67",
17-Jul-21,IMPS,00.00,"14,792.84","14,792.84",
17-Jul-21,ATM,31.8,00.00,"14,824.64",
17-Jul-21,NEFT,486.3,00.00,"15,310.94",
17-Jul-21,Transportellaneous,"16,181.00",00.00,"31,491.94",
17-Jul-21,Transportellaneous,00.00,"3,936.49","27,555.45",
17-Jul-21,Tax,00.00,"9,185.15","18,370.30",
17-Jul-21,Reversal,51,00.00,"18,421.30",
17-Jul-21,NEFT,"2,47,498.91",00.00,"2,65,920.21",
17-Jul-21,Tax,00.00,"33,240.03","2,32,680.18",
17-Jul-21,Transfer,00.00,"58,170.05","1,74,510.14",
17-Jul-21,Reversal,"1,74,874.30",00.00,"3,49,384.44",
17-Jul-21,Purchase,"23,960.41",00.00,"3,73,344.85",
17-Jul-21,Transfer,00.00,"93,336.21","2,80,008.64",
17-Jul-21,Reversal,00.00,"31,112.07","2,48,896.57",
17-Jul-21,Commission,470.2,00.00,"2,49,366.77",
17-Jul-21,Transfer,00.00,"31,170.85","2,18,195.92",
17-Jul-21,Transportellaneous,271.8,00.00,"2,18,467.72",
17-Jul-21,RTGS,370,00.00,"2,18,837.72",
17-Jul-21,Tax,00.00,"31,262.53","1,87,575.19",
17-Jul-21,NEFT,252.59,00.00,"1,87,827.78",
17-Jul-21,Reversal,"27,291.50",00.00,"2,15,119.28",
17-Jul-21,ATM,25.66,00.00,"2,15,144.94",
17-Jul-21,RTGS,"94,340.00",00.00,"3,09,484.94",
17-Jul-21,Reversal,00.00,"51,580.82","2,57,904.12",
17-Jul-21,Commission,339.13,00.00,"2,58,243.25",
17-Jul-21,Transportellaneous,05.00,00.00,"2,58,248.25",
17-Jul-21,Bill,84.81,00.00,"2,58,333.06",
17-Jul-21,Purchase,00.00,"25,833.31","2,32,499.75",
17-Jul-21,Reversal,00.00,"23,249.98","2,09,249.78",
17-Jul-21,Interest,303.1,00.00,"2,09,552.88",
17-Jul-21,Cash,01.28,00.00,"2,09,554.16",
17-Jul-21,Reversal,485.77,00.00,"2,10,039.93",
17-Jul-21,Cheque,210,00.00,"2,10,249.93",
17-Jul-21,Debit Card,00.00,"26,281.24","1,83,968.69",
17-Jul-21,Interest,464.8,00.00,"1,84,433.49",
17-Jul-21,Tax,00.00,"46,108.37","1,38,325.12",
17-Jul-21,Cash,00.00,"27,665.02","1,10,660.10",
17-Jul-21,Interest,00.00,"12,295.57","98,364.53",
17-Jul-21,Cash,"16,160.74",00.00,"1,14,525.27",
17-Jul-21,Reversal,"2,20,655.20",00.00,"3,35,180.47",
17-Jul-21,Commission,00.00,"83,795.12","2,51,385.35",
17-Jul-21,Commission,00.00,"31,423.17","2,19,962.18",
18-Jul-21,Purchase,00.00,"27,495.27","1,92,466.91",
18-Jul-21,RTGS,00.00,"32,077.82","1,60,389.09",
18-Jul-21,NEFT,00.00,"22,912.73","1,37,476.36",
18-Jul-21,Interest,02.60,00.00,"1,37,478.96",
18-Jul-21,RTGS,33.64,00.00,"1,37,512.60",
18-Jul-21,IMPS,00.00,"45,837.53","91,675.07",
18-Jul-21,RTGS,00.00,"45,837.54","45,837.54",
18-Jul-21,NEFT,572,00.00,"46,409.54",
18-Jul-21,Interest,00.00,"6,629.93","39,779.61",
18-Jul-21,Interest,02.19,00.00,"39,781.80",
18-Jul-21,IMPS,00.00,"3,978.18","35,803.62",
18-Jul-21,Cash,"5,637.34",00.00,"41,440.96",
18-Jul-21,Transportellaneous,07.90,00.00,"41,448.86",
18-Jul-21,Interest,00.00,"4,605.43","36,843.43",
18-Jul-21,Purchase,00.00,"36,843.43",00.00,
18-Jul-21,Interest,102.74,00.00,102.74,
18-Jul-21,ATM,497.7,00.00,600.44,
18-Jul-21,Interest,363.5,00.00,963.94,
18-Jul-21,Transportellaneous,00.00,96.39,867.55,
18-Jul-21,Reversal,00.00,216.89,650.66,
18-Jul-21,Cash,00.00,72.3,578.36,
18-Jul-21,Transfer,"1,84,380.00",00.00,"1,84,958.36",
18-Jul-21,Transfer,"44,387.40",00.00,"2,29,345.76",
18-Jul-21,Transportellaneous,00.00,"38,224.29","1,91,121.47",
18-Jul-21,Cheque,06.00,00.00,"1,91,127.47",
18-Jul-21,Transfer,00.00,"63,709.16","1,27,418.31",
18-Jul-21,Purchase,00.00,"18,202.62","1,09,215.69",
18-Jul-21,NEFT,00.00,"1,09,215.69",00.00,
18-Jul-21,Purchase,"7,79,656.00",00.00,"7,79,656.00",
18-Jul-21,Debit Card,00.00,"86,628.44","6,93,027.56",
18-Jul-21,Transportellaneous,01.10,00.00,"6,93,028.66",
18-Jul-21,Interest,00.00,"69,302.87","6,23,725.79",
18-Jul-21,Interest,"8,726.04",00.00,"6,32,451.83",
18-Jul-21,Debit Card,"1,32,329.30",00.00,"7,64,781.13",
18-Jul-21,Commission,00.00,"7,64,781.13",00.00,
18-Jul-21,NEFT,"1,70,412.97",00.00,"1,70,412.97",
18-Jul-21,RTGS,20.6,00.00,"1,70,433.57",
18-Jul-21,RTGS,00.00,"34,086.71","1,36,346.86",
19-Jul-21,Bill,00.00,"17,043.36","1,19,303.50",
19-Jul-21,IMPS,00.00,"23,860.70","95,442.80",
19-Jul-21,Transfer,00.00,"9,544.28","85,898.52",
20-Jul-21,Debit Card,00.00,"21,474.63","64,423.89",
20-Jul-21,Commission,"26,610.00",00.00,"91,033.89",
20-Jul-21,RTGS,00.00,"9,103.39","81,930.50",
20-Jul-21,Purchase,00.00,"16,386.10","65,544.40",
20-Jul-21,Tax,07.40,00.00,"65,551.80",
20-Jul-21,Tax,00.00,"65,551.80",00.00,
20-Jul-21,Transfer,"10,45,984.80",00.00,"10,45,984.80",
20-Jul-21,Tax,00.00,"1,04,598.48","9,41,386.32",
20-Jul-21,Debit Card,"49,302.20",00.00,"9,90,688.52",
20-Jul-21,Tax,00.00,"1,98,137.70","7,92,550.82",
20-Jul-21,Transfer,00.00,"88,061.20","7,04,489.62",
20-Jul-21,Debit Card,06.00,00.00,"7,04,495.62",
20-Jul-21,Cash,00.00,"1,17,415.94","5,87,079.68",
20-Jul-21,Transfer,00.00,"1,95,693.23","3,91,386.45",
20-Jul-21,Cash,00.00,"65,231.08","3,26,155.38",
20-Jul-21,Transportellaneous,00.00,"3,26,155.38",00.00,
20-Jul-21,Bill,"2,10,336.00",00.00,"2,10,336.00",
20-Jul-21,Transfer,00.00,"23,370.67","1,86,965.33",
20-Jul-21,Cheque,00.00,"31,160.89","1,55,804.44",
20-Jul-21,Debit Card,01.50,00.00,"1,55,805.94",
20-Jul-21,Commission,53.29,00.00,"1,55,859.23",
20-Jul-21,Interest,00.00,"15,585.92","1,40,273.31",
20-Jul-21,Purchase,"1,42,654.00",00.00,"2,82,927.31",
20-Jul-21,ATM,"2,27,290.50",00.00,"5,10,217.81",
20-Jul-21,IMPS,"7,54,658.25",00.00,"12,64,876.06",
20-Jul-21,RTGS,"7,10,644.00",00.00,"19,75,520.06",
20-Jul-21,ATM,00.00,"3,29,253.34","16,46,266.72",
20-Jul-21,Bill,00.00,"8,23,133.36","8,23,133.36",
20-Jul-21,NEFT,81,00.00,"8,23,214.36",
21-Jul-21,Debit Card,496.18,00.00,"8,23,710.54",
21-Jul-21,Cash,00.00,"1,64,742.11","6,58,968.43",
22-Jul-21,ATM,00.00,"3,29,484.22","3,29,484.22",
22-Jul-21,Debit Card,"1,52,745.03",00.00,"4,82,229.25",
22-Jul-21,Transfer,801.71,00.00,"4,83,030.96",
22-Jul-21,ATM,04.00,00.00,"4,83,034.96",
22-Jul-21,Commission,00.00,"1,20,758.74","3,62,276.22",
22-Jul-21,IMPS,00.00,"3,62,276.22",00.00,
22-Jul-21,Reversal,21,00.00,21,
22-Jul-21,Cash,00.00,03.00,18,
22-Jul-21,Commission,"1,29,280.80",00.00,"1,29,298.80",
22-Jul-21,IMPS,00.00,"18,471.26","1,10,827.54",
22-Jul-21,Reversal,"4,309.50",00.00,"1,15,137.04",
22-Jul-21,Transfer,00.00,"28,784.26","86,352.78",
22-Jul-21,IMPS,00.00,"10,794.10","75,558.68",
22-Jul-21,Interest,156.3,00.00,"75,714.98",
23-Jul-21,Commission,20.49,00.00,"75,735.47",
23-Jul-21,NEFT,00.00,"10,819.35","64,916.12",
23-Jul-21,Debit Card,00.00,"7,212.90","57,703.22",
23-Jul-21,IMPS,00.00,"6,411.47","51,291.75",
23-Jul-21,Bill,"2,103.30",00.00,"53,395.05",
23-Jul-21,Reversal,00.00,"17,798.35","35,596.70",
23-Jul-21,Transportellaneous,00.00,"5,085.24","30,511.46",
24-Jul-21,Tax,00.00,"3,390.16","27,121.30",
24-Jul-21,Transfer,00.00,"5,424.26","21,697.04",
24-Jul-21,Reversal,203,00.00,"21,900.04",
24-Jul-21,Interest,07.83,00.00,"21,907.87",
24-Jul-21,Commission,00.00,"2,434.21","19,473.66",
24-Jul-21,Reversal,00.00,"9,736.83","9,736.83",
24-Jul-21,Cash,00.00,"1,217.10","8,519.73",
24-Jul-21,Bill,00.00,"1,419.96","7,099.78",
24-Jul-21,Cash,07.00,00.00,"7,106.78",
24-Jul-21,Commission,"20,306.86",00.00,"27,413.64",
24-Jul-21,ATM,"17,98,090.75",00.00,"18,25,504.39",
24-Jul-21,Debit Card,03.48,00.00,"18,25,507.87",
24-Jul-21,Tax,00.00,"2,60,786.84","15,64,721.03",
24-Jul-21,Tax,"17,65,954.00",00.00,"33,30,675.03",
24-Jul-21,NEFT,00.00,"5,55,112.51","27,75,562.52",
24-Jul-21,Interest,706.9,00.00,"27,76,269.42",
24-Jul-21,Purchase,00.00,"5,55,253.88","22,21,015.54",
24-Jul-21,Transportellaneous,06.10,00.00,"22,21,021.64",
24-Jul-21,Commission,00.00,"5,55,255.41","16,65,766.23",
24-Jul-21,IMPS,209,00.00,"16,65,975.23",
24-Jul-21,ATM,868.9,00.00,"16,66,844.13",
24-Jul-21,NEFT,"3,167.11",00.00,"16,70,011.24",
24-Jul-21,RTGS,"9,89,220.00",00.00,"26,59,231.24",
24-Jul-21,Commission,"9,24,282.00",00.00,"35,83,513.24",
24-Jul-21,Reversal,00.00,"5,11,930.46","30,71,582.78",
24-Jul-21,Cheque,"55,444.00",00.00,"31,27,026.78",
24-Jul-21,NEFT,37,00.00,"31,27,063.78",
24-Jul-21,RTGS,"13,59,412.00",00.00,"44,86,475.78",
24-Jul-21,Commission,"1,00,908.00",00.00,"45,87,383.78",
24-Jul-21,Cheque,"3,576.34",00.00,"45,90,960.12",
24-Jul-21,Cash,53,00.00,"45,91,013.12",
24-Jul-21,Bill,39.4,00.00,"45,91,052.52",
24-Jul-21,Cash,00.00,"5,73,881.57","40,17,170.95",
24-Jul-21,RTGS,"1,32,555.12",00.00,"41,49,726.07",
24-Jul-21,Purchase,00.00,"13,83,242.02","27,66,484.05",
24-Jul-21,Transportellaneous,00.00,"3,95,212.01","23,71,272.04",
24-Jul-21,ATM,00.00,"2,96,409.01","20,74,863.04",
24-Jul-21,Reversal,02.50,00.00,"20,74,865.54",
24-Jul-21,RTGS,00.00,"20,74,865.54",00.00,
24-Jul-21,ATM,"3,68,421.50",00.00,"3,68,421.50",
24-Jul-21,Bill,00.00,"3,68,421.50",00.00,
24-Jul-21,Cash,"14,394.23",00.00,"14,394.23",
25-Jul-21,Bill,26.81,00.00,"14,421.04",
25-Jul-21,RTGS,00.00,"2,884.21","11,536.83",
25-Jul-21,Cash,"7,337.88",00.00,"18,874.71",
25-Jul-21,Bill,"16,420.00",00.00,"35,294.71",
25-Jul-21,Cash,00.00,"3,921.63","31,373.08",
25-Jul-21,Reversal,436.95,00.00,"31,810.03",
26-Jul-21,Transfer,00.00,"3,181.00","28,629.03",
26-Jul-21,Purchase,00.00,"28,629.03",00.00,
26-Jul-21,Transportellaneous,"1,27,109.10",00.00,"1,27,109.10",
26-Jul-21,Transportellaneous,31,00.00,"1,27,140.10",
26-Jul-21,RTGS,05.00,00.00,"1,27,145.10",
26-Jul-21,Purchase,07.37,00.00,"1,27,152.47",
26-Jul-21,IMPS,00.00,"1,27,152.47",00.00,
26-Jul-21,ATM,"1,64,794.20",00.00,"1,64,794.20",
26-Jul-21,Cash,00.00,"41,198.55","1,23,595.65",
26-Jul-21,Tax,"21,194.00",00.00,"1,44,789.65",
26-Jul-21,ATM,"4,073.00",00.00,"1,48,862.65",
26-Jul-21,Purchase,00.00,"37,215.66","1,11,646.99",
26-Jul-21,Transportellaneous,00.00,"37,215.66","74,431.33",
26-Jul-21,Debit Card,285.8,00.00,"74,717.13",
26-Jul-21,Cash,"1,005.00",00.00,"75,722.13",
26-Jul-21,Transportellaneous,00.00,"9,465.27","66,256.86",
26-Jul-21,Reversal,765.95,00.00,"67,022.81",
26-Jul-21,Transportellaneous,"15,86,737.00",00.00,"16,53,759.81",
26-Jul-21,NEFT,49,00.00,"16,53,808.81",
26-Jul-21,Tax,00.00,"1,83,756.53","14,70,052.28",
26-Jul-21,RTGS,00.00,"1,83,756.54","12,86,295.75",
26-Jul-21,ATM,34.11,00.00,"12,86,329.86",
26-Jul-21,ATM,00.00,"6,43,164.93","6,43,164.93",
26-Jul-21,Debit Card,00.00,"91,880.70","5,51,284.23",
26-Jul-21,Interest,00.00,"68,910.53","4,82,373.70",
26-Jul-21,Tax,01.42,00.00,"4,82,375.12",
26-Jul-21,ATM,456.5,00.00,"4,82,831.62",
26-Jul-21,Transfer,00.00,"4,82,831.62",00.00,
26-Jul-21,Transfer,"5,540.25",00.00,"5,540.25",
27-Jul-21,Purchase,"3,780.00",00.00,"9,320.25",
27-Jul-21,RTGS,52,00.00,"9,372.25",
27-Jul-21,Cheque,00.00,"9,372.25",00.00,
27-Jul-21,Purchase,30,00.00,30,
27-Jul-21,Purchase,"31,236.00",00.00,"31,266.00",
27-Jul-21,Purchase,"2,775.00",00.00,"34,041.00",
27-Jul-21,RTGS,03.60,00.00,"34,044.60",
27-Jul-21,Commission,04.00,00.00,"34,048.60",
27-Jul-21,Purchase,00.00,"3,404.86","30,643.74",
27-Jul-21,ATM,00.00,"3,404.86","27,238.88",
27-Jul-21,IMPS,"1,33,418.00",00.00,"1,60,656.88",
27-Jul-21,ATM,778.92,00.00,"1,61,435.80",
27-Jul-21,NEFT,00.00,"40,358.95","1,21,076.85",
27-Jul-21,Interest,00.00,"15,134.61","1,05,942.24",
27-Jul-21,NEFT,00.00,"17,657.04","88,285.20",
27-Jul-21,NEFT,00.00,"44,142.60","44,142.60",
27-Jul-21,Bill,"13,241.50",00.00,"57,384.10",
27-Jul-21,Tax,00.00,"8,197.73","49,186.37",
27-Jul-21,Interest,06.30,00.00,"49,192.67",
28-Jul-21,Tax,00.00,"4,919.27","44,273.40",
28-Jul-21,Debit Card,"32,408.14",00.00,"76,681.54",
28-Jul-21,Reversal,06.36,00.00,"76,687.90",
28-Jul-21,Interest,00.00,"25,562.63","51,125.27",
28-Jul-21,Debit Card,"3,011.10",00.00,"54,136.37",
28-Jul-21,Purchase,00.00,"9,022.73","45,113.64",
28-Jul-21,Cash,00.00,"5,012.63","40,101.01",
28-Jul-21,ATM,00.00,"5,012.63","35,088.38",
28-Jul-21,Cash,00.00,"3,898.71","31,189.67",
28-Jul-21,IMPS,00.00,"5,198.28","25,991.39",
28-Jul-21,Reversal,"6,658.30",00.00,"32,649.69",
28-Jul-21,Purchase,00.00,"4,664.24","27,985.45",
28-Jul-21,IMPS,"4,13,608.25",00.00,"4,41,593.70",
28-Jul-21,NEFT,06.90,00.00,"4,41,600.60",
28-Jul-21,Debit Card,"3,17,414.00",00.00,"7,59,014.60",
28-Jul-21,Debit Card,00.00,"1,08,430.66","6,50,583.94",
28-Jul-21,Reversal,"1,61,737.00",00.00,"8,12,320.94",
28-Jul-21,Bill,"4,35,445.00",00.00,"12,47,765.94",
28-Jul-21,IMPS,368,00.00,"12,48,133.94",
28-Jul-21,Tax,00.00,"12,48,133.94",00.00,
28-Jul-21,Cheque,332.22,00.00,332.22,
28-Jul-21,Transfer,"29,475.00",00.00,"29,807.22",
28-Jul-21,Reversal,00.00,"4,967.87","24,839.35",
28-Jul-21,Transfer,00.00,"4,967.87","19,871.48",
28-Jul-21,Transportellaneous,00.00,"2,207.94","17,663.54",
28-Jul-21,Tax,00.00,"8,831.77","8,831.77",
28-Jul-21,Interest,00.00,"1,766.35","7,065.42",
28-Jul-21,NEFT,00.00,"3,532.71","3,532.71",
29-Jul-21,Interest,00.00,706.54,"2,826.17",
29-Jul-21,ATM,00.00,403.74,"2,422.43",
29-Jul-21,Reversal,00.00,605.61,"1,816.82",
29-Jul-21,Tax,"10,88,920.00",00.00,"10,90,736.82",
29-Jul-21,Tax,00.00,"1,55,819.55","9,34,917.27",
29-Jul-21,Interest,00.00,"93,491.73","8,41,425.54",
29-Jul-21,Transfer,00.00,"8,41,425.54",00.00,
29-Jul-21,Interest,"15,59,442.00",00.00,"15,59,442.00",
29-Jul-21,Debit Card,00.00,"3,89,860.50","11,69,581.50",
29-Jul-21,Interest,00.00,"3,89,860.50","7,79,721.00",
29-Jul-21,Interest,"3,244.00",00.00,"7,82,965.00",
29-Jul-21,Cheque,00.00,"3,91,482.50","3,91,482.50",
29-Jul-21,Cash,00.00,"1,30,494.17","2,60,988.33",
29-Jul-21,Debit Card,"1,07,907.00",00.00,"3,68,895.33",
29-Jul-21,IMPS,00.00,"61,482.56","3,07,412.78",
29-Jul-21,Interest,00.00,"30,741.28","2,76,671.50",
29-Jul-21,Debit Card,00.00,"2,76,671.50",00.00,
29-Jul-21,Cash,28,00.00,28,
29-Jul-21,Debit Card,00.00,03.50,24.5,
29-Jul-21,Tax,02.03,00.00,26.53,
29-Jul-21,Interest,00.00,13.27,13.26,
29-Jul-21,RTGS,"2,328.00",00.00,"2,341.26",
29-Jul-21,Cheque,"1,469.20",00.00,"3,810.46",
29-Jul-21,NEFT,00.00,"1,905.23","1,905.23",
29-Jul-21,Transportellaneous,"27,377.00",00.00,"29,282.23",
29-Jul-21,Bill,00.00,"3,253.58","26,028.65",
29-Jul-21,Cheque,"3,216.00",00.00,"29,244.65",
30-Jul-21,Reversal,"1,76,891.19",00.00,"2,06,135.84",
30-Jul-21,Cash,00.00,"1,03,067.92","1,03,067.92",
30-Jul-21,Bill,00.00,"12,883.49","90,184.43",
30-Jul-21,Commission,00.00,"9,018.44","81,165.99",
30-Jul-21,IMPS,00.00,"9,018.44","72,147.55",
30-Jul-21,Cheque,02.00,00.00,"72,149.55",
30-Jul-21,Tax,00.00,"14,429.91","57,719.64",
30-Jul-21,Reversal,"19,04,266.00",00.00,"19,61,985.64",
30-Jul-21,RTGS,"1,80,829.94",00.00,"21,42,815.58",
30-Jul-21,Bill,00.00,"7,14,271.86","14,28,543.72",
30-Jul-21,Bill,00.00,"3,57,135.93","10,71,407.79",
30-Jul-21,Purchase,00.00,"3,57,135.93","7,14,271.86",
30-Jul-21,Purchase,23,00.00,"7,14,294.86",
30-Jul-21,Debit Card,00.00,"2,38,098.29","4,76,196.57",
31-Jul-21,RTGS,"3,22,820.00",00.00,"7,99,016.57",
31-Jul-21,Transfer,00.00,"88,779.62","7,10,236.95",
31-Jul-21,Bill,"2,04,177.00",00.00,"9,14,413.95",
31-Jul-21,Purchase,00.00,"1,30,630.56","7,83,783.39",
31-Jul-21,Reversal,"13,336.00",00.00,"7,97,119.39",
31-Jul-21,NEFT,17.69,00.00,"7,97,137.08",
31-Jul-21,Cash,"23,019.00",00.00,"8,20,156.08",
31-Jul-21,Cheque,00.00,"1,36,692.68","6,83,463.40",
31-Jul-21,Reversal,00.00,"2,27,821.13","4,55,642.27",
31-Jul-21,NEFT,264.63,00.00,"4,55,906.90",
31-Jul-21,Purchase,00.00,"65,129.56","3,90,777.34",
31-Jul-21,Reversal,00.00,"39,077.73","3,51,699.61",
01-Aug-21,Transfer,06.29,00.00,"3,51,705.90",
01-Aug-21,RTGS,"1,422.00",00.00,"3,53,127.90",
01-Aug-21,Transportellaneous,147,00.00,"3,53,274.90",
01-Aug-21,ATM,"25,971.00",00.00,"3,79,245.90",
01-Aug-21,Debit Card,31,00.00,"3,79,276.90",
02-Aug-21,Bill,"3,597.80",00.00,"3,82,874.70",
02-Aug-21,Interest,22.46,00.00,"3,82,897.16",
02-Aug-21,IMPS,00.00,"42,544.13","3,40,353.03",
02-Aug-21,Commission,00.00,"37,817.00","3,02,536.03",
02-Aug-21,Commission,"1,613.00",00.00,"3,04,149.03",
02-Aug-21,NEFT,00.00,"76,037.26","2,28,111.77",
02-Aug-21,Reversal,00.00,"38,018.63","1,90,093.14",
02-Aug-21,Interest,"15,37,766.00",00.00,"17,27,859.14",
02-Aug-21,IMPS,00.00,"8,63,929.57","8,63,929.57",
02-Aug-21,Transfer,"1,473.10",00.00,"8,65,402.67",
02-Aug-21,Debit Card,24.58,00.00,"8,65,427.25",
02-Aug-21,RTGS,307,00.00,"8,65,734.25",
02-Aug-21,Cheque,00.00,"2,88,578.08","5,77,156.17",
02-Aug-21,Commission,407.5,00.00,"5,77,563.67",
02-Aug-21,Commission,00.00,"1,15,512.73","4,62,050.94",
02-Aug-21,RTGS,00.00,"2,31,025.47","2,31,025.47",
02-Aug-21,Transfer,"14,92,519.75",00.00,"17,23,545.22",
03-Aug-21,RTGS,00.00,"5,74,515.07","11,49,030.15",
03-Aug-21,RTGS,"16,95,853.25",00.00,"28,44,883.40",
03-Aug-21,NEFT,00.00,"7,11,220.85","21,33,662.55",
03-Aug-21,RTGS,"29,281.42",00.00,"21,62,943.97",
03-Aug-21,NEFT,05.44,00.00,"21,62,949.41",
03-Aug-21,Transfer,00.00,"7,20,983.14","14,41,966.27",
03-Aug-21,NEFT,00.00,"4,80,655.42","9,61,310.85",
03-Aug-21,NEFT,00.00,"2,40,327.71","7,20,983.14",
03-Aug-21,Cash,41.7,00.00,"7,21,024.84",
03-Aug-21,Transfer,00.00,"1,03,003.55","6,18,021.29",
03-Aug-21,Commission,"2,496.20",00.00,"6,20,517.49",
03-Aug-21,Cash,00.00,"1,24,103.50","4,96,413.99",
03-Aug-21,Purchase,"7,83,470.50",00.00,"12,79,884.49",
03-Aug-21,Bill,17,00.00,"12,79,901.49",
03-Aug-21,IMPS,00.00,"2,13,316.92","10,66,584.58",
03-Aug-21,ATM,00.00,"1,06,658.46","9,59,926.12",
03-Aug-21,NEFT,00.00,"3,19,975.37","6,39,950.75",
03-Aug-21,Purchase,00.00,"91,421.54","5,48,529.21",
03-Aug-21,Transfer,00.00,"1,82,843.07","3,65,686.14",
03-Aug-21,RTGS,00.00,"73,137.23","2,92,548.91",
03-Aug-21,Interest,247.5,00.00,"2,92,796.41",
03-Aug-21,Cheque,00.00,"36,599.55","2,56,196.86",
03-Aug-21,ATM,08.00,00.00,"2,56,204.86",
03-Aug-21,Cheque,00.00,"32,025.61","2,24,179.25",
03-Aug-21,Transportellaneous,21.42,00.00,"2,24,200.67",
03-Aug-21,Debit Card,"3,328.94",00.00,"2,27,529.61",
03-Aug-21,Transfer,00.00,"28,441.20","1,99,088.41",
03-Aug-21,Purchase,319.7,00.00,"1,99,408.11",
03-Aug-21,Cash,"18,13,146.50",00.00,"20,12,554.61",
03-Aug-21,Cheque,00.00,"4,02,510.92","16,10,043.69",
03-Aug-21,Bill,00.00,"16,10,043.69",00.00,
03-Aug-21,IMPS,"3,09,568.00",00.00,"3,09,568.00",
04-Aug-21,RTGS,00.00,"77,392.00","2,32,176.00",
04-Aug-21,Cheque,00.00,"46,435.20","1,85,740.80",
04-Aug-21,Transfer,00.00,"18,574.08","1,67,166.72",
04-Aug-21,Interest,00.00,"83,583.36","83,583.36",
04-Aug-21,Cheque,"13,05,456.50",00.00,"13,89,039.86",
04-Aug-21,Bill,00.00,"6,94,519.93","6,94,519.93",
04-Aug-21,RTGS,00.00,"86,814.99","6,07,704.94",
04-Aug-21,Reversal,461.77,00.00,"6,08,166.71",
04-Aug-21,Cheque,480.96,00.00,"6,08,647.67",
04-Aug-21,Transfer,"2,62,037.40",00.00,"8,70,685.07",
04-Aug-21,Interest,00.00,"1,08,835.63","7,61,849.44",
04-Aug-21,Purchase,00.00,"1,90,462.36","5,71,387.08",
04-Aug-21,Interest,07.21,00.00,"5,71,394.29",
04-Aug-21,Reversal,00.00,"5,71,394.29",00.00,
05-Aug-21,Transfer,"18,25,824.00",00.00,"18,25,824.00",
05-Aug-21,Purchase,"3,840.90",00.00,"18,29,664.90",
05-Aug-21,IMPS,99.62,00.00,"18,29,764.52",
05-Aug-21,Tax,02.30,00.00,"18,29,766.82",
05-Aug-21,Transfer,"2,790.77",00.00,"18,32,557.59",
05-Aug-21,RTGS,51,00.00,"18,32,608.59",
05-Aug-21,Bill,"3,852.30",00.00,"18,36,460.89",
05-Aug-21,NEFT,03.70,00.00,"18,36,464.59",
05-Aug-21,Commission,00.00,"4,59,116.15","13,77,348.44",
05-Aug-21,Interest,00.00,"2,75,469.69","11,01,878.75",
05-Aug-21,Cheque,19.77,00.00,"11,01,898.52",
05-Aug-21,NEFT,00.00,"3,67,299.51","7,34,599.01",
05-Aug-21,Transfer,00.00,"3,67,299.51","3,67,299.50",
05-Aug-21,Purchase,"5,57,253.00",00.00,"9,24,552.50",
05-Aug-21,Transportellaneous,00.00,"92,455.25","8,32,097.25",
05-Aug-21,Purchase,00.00,"4,16,048.63","4,16,048.62",
05-Aug-21,RTGS,00.00,"83,209.72","3,32,838.90",
05-Aug-21,Transportellaneous,57.66,00.00,"3,32,896.56",
05-Aug-21,NEFT,00.00,"41,612.07","2,91,284.49",
05-Aug-21,Transfer,"1,189.81",00.00,"2,92,474.30",
05-Aug-21,Transportellaneous,00.00,"29,247.43","2,63,226.87",
05-Aug-21,Interest,00.00,"29,247.43","2,33,979.44",
05-Aug-21,Bill,"73,721.00",00.00,"3,07,700.44",
05-Aug-21,Tax,"17,47,104.25",00.00,"20,54,804.69",
05-Aug-21,Debit Card,00.00,"4,10,960.94","16,43,843.75",
05-Aug-21,Commission,500.09,00.00,"16,44,343.84",
05-Aug-21,IMPS,00.00,"5,48,114.61","10,96,229.23",
05-Aug-21,RTGS,"3,224.00",00.00,"10,99,453.23",
05-Aug-21,Purchase,"2,496.70",00.00,"11,01,949.93",
05-Aug-21,Bill,00.00,"1,10,194.99","9,91,754.94",
05-Aug-21,IMPS,02.04,00.00,"9,91,756.98",
05-Aug-21,Interest,00.00,"1,23,969.62","8,67,787.36",
05-Aug-21,Reversal,"29,855.00",00.00,"8,97,642.36",
05-Aug-21,RTGS,323.1,00.00,"8,97,965.46",
05-Aug-21,Tax,00.00,"99,773.94","7,98,191.52",
05-Aug-21,Purchase,279,00.00,"7,98,470.52",
05-Aug-21,Purchase,00.00,"79,847.05","7,18,623.47",
05-Aug-21,Tax,62.06,00.00,"7,18,685.53",
05-Aug-21,RTGS,"2,000.00",00.00,"7,20,685.53",
05-Aug-21,IMPS,00.00,"1,80,171.38","5,40,514.15",
05-Aug-21,NEFT,00.00,"1,35,128.54","4,05,385.61",
05-Aug-21,ATM,00.00,"4,05,385.61",00.00,
05-Aug-21,Debit Card,368,00.00,368,
05-Aug-21,NEFT,00.00,61.33,306.67,
05-Aug-21,ATM,509,00.00,815.67,
05-Aug-21,Reversal,00.00,90.63,725.04,
05-Aug-21,IMPS,00.00,80.56,644.48,
05-Aug-21,Cheque,84,00.00,728.48,
05-Aug-21,Transportellaneous,00.00,242.83,485.65,
05-Aug-21,Cash,00.00,60.71,424.94,
05-Aug-21,Interest,00.00,106.24,318.7,
05-Aug-21,Transfer,574.6,00.00,893.3,
05-Aug-21,Interest,00.00,893.3,00.00,
05-Aug-21,NEFT,364.5,00.00,364.5,
05-Aug-21,Purchase,"1,662.10",00.00,"2,026.60",
05-Aug-21,Reversal,"28,647.00",00.00,"30,673.60",
05-Aug-21,Transfer,00.00,"10,224.53","20,449.07",
05-Aug-21,Transportellaneous,00.00,"5,112.27","15,336.80",
05-Aug-21,Commission,00.00,"3,067.36","12,269.44",
05-Aug-21,NEFT,"3,077.93",00.00,"15,347.37",
05-Aug-21,Reversal,02.00,00.00,"15,349.37",
05-Aug-21,IMPS,00.00,"1,918.67","13,430.70",
05-Aug-21,Debit Card,00.00,"2,238.45","11,192.25",
05-Aug-21,Cheque,20.87,00.00,"11,213.12",
05-Aug-21,Tax,"1,879.20",00.00,"13,092.32",
05-Aug-21,Interest,00.00,"1,636.54","11,455.78",
05-Aug-21,Transportellaneous,866.27,00.00,"12,322.05",
05-Aug-21,Transportellaneous,00.00,"6,161.03","6,161.02",
05-Aug-21,Cash,00.00,770.13,"5,390.89",
05-Aug-21,Interest,00.00,770.13,"4,620.76",
05-Aug-21,ATM,449.1,00.00,"5,069.86",
05-Aug-21,Transportellaneous,"6,566.07",00.00,"11,635.93",
06-Aug-21,IMPS,00.00,"1,939.32","9,696.61",
06-Aug-21,Debit Card,02.00,00.00,"9,698.61",
06-Aug-21,Commission,00.00,"2,424.65","7,273.96",
06-Aug-21,Transfer,209.54,00.00,"7,483.50",
06-Aug-21,Cash,00.00,"7,483.50",00.00,
06-Aug-21,NEFT,"4,60,020.80",00.00,"4,60,020.80",
06-Aug-21,Debit Card,00.00,"1,53,340.27","3,06,680.53",
06-Aug-21,IMPS,00.00,"76,670.13","2,30,010.40",
06-Aug-21,Interest,13.33,00.00,"2,30,023.73",
06-Aug-21,Bill,00.00,"57,505.93","1,72,517.80",
06-Aug-21,Purchase,"2,04,327.69",00.00,"3,76,845.49",
06-Aug-21,Reversal,00.00,"47,105.69","3,29,739.80",
06-Aug-21,NEFT,00.00,"1,64,869.90","1,64,869.90",
06-Aug-21,Cheque,00.00,"32,973.98","1,31,895.92",
06-Aug-21,Interest,"1,95,599.06",00.00,"3,27,494.98",
06-Aug-21,Cheque,00.00,"40,936.87","2,86,558.11",
06-Aug-21,Transportellaneous,00.00,"35,819.76","2,50,738.35",
06-Aug-21,Reversal,"21,006.20",00.00,"2,71,744.55",
06-Aug-21,Cash,82.7,00.00,"2,71,827.25",
06-Aug-21,Cheque,"2,631.70",00.00,"2,74,458.95",
06-Aug-21,Bill,00.00,"27,445.90","2,47,013.06",
06-Aug-21,Bill,"16,13,569.00",00.00,"18,60,582.06",
06-Aug-21,Interest,00.00,"2,32,572.76","16,28,009.30",
06-Aug-21,RTGS,25,00.00,"16,28,034.30",
06-Aug-21,Debit Card,00.00,"3,25,606.86","13,02,427.44",
06-Aug-21,Transfer,00.00,"13,02,427.44",00.00,
06-Aug-21,Transportellaneous,"14,351.60",00.00,"14,351.60",
06-Aug-21,RTGS,00.00,"1,435.16","12,916.44",
06-Aug-21,ATM,"2,07,586.40",00.00,"2,20,502.84",
06-Aug-21,RTGS,"2,787.89",00.00,"2,23,290.73",
06-Aug-21,RTGS,"28,070.57",00.00,"2,51,361.30",
06-Aug-21,Reversal,00.00,"31,420.16","2,19,941.14",
06-Aug-21,Interest,00.00,"2,19,941.14",00.00,
06-Aug-21,NEFT,58.85,00.00,58.85,
06-Aug-21,Transportellaneous,00.00,06.54,52.31,
06-Aug-21,Debit Card,00.00,08.72,43.59,
06-Aug-21,NEFT,00.00,21.8,21.8,
06-Aug-21,RTGS,00.00,21.8,00.00,
06-Aug-21,NEFT,"2,41,791.31",00.00,"2,41,791.31",
07-Aug-21,Cheque,30,00.00,"2,41,821.31",
07-Aug-21,Bill,05.41,00.00,"2,41,826.72",
07-Aug-21,Debit Card,"11,85,184.00",00.00,"14,27,010.72",
07-Aug-21,RTGS,06.80,00.00,"14,27,017.52",
07-Aug-21,IMPS,00.00,"1,58,557.50","12,68,460.02",
07-Aug-21,Debit Card,07.00,00.00,"12,68,467.02",
07-Aug-21,Transportellaneous,07.00,00.00,"12,68,474.02",
07-Aug-21,Commission,214.4,00.00,"12,68,688.42",
07-Aug-21,Transportellaneous,00.00,"2,53,737.68","10,14,950.74",
07-Aug-21,Bill,00.00,"1,26,868.84","8,88,081.90",
07-Aug-21,RTGS,"2,992.32",00.00,"8,91,074.22",
07-Aug-21,Interest,12.04,00.00,"8,91,086.26",
07-Aug-21,Tax,13,00.00,"8,91,099.26",
07-Aug-21,IMPS,00.00,"8,91,099.26",00.00,
07-Aug-21,Cheque,"12,57,752.80",00.00,"12,57,752.80",
08-Aug-21,Cheque,00.00,"1,79,678.97","10,78,073.83",
08-Aug-21,Interest,367,00.00,"10,78,440.83",
08-Aug-21,Transfer,23,00.00,"10,78,463.83",
08-Aug-21,Debit Card,"95,685.00",00.00,"11,74,148.83",
08-Aug-21,Cash,00.00,"1,30,460.98","10,43,687.85",
08-Aug-21,Transfer,"2,108.10",00.00,"10,45,795.95",
08-Aug-21,Commission,00.00,"1,04,579.60","9,41,216.36",
08-Aug-21,Purchase,45.8,00.00,"9,41,262.16",
08-Aug-21,Cheque,00.00,"4,70,631.08","4,70,631.08",
08-Aug-21,Reversal,00.00,"58,828.89","4,11,802.20",
08-Aug-21,IMPS,00.00,"1,02,950.55","3,08,851.65",
08-Aug-21,Cash,"1,75,046.20",00.00,"4,83,897.85",
08-Aug-21,ATM,00.00,"4,83,897.85",00.00,
08-Aug-21,Cash,"1,91,994.91",00.00,"1,91,994.91",
08-Aug-21,Tax,00.00,"19,199.49","1,72,795.42",
08-Aug-21,IMPS,00.00,"1,72,795.42",00.00,
08-Aug-21,Cash,40,00.00,40,
08-Aug-21,Cheque,00.00,13.33,26.67,
08-Aug-21,ATM,00.00,02.67,24,
08-Aug-21,Transportellaneous,00.00,24,00.00,
08-Aug-21,ATM,145.5,00.00,145.5,
08-Aug-21,Debit Card,"32,831.70",00.00,"32,977.20",
08-Aug-21,Debit Card,07.00,00.00,"32,984.20",
08-Aug-21,RTGS,374,00.00,"33,358.20",
08-Aug-21,Bill,38.1,00.00,"33,396.30",
08-Aug-21,NEFT,00.00,"3,339.63","30,056.67",
08-Aug-21,Interest,01.00,00.00,"30,057.67",
08-Aug-21,IMPS,"10,647.00",00.00,"40,704.67",
08-Aug-21,Tax,00.00,"13,568.22","27,136.45",
08-Aug-21,Reversal,839.32,00.00,"27,975.77",
08-Aug-21,Transfer,00.00,"9,325.26","18,650.51",
08-Aug-21,RTGS,00.23,00.00,"18,650.74",
08-Aug-21,Interest,00.00,"2,072.30","16,578.44",
08-Aug-21,Tax,00.00,"16,578.44",00.00,
08-Aug-21,Cheque,"12,35,032.00",00.00,"12,35,032.00",
08-Aug-21,Interest,"1,342.60",00.00,"12,36,374.60",
08-Aug-21,Debit Card,00.00,"12,36,374.60",00.00,
08-Aug-21,NEFT,05.87,00.00,05.87,
09-Aug-21,Transfer,"27,371.00",00.00,"27,376.87",
09-Aug-21,Commission,00.00,"4,562.81","22,814.06",
09-Aug-21,Commission,00.00,"3,802.34","19,011.72",
09-Aug-21,Tax,00.00,"1,901.17","17,110.55",
09-Aug-21,Interest,00.00,"4,277.64","12,832.91",
09-Aug-21,IMPS,00.00,"4,277.64","8,555.27",
09-Aug-21,Cash,00.00,"1,222.18","7,333.09",
09-Aug-21,Bill,369.46,00.00,"7,702.55",
10-Aug-21,ATM,00.00,"2,567.52","5,135.03",
10-Aug-21,RTGS,01.00,00.00,"5,136.03",
10-Aug-21,NEFT,01.00,00.00,"5,137.03",
10-Aug-21,Cheque,"11,760.80",00.00,"16,897.83",
10-Aug-21,RTGS,00.00,"3,379.57","13,518.26",
10-Aug-21,Bill,00.00,"1,931.18","11,587.08",
10-Aug-21,Purchase,00.00,"1,287.45","10,299.63",
10-Aug-21,Cheque,00.00,"2,059.93","8,239.70",
10-Aug-21,Debit Card,00.00,"1,647.94","6,591.76",
10-Aug-21,Bill,"2,973.00",00.00,"9,564.76",
10-Aug-21,Reversal,"11,79,008.50",00.00,"11,88,573.26",
10-Aug-21,Interest,00.00,00.00,"11,88,573.26",
10-Aug-21,Debit Card,00.00,"2,97,143.32","8,91,429.94",
11-Aug-21,Cash,00.00,"4,45,714.97","4,45,714.97",
11-Aug-21,Reversal,695.7,00.00,"4,46,410.67",
11-Aug-21,NEFT,03.01,00.00,"4,46,413.68",
11-Aug-21,ATM,"11,661.58",00.00,"4,58,075.26",
11-Aug-21,Purchase,52,00.00,"4,58,127.26",
11-Aug-21,Purchase,00.00,"1,52,709.09","3,05,418.17",
11-Aug-21,Transportellaneous,00.00,"1,52,709.09","1,52,709.08",
11-Aug-21,Debit Card,53,00.00,"1,52,762.08",
11-Aug-21,Tax,05.90,00.00,"1,52,767.98",
11-Aug-21,Reversal,05.00,00.00,"1,52,772.98",
11-Aug-21,Cheque,"6,62,369.20",00.00,"8,15,142.18",
11-Aug-21,Cash,00.00,"2,71,714.06","5,43,428.12",
11-Aug-21,Transfer,00.00,"60,380.90","4,83,047.22",
11-Aug-21,NEFT,"2,20,245.60",00.00,"7,03,292.82",
11-Aug-21,Cheque,00.00,"3,51,646.41","3,51,646.41",
11-Aug-21,Commission,00.00,"50,235.20","3,01,411.21",
11-Aug-21,Interest,00.00,"50,235.20","2,51,176.01",
11-Aug-21,NEFT,00.00,"41,862.67","2,09,313.34",
11-Aug-21,RTGS,00.00,"69,771.11","1,39,542.23",
11-Aug-21,Commission,"17,21,425.00",00.00,"18,60,967.23",
11-Aug-21,Interest,"16,99,156.75",00.00,"35,60,123.98",
11-Aug-21,Tax,01.00,00.00,"35,60,124.98",
11-Aug-21,Reversal,331.05,00.00,"35,60,456.03",
11-Aug-21,Transportellaneous,00.00,"35,60,456.03",00.00,
11-Aug-21,Transfer,"2,811.60",00.00,"2,811.60",
11-Aug-21,NEFT,"1,135.30",00.00,"3,946.90",
11-Aug-21,Commission,00.00,789.38,"3,157.52",
11-Aug-21,Interest,46,00.00,"3,203.52",
11-Aug-21,Transfer,"2,588.55",00.00,"5,792.07",
11-Aug-21,IMPS,02.10,00.00,"5,794.17",
11-Aug-21,ATM,00.00,"1,158.83","4,635.34",
11-Aug-21,Purchase,00.00,927.07,"3,708.27",
11-Aug-21,IMPS,00.00,"3,708.27",00.00,
11-Aug-21,Cheque,"2,560.35",00.00,"2,560.35",
11-Aug-21,Interest,"15,543.30",00.00,"18,103.65",
11-Aug-21,Commission,127.62,00.00,"18,231.27",
11-Aug-21,Debit Card,00.00,"2,604.47","15,626.80",
11-Aug-21,ATM,00.00,"2,604.47","13,022.33",
11-Aug-21,Cash,00.00,"1,446.93","11,575.40",
11-Aug-21,Commission,04.22,00.00,"11,579.62",
11-Aug-21,Tax,21,00.00,"11,600.62",
11-Aug-21,NEFT,"18,181.10",00.00,"29,781.72",
11-Aug-21,Transfer,"3,359.16",00.00,"33,140.88",
11-Aug-21,Reversal,27.9,00.00,"33,168.78",
11-Aug-21,Commission,"1,40,548.80",00.00,"1,73,717.58",
11-Aug-21,Cash,00.00,"24,816.80","1,48,900.78",
11-Aug-21,Commission,"17,103.50",00.00,"1,66,004.28",
11-Aug-21,NEFT,00.00,"83,002.14","83,002.14",
11-Aug-21,IMPS,"6,278.00",00.00,"89,280.14",
11-Aug-21,Bill,00.00,"29,760.05","59,520.09",
11-Aug-21,Interest,431.3,00.00,"59,951.39",
11-Aug-21,Cheque,169.3,00.00,"60,120.69",
11-Aug-21,Commission,00.00,"60,120.69",00.00,
11-Aug-21,IMPS,03.50,00.00,03.50,
11-Aug-21,Debit Card,"3,398.69",00.00,"3,402.19",
11-Aug-21,Purchase,00.00,567.03,"2,835.16",
11-Aug-21,Commission,249,00.00,"3,084.16",
11-Aug-21,Debit Card,00.00,771.04,"2,313.12",
11-Aug-21,ATM,00.00,"2,313.12",00.00,
11-Aug-21,Interest,"2,672.19",00.00,"2,672.19",
11-Aug-21,Cash,00.00,"1,336.10","1,336.10",
11-Aug-21,Interest,00.00,133.61,"1,202.49",
11-Aug-21,IMPS,00.00,"1,202.49",00.00,
11-Aug-21,Interest,"1,988.00",00.00,"1,988.00",
11-Aug-21,Reversal,00.00,284,"1,704.00",
12-Aug-21,Debit Card,00.00,426,"1,278.00",
12-Aug-21,Transfer,01.99,00.00,"1,279.99",
13-Aug-21,Cash,00.00,"1,279.99",00.00,
13-Aug-21,Transportellaneous,"8,54,393.00",00.00,"8,54,393.00",
13-Aug-21,Purchase,00.00,"1,42,398.83","7,11,994.17",
13-Aug-21,Tax,00.00,"88,999.27","6,22,994.90",
13-Aug-21,Transportellaneous,00.00,"1,24,598.98","4,98,395.92",
13-Aug-21,RTGS,00.00,"55,377.32","4,43,018.60",
13-Aug-21,ATM,29,00.00,"4,43,047.60",
13-Aug-21,Transportellaneous,37,00.00,"4,43,084.60",
13-Aug-21,Cheque,"17,93,099.00",00.00,"22,36,183.60",
13-Aug-21,Transfer,00.00,"7,45,394.53","14,90,789.07",
13-Aug-21,Commission,00.00,"1,65,643.23","13,25,145.84",
13-Aug-21,Purchase,"13,508.30",00.00,"13,38,654.14",
13-Aug-21,Commission,00.00,"2,23,109.02","11,15,545.12",
13-Aug-21,Transportellaneous,"2,51,474.22",00.00,"13,67,019.34",
13-Aug-21,Cheque,00.00,"1,70,877.42","11,96,141.92",
13-Aug-21,Debit Card,00.00,"1,19,614.19","10,76,527.73",
13-Aug-21,Commission,05.00,00.00,"10,76,532.73",
13-Aug-21,RTGS,"9,38,373.00",00.00,"20,14,905.73",
13-Aug-21,Cheque,00.00,"2,51,863.22","17,63,042.51",
13-Aug-21,Tax,"21,576.00",00.00,"17,84,618.51",
13-Aug-21,Transportellaneous,"2,269.15",00.00,"17,86,887.66",
13-Aug-21,Commission,00.00,"4,46,721.92","13,40,165.74",
13-Aug-21,Commission,00.00,"1,67,520.72","11,72,645.02",
13-Aug-21,Reversal,00.00,"1,46,580.63","10,26,064.39",
13-Aug-21,Reversal,200.86,00.00,"10,26,265.25",
13-Aug-21,Bill,91.08,00.00,"10,26,356.33",
14-Aug-21,Reversal,00.00,"2,56,589.08","7,69,767.25",
14-Aug-21,Transportellaneous,02.93,00.00,"7,69,770.18",
14-Aug-21,IMPS,00.00,"76,977.02","6,92,793.16",
14-Aug-21,Interest,00.00,"86,599.15","6,06,194.02",
14-Aug-21,Interest,"4,49,379.50",00.00,"10,55,573.52",
15-Aug-21,Interest,"9,45,411.00",00.00,"20,00,984.52",
15-Aug-21,Transportellaneous,00.00,"6,66,994.84","13,33,989.68",
15-Aug-21,Tax,00.00,"1,66,748.71","11,67,240.97",
15-Aug-21,NEFT,"29,935.50",00.00,"11,97,176.47",
15-Aug-21,Bill,00.00,"1,71,025.21","10,26,151.26",
15-Aug-21,NEFT,00.00,"3,42,050.42","6,84,100.84",
15-Aug-21,Commission,00.00,"3,42,050.42","3,42,050.42",
15-Aug-21,IMPS,"3,135.90",00.00,"3,45,186.32",
15-Aug-21,Bill,00.00,"43,148.29","3,02,038.03",
15-Aug-21,Reversal,00.00,"60,407.61","2,41,630.42",
15-Aug-21,IMPS,"1,78,443.00",00.00,"4,20,073.42",
15-Aug-21,IMPS,09.03,00.00,"4,20,082.45",
15-Aug-21,Debit Card,00.00,"42,008.25","3,78,074.20",
15-Aug-21,ATM,00.00,"63,012.37","3,15,061.83",
15-Aug-21,NEFT,00.00,"45,008.83","2,70,053.00",
15-Aug-21,RTGS,"20,748.00",00.00,"2,90,801.00",
15-Aug-21,RTGS,00.00,"41,543.00","2,49,258.00",
15-Aug-21,Interest,02.36,00.00,"2,49,260.36",
15-Aug-21,RTGS,"27,902.40",00.00,"2,77,162.76",
15-Aug-21,RTGS,00.00,"30,795.86","2,46,366.90",
15-Aug-21,ATM,"2,31,378.30",00.00,"4,77,745.20",
15-Aug-21,Reversal,00.00,"47,774.52","4,29,970.68",
15-Aug-21,Tax,"23,360.75",00.00,"4,53,331.43",
15-Aug-21,Cheque,00.00,"1,13,332.86","3,39,998.57",
15-Aug-21,Tax,00.00,"56,666.43","2,83,332.14",
15-Aug-21,Transportellaneous,"2,166.03",00.00,"2,85,498.17",
15-Aug-21,NEFT,"6,65,954.75",00.00,"9,51,452.92",
15-Aug-21,RTGS,00.00,"4,75,726.46","4,75,726.46",
15-Aug-21,Interest,00.00,"1,18,931.62","3,56,794.84",
15-Aug-21,NEFT,395.41,00.00,"3,57,190.25",
15-Aug-21,Interest,"3,932.80",00.00,"3,61,123.05",
15-Aug-21,Bill,00.00,"40,124.78","3,20,998.27",
15-Aug-21,Reversal,07.00,00.00,"3,21,005.27",
15-Aug-21,Transfer,00.00,"1,60,502.64","1,60,502.64",
15-Aug-21,Cheque,00.00,"32,100.53","1,28,402.11",
15-Aug-21,Cheque,03.50,00.00,"1,28,405.61",
15-Aug-21,Transportellaneous,"98,939.80",00.00,"2,27,345.41",
15-Aug-21,Purchase,06.50,00.00,"2,27,351.91",
15-Aug-21,RTGS,"2,03,799.50",00.00,"4,31,151.41",
15-Aug-21,RTGS,969.7,00.00,"4,32,121.11",
15-Aug-21,Interest,"1,185.00",00.00,"4,33,306.11",
15-Aug-21,Reversal,"1,54,111.38",00.00,"5,87,417.49",
15-Aug-21,Purchase,44,00.00,"5,87,461.49",
15-Aug-21,Bill,"67,202.00",00.00,"6,54,663.49",
15-Aug-21,NEFT,00.00,"1,30,932.70","5,23,730.79",
15-Aug-21,NEFT,00.00,"52,373.08","4,71,357.71",
15-Aug-21,Debit Card,07.07,00.00,"4,71,364.78",
15-Aug-21,RTGS,00.00,"58,920.60","4,12,444.18",
15-Aug-21,RTGS,00.00,"41,244.42","3,71,199.76",
15-Aug-21,Bill,00.00,"1,23,733.25","2,47,466.51",
15-Aug-21,Purchase,00.00,"24,746.65","2,22,719.86",
15-Aug-21,Cash,"1,28,140.31",00.00,"3,50,860.17",
15-Aug-21,RTGS,00.00,"1,16,953.39","2,33,906.78",
15-Aug-21,Debit Card,00.00,"58,476.70","1,75,430.08",
15-Aug-21,NEFT,00.00,"19,492.23","1,55,937.85",
15-Aug-21,Interest,00.00,"19,492.23","1,36,445.62",
15-Aug-21,IMPS,00.00,"1,36,445.62",00.00,
15-Aug-21,Bill,"3,974.95",00.00,"3,974.95",
15-Aug-21,NEFT,23.6,00.00,"3,998.55",
15-Aug-21,ATM,00.00,"1,332.85","2,665.70",
15-Aug-21,RTGS,04.60,00.00,"2,670.30",
15-Aug-21,Debit Card,"1,626.72",00.00,"4,297.02",
15-Aug-21,Bill,"2,022.20",00.00,"6,319.22",
15-Aug-21,Purchase,"1,368.30",00.00,"7,687.52",
15-Aug-21,Transportellaneous,68.8,00.00,"7,756.32",
15-Aug-21,RTGS,"3,263.00",00.00,"11,019.32",
15-Aug-21,Transfer,"3,64,481.00",00.00,"3,75,500.32",
15-Aug-21,Reversal,00.00,"41,722.26","3,33,778.06",
15-Aug-21,Cash,00.00,"47,682.58","2,86,095.48",
15-Aug-21,RTGS,"3,306.70",00.00,"2,89,402.18",
15-Aug-21,Debit Card,"13,51,635.80",00.00,"16,41,037.98",
15-Aug-21,IMPS,00.00,"2,34,434.00","14,06,603.98",
15-Aug-21,Cheque,00.00,"1,40,660.40","12,65,943.58",
15-Aug-21,Transportellaneous,00.00,"12,65,943.58",00.00,
15-Aug-21,RTGS,62,00.00,62,
15-Aug-21,Purchase,00.00,06.20,55.8,
15-Aug-21,Interest,00.00,06.98,48.82,
15-Aug-21,Tax,00.00,09.76,39.06,
15-Aug-21,ATM,"2,218.93",00.00,"2,257.99",
15-Aug-21,Transportellaneous,"23,190.99",00.00,"25,448.98",
15-Aug-21,Reversal,"2,022.00",00.00,"27,470.98",
16-Aug-21,NEFT,00.00,"13,735.49","13,735.49",
16-Aug-21,RTGS,00.00,"2,289.25","11,446.24",
16-Aug-21,Tax,00.00,"2,861.56","8,584.68",
16-Aug-21,NEFT,"2,119.90",00.00,"10,704.58",
16-Aug-21,RTGS,"2,388.40",00.00,"13,092.98",
16-Aug-21,NEFT,"20,793.50",00.00,"33,886.48",
16-Aug-21,Purchase,"2,02,090.69",00.00,"2,35,977.17",
16-Aug-21,Bill,03.00,00.00,"2,35,980.17",
16-Aug-21,Interest,"21,239.90",00.00,"2,57,220.07",
16-Aug-21,ATM,"21,042.30",00.00,"2,78,262.37",
16-Aug-21,Transportellaneous,139,00.00,"2,78,401.37",
16-Aug-21,Reversal,00.00,"27,840.14","2,50,561.23",
16-Aug-21,Interest,274,00.00,"2,50,835.23",
16-Aug-21,Cheque,"20,389.59",00.00,"2,71,224.82",
16-Aug-21,ATM,"11,42,635.50",00.00,"14,13,860.32",
16-Aug-21,Reversal,07.44,00.00,"14,13,867.76",
16-Aug-21,Transportellaneous,"24,714.00",00.00,"14,38,581.76",
16-Aug-21,Cheque,06.30,00.00,"14,38,588.06",
17-Aug-21,ATM,00.00,"1,43,858.81","12,94,729.25",
18-Aug-21,Interest,00.00,"12,94,729.25",00.00,
18-Aug-21,Reversal,00.00,00.00,00.00,
18-Aug-21,Tax,232.4,00.00,232.4,
18-Aug-21,Tax,328,00.00,560.4,
18-Aug-21,RTGS,"1,890.47",00.00,"2,450.87",
18-Aug-21,Commission,00.00,490.17,"1,960.70",
18-Aug-21,Interest,00.00,653.57,"1,307.13",
18-Aug-21,Interest,00.07,00.00,"1,307.20",
18-Aug-21,IMPS,194.7,00.00,"1,501.90",
18-Aug-21,ATM,00.00,150.19,"1,351.71",
18-Aug-21,NEFT,168.4,00.00,"1,520.11",
18-Aug-21,Bill,00.00,380.03,"1,140.08",
18-Aug-21,RTGS,00.00,"1,140.08",00.00,
18-Aug-21,IMPS,435.71,00.00,435.71,
18-Aug-21,Transportellaneous,00.00,87.14,348.57,
18-Aug-21,Reversal,"1,369.00",00.00,"1,717.57",
18-Aug-21,IMPS,00.00,343.51,"1,374.06",
18-Aug-21,Bill,00.00,274.81,"1,099.25",
18-Aug-21,RTGS,44.57,00.00,"1,143.82",
18-Aug-21,Debit Card,00.00,571.91,571.91,
18-Aug-21,ATM,00.00,190.64,381.27,
18-Aug-21,Transfer,00.00,54.47,326.8,
18-Aug-21,Transfer,"6,663.00",00.00,"6,989.80",
18-Aug-21,IMPS,00.00,"6,989.80",00.00,
18-Aug-21,Interest,515.88,00.00,515.88,
18-Aug-21,Reversal,00.00,51.59,464.29,
18-Aug-21,Transportellaneous,00.00,154.76,309.53,
18-Aug-21,RTGS,"3,523.00",00.00,"3,832.53",
18-Aug-21,NEFT,"1,37,580.00",00.00,"1,41,412.53",
18-Aug-21,IMPS,"17,15,789.00",00.00,"18,57,201.53",
18-Aug-21,Debit Card,00.70,00.00,"18,57,202.23",
18-Aug-21,Transfer,216,00.00,"18,57,418.23",
18-Aug-21,Tax,04.88,00.00,"18,57,423.11",
18-Aug-21,Cash,00.00,"9,28,711.56","9,28,711.56",
18-Aug-21,Interest,"2,50,560.47",00.00,"11,79,272.03",
18-Aug-21,ATM,582.67,00.00,"11,79,854.70",
18-Aug-21,RTGS,00.00,"1,96,642.45","9,83,212.25",
18-Aug-21,Debit Card,00.00,"1,22,901.53","8,60,310.72",
18-Aug-21,Debit Card,"1,05,751.00",00.00,"9,66,061.72",
18-Aug-21,Transfer,75,00.00,"9,66,136.72",
18-Aug-21,Tax,"1,095.02",00.00,"9,67,231.74",
18-Aug-21,Tax,00.00,"96,723.17","8,70,508.57",
18-Aug-21,Cheque,00.00,"87,050.86","7,83,457.71",
18-Aug-21,Debit Card,00.00,"1,30,576.29","6,52,881.42",
18-Aug-21,Transportellaneous,255.3,00.00,"6,53,136.72",
18-Aug-21,Tax,00.00,"65,313.67","5,87,823.05",
18-Aug-21,Commission,836,00.00,"5,88,659.05",
18-Aug-21,Reversal,00.00,"5,88,659.05",00.00,
18-Aug-21,Cash,"1,92,542.30",00.00,"1,92,542.30",
18-Aug-21,NEFT,287.7,00.00,"1,92,830.00",
18-Aug-21,Purchase,"27,058.20",00.00,"2,19,888.20",
18-Aug-21,IMPS,00.00,"27,486.03","1,92,402.18",
18-Aug-21,Transportellaneous,00.00,"32,067.03","1,60,335.15",
19-Aug-21,Debit Card,"1,265.72",00.00,"1,61,600.87",
19-Aug-21,NEFT,"1,996.90",00.00,"1,63,597.77",
19-Aug-21,ATM,00.00,"54,532.59","1,09,065.18",
19-Aug-21,Interest,00.00,"12,118.35","96,946.83",
19-Aug-21,NEFT,"91,199.20",00.00,"1,88,146.03",
19-Aug-21,Reversal,73.7,00.00,"1,88,219.73",
19-Aug-21,Transfer,00.00,"37,643.95","1,50,575.78",
19-Aug-21,Transfer,00.00,"75,287.89","75,287.89",
19-Aug-21,NEFT,47,00.00,"75,334.89",
19-Aug-21,Transportellaneous,295.88,00.00,"75,630.77",
19-Aug-21,Reversal,29.7,00.00,"75,660.47",
19-Aug-21,Transfer,"18,77,566.00",00.00,"19,53,226.47",
19-Aug-21,Transportellaneous,63.6,00.00,"19,53,290.07",
19-Aug-21,Cheque,57.6,00.00,"19,53,347.67",
19-Aug-21,Commission,00.00,"2,44,168.46","17,09,179.21",
19-Aug-21,Transfer,46.51,00.00,"17,09,225.72",
19-Aug-21,Commission,"2,379.70",00.00,"17,11,605.42",
19-Aug-21,RTGS,00.00,"17,11,605.42",00.00,
19-Aug-21,Debit Card,64.34,00.00,64.34,
19-Aug-21,Bill,07.00,00.00,71.34,
19-Aug-21,Tax,"1,09,708.80",00.00,"1,09,780.14",
19-Aug-21,Cash,00.00,"36,593.38","73,186.76",
19-Aug-21,Cash,00.00,"8,131.86","65,054.90",
19-Aug-21,Cheque,00.00,"13,010.98","52,043.92",
19-Aug-21,Transportellaneous,00.00,"13,010.98","39,032.94",
19-Aug-21,Interest,"2,975.04",00.00,"42,007.98",
19-Aug-21,Cash,"6,13,826.00",00.00,"6,55,833.98",
19-Aug-21,ATM,762.8,00.00,"6,56,596.78",
19-Aug-21,NEFT,00.00,"82,074.60","5,74,522.18",
19-Aug-21,IMPS,"16,19,880.00",00.00,"21,94,402.18",
20-Aug-21,Transportellaneous,00.00,"10,97,201.09","10,97,201.09",
20-Aug-21,RTGS,236,00.00,"10,97,437.09",
20-Aug-21,Transfer,"30,357.11",00.00,"11,27,794.20",
20-Aug-21,Commission,00.00,"1,61,113.46","9,66,680.74",
20-Aug-21,NEFT,00.00,"1,38,097.25","8,28,583.49",
20-Aug-21,Interest,00.00,"8,28,583.49",00.00,
20-Aug-21,Tax,"17,155.28",00.00,"17,155.28",
20-Aug-21,Interest,19,00.00,"17,174.28",
20-Aug-21,Bill,"1,07,886.40",00.00,"1,25,060.68",
20-Aug-21,Interest,00.00,"17,865.81","1,07,194.87",
20-Aug-21,Purchase,00.00,"35,731.62","71,463.25",
21-Aug-21,ATM,00.00,"23,821.08","47,642.17",
21-Aug-21,Tax,00.00,"7,940.36","39,701.81",
21-Aug-21,RTGS,00.00,"4,962.73","34,739.08",
21-Aug-21,Debit Card,18.6,00.00,"34,757.68",
21-Aug-21,RTGS,00.00,"34,757.68",00.00,
21-Aug-21,Cheque,"2,654.00",00.00,"2,654.00",
21-Aug-21,Commission,"1,83,991.20",00.00,"1,86,645.20",
21-Aug-21,RTGS,"14,45,171.00",00.00,"16,31,816.20",
22-Aug-21,Cash,"2,57,308.84",00.00,"18,89,125.04",
22-Aug-21,Reversal,00.00,"2,69,875.01","16,19,250.03",
22-Aug-21,Commission,00.00,"2,31,321.43","13,87,928.60",
23-Aug-21,Cheque,03.45,00.00,"13,87,932.05",
23-Aug-21,Transportellaneous,00.00,"1,38,793.21","12,49,138.84",
23-Aug-21,Cheque,00.00,"12,49,138.84",00.00,
23-Aug-21,Bill,"14,89,759.00",00.00,"14,89,759.00",
23-Aug-21,Transportellaneous,00.00,"1,86,219.88","13,03,539.12",
23-Aug-21,RTGS,00.00,"1,62,942.39","11,40,596.73",
23-Aug-21,Debit Card,52.1,00.00,"11,40,648.83",
23-Aug-21,RTGS,00.00,"1,90,108.14","9,50,540.69",
23-Aug-21,IMPS,"27,568.81",00.00,"9,78,109.50",
23-Aug-21,Purchase,00.00,"3,26,036.50","6,52,073.00",
23-Aug-21,Bill,00.00,"3,26,036.50","3,26,036.50",
23-Aug-21,Bill,"2,38,448.70",00.00,"5,64,485.20",
23-Aug-21,ATM,00.00,"1,88,161.73","3,76,323.47",
23-Aug-21,Cash,00.00,"62,720.58","3,13,602.89",
23-Aug-21,NEFT,248.5,00.00,"3,13,851.39",
23-Aug-21,Cash,"50,289.00",00.00,"3,64,140.39",
23-Aug-21,Commission,00.00,"1,21,380.13","2,42,760.26",
23-Aug-21,Debit Card,00.00,"34,680.04","2,08,080.22",
23-Aug-21,Transfer,"13,69,291.50",00.00,"15,77,371.72",
23-Aug-21,NEFT,00.00,"1,75,263.52","14,02,108.20",
23-Aug-21,Transportellaneous,10,00.00,"14,02,118.20",
23-Aug-21,Bill,00.00,"1,75,264.78","12,26,853.42",
23-Aug-21,Debit Card,06.00,00.00,"12,26,859.42",
23-Aug-21,Commission,00.00,"1,53,357.43","10,73,501.99",
23-Aug-21,Interest,402.6,00.00,"10,73,904.59",
23-Aug-21,Tax,473.6,00.00,"10,74,378.19",
23-Aug-21,Commission,04.17,00.00,"10,74,382.36",
23-Aug-21,Purchase,00.00,"5,37,191.18","5,37,191.18",
23-Aug-21,Transportellaneous,431,00.00,"5,37,622.18",
23-Aug-21,Commission,00.00,"53,762.22","4,83,859.96",
23-Aug-21,Reversal,00.00,"69,122.85","4,14,737.11",
23-Aug-21,Debit Card,"14,18,708.00",00.00,"18,33,445.11",
23-Aug-21,Bill,00.00,"3,66,689.02","14,66,756.09",
23-Aug-21,RTGS,"25,453.28",00.00,"14,92,209.37",
23-Aug-21,Reversal,00.00,"1,49,220.94","13,42,988.43",
23-Aug-21,IMPS,00.00,"13,42,988.43",00.00,
23-Aug-21,Cash,426.67,00.00,426.67,
23-Aug-21,Commission,00.00,42.67,384,
23-Aug-21,Transportellaneous,"7,64,530.50",00.00,"7,64,914.50",
23-Aug-21,Cheque,00.00,"1,27,485.75","6,37,428.75",
23-Aug-21,ATM,"15,364.19",00.00,"6,52,792.94",
23-Aug-21,Transportellaneous,482.92,00.00,"6,53,275.86",
23-Aug-21,Debit Card,"1,48,482.00",00.00,"8,01,757.86",
23-Aug-21,Cheque,00.00,"1,33,626.31","6,68,131.55",
23-Aug-21,Bill,00.00,"66,813.16","6,01,318.40",
23-Aug-21,Interest,00.00,"66,813.16","5,34,505.24",
23-Aug-21,Transfer,00.00,"2,67,252.62","2,67,252.62",
23-Aug-21,Purchase,00.00,"89,084.21","1,78,168.41",
23-Aug-21,Cash,00.00,"89,084.21","89,084.20",
23-Aug-21,Transportellaneous,429.2,00.00,"89,513.40",
23-Aug-21,Transportellaneous,00.00,"8,951.34","80,562.06",
23-Aug-21,IMPS,00.00,"16,112.41","64,449.65",
23-Aug-21,Debit Card,00.00,"32,224.83","32,224.82",
23-Aug-21,Transfer,00.00,"3,580.54","28,644.28",
23-Aug-21,Transportellaneous,"1,575.30",00.00,"30,219.58",
23-Aug-21,Commission,"28,640.00",00.00,"58,859.58",
23-Aug-21,Purchase,00.00,"19,619.86","39,239.72",
23-Aug-21,RTGS,00.00,"4,359.97","34,879.75",
23-Aug-21,Commission,00.00,"17,439.88","17,439.88",
23-Aug-21,Transportellaneous,"69,917.20",00.00,"87,357.08",
23-Aug-21,Transportellaneous,403.1,00.00,"87,760.18",
23-Aug-21,NEFT,00.00,"10,970.02","76,790.16",
23-Aug-21,Transportellaneous,00.00,"10,970.02","65,820.14",
23-Aug-21,NEFT,00.00,"7,313.35","58,506.79",
23-Aug-21,Transfer,"2,442.46",00.00,"60,949.25",
23-Aug-21,Interest,29.7,00.00,"60,978.95",
23-Aug-21,Bill,02.90,00.00,"60,981.85",
23-Aug-21,Transportellaneous,00.00,"30,490.93","30,490.92",
23-Aug-21,Cheque,"13,354.39",00.00,"43,845.31",
23-Aug-21,RTGS,69.02,00.00,"43,914.33",
23-Aug-21,RTGS,44.35,00.00,"43,958.68",
23-Aug-21,Bill,"2,39,722.00",00.00,"2,83,680.68",
23-Aug-21,Bill,00.00,"56,736.14","2,26,944.54",
23-Aug-21,NEFT,00.00,"2,26,944.54",00.00,
23-Aug-21,NEFT,"24,044.69",00.00,"24,044.69",
23-Aug-21,Tax,02.21,00.00,"24,046.90",
23-Aug-21,Reversal,405.7,00.00,"24,452.60",
23-Aug-21,Bill,02.00,00.00,"24,454.60",
23-Aug-21,Debit Card,00.00,"3,056.83","21,397.78",
23-Aug-21,Reversal,00.00,"2,377.53","19,020.25",
23-Aug-21,NEFT,00.00,"9,510.13","9,510.12",
23-Aug-21,Reversal,00.00,"3,170.04","6,340.08",
23-Aug-21,Debit Card,"16,879.00",00.00,"23,219.08",
23-Aug-21,Interest,112.3,00.00,"23,331.38",
23-Aug-21,Transportellaneous,00.00,"2,333.14","20,998.24",
23-Aug-21,Debit Card,00.00,"5,249.56","15,748.68",
23-Aug-21,Reversal,01.10,00.00,"15,749.78",
23-Aug-21,Debit Card,05.93,00.00,"15,755.71",
23-Aug-21,NEFT,00.00,"3,938.93","11,816.78",
23-Aug-21,Purchase,06.00,00.00,"11,822.78",
23-Aug-21,Commission,132.9,00.00,"11,955.68",
23-Aug-21,Reversal,"23,610.02",00.00,"35,565.70",
23-Aug-21,ATM,02.20,00.00,"35,567.90",
23-Aug-21,Tax,00.00,"3,556.79","32,011.11",
23-Aug-21,Reversal,00.00,"6,402.22","25,608.89",
23-Aug-21,Transportellaneous,37.19,00.00,"25,646.08",
23-Aug-21,Transfer,400,00.00,"26,046.08",
23-Aug-21,RTGS,"3,194.80",00.00,"29,240.88",
24-Aug-21,Transfer,00.00,"2,924.09","26,316.79",
24-Aug-21,NEFT,00.00,"3,289.60","23,027.19",
24-Aug-21,Tax,"4,47,089.00",00.00,"4,70,116.19",
24-Aug-21,ATM,00.00,"4,70,116.19",00.00,
24-Aug-21,Purchase,"18,012.50",00.00,"18,012.50",
24-Aug-21,Transportellaneous,229.5,00.00,"18,242.00",
24-Aug-21,IMPS,04.00,00.00,"18,246.00",
24-Aug-21,NEFT,00.00,"2,280.75","15,965.25",
24-Aug-21,Commission,"10,25,725.50",00.00,"10,41,690.75",
24-Aug-21,Debit Card,"2,840.20",00.00,"10,44,530.95",
24-Aug-21,Commission,00.00,"1,74,088.49","8,70,442.46",
24-Aug-21,Interest,"12,06,843.00",00.00,"20,77,285.46",
24-Aug-21,RTGS,04.35,00.00,"20,77,289.81",
24-Aug-21,Debit Card,00.00,"2,59,661.23","18,17,628.58",
24-Aug-21,Debit Card,06.82,00.00,"18,17,635.40",
24-Aug-21,Tax,"13,81,646.00",00.00,"31,99,281.40",
24-Aug-21,Cash,00.00,"3,99,910.18","27,99,371.22",
24-Aug-21,Debit Card,00.00,"2,79,937.12","25,19,434.10",
24-Aug-21,Debit Card,00.00,"5,03,886.82","20,15,547.28",
24-Aug-21,Tax,"3,648.25",00.00,"20,19,195.53",
24-Aug-21,Interest,00.00,"2,52,399.44","17,66,796.09",
24-Aug-21,Tax,00.00,"8,83,398.05","8,83,398.04",
24-Aug-21,Tax,00.00,"88,339.80","7,95,058.24",
24-Aug-21,Bill,00.00,"1,32,509.71","6,62,548.53",
24-Aug-21,Purchase,00.00,"94,649.79","5,67,898.74",
24-Aug-21,Transfer,"1,182.05",00.00,"5,69,080.79",
24-Aug-21,RTGS,00.00,"5,69,080.79",00.00,
24-Aug-21,Interest,"2,341.00",00.00,"2,341.00",
24-Aug-21,IMPS,07.00,00.00,"2,348.00",
24-Aug-21,Transportellaneous,"2,51,059.53",00.00,"2,53,407.53",
24-Aug-21,Cash,00.00,"31,675.94","2,21,731.59",
24-Aug-21,RTGS,243.9,00.00,"2,21,975.49",
24-Aug-21,Commission,00.00,"55,493.87","1,66,481.62",
24-Aug-21,Transportellaneous,00.00,"20,810.20","1,45,671.42",
24-Aug-21,Cheque,585,00.00,"1,46,256.42",
24-Aug-21,Interest,00.00,"29,251.28","1,17,005.14",
24-Aug-21,Reversal,00.00,"16,715.02","1,00,290.12",
24-Aug-21,Commission,"3,594.30",00.00,"1,03,884.42",
24-Aug-21,Debit Card,02.40,00.00,"1,03,886.82",
24-Aug-21,Tax,00.10,00.00,"1,03,886.92",
24-Aug-21,Cash,260.38,00.00,"1,04,147.30",
24-Aug-21,ATM,"19,655.58",00.00,"1,23,802.88",
24-Aug-21,Debit Card,00.00,"1,23,802.88",00.00,
24-Aug-21,Reversal,04.60,00.00,04.60,
24-Aug-21,Commission,19,00.00,23.6,
24-Aug-21,Cheque,00.00,02.95,20.65,
24-Aug-21,Interest,"3,020.00",00.00,"3,040.65",
24-Aug-21,Transfer,00.00,337.85,"2,702.80",
24-Aug-21,RTGS,00.00,337.85,"2,364.95",
24-Aug-21,IMPS,"7,01,579.20",00.00,"7,03,944.15",
24-Aug-21,IMPS,00.00,"2,34,648.05","4,69,296.10",
24-Aug-21,RTGS,"9,802.00",00.00,"4,79,098.10",
24-Aug-21,ATM,00.00,"4,79,098.10",00.00,
24-Aug-21,Transfer,06.30,00.00,06.30,
24-Aug-21,Purchase,"16,21,248.00",00.00,"16,21,254.30",
24-Aug-21,Purchase,437.98,00.00,"16,21,692.28",
24-Aug-21,Interest,00.00,"1,62,169.23","14,59,523.05",
24-Aug-21,Debit Card,00.00,"1,82,440.38","12,77,082.67",
24-Aug-21,Purchase,"29,130.00",00.00,"13,06,212.67",
24-Aug-21,ATM,94,00.00,"13,06,306.67",
24-Aug-21,ATM,41.87,00.00,"13,06,348.54",
24-Aug-21,Cheque,00.00,"3,26,587.14","9,79,761.40",
24-Aug-21,Transportellaneous,"5,52,310.00",00.00,"15,32,071.40",
24-Aug-21,RTGS,00.00,"3,83,017.85","11,49,053.55",
24-Aug-21,Commission,00.00,"1,91,508.93","9,57,544.62",
24-Aug-21,Commission,49.3,00.00,"9,57,593.92",
24-Aug-21,Reversal,00.00,"1,59,598.99","7,97,994.93",
24-Aug-21,Transportellaneous,04.00,00.00,"7,97,998.93",
24-Aug-21,ATM,00.00,"88,666.55","7,09,332.38",
24-Aug-21,Reversal,"3,901.00",00.00,"7,13,233.38",
24-Aug-21,Interest,05.80,00.00,"7,13,239.18",
24-Aug-21,NEFT,00.00,"1,01,891.31","6,11,347.87",
24-Aug-21,Reversal,00.00,"61,134.79","5,50,213.08",
24-Aug-21,Purchase,"3,054.00",00.00,"5,53,267.08",
24-Aug-21,Bill,00.00,"55,326.71","4,97,940.37",
24-Aug-21,Commission,00.00,"49,794.04","4,48,146.33",
24-Aug-21,Commission,00.00,"56,018.29","3,92,128.04",
24-Aug-21,RTGS,"13,18,016.00",00.00,"17,10,144.04",
24-Aug-21,Reversal,00.00,"2,85,024.01","14,25,120.03",
24-Aug-21,Commission,31.93,00.00,"14,25,151.96",
24-Aug-21,Cheque,00.00,"1,78,144.00","12,47,007.96",
24-Aug-21,Transfer,00.00,"6,23,503.98","6,23,503.98",
24-Aug-21,RTGS,00.00,"3,11,751.99","3,11,751.99",
24-Aug-21,ATM,"6,42,225.00",00.00,"9,53,976.99",
24-Aug-21,Cheque,06.40,00.00,"9,53,983.39",
24-Aug-21,Transfer,00.00,"1,90,796.68","7,63,186.71",
24-Aug-21,Bill,"1,36,379.00",00.00,"8,99,565.71",
24-Aug-21,Transfer,00.00,"99,951.75","7,99,613.96",
24-Aug-21,Debit Card,00.00,"7,99,613.96",00.00,
24-Aug-21,Transfer,06.00,00.00,06.00,
24-Aug-21,Debit Card,33,00.00,39,
24-Aug-21,Commission,37.3,00.00,76.3,
25-Aug-21,Cheque,04.10,00.00,80.4,
25-Aug-21,Transportellaneous,"17,86,572.25",00.00,"17,86,652.65",
25-Aug-21,IMPS,03.40,00.00,"17,86,656.05",
25-Aug-21,Debit Card,00.00,"17,86,656.05",00.00,
25-Aug-21,Interest,"5,068.70",00.00,"5,068.70",
25-Aug-21,Bill,00.00,844.78,"4,223.92",
25-Aug-21,Transportellaneous,00.00,703.99,"3,519.93",
25-Aug-21,Cash,"2,636.00",00.00,"6,155.93",
25-Aug-21,NEFT,00.00,769.49,"5,386.44",
25-Aug-21,Transfer,00.00,"1,077.29","4,309.15",
25-Aug-21,Reversal,04.00,00.00,"4,313.15",
25-Aug-21,Commission,00.00,"1,437.72","2,875.43",
25-Aug-21,Transportellaneous,"1,694.40",00.00,"4,569.83",
25-Aug-21,Cheque,"28,852.30",00.00,"33,422.13",
25-Aug-21,Transfer,00.00,"3,342.21","30,079.92",
25-Aug-21,ATM,"11,78,242.75",00.00,"12,08,322.67",
25-Aug-21,NEFT,00.00,"1,51,040.33","10,57,282.34",
25-Aug-21,Cheque,33.2,00.00,"10,57,315.54",
25-Aug-21,ATM,07.00,00.00,"10,57,322.54",
25-Aug-21,Tax,"1,11,754.72",00.00,"11,69,077.26",
25-Aug-21,Transfer,38.54,00.00,"11,69,115.80",
25-Aug-21,Transfer,641.9,00.00,"11,69,757.70",
25-Aug-21,Debit Card,"19,58,117.00",00.00,"31,27,874.70",
25-Aug-21,Tax,42.37,00.00,"31,27,917.07",
25-Aug-21,Cheque,00.00,"4,46,845.30","26,81,071.77",
25-Aug-21,Cash,00.00,"2,68,107.18","24,12,964.59",
25-Aug-21,Purchase,495.42,00.00,"24,13,460.01",
25-Aug-21,Commission,"99,515.00",00.00,"25,12,975.01",
25-Aug-21,Purchase,00.00,"3,14,121.88","21,98,853.13",
25-Aug-21,IMPS,00.00,"10,99,426.57","10,99,426.56",
25-Aug-21,Cheque,43.3,00.00,"10,99,469.86",
25-Aug-21,NEFT,04.15,00.00,"10,99,474.01",
25-Aug-21,Commission,"58,629.56",00.00,"11,58,103.57",
25-Aug-21,Cash,23.1,00.00,"11,58,126.67",
25-Aug-21,IMPS,00.00,"1,15,812.67","10,42,314.00",
25-Aug-21,Cash,"90,428.00",00.00,"11,32,742.00",
25-Aug-21,NEFT,07.52,00.00,"11,32,749.52",
25-Aug-21,Transfer,07.66,00.00,"11,32,757.18",
25-Aug-21,Transportellaneous,00.00,"1,41,594.65","9,91,162.53",
25-Aug-21,Transfer,00.00,"99,116.25","8,92,046.28",
25-Aug-21,Reversal,"5,44,898.50",00.00,"14,36,944.78",
25-Aug-21,Commission,00.00,"14,36,944.78",00.00,
25-Aug-21,IMPS,"10,264.44",00.00,"10,264.44",
25-Aug-21,Transfer,"25,281.60",00.00,"35,546.04",
25-Aug-21,IMPS,"2,09,539.69",00.00,"2,45,085.73",
25-Aug-21,Cash,"15,82,765.00",00.00,"18,27,850.73",
25-Aug-21,Cheque,00.00,"1,82,785.07","16,45,065.66",
25-Aug-21,Transportellaneous,"96,923.00",00.00,"17,41,988.66",
25-Aug-21,Transportellaneous,448.46,00.00,"17,42,437.12",
25-Aug-21,Bill,00.00,"1,93,604.12","15,48,833.00",
25-Aug-21,Bill,"1,01,106.00",00.00,"16,49,939.00",
25-Aug-21,Cash,02.87,00.00,"16,49,941.87",
25-Aug-21,Transportellaneous,00.00,"16,49,941.87",00.00,
25-Aug-21,Cheque,340,00.00,340,
25-Aug-21,Debit Card,00.00,85,255,
25-Aug-21,Purchase,00.00,127.5,127.5,
25-Aug-21,Transfer,"14,002.70",00.00,"14,130.20",
25-Aug-21,Reversal,453,00.00,"14,583.20",
25-Aug-21,ATM,00.00,"1,620.36","12,962.84",
25-Aug-21,Bill,00.00,"12,962.84",00.00,
25-Aug-21,Tax,283.42,00.00,283.42,
25-Aug-21,Reversal,00.00,35.43,247.99,
25-Aug-21,Transportellaneous,558,00.00,805.99,
26-Aug-21,Cash,378.6,00.00,"1,184.59",
26-Aug-21,Cheque,04.00,00.00,"1,188.59",
26-Aug-21,ATM,"12,12,412.00",00.00,"12,13,600.59",
26-Aug-21,Interest,"21,943.97",00.00,"12,35,544.56",
26-Aug-21,Commission,00.00,"12,35,544.56",00.00,
26-Aug-21,NEFT,42.17,00.00,42.17,
26-Aug-21,Reversal,00.00,06.02,36.15,
26-Aug-21,Bill,61.64,00.00,97.79,
26-Aug-21,Cash,05.92,00.00,103.71,
26-Aug-21,Interest,04.18,00.00,107.89,
26-Aug-21,ATM,35,00.00,142.89,
26-Aug-21,Reversal,"31,691.81",00.00,"31,834.70",
26-Aug-21,Bill,00.00,"3,537.19","28,297.51",
26-Aug-21,Reversal,52,00.00,"28,349.51",
26-Aug-21,IMPS,00.00,"14,174.76","14,174.76",
26-Aug-21,Purchase,00.00,"2,362.46","11,812.30",
26-Aug-21,Tax,785.3,00.00,"12,597.60",
26-Aug-21,Bill,00.00,"1,259.76","11,337.84",
26-Aug-21,Commission,00.00,"1,619.69","9,718.15",
26-Aug-21,Tax,00.00,"4,859.08","4,859.08",
26-Aug-21,Interest,"11,985.00",00.00,"16,844.08",
26-Aug-21,Tax,00.00,"2,105.51","14,738.57",
26-Aug-21,Transportellaneous,44,00.00,"14,782.57",
26-Aug-21,NEFT,00.00,"14,782.57",00.00,
26-Aug-21,Tax,26.8,00.00,26.8,
26-Aug-21,Purchase,"27,724.10",00.00,"27,750.90",
26-Aug-21,NEFT,"2,63,214.00",00.00,"2,90,964.90",
26-Aug-21,NEFT,"2,52,428.00",00.00,"5,43,392.90",
26-Aug-21,ATM,00.00,"77,627.56","4,65,765.34",
26-Aug-21,NEFT,03.23,00.00,"4,65,768.57",
26-Aug-21,Cash,00.00,"4,65,768.57",00.00,
26-Aug-21,Bill,"1,67,737.00",00.00,"1,67,737.00",
26-Aug-21,Transportellaneous,"20,90,430.80",00.00,"22,58,167.80",
26-Aug-21,Interest,00.00,"11,29,083.90","11,29,083.90",
26-Aug-21,Transfer,00.00,"3,76,361.30","7,52,722.60",
26-Aug-21,NEFT,00.00,"2,50,907.53","5,01,815.07",
26-Aug-21,NEFT,00.00,"50,181.51","4,51,633.56",
26-Aug-21,RTGS,"2,061.00",00.00,"4,53,694.56",
26-Aug-21,Reversal,00.00,"1,13,423.64","3,40,270.92",
26-Aug-21,Commission,00.00,"34,027.09","3,06,243.83",
26-Aug-21,Cash,00.00,"38,280.48","2,67,963.35",
26-Aug-21,Bill,00.00,"33,495.42","2,34,467.93",
26-Aug-21,Commission,362,00.00,"2,34,829.93",
26-Aug-21,NEFT,00.00,"1,17,414.97","1,17,414.96",
26-Aug-21,Cash,00.00,"58,707.48","58,707.48",
27-Aug-21,NEFT,765,00.00,"59,472.48",
27-Aug-21,Bill,00.00,"7,434.06","52,038.42",
27-Aug-21,Debit Card,00.00,"7,434.06","44,604.36",
27-Aug-21,ATM,00.00,"5,575.55","39,028.82",
27-Aug-21,Reversal,00.00,"4,336.54","34,692.28",
27-Aug-21,RTGS,00.00,"8,673.07","26,019.21",
27-Aug-21,NEFT,00.00,"8,673.07","17,346.14",
27-Aug-21,RTGS,00.00,"5,782.05","11,564.09",
27-Aug-21,Transfer,00.00,"1,927.35","9,636.74",
27-Aug-21,NEFT,00.00,"1,204.59","8,432.15",
27-Aug-21,ATM,00.00,936.91,"7,495.24",
27-Aug-21,Interest,00.00,"1,873.81","5,621.43",
28-Aug-21,Cash,43,00.00,"5,664.43",
28-Aug-21,NEFT,"1,582.39",00.00,"7,246.82",
28-Aug-21,Bill,00.00,"7,246.82",00.00,
28-Aug-21,Cash,07.87,00.00,07.87,
28-Aug-21,Debit Card,00.00,00.00,07.87,
28-Aug-21,Bill,00.00,07.87,00.00,
28-Aug-21,Reversal,"2,45,748.38",00.00,"2,45,748.38",
28-Aug-21,Bill,00.00,"2,45,748.38",00.00,
28-Aug-21,Cash,"2,31,718.60",00.00,"2,31,718.60",
28-Aug-21,Tax,558.59,00.00,"2,32,277.19",
28-Aug-21,Bill,"9,69,646.00",00.00,"12,01,923.19",
28-Aug-21,RTGS,"13,26,377.80",00.00,"25,28,300.99",
28-Aug-21,Purchase,00.00,"2,52,830.10","22,75,470.89",
28-Aug-21,Interest,00.00,"2,52,830.10","20,22,640.79",
28-Aug-21,ATM,00.00,"5,05,660.20","15,16,980.59",
28-Aug-21,Interest,00.00,"1,89,622.57","13,27,358.02",
28-Aug-21,NEFT,"7,12,586.50",00.00,"20,39,944.52",
28-Aug-21,Cash,00.00,"6,79,981.51","13,59,963.01",
28-Aug-21,Debit Card,00.00,"1,69,995.38","11,89,967.63",
29-Aug-21,Debit Card,00.00,"1,69,995.38","10,19,972.25",
30-Aug-21,NEFT,"2,821.10",00.00,"10,22,793.35",
30-Aug-21,Transfer,00.00,"2,55,698.34","7,67,095.01",
30-Aug-21,Bill,00.00,"85,232.78","6,81,862.23",
30-Aug-21,ATM,00.00,"1,36,372.45","5,45,489.78",
30-Aug-21,Tax,00.00,"2,72,744.89","2,72,744.89",
30-Aug-21,IMPS,00.00,"38,963.56","2,33,781.33",
30-Aug-21,Debit Card,150.3,00.00,"2,33,931.63",
30-Aug-21,NEFT,00.00,"33,418.80","2,00,512.83",
30-Aug-21,Purchase,"3,048.93",00.00,"2,03,561.76",
30-Aug-21,Transportellaneous,07.38,00.00,"2,03,569.14",
30-Aug-21,Interest,"2,400.10",00.00,"2,05,969.24",
30-Aug-21,RTGS,00.00,"34,328.21","1,71,641.03",
30-Aug-21,RTGS,00.00,"24,520.15","1,47,120.88",
30-Aug-21,Tax,"1,09,484.00",00.00,"2,56,604.88",
30-Aug-21,Commission,48.6,00.00,"2,56,653.48",
30-Aug-21,Reversal,05.89,00.00,"2,56,659.37",
30-Aug-21,Transportellaneous,49,00.00,"2,56,708.37",
30-Aug-21,IMPS,238,00.00,"2,56,946.37",
30-Aug-21,IMPS,00.00,"32,118.30","2,24,828.07",
30-Aug-21,Debit Card,00.00,"32,118.30","1,92,709.77",
30-Aug-21,Transportellaneous,"9,48,620.50",00.00,"11,41,330.27",
30-Aug-21,Transportellaneous,00.00,"1,14,133.03","10,27,197.24",
30-Aug-21,Bill,267,00.00,"10,27,464.24",
30-Aug-21,Debit Card,"32,377.00",00.00,"10,59,841.24",
30-Aug-21,IMPS,07.40,00.00,"10,59,848.64",
30-Aug-21,IMPS,"3,895.45",00.00,"10,63,744.09",
30-Aug-21,Bill,00.00,"1,06,374.41","9,57,369.68",
30-Aug-21,Debit Card,27.9,00.00,"9,57,397.58",
30-Aug-21,Cash,00.00,"1,91,479.52","7,65,918.06",
30-Aug-21,Interest,"20,06,186.00",00.00,"27,72,104.06",
30-Aug-21,IMPS,00.00,"6,93,026.02","20,79,078.04",
30-Aug-21,Bill,07.00,00.00,"20,79,085.04",
30-Aug-21,Bill,00.00,"20,79,085.04",00.00,
31-Aug-21,ATM,"1,68,865.66",00.00,"1,68,865.66",
31-Aug-21,Commission,06.70,00.00,"1,68,872.36",
31-Aug-21,RTGS,00.00,"1,68,872.36",00.00,
31-Aug-21,Bill,42.32,00.00,42.32,
31-Aug-21,Debit Card,"5,06,896.20",00.00,"5,06,938.52",
31-Aug-21,Transportellaneous,"3,979.78",00.00,"5,10,918.30",
01-Sep-21,Transfer,"2,86,157.75",00.00,"7,97,076.05",
01-Sep-21,Debit Card,00.00,"2,65,692.02","5,31,384.03",
01-Sep-21,Bill,00.00,"5,31,384.03",00.00,
01-Sep-21,Bill,"29,168.50",00.00,"29,168.50",
01-Sep-21,Interest,"30,149.00",00.00,"59,317.50",
01-Sep-21,Cash,00.00,"9,886.25","49,431.25",
01-Sep-21,ATM,00.00,"4,943.13","44,488.12",
01-Sep-21,Tax,00.00,"4,448.81","40,039.31",
01-Sep-21,Cash,00.00,"5,719.90","34,319.41",
01-Sep-21,Purchase,00.00,"6,863.88","27,455.53",
01-Sep-21,NEFT,"19,84,729.20",00.00,"20,12,184.73",
01-Sep-21,Reversal,00.00,"2,01,218.47","18,10,966.26",
01-Sep-21,IMPS,00.00,"3,62,193.25","14,48,773.01",
02-Sep-21,Transfer,00.00,"2,06,967.57","12,41,805.44",
02-Sep-21,RTGS,00.00,"2,06,967.57","10,34,837.87",
02-Sep-21,Transfer,00.00,"1,14,981.99","9,19,855.88",
02-Sep-21,Transfer,00.00,"1,14,981.99","8,04,873.90",
02-Sep-21,RTGS,452,00.00,"8,05,325.90",
02-Sep-21,IMPS,"1,347.00",00.00,"8,06,672.90",
02-Sep-21,Tax,322.1,00.00,"8,06,995.00",
02-Sep-21,IMPS,315,00.00,"8,07,310.00",
03-Sep-21,Reversal,00.00,"1,00,913.75","7,06,396.25",
03-Sep-21,Bill,"11,53,346.20",00.00,"18,59,742.45",
03-Sep-21,Bill,00.00,"2,06,638.05","16,53,104.40",
03-Sep-21,Cash,"14,90,911.80",00.00,"31,44,016.20",
03-Sep-21,Cheque,00.47,00.00,"31,44,016.67",
03-Sep-21,Cheque,"15,227.00",00.00,"31,59,243.67",
04-Sep-21,IMPS,00.00,"3,51,027.07","28,08,216.60",
04-Sep-21,Commission,00.00,"7,02,054.15","21,06,162.45",
04-Sep-21,Purchase,09.41,00.00,"21,06,171.86",
04-Sep-21,Bill,00.00,"2,10,617.19","18,95,554.67",
04-Sep-21,Purchase,00.00,"3,79,110.93","15,16,443.74",
04-Sep-21,NEFT,00.00,"3,79,110.94","11,37,332.80",
04-Sep-21,Bill,00.00,"1,62,476.11","9,74,856.69",
04-Sep-21,Cheque,00.00,"1,08,317.41","8,66,539.28",
04-Sep-21,Bill,00.00,"1,44,423.21","7,22,116.07",
04-Sep-21,Debit Card,"2,46,616.75",00.00,"9,68,732.82",
04-Sep-21,Transfer,00.00,"9,68,732.82",00.00,
04-Sep-21,Bill,"25,946.20",00.00,"25,946.20",
05-Sep-21,Transfer,00.00,"6,486.55","19,459.65",
05-Sep-21,Interest,00.00,"3,243.28","16,216.38",
05-Sep-21,Bill,"3,171.80",00.00,"19,388.18",
05-Sep-21,ATM,18.7,00.00,"19,406.88",
05-Sep-21,Debit Card,00.00,"19,406.88",00.00,
05-Sep-21,Transportellaneous,"1,01,571.80",00.00,"1,01,571.80",
05-Sep-21,RTGS,00.00,"50,785.90","50,785.90",
05-Sep-21,Cheque,"11,19,476.20",00.00,"11,70,262.10",
05-Sep-21,RTGS,00.00,"2,34,052.42","9,36,209.68",
05-Sep-21,Transportellaneous,38,00.00,"9,36,247.68",
05-Sep-21,Commission,00.00,"1,56,041.28","7,80,206.40",
05-Sep-21,RTGS,00.00,"97,525.80","6,82,680.60",
05-Sep-21,ATM,00.00,"68,268.06","6,14,412.54",
05-Sep-21,ATM,00.00,"6,14,412.54",00.00,
05-Sep-21,NEFT,89.41,00.00,89.41,
05-Sep-21,Interest,"16,54,234.00",00.00,"16,54,323.41",
05-Sep-21,Tax,"2,26,661.50",00.00,"18,80,984.91",
05-Sep-21,Cash,07.00,00.00,"18,80,991.91",
05-Sep-21,Cash,219,00.00,"18,81,210.91",
05-Sep-21,NEFT,00.00,"3,13,535.15","15,67,675.76",
05-Sep-21,Cheque,04.00,00.00,"15,67,679.76",
05-Sep-21,Transportellaneous,00.00,"15,67,679.76",00.00,
05-Sep-21,Debit Card,22.32,00.00,22.32,
05-Sep-21,Purchase,00.00,04.46,17.86,
05-Sep-21,Bill,"2,146.53",00.00,"2,164.39",
05-Sep-21,Transfer,00.00,"2,164.39",00.00,
05-Sep-21,Purchase,108.4,00.00,108.4,
05-Sep-21,Cheque,"2,14,243.00",00.00,"2,14,351.40",
05-Sep-21,Cash,00.00,"53,587.85","1,60,763.55",
05-Sep-21,Purchase,58.48,00.00,"1,60,822.03",
05-Sep-21,Transfer,00.00,"16,082.20","1,44,739.83",
05-Sep-21,Tax,"20,796.60",00.00,"1,65,536.43",
05-Sep-21,Purchase,"1,84,723.00",00.00,"3,50,259.43",
05-Sep-21,Bill,00.00,"1,75,129.72","1,75,129.72",
05-Sep-21,Reversal,00.00,"19,458.86","1,55,670.86",
05-Sep-21,Commission,"5,31,465.00",00.00,"6,87,135.86",
05-Sep-21,Transfer,00.00,"6,87,135.86",00.00,
05-Sep-21,Interest,04.80,00.00,04.80,
05-Sep-21,Transportellaneous,"14,73,172.00",00.00,"14,73,176.80",
05-Sep-21,Purchase,"15,70,700.20",00.00,"30,43,877.00",
05-Sep-21,Reversal,00.00,"3,80,484.63","26,63,392.38",
05-Sep-21,Purchase,00.00,"6,65,848.10","19,97,544.28",
05-Sep-21,Cheque,00.00,"2,85,363.47","17,12,180.81",
05-Sep-21,Purchase,63.4,00.00,"17,12,244.21",
05-Sep-21,Transportellaneous,"17,83,993.00",00.00,"34,96,237.21",
05-Sep-21,IMPS,00.00,"8,74,059.30","26,22,177.91",
05-Sep-21,RTGS,00.00,"6,55,544.48","19,66,633.43",
05-Sep-21,Reversal,00.00,"3,93,326.69","15,73,306.74",
06-Sep-21,IMPS,00.00,"5,24,435.58","10,48,871.16",
06-Sep-21,IMPS,00.00,"10,48,871.16",00.00,
07-Sep-21,NEFT,469,00.00,469,
07-Sep-21,Purchase,04.59,00.00,473.59,
07-Sep-21,Tax,"15,107.70",00.00,"15,581.29",
07-Sep-21,Purchase,00.00,"1,558.13","14,023.16",
07-Sep-21,ATM,00.00,00.00,"14,023.16",
07-Sep-21,Tax,"11,40,696.20",00.00,"11,54,719.36",
07-Sep-21,Transportellaneous,"1,78,671.25",00.00,"13,33,390.61",
07-Sep-21,Interest,00.00,"13,33,390.61",00.00,
07-Sep-21,Commission,04.30,00.00,04.30,
07-Sep-21,Cash,00.00,00.72,03.58,
07-Sep-21,Commission,"30,846.60",00.00,"30,850.18",
07-Sep-21,Tax,240,00.00,"31,090.18",
07-Sep-21,Cheque,321,00.00,"31,411.18",
07-Sep-21,Cheque,"1,015.87",00.00,"32,427.05",
07-Sep-21,Transfer,00.00,"4,053.38","28,373.67",
07-Sep-21,Commission,01.37,00.00,"28,375.04",
07-Sep-21,Cheque,00.00,"5,675.01","22,700.03",
07-Sep-21,Transportellaneous,"1,51,604.16",00.00,"1,74,304.19",
07-Sep-21,Cheque,04.68,00.00,"1,74,308.87",
07-Sep-21,IMPS,"9,817.00",00.00,"1,84,125.87",
07-Sep-21,NEFT,549.46,00.00,"1,84,675.33",
07-Sep-21,Purchase,"30,216.60",00.00,"2,14,891.93",
07-Sep-21,Reversal,"7,41,862.00",00.00,"9,56,753.93",
07-Sep-21,Tax,05.70,00.00,"9,56,759.63",
07-Sep-21,Transfer,00.00,"1,06,306.63","8,50,453.00",
07-Sep-21,NEFT,395.8,00.00,"8,50,848.80",
08-Sep-21,Tax,"2,44,754.00",00.00,"10,95,602.80",
08-Sep-21,Bill,00.00,"2,19,120.56","8,76,482.24",
08-Sep-21,ATM,00.00,"8,76,482.24",00.00,
08-Sep-21,Commission,831.5,00.00,831.5,
08-Sep-21,NEFT,"21,299.44",00.00,"22,130.94",
08-Sep-21,Transfer,00.70,00.00,"22,131.64",
08-Sep-21,Bill,00.00,"7,377.21","14,754.43",
08-Sep-21,Tax,02.89,00.00,"14,757.32",
08-Sep-21,Transfer,00.00,"1,844.67","12,912.66",
08-Sep-21,Cash,"23,661.40",00.00,"36,574.06",
08-Sep-21,RTGS,00.00,"4,063.78","32,510.28",
08-Sep-21,Interest,00.00,"3,251.03","29,259.25",
09-Sep-21,NEFT,00.00,"29,259.25",00.00,
09-Sep-21,Cash,508.1,00.00,508.1,
09-Sep-21,Cheque,00.00,101.62,406.48,
09-Sep-21,Interest,54.8,00.00,461.28,
09-Sep-21,Purchase,"5,614.00",00.00,"6,075.28",
09-Sep-21,ATM,00.00,"1,518.82","4,556.46",
09-Sep-21,Cheque,"1,47,310.50",00.00,"1,51,866.96",
10-Sep-21,Bill,00.00,"37,966.74","1,13,900.22",
10-Sep-21,Debit Card,00.00,"37,966.74","75,933.48",
10-Sep-21,Transfer,"12,662.80",00.00,"88,596.28",
10-Sep-21,Cheque,00.00,"29,532.09","59,064.19",
10-Sep-21,NEFT,572.9,00.00,"59,637.09",
10-Sep-21,ATM,00.00,"14,909.27","44,727.82",
10-Sep-21,Tax,00.00,"4,969.76","39,758.06",
10-Sep-21,ATM,00.00,"19,879.03","19,879.03",
10-Sep-21,Reversal,00.00,"2,208.78","17,670.25",
10-Sep-21,ATM,"38,039.75",00.00,"55,710.00",
10-Sep-21,Cheque,"9,73,753.75",00.00,"10,29,463.75",
10-Sep-21,IMPS,"1,922.00",00.00,"10,31,385.75",
10-Sep-21,Cash,00.00,"1,14,598.42","9,16,787.33",
10-Sep-21,Debit Card,00.00,"91,678.73","8,25,108.60",
10-Sep-21,Tax,"18,357.60",00.00,"8,43,466.20",
10-Sep-21,Debit Card,58.8,00.00,"8,43,525.00",
10-Sep-21,Debit Card,00.00,"93,725.00","7,49,800.00",
10-Sep-21,NEFT,"2,37,366.50",00.00,"9,87,166.50",
10-Sep-21,Transfer,00.00,"1,41,023.79","8,46,142.71",
10-Sep-21,Transportellaneous,02.11,00.00,"8,46,144.82",
10-Sep-21,Cash,"1,67,585.00",00.00,"10,13,729.82",
10-Sep-21,Tax,00.00,"1,26,716.23","8,87,013.59",
10-Sep-21,NEFT,"5,133.80",00.00,"8,92,147.39",
10-Sep-21,Tax,00.00,"1,11,518.42","7,80,628.97",
10-Sep-21,RTGS,04.00,00.00,"7,80,632.97",
10-Sep-21,Cash,"19,96,074.00",00.00,"27,76,706.97",
10-Sep-21,Tax,367.95,00.00,"27,77,074.92",
10-Sep-21,ATM,00.00,"3,96,724.99","23,80,349.93",
10-Sep-21,Commission,55.87,00.00,"23,80,405.80",
10-Sep-21,IMPS,06.00,00.00,"23,80,411.80",
10-Sep-21,Transfer,00.00,"5,95,102.95","17,85,308.85",
10-Sep-21,Interest,00.00,"2,23,163.61","15,62,145.24",
10-Sep-21,Cheque,402.6,00.00,"15,62,547.84",
10-Sep-21,Tax,07.62,00.00,"15,62,555.46",
10-Sep-21,Cheque,"17,811.20",00.00,"15,80,366.66",
10-Sep-21,Purchase,00.00,"15,80,366.66",00.00,
10-Sep-21,Bill,164,00.00,164,
10-Sep-21,Debit Card,00.00,54.67,109.33,
10-Sep-21,IMPS,"11,673.98",00.00,"11,783.31",
10-Sep-21,Cash,00.00,"1,963.89","9,819.42",
10-Sep-21,NEFT,00.00,"4,909.71","4,909.71",
10-Sep-21,Tax,422,00.00,"5,331.71",
10-Sep-21,Cash,03.00,00.00,"5,334.71",
10-Sep-21,Reversal,"30,775.87",00.00,"36,110.58",
10-Sep-21,Tax,00.00,"3,611.06","32,499.52",
10-Sep-21,Cheque,50.8,00.00,"32,550.32",
10-Sep-21,NEFT,"28,431.07",00.00,"60,981.39",
10-Sep-21,Debit Card,00.00,"60,981.39",00.00,
10-Sep-21,Commission,816,00.00,816,
10-Sep-21,Debit Card,06.00,00.00,822,
10-Sep-21,ATM,"12,26,584.00",00.00,"12,27,406.00",
10-Sep-21,ATM,00.00,"1,75,343.71","10,52,062.29",
10-Sep-21,RTGS,09.99,00.00,"10,52,072.28",
10-Sep-21,RTGS,00.00,"5,26,036.14","5,26,036.14",
10-Sep-21,Transportellaneous,"5,002.80",00.00,"5,31,038.94",
10-Sep-21,Bill,00.00,"1,32,759.74","3,98,279.20",
10-Sep-21,Tax,00.00,"44,253.24","3,54,025.96",
10-Sep-21,Transportellaneous,00.00,"1,77,012.98","1,77,012.98",
10-Sep-21,IMPS,"31,121.46",00.00,"2,08,134.44",
10-Sep-21,Commission,00.00,"23,126.05","1,85,008.39",
10-Sep-21,RTGS,00.00,"46,252.10","1,38,756.29",
10-Sep-21,Transfer,00.00,"27,751.26","1,11,005.03",
10-Sep-21,Interest,00.00,"1,11,005.03",00.00,
10-Sep-21,Interest,48.91,00.00,48.91,
10-Sep-21,Cheque,"55,344.80",00.00,"55,393.71",
10-Sep-21,Cash,00.00,"7,913.39","47,480.32",
10-Sep-21,Tax,"1,03,036.50",00.00,"1,50,516.82",
10-Sep-21,NEFT,"2,752.00",00.00,"1,53,268.82",
10-Sep-21,Bill,00.00,"51,089.61","1,02,179.21",
10-Sep-21,Purchase,00.00,"10,217.92","91,961.29",
10-Sep-21,ATM,"14,44,503.00",00.00,"15,36,464.29",
10-Sep-21,Tax,"31,919.82",00.00,"15,68,384.11",
10-Sep-21,RTGS,00.00,"2,24,054.87","13,44,329.24",
10-Sep-21,Transfer,00.00,"6,72,164.62","6,72,164.62",
10-Sep-21,RTGS,58,00.00,"6,72,222.62",
10-Sep-21,IMPS,00.00,"2,24,074.21","4,48,148.41",
10-Sep-21,Reversal,477.75,00.00,"4,48,626.16",
10-Sep-21,Debit Card,00.00,"4,48,626.16",00.00,
10-Sep-21,NEFT,"2,617.00",00.00,"2,617.00",
10-Sep-21,Reversal,00.00,327.13,"2,289.88",
10-Sep-21,RTGS,468.8,00.00,"2,758.68",
10-Sep-21,RTGS,00.00,306.52,"2,452.16",
10-Sep-21,Cash,"2,301.00",00.00,"4,753.16",
10-Sep-21,Cheque,00.00,"4,753.16",00.00,
10-Sep-21,Bill,"13,88,597.00",00.00,"13,88,597.00",
10-Sep-21,ATM,00.00,"1,73,574.63","12,15,022.38",
10-Sep-21,Debit Card,00.00,"12,15,022.38",00.00,
10-Sep-21,Transfer,22,00.00,22,
10-Sep-21,Cheque,"3,177.10",00.00,"3,199.10",
10-Sep-21,Commission,139.7,00.00,"3,338.80",
10-Sep-21,Cheque,00.00,667.76,"2,671.04",
10-Sep-21,Interest,"30,611.90",00.00,"33,282.94",
11-Sep-21,Cash,479.93,00.00,"33,762.87",
12-Sep-21,NEFT,00.00,"3,376.29","30,386.58",
12-Sep-21,Debit Card,00.00,"15,193.29","15,193.29",
12-Sep-21,Reversal,61.8,00.00,"15,255.09",
13-Sep-21,Purchase,03.00,00.00,"15,258.09",
13-Sep-21,Debit Card,00.00,"1,525.81","13,732.28",
13-Sep-21,Purchase,00.00,"1,961.75","11,770.53",
13-Sep-21,Transportellaneous,00.00,"1,471.32","10,299.21",
13-Sep-21,Debit Card,00.00,"1,716.54","8,582.67",
13-Sep-21,NEFT,00.00,"8,582.67",00.00,
13-Sep-21,Transportellaneous,04.46,00.00,04.46,
13-Sep-21,Commission,00.00,01.49,02.97,
13-Sep-21,ATM,00.00,01.49,01.48,
13-Sep-21,Transfer,"27,701.09",00.00,"27,702.57",
13-Sep-21,Cheque,00.00,"4,617.10","23,085.48",
14-Sep-21,Cash,06.03,00.00,"23,091.51",
14-Sep-21,Interest,00.00,"4,618.30","18,473.21",
14-Sep-21,NEFT,297,00.00,"18,770.21",
14-Sep-21,IMPS,00.00,"9,385.11","9,385.10",
14-Sep-21,Debit Card,"3,570.54",00.00,"12,955.64",
14-Sep-21,Reversal,00.00,"1,619.46","11,336.18",
14-Sep-21,ATM,"2,58,108.00",00.00,"2,69,444.18",
14-Sep-21,ATM,"93,361.00",00.00,"3,62,805.18",
14-Sep-21,NEFT,"1,838.00",00.00,"3,64,643.18",
14-Sep-21,Tax,00.00,"36,464.32","3,28,178.86",
14-Sep-21,Bill,00.00,"1,09,392.95","2,18,785.91",
14-Sep-21,Bill,00.00,"21,878.59","1,96,907.32",
14-Sep-21,Purchase,00.00,"32,817.89","1,64,089.43",
14-Sep-21,Cash,"1,347.30",00.00,"1,65,436.73",
14-Sep-21,Bill,103.6,00.00,"1,65,540.33",
14-Sep-21,Tax,"3,795.00",00.00,"1,69,335.33",
14-Sep-21,Interest,"1,46,122.00",00.00,"3,15,457.33",
14-Sep-21,Cash,00.00,"63,091.47","2,52,365.86",
14-Sep-21,Reversal,80,00.00,"2,52,445.86",
14-Sep-21,Transfer,134.13,00.00,"2,52,579.99",
14-Sep-21,Transportellaneous,00.00,"2,52,579.99",00.00,
14-Sep-21,Cheque,"2,56,694.25",00.00,"2,56,694.25",
14-Sep-21,RTGS,00.00,"32,086.78","2,24,607.47",
14-Sep-21,RTGS,00.00,"1,12,303.74","1,12,303.74",
14-Sep-21,IMPS,00.00,"1,12,303.74",00.00,
14-Sep-21,Commission,"19,22,457.25",00.00,"19,22,457.25",
14-Sep-21,Transfer,37.1,00.00,"19,22,494.35",
14-Sep-21,NEFT,00.00,"2,40,311.79","16,82,182.56",
14-Sep-21,Purchase,00.00,"8,41,091.28","8,41,091.28",
14-Sep-21,IMPS,00.00,"1,68,218.26","6,72,873.02",
14-Sep-21,IMPS,"14,41,822.00",00.00,"21,14,695.02",
14-Sep-21,Reversal,"74,243.00",00.00,"21,88,938.02",
14-Sep-21,Transportellaneous,"49,343.90",00.00,"22,38,281.92",
15-Sep-21,Transfer,00.00,"7,46,093.97","14,92,187.95",
15-Sep-21,Cheque,00.00,"14,92,187.95",00.00,
15-Sep-21,NEFT,52.38,00.00,52.38,
15-Sep-21,Tax,00.00,07.48,44.9,
15-Sep-21,Commission,"1,40,224.30",00.00,"1,40,269.20",
15-Sep-21,Transportellaneous,00.00,"70,134.60","70,134.60",
15-Sep-21,RTGS,00.00,"8,766.83","61,367.78",
15-Sep-21,Purchase,"8,83,605.50",00.00,"9,44,973.28",
15-Sep-21,NEFT,328.7,00.00,"9,45,301.98",
15-Sep-21,Cash,00.00,"1,89,060.40","7,56,241.58",
15-Sep-21,Cheque,"2,073.90",00.00,"7,58,315.48",
15-Sep-21,Cheque,00.00,"84,257.28","6,74,058.20",
15-Sep-21,RTGS,00.00,"1,68,514.55","5,05,543.65",
15-Sep-21,Debit Card,00.00,"72,220.52","4,33,323.13",
15-Sep-21,Reversal,"5,646.60",00.00,"4,38,969.73",
15-Sep-21,RTGS,"16,063.00",00.00,"4,55,032.73",
15-Sep-21,Debit Card,"1,85,793.00",00.00,"6,40,825.73",
15-Sep-21,Bill,00.00,"91,546.53","5,49,279.20",
15-Sep-21,Debit Card,"8,144.00",00.00,"5,57,423.20",
15-Sep-21,Bill,424.9,00.00,"5,57,848.10",
15-Sep-21,Purchase,"2,28,174.00",00.00,"7,86,022.10",
15-Sep-21,NEFT,00.00,"98,252.76","6,87,769.34",
15-Sep-21,ATM,04.77,00.00,"6,87,774.11",
15-Sep-21,NEFT,00.00,"1,71,943.53","5,15,830.58",
15-Sep-21,Purchase,00.00,"2,57,915.29","2,57,915.29",
15-Sep-21,Purchase,"29,181.38",00.00,"2,87,096.67",
15-Sep-21,Cheque,"2,36,763.84",00.00,"5,23,860.51",
15-Sep-21,Purchase,00.00,"1,30,965.13","3,92,895.38",
15-Sep-21,RTGS,00.00,"3,92,895.38",00.00,
15-Sep-21,Commission,"1,09,406.75",00.00,"1,09,406.75",
15-Sep-21,Interest,"6,148.78",00.00,"1,15,555.53",
15-Sep-21,Tax,00.00,"28,888.88","86,666.65",
15-Sep-21,RTGS,"1,931.00",00.00,"88,597.65",
15-Sep-21,IMPS,02.34,00.00,"88,599.99",
15-Sep-21,Interest,00.00,"29,533.33","59,066.66",
15-Sep-21,ATM,"6,57,746.50",00.00,"7,16,813.16",
15-Sep-21,Transportellaneous,"19,66,746.20",00.00,"26,83,559.36",
15-Sep-21,RTGS,00.00,"2,98,173.26","23,85,386.10",
15-Sep-21,Reversal,203.23,00.00,"23,85,589.33",
15-Sep-21,Interest,00.00,"2,98,198.67","20,87,390.66",
15-Sep-21,ATM,"2,522.00",00.00,"20,89,912.66",
15-Sep-21,IMPS,"5,591.00",00.00,"20,95,503.66",
15-Sep-21,IMPS,04.00,00.00,"20,95,507.66",
15-Sep-21,NEFT,00.00,"2,61,938.46","18,33,569.20",
15-Sep-21,Transportellaneous,"18,712.00",00.00,"18,52,281.20",
15-Sep-21,ATM,"11,454.00",00.00,"18,63,735.20",
15-Sep-21,RTGS,07.38,00.00,"18,63,742.58",
15-Sep-21,Commission,00.00,"3,72,748.52","14,90,994.06",
15-Sep-21,RTGS,00.00,"3,72,748.52","11,18,245.54",
15-Sep-21,Debit Card,00.00,"3,72,748.51","7,45,497.03",
15-Sep-21,ATM,07.00,00.00,"7,45,504.03",
15-Sep-21,Tax,00.00,"74,550.40","6,70,953.63",
15-Sep-21,Bill,"2,42,662.20",00.00,"9,13,615.83",
15-Sep-21,NEFT,00.00,"1,14,201.98","7,99,413.85",
15-Sep-21,Purchase,06.00,00.00,"7,99,419.85",
15-Sep-21,Cash,00.00,"1,59,883.97","6,39,535.88",
16-Sep-21,Transportellaneous,03.32,00.00,"6,39,539.20",
16-Sep-21,Bill,00.00,"1,27,907.84","5,11,631.36",
16-Sep-21,Transfer,00.00,"56,847.93","4,54,783.43",
16-Sep-21,Bill,"14,65,684.50",00.00,"19,20,467.93",
16-Sep-21,RTGS,00.00,"1,92,046.79","17,28,421.14",
16-Sep-21,ATM,00.00,"2,16,052.64","15,12,368.50",
16-Sep-21,NEFT,00.00,"1,51,236.85","13,61,131.65",
16-Sep-21,NEFT,00.00,"1,51,236.85","12,09,894.80",
16-Sep-21,Commission,"14,77,231.20",00.00,"26,87,126.00",
16-Sep-21,Commission,00.00,"2,68,712.60","24,18,413.40",
16-Sep-21,Purchase,29.5,00.00,"24,18,442.90",
16-Sep-21,RTGS,00.00,"3,02,305.36","21,16,137.54",
16-Sep-21,Debit Card,"1,92,998.30",00.00,"23,09,135.84",
16-Sep-21,Bill,00.00,"2,88,641.98","20,20,493.86",
16-Sep-21,ATM,73.4,00.00,"20,20,567.26",
16-Sep-21,Purchase,01.86,00.00,"20,20,569.12",
16-Sep-21,IMPS,04.60,00.00,"20,20,573.72",
16-Sep-21,ATM,00.00,"2,52,571.72","17,68,002.00",
16-Sep-21,Cheque,"2,654.00",00.00,"17,70,656.00",
16-Sep-21,Transportellaneous,"4,130.01",00.00,"17,74,786.01",
16-Sep-21,Bill,00.00,"4,43,696.50","13,31,089.51",
16-Sep-21,Purchase,34.39,00.00,"13,31,123.90",
16-Sep-21,Debit Card,00.00,"1,33,112.39","11,98,011.51",
16-Sep-21,Cash,00.00,"3,99,337.17","7,98,674.34",
16-Sep-21,Cheque,01.50,00.00,"7,98,675.84",
16-Sep-21,NEFT,00.00,"99,834.48","6,98,841.36",
16-Sep-21,Transportellaneous,"3,144.10",00.00,"7,01,985.46",
16-Sep-21,Transportellaneous,"10,063.40",00.00,"7,12,048.86",
16-Sep-21,Cheque,00.00,"79,116.54","6,32,932.32",
16-Sep-21,ATM,"11,536.75",00.00,"6,44,469.07",
16-Sep-21,Debit Card,"5,79,420.00",00.00,"12,23,889.07",
17-Sep-21,RTGS,00.00,"1,22,388.91","11,01,500.16",
17-Sep-21,Reversal,"6,09,889.20",00.00,"17,11,389.36",
17-Sep-21,Transportellaneous,00.00,"4,27,847.34","12,83,542.02",
18-Sep-21,Commission,00.00,"3,20,885.51","9,62,656.52",
18-Sep-21,Purchase,00.00,"1,06,961.84","8,55,694.68",
18-Sep-21,Transfer,00.00,"1,06,961.84","7,48,732.85",
18-Sep-21,Debit Card,"17,699.00",00.00,"7,66,431.85",
18-Sep-21,NEFT,00.00,"1,91,607.96","5,74,823.89",
18-Sep-21,Purchase,04.79,00.00,"5,74,828.68",
18-Sep-21,Commission,461.63,00.00,"5,75,290.31",
18-Sep-21,NEFT,"3,807.70",00.00,"5,79,098.01",
18-Sep-21,RTGS,179,00.00,"5,79,277.01",
18-Sep-21,NEFT,00.00,"82,753.86","4,96,523.15",
18-Sep-21,Cheque,348.2,00.00,"4,96,871.35",
18-Sep-21,Transfer,"26,190.40",00.00,"5,23,061.75",
18-Sep-21,NEFT,00.00,"65,382.72","4,57,679.03",
19-Sep-21,Bill,00.00,"76,279.84","3,81,399.19",
19-Sep-21,ATM,00.00,"1,27,133.06","2,54,266.13",
19-Sep-21,Tax,"8,97,415.00",00.00,"11,51,681.13",
19-Sep-21,Debit Card,00.00,"1,43,960.14","10,07,720.99",
19-Sep-21,Commission,"15,43,384.50",00.00,"25,51,105.49",
19-Sep-21,ATM,00.00,"5,10,221.10","20,40,884.39",
19-Sep-21,Reversal,35,00.00,"20,40,919.39",
19-Sep-21,Interest,00.00,"2,04,091.94","18,36,827.45",
19-Sep-21,Cheque,05.00,00.00,"18,36,832.45",
19-Sep-21,Tax,00.00,"1,83,683.25","16,53,149.20",
19-Sep-21,Interest,00.00,"1,83,683.24","14,69,465.96",
19-Sep-21,ATM,00.00,"1,63,274.00","13,06,191.96",
19-Sep-21,Transfer,00.00,"2,17,698.66","10,88,493.30",
19-Sep-21,Tax,"50,082.78",00.00,"11,38,576.08",
19-Sep-21,Commission,"9,49,512.00",00.00,"20,88,088.08",
19-Sep-21,Interest,15.4,00.00,"20,88,103.48",
19-Sep-21,IMPS,00.00,"2,32,011.50","18,56,091.98",
19-Sep-21,Transfer,00.00,"2,65,156.00","15,90,935.98",
19-Sep-21,NEFT,"9,81,363.00",00.00,"25,72,298.98",
19-Sep-21,NEFT,12.3,00.00,"25,72,311.28",
19-Sep-21,Cheque,"1,58,912.56",00.00,"27,31,223.84",
19-Sep-21,Reversal,21.82,00.00,"27,31,245.66",
19-Sep-21,RTGS,28,00.00,"27,31,273.66",
19-Sep-21,Bill,00.00,"13,65,636.83","13,65,636.83",
19-Sep-21,NEFT,00.00,"4,55,212.28","9,10,424.55",
19-Sep-21,ATM,00.00,"1,82,084.91","7,28,339.64",
19-Sep-21,RTGS,00.00,"80,926.63","6,47,413.01",
19-Sep-21,ATM,00.00,"80,926.63","5,66,486.38",
19-Sep-21,Cash,00.00,"62,942.93","5,03,543.45",
19-Sep-21,RTGS,00.00,"83,923.91","4,19,619.54",
19-Sep-21,RTGS,"13,76,372.00",00.00,"17,95,991.54",
19-Sep-21,Interest,00.00,"1,99,554.62","15,96,436.92",
19-Sep-21,Reversal,"1,39,551.00",00.00,"17,35,987.92",
19-Sep-21,Interest,00.00,"3,47,197.58","13,88,790.34",
19-Sep-21,Bill,"2,01,579.90",00.00,"15,90,370.24",
19-Sep-21,ATM,00.00,"3,18,074.05","12,72,296.19",
19-Sep-21,Bill,"1,276.60",00.00,"12,73,572.79",
19-Sep-21,RTGS,00.00,"1,81,938.97","10,91,633.82",
19-Sep-21,Reversal,00.00,"1,81,938.97","9,09,694.85",
19-Sep-21,Transportellaneous,00.00,"1,13,711.86","7,95,982.99",
19-Sep-21,RTGS,00.00,"1,98,995.75","5,96,987.24",
19-Sep-21,Cheque,"12,209.70",00.00,"6,09,196.94",
20-Sep-21,NEFT,"9,208.30",00.00,"6,18,405.24",
20-Sep-21,Bill,00.00,"88,343.61","5,30,061.63",
20-Sep-21,Interest,"8,33,670.50",00.00,"13,63,732.13",
20-Sep-21,Debit Card,00.00,"1,70,466.52","11,93,265.61",
20-Sep-21,Reversal,"24,695.50",00.00,"12,17,961.11",
21-Sep-21,ATM,00.00,"1,52,245.14","10,65,715.97",
21-Sep-21,Tax,04.84,00.00,"10,65,720.81",
21-Sep-21,Cheque,"2,25,842.00",00.00,"12,91,562.81",
21-Sep-21,Cash,"14,14,987.00",00.00,"27,06,549.81",
21-Sep-21,Cheque,00.00,"27,06,549.81",00.00,
21-Sep-21,Reversal,"1,82,475.56",00.00,"1,82,475.56",
21-Sep-21,Interest,00.00,"45,618.89","1,36,856.67",
21-Sep-21,Transportellaneous,109,00.00,"1,36,965.67",
21-Sep-21,Reversal,"3,414.30",00.00,"1,40,379.97",
21-Sep-21,Debit Card,"20,578.87",00.00,"1,60,958.84",
21-Sep-21,Commission,"3,896.60",00.00,"1,64,855.44",
21-Sep-21,Cheque,00.00,"32,971.09","1,31,884.35",
21-Sep-21,Purchase,00.00,"43,961.45","87,922.90",
21-Sep-21,RTGS,00.00,"87,922.90",00.00,
21-Sep-21,Debit Card,00.30,00.00,00.30,
21-Sep-21,Commission,45,00.00,45.3,
21-Sep-21,IMPS,"1,176.05",00.00,"1,221.35",
21-Sep-21,Transportellaneous,00.00,135.71,"1,085.64",
21-Sep-21,Bill,57.8,00.00,"1,143.44",
21-Sep-21,Tax,"2,166.61",00.00,"3,310.05",
21-Sep-21,Transfer,36.4,00.00,"3,346.45",
21-Sep-21,Debit Card,38.61,00.00,"3,385.06",
21-Sep-21,NEFT,00.00,483.58,"2,901.48",
21-Sep-21,RTGS,00.00,362.69,"2,538.80",
21-Sep-21,RTGS,00.00,253.88,"2,284.92",
21-Sep-21,RTGS,"1,561.55",00.00,"3,846.47",
21-Sep-21,Transfer,00.00,"1,282.16","2,564.31",
21-Sep-21,Tax,00.00,284.92,"2,279.39",
21-Sep-21,Transfer,00.00,"1,139.70","1,139.70",
21-Sep-21,Reversal,00.00,162.81,976.89,
21-Sep-21,ATM,00.00,244.22,732.67,
21-Sep-21,Debit Card,00.00,732.67,00.00,
21-Sep-21,ATM,"2,40,804.00",00.00,"2,40,804.00",
21-Sep-21,ATM,00.00,"1,20,402.00","1,20,402.00",
21-Sep-21,Reversal,"2,840.00",00.00,"1,23,242.00",
21-Sep-21,Cheque,"22,132.55",00.00,"1,45,374.55",
21-Sep-21,Cheque,"1,70,346.84",00.00,"3,15,721.39",
21-Sep-21,Commission,"28,730.82",00.00,"3,44,452.21",
21-Sep-21,Purchase,00.00,"57,408.70","2,87,043.51",
21-Sep-21,NEFT,00.00,"41,006.22","2,46,037.29",
21-Sep-21,Reversal,58.11,00.00,"2,46,095.40",
21-Sep-21,Transportellaneous,215,00.00,"2,46,310.40",
21-Sep-21,NEFT,00.00,"61,577.60","1,84,732.80",
21-Sep-21,Transportellaneous,39.8,00.00,"1,84,772.60",
21-Sep-21,ATM,"18,02,908.75",00.00,"19,87,681.35",
21-Sep-21,IMPS,00.00,"19,87,681.35",00.00,
21-Sep-21,Reversal,07.10,00.00,07.10,
21-Sep-21,Tax,"27,721.00",00.00,"27,728.10",
21-Sep-21,Reversal,00.00,"3,080.90","24,647.20",
21-Sep-21,Tax,00.00,"6,161.80","18,485.40",
21-Sep-21,Purchase,00.00,"4,621.35","13,864.05",
21-Sep-21,Bill,"1,20,033.88",00.00,"1,33,897.93",
22-Sep-21,Cash,06.92,00.00,"1,33,904.85",
22-Sep-21,Debit Card,"94,524.00",00.00,"2,28,428.85",
22-Sep-21,ATM,00.00,"76,142.95","1,52,285.90",
22-Sep-21,NEFT,264.8,00.00,"1,52,550.70",
22-Sep-21,Debit Card,"2,045.10",00.00,"1,54,595.80",
22-Sep-21,Interest,"19,262.90",00.00,"1,73,858.70",
22-Sep-21,NEFT,00.00,"57,952.90","1,15,905.80",
22-Sep-21,Tax,02.00,00.00,"1,15,907.80",
22-Sep-21,Debit Card,00.00,"11,590.78","1,04,317.02",
22-Sep-21,Debit Card,00.00,"52,158.51","52,158.51",
22-Sep-21,Tax,"14,84,510.25",00.00,"15,36,668.76",
22-Sep-21,NEFT,"31,326.25",00.00,"15,67,995.01",
22-Sep-21,Purchase,00.00,"1,56,799.50","14,11,195.51",
22-Sep-21,Interest,00.00,"4,70,398.50","9,40,797.01",
22-Sep-21,ATM,"3,642.38",00.00,"9,44,439.39",
22-Sep-21,Transfer,"4,61,563.00",00.00,"14,06,002.39",
22-Sep-21,Transfer,"3,307.72",00.00,"14,09,310.11",
22-Sep-21,RTGS,57.49,00.00,"14,09,367.60",
22-Sep-21,Commission,05.80,00.00,"14,09,373.40",
22-Sep-21,ATM,"9,18,534.00",00.00,"23,27,907.40",
22-Sep-21,IMPS,00.00,"5,81,976.85","17,45,930.55",
22-Sep-21,IMPS,00.00,"4,36,482.64","13,09,447.91",
22-Sep-21,RTGS,106.53,00.00,"13,09,554.44",
22-Sep-21,Interest,00.00,"1,30,955.44","11,78,599.00",
22-Sep-21,Transportellaneous,00.00,"5,89,299.50","5,89,299.50",
22-Sep-21,Tax,00.00,"84,185.64","5,05,113.86",
22-Sep-21,NEFT,00.00,"50,511.39","4,54,602.47",
22-Sep-21,Commission,"2,779.00",00.00,"4,57,381.47",
22-Sep-21,Debit Card,00.00,"2,28,690.74","2,28,690.74",
23-Sep-21,Interest,331,00.00,"2,29,021.74",
23-Sep-21,Cash,04.00,00.00,"2,29,025.74",
24-Sep-21,ATM,00.00,"57,256.44","1,71,769.30",
24-Sep-21,Transfer,294,00.00,"1,72,063.30",
24-Sep-21,NEFT,"87,495.10",00.00,"2,59,558.40",
24-Sep-21,Cheque,00.00,"1,29,779.20","1,29,779.20",
24-Sep-21,Transfer,00.00,"1,29,779.20",00.00,
24-Sep-21,Tax,957.2,00.00,957.2,
24-Sep-21,Cheque,00.00,136.74,820.46,
24-Sep-21,Purchase,14.5,00.00,834.96,
24-Sep-21,Transfer,00.00,278.32,556.64,
24-Sep-21,Tax,"30,027.00",00.00,"30,583.64",
24-Sep-21,NEFT,"9,08,174.50",00.00,"9,38,758.14",
24-Sep-21,NEFT,00.00,"1,56,459.69","7,82,298.45",
24-Sep-21,Debit Card,00.00,"1,95,574.61","5,86,723.84",
24-Sep-21,Reversal,00.00,"58,672.38","5,28,051.46",
24-Sep-21,Transfer,"2,036.80",00.00,"5,30,088.26",
24-Sep-21,Interest,817,00.00,"5,30,905.26",
24-Sep-21,Transfer,00.00,"5,30,905.26",00.00,
24-Sep-21,Purchase,"65,904.84",00.00,"65,904.84",
24-Sep-21,Commission,261.5,00.00,"66,166.34",
24-Sep-21,RTGS,00.00,"9,452.33","56,714.01",
24-Sep-21,Purchase,00.00,"14,178.50","42,535.51",
24-Sep-21,Cheque,00.00,"21,267.76","21,267.76",
24-Sep-21,NEFT,00.00,"5,316.94","15,950.82",
24-Sep-21,Transfer,"1,08,544.00",00.00,"1,24,494.82",
24-Sep-21,NEFT,"10,618.00",00.00,"1,35,112.82",
24-Sep-21,RTGS,"18,89,997.00",00.00,"20,25,109.82",
24-Sep-21,NEFT,"1,10,647.30",00.00,"21,35,757.12",
24-Sep-21,NEFT,00.00,"2,37,306.35","18,98,450.77",
24-Sep-21,Transfer,"7,05,492.00",00.00,"26,03,942.77",
24-Sep-21,Commission,152.69,00.00,"26,04,095.46",
24-Sep-21,Reversal,00.00,"4,34,015.91","21,70,079.55",
24-Sep-21,Commission,540.1,00.00,"21,70,619.65",
24-Sep-21,NEFT,00.00,"2,41,179.96","19,29,439.69",
24-Sep-21,Tax,"3,850.29",00.00,"19,33,289.98",
24-Sep-21,Cash,139.7,00.00,"19,33,429.68",
24-Sep-21,Bill,00.00,"9,66,714.84","9,66,714.84",
24-Sep-21,Bill,"20,957.00",00.00,"9,87,671.84",
24-Sep-21,Commission,00.00,"2,46,917.96","7,40,753.88",
24-Sep-21,ATM,00.00,"7,40,753.88",00.00,
24-Sep-21,Purchase,"18,13,195.00",00.00,"18,13,195.00",
24-Sep-21,RTGS,00.00,"3,02,199.17","15,10,995.83",
24-Sep-21,RTGS,06.00,00.00,"15,11,001.83",
24-Sep-21,Cheque,03.00,00.00,"15,11,004.83",
24-Sep-21,Interest,"24,192.22",00.00,"15,35,197.05",
24-Sep-21,Cash,"2,51,432.00",00.00,"17,86,629.05",
24-Sep-21,Transfer,00.00,"1,78,662.91","16,07,966.14",
24-Sep-21,Interest,"25,844.02",00.00,"16,33,810.16",
24-Sep-21,ATM,03.00,00.00,"16,33,813.16",
24-Sep-21,Interest,"19,73,931.00",00.00,"36,07,744.16",
24-Sep-21,RTGS,00.00,"4,50,968.02","31,56,776.14",
24-Sep-21,Cash,"15,198.95",00.00,"31,71,975.09",
24-Sep-21,Debit Card,"2,45,710.53",00.00,"34,17,685.62",
24-Sep-21,Transfer,00.00,"11,39,228.54","22,78,457.08",
24-Sep-21,Commission,00.00,"22,78,457.08",00.00,
24-Sep-21,NEFT,57.7,00.00,57.7,
24-Sep-21,Interest,"1,76,115.00",00.00,"1,76,172.70",
24-Sep-21,NEFT,03.00,00.00,"1,76,175.70",
24-Sep-21,Bill,452,00.00,"1,76,627.70",
24-Sep-21,Transportellaneous,00.00,"58,875.90","1,17,751.80",
24-Sep-21,RTGS,00.00,"29,437.95","88,313.85",
24-Sep-21,Cheque,00.00,"14,718.98","73,594.88",
24-Sep-21,Bill,00.00,"24,531.63","49,063.25",
24-Sep-21,Reversal,00.00,"4,906.33","44,156.92",
24-Sep-21,Purchase,10,00.00,"44,166.92",
24-Sep-21,Cash,00.00,"5,520.87","38,646.06",
24-Sep-21,Cheque,"7,186.70",00.00,"45,832.76",
24-Sep-21,ATM,"19,45,320.50",00.00,"19,91,153.26",
24-Sep-21,Bill,00.00,"19,91,153.26",00.00,
24-Sep-21,Bill,"14,616.50",00.00,"14,616.50",
24-Sep-21,NEFT,00.00,"7,308.25","7,308.25",
24-Sep-21,Reversal,00.00,"1,218.04","6,090.21",
24-Sep-21,Debit Card,59.49,00.00,"6,149.70",
24-Sep-21,Tax,00.00,"6,149.70",00.00,
24-Sep-21,Debit Card,271,00.00,271,
24-Sep-21,ATM,00.00,30.11,240.89,
24-Sep-21,Reversal,00.00,24.09,216.8,
24-Sep-21,Reversal,00.00,36.13,180.67,
24-Sep-21,Interest,00.00,30.11,150.56,
24-Sep-21,Interest,00.00,16.73,133.83,
24-Sep-21,Cash,00.00,66.92,66.92,
24-Sep-21,Transfer,04.94,00.00,71.86,
24-Sep-21,Purchase,"20,91,958.75",00.00,"20,92,030.61",
24-Sep-21,Debit Card,"10,64,980.50",00.00,"31,57,011.11",
24-Sep-21,Tax,00.00,"6,31,402.22","25,25,608.89",
24-Sep-21,IMPS,43.66,00.00,"25,25,652.55",
24-Sep-21,NEFT,00.00,"2,52,565.26","22,73,087.30",
24-Sep-21,NEFT,00.00,"2,27,308.73","20,45,778.57",
24-Sep-21,Cash,47,00.00,"20,45,825.57",
24-Sep-21,Purchase,"2,49,543.00",00.00,"22,95,368.57",
24-Sep-21,Debit Card,00.00,"2,55,040.95","20,40,327.62",
24-Sep-21,IMPS,00.00,"2,26,703.07","18,13,624.55",
24-Sep-21,Tax,23.16,00.00,"18,13,647.71",
24-Sep-21,Tax,"33,456.50",00.00,"18,47,104.21",
24-Sep-21,Cash,00.00,"3,07,850.70","15,39,253.51",
24-Sep-21,Purchase,00.00,"3,84,813.38","11,54,440.13",
24-Sep-21,Cash,00.00,"1,28,271.13","10,26,169.00",
24-Sep-21,RTGS,00.00,"1,14,018.78","9,12,150.22",
24-Sep-21,Transfer,"21,619.04",00.00,"9,33,769.26",
24-Sep-21,RTGS,03.10,00.00,"9,33,772.36",
24-Sep-21,Commission,00.00,"1,86,754.47","7,47,017.89",
24-Sep-21,Transportellaneous,00.00,"2,49,005.96","4,98,011.93",
24-Sep-21,Reversal,00.00,"2,49,005.97","2,49,005.96",
24-Sep-21,Commission,00.00,"27,667.33","2,21,338.63",
24-Sep-21,Transfer,00.00,"1,10,669.32","1,10,669.32",
24-Sep-21,Purchase,00.00,"27,667.33","83,001.99",
24-Sep-21,Bill,"16,55,048.80",00.00,"17,38,050.79",
24-Sep-21,Purchase,00.00,"4,34,512.70","13,03,538.09",
24-Sep-21,Cash,54,00.00,"13,03,592.09",
24-Sep-21,NEFT,00.00,"1,62,949.01","11,40,643.08",
24-Sep-21,Interest,00.00,"1,62,949.01","9,77,694.07",
24-Sep-21,Tax,"7,60,754.00",00.00,"17,38,448.07",
24-Sep-21,Cheque,"1,294.00",00.00,"17,39,742.07",
24-Sep-21,Bill,"2,19,723.40",00.00,"19,59,465.47",
24-Sep-21,Purchase,00.00,"2,44,933.18","17,14,532.29",
24-Sep-21,Tax,00.00,"4,28,633.07","12,85,899.22",
24-Sep-21,Interest,00.00,"1,28,589.92","11,57,309.30",
24-Sep-21,NEFT,00.00,"1,92,884.88","9,64,424.42",
24-Sep-21,ATM,00.00,"2,41,106.11","7,23,318.32",
24-Sep-21,Reversal,00.00,"3,61,659.16","3,61,659.16",
24-Sep-21,Tax,"89,817.00",00.00,"4,51,476.16",
24-Sep-21,Tax,00.00,"56,434.52","3,95,041.64",
24-Sep-21,Tax,00.00,"65,840.27","3,29,201.37",
24-Sep-21,ATM,00.29,00.00,"3,29,201.66",
24-Sep-21,Bill,"15,394.00",00.00,"3,44,595.66",
24-Sep-21,Purchase,"1,99,499.50",00.00,"5,44,095.16",
24-Sep-21,Reversal,"2,637.30",00.00,"5,46,732.46",
24-Sep-21,RTGS,00.00,"78,104.64","4,68,627.82",
24-Sep-21,Cheque,00.00,"78,104.64","3,90,523.18",
24-Sep-21,ATM,00.00,"43,391.46","3,47,131.72",
24-Sep-21,ATM,00.00,"3,47,131.72",00.00,
24-Sep-21,Transportellaneous,24.6,00.00,24.6,
24-Sep-21,Transfer,"4,21,872.00",00.00,"4,21,896.60",
24-Sep-21,ATM,00.00,"46,877.40","3,75,019.20",
24-Sep-21,IMPS,00.00,"1,87,509.60","1,87,509.60",
24-Sep-21,Commission,"22,361.80",00.00,"2,09,871.40",
24-Sep-21,Transportellaneous,00.00,"52,467.85","1,57,403.55",
24-Sep-21,Interest,02.60,00.00,"1,57,406.15",
24-Sep-21,RTGS,"12,80,801.00",00.00,"14,38,207.15",
24-Sep-21,Interest,00.00,"1,79,775.89","12,58,431.26",
24-Sep-21,Transfer,00.00,"3,14,607.82","9,43,823.44",
24-Sep-21,IMPS,00.00,"1,88,764.69","7,55,058.75",
24-Sep-21,Commission,"4,039.60",00.00,"7,59,098.35",
24-Sep-21,IMPS,00.00,"3,79,549.18","3,79,549.18",
24-Sep-21,Transfer,"1,52,855.00",00.00,"5,32,404.18",
24-Sep-21,ATM,"11,553.00",00.00,"5,43,957.18",
24-Sep-21,Debit Card,454.74,00.00,"5,44,411.92",
24-Sep-21,Interest,00.00,"60,490.21","4,83,921.71",
24-Sep-21,Debit Card,97.89,00.00,"4,84,019.60",
24-Sep-21,Purchase,"2,185.12",00.00,"4,86,204.72",
24-Sep-21,Cash,02.00,00.00,"4,86,206.72",
24-Sep-21,Transportellaneous,"9,688.00",00.00,"4,95,894.72",
24-Sep-21,Cash,00.00,"1,65,298.24","3,30,596.48",
24-Sep-21,Bill,"16,568.00",00.00,"3,47,164.48",
25-Sep-21,Cheque,"14,00,620.80",00.00,"17,47,785.28",
25-Sep-21,Cash,29.7,00.00,"17,47,814.98",
25-Sep-21,Cheque,"1,938.57",00.00,"17,49,753.55",
25-Sep-21,Purchase,01.80,00.00,"17,49,755.35",
25-Sep-21,Interest,00.00,"4,37,438.84","13,12,316.51",
25-Sep-21,Bill,"20,110.80",00.00,"13,32,427.31",
25-Sep-21,Cash,05.00,00.00,"13,32,432.31",
25-Sep-21,IMPS,00.00,"2,22,072.05","11,10,360.26",
25-Sep-21,Cash,787.79,00.00,"11,11,148.05",
25-Sep-21,Cash,00.00,"1,58,735.44","9,52,412.61",
25-Sep-21,Commission,00.00,"9,52,412.61",00.00,
25-Sep-21,ATM,"2,46,869.20",00.00,"2,46,869.20",
25-Sep-21,RTGS,00.13,00.00,"2,46,869.33",
25-Sep-21,Bill,00.00,"27,429.93","2,19,439.40",
25-Sep-21,Bill,"6,052.68",00.00,"2,25,492.08",
25-Sep-21,Cheque,316,00.00,"2,25,808.08",
25-Sep-21,Bill,143.8,00.00,"2,25,951.88",
25-Sep-21,Bill,"2,33,832.81",00.00,"4,59,784.69",
25-Sep-21,RTGS,"94,830.20",00.00,"5,54,614.89",
25-Sep-21,Reversal,23.5,00.00,"5,54,638.39",
25-Sep-21,Tax,00.00,"1,84,879.46","3,69,758.93",
25-Sep-21,Purchase,00.00,"36,975.89","3,32,783.04",
25-Sep-21,Reversal,"1,87,338.16",00.00,"5,20,121.20",
25-Sep-21,Purchase,00.00,"52,012.12","4,68,109.08",
25-Sep-21,Debit Card,00.00,"4,68,109.08",00.00,
25-Sep-21,ATM,"14,35,932.50",00.00,"14,35,932.50",
25-Sep-21,Bill,00.00,"1,59,548.06","12,76,384.44",
25-Sep-21,Transfer,212.82,00.00,"12,76,597.26",
25-Sep-21,Bill,"45,002.22",00.00,"13,21,599.48",
25-Sep-21,Debit Card,"33,903.00",00.00,"13,55,502.48",
25-Sep-21,NEFT,902.98,00.00,"13,56,405.46",
25-Sep-21,Transportellaneous,00.00,"13,56,405.46",00.00,
25-Sep-21,Cheque,"91,460.75",00.00,"91,460.75",
25-Sep-21,Bill,00.00,"9,146.08","82,314.68",
25-Sep-21,Commission,00.00,"41,157.34","41,157.34",
25-Sep-21,NEFT,"8,304.19",00.00,"49,461.53",
25-Sep-21,Interest,"9,891.37",00.00,"59,352.90",
25-Sep-21,Purchase,"19,36,141.50",00.00,"19,95,494.40",
25-Sep-21,Cheque,"20,21,405.00",00.00,"40,16,899.40",
25-Sep-21,Bill,00.00,"5,73,842.77","34,43,056.63",
26-Sep-21,Cash,03.60,00.00,"34,43,060.23",
26-Sep-21,RTGS,00.00,"4,30,382.53","30,12,677.70",
26-Sep-21,Cheque,00.00,"3,76,584.71","26,36,092.99",
26-Sep-21,Interest,00.00,"8,78,697.66","17,57,395.33",
26-Sep-21,Transportellaneous,02.00,00.00,"17,57,397.33",
26-Sep-21,Transportellaneous,02.00,00.00,"17,57,399.33",
26-Sep-21,Reversal,00.00,"3,51,479.87","14,05,919.46",
26-Sep-21,Debit Card,"3,350.00",00.00,"14,09,269.46",
26-Sep-21,Tax,"11,52,849.00",00.00,"25,62,118.46",
26-Sep-21,Commission,03.00,00.00,"25,62,121.46",
26-Sep-21,Bill,00.00,"3,20,265.18","22,41,856.28",
26-Sep-21,Bill,"4,62,200.00",00.00,"27,04,056.28",
26-Sep-21,Cheque,"39,084.50",00.00,"27,43,140.78",
26-Sep-21,Transportellaneous,00.00,"5,48,628.16","21,94,512.62",
26-Sep-21,RTGS,29,00.00,"21,94,541.62",
26-Sep-21,Cash,16.84,00.00,"21,94,558.46",
26-Sep-21,IMPS,00.00,"2,19,455.85","19,75,102.61",
26-Sep-21,Tax,00.00,"3,29,183.77","16,45,918.84",
26-Sep-21,Reversal,"24,045.69",00.00,"16,69,964.53",
26-Sep-21,IMPS,00.00,"1,66,996.45","15,02,968.08",
26-Sep-21,Purchase,477.7,00.00,"15,03,445.78",
26-Sep-21,NEFT,"8,33,743.50",00.00,"23,37,189.28",
26-Sep-21,Cheque,00.00,"2,33,718.93","21,03,470.35",
26-Sep-21,Purchase,07.88,00.00,"21,03,478.23",
26-Sep-21,Cash,00.00,"5,25,869.56","15,77,608.67",
26-Sep-21,Purchase,79,00.00,"15,77,687.67",
26-Sep-21,Purchase,85,00.00,"15,77,772.67",
27-Sep-21,Bill,00.00,"2,25,396.10","13,52,376.57",
27-Sep-21,Interest,00.00,"3,38,094.14","10,14,282.43",
27-Sep-21,Cheque,00.00,"2,53,570.61","7,60,711.82",
27-Sep-21,Commission,"6,25,077.20",00.00,"13,85,789.02",
27-Sep-21,Commission,00.00,"1,38,578.90","12,47,210.12",
27-Sep-21,Transportellaneous,00.00,"12,47,210.12",00.00,
27-Sep-21,Cheque,96.79,00.00,96.79,
28-Sep-21,Purchase,00.00,09.68,87.11,
28-Sep-21,Purchase,"1,75,371.00",00.00,"1,75,458.11",
28-Sep-21,RTGS,"18,35,765.80",00.00,"20,11,223.91",
28-Sep-21,Bill,"1,769.93",00.00,"20,12,993.84",
28-Sep-21,Cash,00.00,"2,01,299.38","18,11,694.46",
28-Sep-21,Reversal,00.00,"6,03,898.15","12,07,796.31",
28-Sep-21,Cash,85.6,00.00,"12,07,881.91",
28-Sep-21,Debit Card,00.00,"12,07,881.91",00.00,
28-Sep-21,Debit Card,"1,317.80",00.00,"1,317.80",
28-Sep-21,ATM,"3,167.20",00.00,"4,485.00",
28-Sep-21,Commission,00.00,747.5,"3,737.50",
28-Sep-21,IMPS,"1,949.00",00.00,"5,686.50",
29-Sep-21,Bill,00.00,947.75,"4,738.75",
29-Sep-21,Bill,81.61,00.00,"4,820.36",
29-Sep-21,Cash,"1,516.09",00.00,"6,336.45",
29-Sep-21,Transfer,00.00,"1,584.11","4,752.34",
29-Sep-21,Interest,290.4,00.00,"5,042.74",
29-Sep-21,ATM,54,00.00,"5,096.74",
29-Sep-21,Transportellaneous,31,00.00,"5,127.74",
29-Sep-21,Debit Card,00.00,569.75,"4,557.99",
29-Sep-21,RTGS,00.00,"1,139.50","3,418.49",
29-Sep-21,Cheque,00.00,"1,709.25","1,709.24",
29-Sep-21,Commission,"1,22,158.59",00.00,"1,23,867.83",
29-Sep-21,Transfer,"2,40,708.30",00.00,"3,64,576.13",
29-Sep-21,Transfer,"93,533.28",00.00,"4,58,109.41",
29-Sep-21,NEFT,00.00,"4,58,109.41",00.00,
29-Sep-21,Cash,"60,128.97",00.00,"60,128.97",
29-Sep-21,Transfer,00.00,"8,589.85","51,539.12",
29-Sep-21,Cash,00.00,"12,884.78","38,654.34",
29-Sep-21,Tax,699.83,00.00,"39,354.17",
29-Sep-21,Interest,"2,167.00",00.00,"41,521.17",
29-Sep-21,Commission,00.00,"4,613.46","36,907.71",
29-Sep-21,Transfer,00.00,"6,151.29","30,756.42",
29-Sep-21,NEFT,00.00,"3,417.38","27,339.04",
30-Sep-21,Transportellaneous,00.00,"5,467.81","21,871.23",
30-Sep-21,NEFT,00.00,"3,124.46","18,746.77",
30-Sep-21,Transportellaneous,00.00,"6,248.92","12,497.85",
30-Sep-21,Transportellaneous,00.00,"6,248.93","6,248.92",
30-Sep-21,Bill,00.00,694.32,"5,554.60",
30-Sep-21,Cash,00.00,793.51,"4,761.09",
01-Oct-21,Commission,00.00,"1,190.27","3,570.82",
01-Oct-21,Purchase,"3,179.58",00.00,"6,750.40",
01-Oct-21,Bill,334,00.00,"7,084.40",
01-Oct-21,RTGS,"24,465.60",00.00,"31,550.00",
01-Oct-21,Reversal,"26,044.00",00.00,"57,594.00",
01-Oct-21,Commission,"11,454.30",00.00,"69,048.30",
01-Oct-21,Cheque,00.00,"34,524.15","34,524.15",
01-Oct-21,Transportellaneous,"1,77,989.00",00.00,"2,12,513.15",
01-Oct-21,Reversal,"3,554.00",00.00,"2,16,067.15",
01-Oct-21,Purchase,00.00,"24,007.46","1,92,059.69",
01-Oct-21,Bill,174,00.00,"1,92,233.69",
01-Oct-21,IMPS,00.00,"64,077.90","1,28,155.79",
01-Oct-21,IMPS,00.00,"12,815.58","1,15,340.21",
01-Oct-21,IMPS,00.00,"28,835.05","86,505.16",
02-Oct-21,Transfer,00.00,"86,505.16",00.00,
02-Oct-21,Interest,61.4,00.00,61.4,
02-Oct-21,Transfer,00.00,12.28,49.12,
02-Oct-21,Transportellaneous,"10,026.31",00.00,"10,075.43",
02-Oct-21,RTGS,05.00,00.00,"10,080.43",
02-Oct-21,Transfer,00.00,"1,680.07","8,400.36",
02-Oct-21,Bill,59.8,00.00,"8,460.16",
02-Oct-21,Reversal,00.00,"8,460.16",00.00,
02-Oct-21,Purchase,05.50,00.00,05.50,
02-Oct-21,Purchase,"2,270.66",00.00,"2,276.16",
02-Oct-21,Cheque,02.00,00.00,"2,278.16",
02-Oct-21,Commission,03.60,00.00,"2,281.76",
02-Oct-21,Transfer,06.00,00.00,"2,287.76",
02-Oct-21,Interest,"1,35,333.00",00.00,"1,37,620.76",
02-Oct-21,NEFT,00.00,"34,405.19","1,03,215.57",
02-Oct-21,Cheque,00.00,"25,803.89","77,411.68",
02-Oct-21,Cheque,00.00,"15,482.34","61,929.34",
03-Oct-21,NEFT,"17,17,414.50",00.00,"17,79,343.84",
03-Oct-21,IMPS,"14,26,638.00",00.00,"32,05,981.84",
03-Oct-21,IMPS,"2,56,768.00",00.00,"34,62,749.84",
03-Oct-21,Debit Card,00.00,"5,77,124.97","28,85,624.87",
03-Oct-21,Transfer,00.00,"28,85,624.87",00.00,
03-Oct-21,Debit Card,"18,52,593.20",00.00,"18,52,593.20",
03-Oct-21,Commission,04.67,00.00,"18,52,597.87",
03-Oct-21,ATM,00.00,"2,05,844.21","16,46,753.66",
03-Oct-21,Debit Card,00.00,"4,11,688.42","12,35,065.24",
03-Oct-21,Debit Card,00.00,"6,17,532.62","6,17,532.62",
03-Oct-21,Transportellaneous,00.00,"68,614.74","5,48,917.88",
03-Oct-21,ATM,00.00,"1,37,229.47","4,11,688.41",
03-Oct-21,Interest,19.8,00.00,"4,11,708.21",
03-Oct-21,IMPS,00.00,"68,618.04","3,43,090.18",
03-Oct-21,Cheque,00.00,"85,772.55","2,57,317.64",
03-Oct-21,Commission,00.00,"32,164.71","2,25,152.94",
04-Oct-21,RTGS,02.00,00.00,"2,25,154.94",
04-Oct-21,NEFT,00.00,"1,12,577.47","1,12,577.47",
04-Oct-21,RTGS,09.00,00.00,"1,12,586.47",
05-Oct-21,Interest,00.00,"22,517.29","90,069.18",
05-Oct-21,Reversal,00.00,"10,007.69","80,061.49",
05-Oct-21,Debit Card,00.00,"10,007.69","70,053.80",
05-Oct-21,NEFT,00.00,"17,513.45","52,540.35",
05-Oct-21,Debit Card,"66,733.30",00.00,"1,19,273.65",
05-Oct-21,Transfer,"2,45,301.00",00.00,"3,64,574.65",
05-Oct-21,Tax,"3,127.80",00.00,"3,67,702.45",
05-Oct-21,Commission,"93,084.20",00.00,"4,60,786.65",
05-Oct-21,Cash,00.00,"76,797.78","3,83,988.88",
05-Oct-21,Interest,04.00,00.00,"3,83,992.88",
05-Oct-21,Debit Card,00.00,"42,665.88","3,41,327.00",
05-Oct-21,Cheque,"13,86,509.00",00.00,"17,27,836.00",
05-Oct-21,RTGS,00.00,"2,46,833.71","14,81,002.29",
05-Oct-21,Bill,"1,13,760.00",00.00,"15,94,762.29",
06-Oct-21,RTGS,00.00,"15,94,762.29",00.00,
06-Oct-21,NEFT,08.51,00.00,08.51,
06-Oct-21,NEFT,"25,671.06",00.00,"25,679.57",
06-Oct-21,Reversal,00.00,"25,679.57",00.00,
06-Oct-21,Debit Card,"1,53,673.20",00.00,"1,53,673.20",
07-Oct-21,NEFT,04.89,00.00,"1,53,678.09",
07-Oct-21,Cash,00.00,"30,735.62","1,22,942.47",
07-Oct-21,Cash,00.00,"61,471.24","61,471.24",
07-Oct-21,ATM,00.00,"15,367.81","46,103.43",
08-Oct-21,NEFT,200.7,00.00,"46,304.13",
08-Oct-21,Bill,00.00,"23,152.07","23,152.06",
08-Oct-21,Cheque,00.00,"2,572.45","20,579.61",
08-Oct-21,NEFT,00.00,"20,579.61",00.00,
08-Oct-21,Transfer,46.2,00.00,46.2,
08-Oct-21,Transfer,34,00.00,80.2,
08-Oct-21,Transportellaneous,"28,741.00",00.00,"28,821.20",
08-Oct-21,Purchase,19.19,00.00,"28,840.39",
08-Oct-21,Purchase,00.00,"7,210.10","21,630.29",
08-Oct-21,Reversal,00.00,"7,210.10","14,420.19",
08-Oct-21,IMPS,"6,32,774.00",00.00,"6,47,194.19",
08-Oct-21,Commission,"1,38,242.66",00.00,"7,85,436.85",
08-Oct-21,Bill,"2,05,222.00",00.00,"9,90,658.85",
08-Oct-21,ATM,00.00,"99,065.89","8,91,592.96",
08-Oct-21,Reversal,"16,41,984.50",00.00,"25,33,577.46",
08-Oct-21,Cash,00.00,"2,81,508.61","22,52,068.85",
08-Oct-21,Cheque,"72,311.20",00.00,"23,24,380.05",
08-Oct-21,Transportellaneous,00.00,"3,32,054.29","19,92,325.76",
08-Oct-21,Cheque,00.00,"6,64,108.59","13,28,217.17",
08-Oct-21,IMPS,00.00,"2,65,643.43","10,62,573.74",
08-Oct-21,Tax,53.7,00.00,"10,62,627.44",
08-Oct-21,Purchase,00.00,"5,31,313.72","5,31,313.72",
08-Oct-21,Transfer,00.00,"1,77,104.57","3,54,209.15",
08-Oct-21,Transfer,495,00.00,"3,54,704.15",
08-Oct-21,Debit Card,63,00.00,"3,54,767.15",
08-Oct-21,Tax,00.00,"70,953.43","2,83,813.72",
08-Oct-21,Tax,00.00,"47,302.29","2,36,511.43",
08-Oct-21,Tax,"1,71,260.20",00.00,"4,07,771.63",
08-Oct-21,Cheque,00.00,"2,03,885.82","2,03,885.82",
08-Oct-21,Bill,00.00,"33,980.97","1,69,904.85",
08-Oct-21,Purchase,"24,268.70",00.00,"1,94,173.55",
08-Oct-21,Commission,"1,968.20",00.00,"1,96,141.75",
08-Oct-21,ATM,00.00,"49,035.44","1,47,106.31",
08-Oct-21,RTGS,"22,195.53",00.00,"1,69,301.84",
08-Oct-21,Cheque,00.00,"28,216.97","1,41,084.87",
08-Oct-21,Reversal,"2,01,607.00",00.00,"3,42,691.87",
08-Oct-21,Transportellaneous,00.00,"85,672.97","2,57,018.90",
08-Oct-21,ATM,"4,072.90",00.00,"2,61,091.80",
08-Oct-21,Transfer,16.2,00.00,"2,61,108.00",
08-Oct-21,Purchase,"18,741.20",00.00,"2,79,849.20",
08-Oct-21,Transportellaneous,"11,22,588.00",00.00,"14,02,437.20",
08-Oct-21,Interest,"29,261.62",00.00,"14,31,698.82",
08-Oct-21,ATM,00.00,"2,38,616.47","11,93,082.35",
08-Oct-21,NEFT,00.00,"11,93,082.35",00.00,
08-Oct-21,Purchase,10.1,00.00,10.1,
08-Oct-21,Bill,00.00,01.44,08.66,
08-Oct-21,Transportellaneous,00.00,00.96,07.70,
08-Oct-21,Cheque,00.00,02.57,05.13,
08-Oct-21,IMPS,"2,51,474.25",00.00,"2,51,479.38",
08-Oct-21,IMPS,"25,201.71",00.00,"2,76,681.09",
08-Oct-21,Cash,00.00,"46,113.52","2,30,567.58",
08-Oct-21,Purchase,00.00,"2,30,567.58",00.00,
08-Oct-21,Bill,319.48,00.00,319.48,
08-Oct-21,Cheque,05.87,00.00,325.35,
08-Oct-21,NEFT,00.00,36.15,289.2,
08-Oct-21,Tax,"24,474.35",00.00,"24,763.55",
08-Oct-21,Interest,"6,08,904.00",00.00,"6,33,667.55",
08-Oct-21,Debit Card,16,00.00,"6,33,683.55",
08-Oct-21,ATM,00.00,"1,58,420.89","4,75,262.66",
08-Oct-21,IMPS,00.00,"52,806.96","4,22,455.70",
08-Oct-21,Reversal,203.5,00.00,"4,22,659.20",
08-Oct-21,IMPS,00.00,"46,962.13","3,75,697.07",
08-Oct-21,NEFT,"2,47,152.60",00.00,"6,22,849.67",
09-Oct-21,Interest,00.00,"1,55,712.42","4,67,137.25",
09-Oct-21,RTGS,"9,36,190.00",00.00,"14,03,327.25",
09-Oct-21,Purchase,281.37,00.00,"14,03,608.62",
09-Oct-21,RTGS,68.05,00.00,"14,03,676.67",
09-Oct-21,Reversal,"13,868.50",00.00,"14,17,545.17",
09-Oct-21,Purchase,"20,51,241.00",00.00,"34,68,786.17",
09-Oct-21,NEFT,00.00,"3,46,878.62","31,21,907.55",
09-Oct-21,NEFT,00.00,"3,12,190.76","28,09,716.80",
10-Oct-21,Transfer,378.62,00.00,"28,10,095.42",
10-Oct-21,IMPS,304.87,00.00,"28,10,400.29",
10-Oct-21,Transfer,00.00,"14,05,200.15","14,05,200.14",
10-Oct-21,Debit Card,00.00,"2,34,200.02","11,71,000.12",
10-Oct-21,Cash,00.00,"11,71,000.12",00.00,
11-Oct-21,Transportellaneous,"53,020.00",00.00,"53,020.00",
11-Oct-21,Transfer,00.00,"5,302.00","47,718.00",
11-Oct-21,Transportellaneous,"2,29,334.00",00.00,"2,77,052.00",
11-Oct-21,RTGS,"25,901.13",00.00,"3,02,953.13",
11-Oct-21,IMPS,"40,749.25",00.00,"3,43,702.38",
11-Oct-21,IMPS,00.00,"49,100.34","2,94,602.04",
11-Oct-21,Purchase,"3,26,283.50",00.00,"6,20,885.54",
11-Oct-21,RTGS,158,00.00,"6,21,043.54",
11-Oct-21,Bill,"16,04,501.00",00.00,"22,25,544.54",
11-Oct-21,Reversal,"6,328.00",00.00,"22,31,872.54",
11-Oct-21,ATM,815.01,00.00,"22,32,687.55",
11-Oct-21,ATM,00.00,"3,18,955.36","19,13,732.19",
11-Oct-21,Interest,00.00,"2,39,216.52","16,74,515.67",
11-Oct-21,RTGS,956.2,00.00,"16,75,471.87",
11-Oct-21,NEFT,00.00,"16,75,471.87",00.00,
11-Oct-21,Transfer,450.7,00.00,450.7,
11-Oct-21,RTGS,491.3,00.00,942,
11-Oct-21,Purchase,00.00,235.5,706.5,
11-Oct-21,NEFT,31.1,00.00,737.6,
11-Oct-21,Interest,"2,806.79",00.00,"3,544.39",
11-Oct-21,Reversal,"1,761.90",00.00,"5,306.29",
11-Oct-21,Tax,00.00,884.38,"4,421.91",
11-Oct-21,Transfer,"1,16,166.94",00.00,"1,20,588.85",
11-Oct-21,Transfer,00.00,"13,398.76","1,07,190.09",
11-Oct-21,Bill,00.00,"26,797.52","80,392.57",
11-Oct-21,Transportellaneous,00.00,"40,196.29","40,196.29",
11-Oct-21,Purchase,"1,54,886.31",00.00,"1,95,082.60",
11-Oct-21,Commission,283,00.00,"1,95,365.60",
11-Oct-21,Bill,01.80,00.00,"1,95,367.40",
11-Oct-21,RTGS,00.00,"27,909.63","1,67,457.77",
11-Oct-21,Transportellaneous,00.00,"20,932.22","1,46,525.55",
11-Oct-21,Commission,00.00,"36,631.39","1,09,894.16",
11-Oct-21,Cash,42.6,00.00,"1,09,936.76",
11-Oct-21,Debit Card,"2,618.90",00.00,"1,12,555.66",
11-Oct-21,Tax,00.00,"16,079.38","96,476.28",
11-Oct-21,NEFT,00.00,"48,238.14","48,238.14",
11-Oct-21,Reversal,39,00.00,"48,277.14",
11-Oct-21,Tax,"2,51,859.70",00.00,"3,00,136.84",
11-Oct-21,ATM,00.00,"33,348.54","2,66,788.30",
11-Oct-21,Transfer,00.00,"26,678.83","2,40,109.47",
11-Oct-21,RTGS,"26,477.00",00.00,"2,66,586.47",
11-Oct-21,Bill,16,00.00,"2,66,602.47",
11-Oct-21,Purchase,07.42,00.00,"2,66,609.89",
11-Oct-21,Cash,287,00.00,"2,66,896.89",
11-Oct-21,Reversal,"8,144.88",00.00,"2,75,041.77",
11-Oct-21,NEFT,00.00,"55,008.35","2,20,033.42",
12-Oct-21,RTGS,00.00,"36,672.24","1,83,361.18",
12-Oct-21,Cash,00.00,"30,560.20","1,52,800.98",
12-Oct-21,Bill,"1,73,908.00",00.00,"3,26,708.98",
12-Oct-21,Reversal,32.6,00.00,"3,26,741.58",
12-Oct-21,Cash,"3,921.00",00.00,"3,30,662.58",
12-Oct-21,Bill,01.80,00.00,"3,30,664.38",
12-Oct-21,Debit Card,00.00,"3,30,664.38",00.00,
12-Oct-21,RTGS,"14,208.70",00.00,"14,208.70",
12-Oct-21,Purchase,"6,158.20",00.00,"20,366.90",
12-Oct-21,Cheque,"32,201.00",00.00,"52,567.90",
12-Oct-21,Transportellaneous,00.00,"26,283.95","26,283.95",
12-Oct-21,Transportellaneous,978,00.00,"27,261.95",
12-Oct-21,Bill,26.7,00.00,"27,288.65",
12-Oct-21,Purchase,00.00,"3,411.08","23,877.57",
12-Oct-21,Cash,"6,271.00",00.00,"30,148.57",
12-Oct-21,Reversal,114,00.00,"30,262.57",
12-Oct-21,IMPS,"4,23,205.50",00.00,"4,53,468.07",
12-Oct-21,IMPS,"12,26,357.00",00.00,"16,79,825.07",
12-Oct-21,Commission,19.04,00.00,"16,79,844.11",
12-Oct-21,Commission,"2,102.90",00.00,"16,81,947.01",
12-Oct-21,Commission,00.00,"1,86,883.00","14,95,064.01",
12-Oct-21,NEFT,"1,857.90",00.00,"14,96,921.91",
12-Oct-21,Bill,00.69,00.00,"14,96,922.60",
12-Oct-21,ATM,"1,47,831.00",00.00,"16,44,753.60",
12-Oct-21,ATM,00.00,"4,11,188.40","12,33,565.20",
12-Oct-21,Commission,00.00,"1,37,062.80","10,96,502.40",
12-Oct-21,Reversal,"2,44,549.00",00.00,"13,41,051.40",
12-Oct-21,Transfer,"21,544.60",00.00,"13,62,596.00",
12-Oct-21,Transfer,00.00,"1,51,399.56","12,11,196.44",
13-Oct-21,Transportellaneous,00.00,"4,03,732.15","8,07,464.29",
14-Oct-21,Transfer,00.00,"1,61,492.86","6,45,971.43",
14-Oct-21,Cash,"1,658.60",00.00,"6,47,630.03",
14-Oct-21,Interest,"1,47,066.20",00.00,"7,94,696.23",
14-Oct-21,NEFT,00.00,"1,32,449.37","6,62,246.86",
14-Oct-21,Transfer,00.00,"66,224.69","5,96,022.17",
14-Oct-21,Cheque,"5,14,286.80",00.00,"11,10,308.97",
14-Oct-21,IMPS,"1,55,794.00",00.00,"12,66,102.97",
14-Oct-21,Transportellaneous,369.67,00.00,"12,66,472.64",
14-Oct-21,Cheque,249,00.00,"12,66,721.64",
14-Oct-21,Commission,00.00,"1,26,672.16","11,40,049.48",
14-Oct-21,Tax,07.51,00.00,"11,40,056.99",
14-Oct-21,Commission,"2,929.00",00.00,"11,42,985.99",
15-Oct-21,ATM,114.76,00.00,"11,43,100.75",
15-Oct-21,Transportellaneous,52,00.00,"11,43,152.75",
15-Oct-21,Debit Card,00.33,00.00,"11,43,153.08",
15-Oct-21,Cheque,00.00,"5,71,576.54","5,71,576.54",
15-Oct-21,Purchase,00.00,"1,90,525.51","3,81,051.03",
16-Oct-21,Transportellaneous,05.10,00.00,"3,81,056.13",
16-Oct-21,Cheque,00.00,"76,211.23","3,04,844.90",
16-Oct-21,Interest,"1,50,017.70",00.00,"4,54,862.60",
16-Oct-21,Reversal,"27,802.00",00.00,"4,82,664.60",
16-Oct-21,Commission,02.39,00.00,"4,82,666.99",
16-Oct-21,ATM,"8,398.88",00.00,"4,91,065.87",
16-Oct-21,ATM,20,00.00,"4,91,085.87",
16-Oct-21,IMPS,00.00,"1,22,771.47","3,68,314.40",
16-Oct-21,Purchase,704.4,00.00,"3,69,018.80",
16-Oct-21,NEFT,00.00,"92,254.70","2,76,764.10",
16-Oct-21,Tax,00.00,"39,537.73","2,37,226.37",
16-Oct-21,Tax,"27,100.00",00.00,"2,64,326.37",
16-Oct-21,Reversal,00.00,"1,32,163.19","1,32,163.18",
16-Oct-21,IMPS,"12,45,454.50",00.00,"13,77,617.68",
16-Oct-21,Bill,00.00,"2,75,523.54","11,02,094.14",
16-Oct-21,Commission,00.00,"11,02,094.14",00.00,
16-Oct-21,Bill,"2,074.16",00.00,"2,074.16",
16-Oct-21,Tax,00.00,230.46,"1,843.70",
16-Oct-21,Cash,45,00.00,"1,888.70",
16-Oct-21,Cash,03.62,00.00,"1,892.32",
16-Oct-21,Transportellaneous,136.8,00.00,"2,029.12",
16-Oct-21,Commission,00.00,289.87,"1,739.25",
16-Oct-21,Tax,07.40,00.00,"1,746.65",
16-Oct-21,IMPS,00.00,582.22,"1,164.43",
16-Oct-21,Cash,07.00,00.00,"1,171.43",
16-Oct-21,NEFT,"32,153.00",00.00,"33,324.43",
16-Oct-21,Transportellaneous,00.00,"4,165.55","29,158.88",
16-Oct-21,ATM,02.15,00.00,"29,161.03",
16-Oct-21,Reversal,"14,305.20",00.00,"43,466.23",
16-Oct-21,Transfer,00.00,"10,866.56","32,599.67",
16-Oct-21,Debit Card,23.3,00.00,"32,622.97",
16-Oct-21,Tax,00.00,"32,622.97",00.00,
16-Oct-21,Cash,314.2,00.00,314.2,
16-Oct-21,Transportellaneous,"12,591.30",00.00,"12,905.50",
16-Oct-21,Interest,00.00,"12,905.50",00.00,
16-Oct-21,IMPS,04.38,00.00,04.38,
16-Oct-21,Interest,47.7,00.00,52.08,
16-Oct-21,Purchase,00.00,07.44,44.64,
16-Oct-21,Reversal,"13,73,608.00",00.00,"13,73,652.64",
16-Oct-21,Reversal,00.00,"13,73,652.64",00.00,
16-Oct-21,RTGS,"17,528.00",00.00,"17,528.00",
16-Oct-21,Cheque,00.00,"2,191.00","15,337.00",
16-Oct-21,NEFT,07.30,00.00,"15,344.30",
16-Oct-21,Purchase,"18,74,677.00",00.00,"18,90,021.30",
16-Oct-21,Transfer,00.00,"3,15,003.55","15,75,017.75",
16-Oct-21,IMPS,"1,053.60",00.00,"15,76,071.35",
16-Oct-21,Debit Card,"19,60,334.00",00.00,"35,36,405.35",
16-Oct-21,Cheque,00.00,"3,92,933.93","31,43,471.42",
16-Oct-21,Bill,"11,53,899.80",00.00,"42,97,371.22",
16-Oct-21,Debit Card,00.00,"42,97,371.22",00.00,
16-Oct-21,RTGS,361.1,00.00,361.1,
16-Oct-21,Bill,00.00,361.1,00.00,
16-Oct-21,ATM,02.60,00.00,02.60,
16-Oct-21,Tax,04.20,00.00,06.80,
16-Oct-21,RTGS,"12,39,028.20",00.00,"12,39,035.00",
17-Oct-21,Interest,123.95,00.00,"12,39,158.95",
17-Oct-21,Transportellaneous,00.00,"1,37,684.33","11,01,474.62",
17-Oct-21,Transfer,00.00,"1,83,579.10","9,17,895.52",
17-Oct-21,NEFT,00.00,"1,01,988.39","8,15,907.13",
17-Oct-21,Tax,00.00,"8,15,907.13",00.00,
17-Oct-21,IMPS,510,00.00,510,
17-Oct-21,Commission,00.00,72.86,437.14,
17-Oct-21,Cash,00.00,145.71,291.43,
17-Oct-21,Tax,33.5,00.00,324.93,
17-Oct-21,Debit Card,00.00,32.49,292.44,
17-Oct-21,Tax,00.00,41.78,250.66,
17-Oct-21,Cheque,00.00,31.33,219.33,
17-Oct-21,Transfer,00.00,27.42,191.91,
17-Oct-21,RTGS,"2,467.00",00.00,"2,658.91",
17-Oct-21,Purchase,"1,98,285.00",00.00,"2,00,943.91",
17-Oct-21,Transportellaneous,00.00,"22,327.10","1,78,616.81",
17-Oct-21,Reversal,00.00,"1,78,616.81",00.00,
17-Oct-21,Commission,"8,44,541.80",00.00,"8,44,541.80",
17-Oct-21,Cash,00.00,"4,22,270.90","4,22,270.90",
17-Oct-21,RTGS,"14,307.20",00.00,"4,36,578.10",
17-Oct-21,NEFT,00.00,"4,36,578.10",00.00,
17-Oct-21,Transfer,03.75,00.00,03.75,
17-Oct-21,Interest,00.00,00.42,03.33,
17-Oct-21,IMPS,00.00,00.67,02.66,
17-Oct-21,RTGS,00.00,00.44,02.22,
17-Oct-21,Debit Card,00.00,00.74,01.48,
17-Oct-21,Commission,"93,658.00",00.00,"93,659.48",
17-Oct-21,NEFT,"84,449.20",00.00,"1,78,108.68",
17-Oct-21,IMPS,26.8,00.00,"1,78,135.48",
17-Oct-21,Bill,"44,455.00",00.00,"2,22,590.48",
17-Oct-21,Purchase,00.00,"37,098.41","1,85,492.07",
17-Oct-21,Transfer,00.00,"37,098.41","1,48,393.66",
17-Oct-21,Transfer,00.00,"14,839.37","1,33,554.29",
17-Oct-21,ATM,00.00,"16,694.29","1,16,860.00",
17-Oct-21,Tax,"2,100.47",00.00,"1,18,960.47",
17-Oct-21,RTGS,00.00,"14,870.06","1,04,090.41",
17-Oct-21,IMPS,00.00,"26,022.60","78,067.81",
17-Oct-21,Debit Card,00.00,"13,011.30","65,056.51",
17-Oct-21,Cash,"2,786.00",00.00,"67,842.51",
17-Oct-21,Tax,00.00,"11,307.09","56,535.42",
18-Oct-21,ATM,"74,848.50",00.00,"1,31,383.92",
18-Oct-21,Tax,02.00,00.00,"1,31,385.92",
18-Oct-21,Transfer,00.00,"1,31,385.92",00.00,
18-Oct-21,Purchase,240.8,00.00,240.8,
18-Oct-21,Purchase,"16,879.70",00.00,"17,120.50",
18-Oct-21,Interest,"20,345.00",00.00,"37,465.50",
18-Oct-21,Transfer,"10,819.00",00.00,"48,284.50",
18-Oct-21,NEFT,00.00,"8,047.42","40,237.08",
18-Oct-21,Cheque,405.2,00.00,"40,642.28",
18-Oct-21,NEFT,00.00,"6,773.71","33,868.57",
18-Oct-21,Cheque,00.00,"6,773.71","27,094.86",
18-Oct-21,Transportellaneous,00.00,"27,094.86",00.00,
18-Oct-21,Bill,06.20,00.00,06.20,
18-Oct-21,Commission,"25,226.00",00.00,"25,232.20",
18-Oct-21,NEFT,"3,558.00",00.00,"28,790.20",
18-Oct-21,Transportellaneous,00.00,"3,598.78","25,191.42",
18-Oct-21,Commission,00.00,"25,191.42",00.00,
18-Oct-21,Transportellaneous,"15,238.00",00.00,"15,238.00",
18-Oct-21,RTGS,00.00,"2,539.67","12,698.33",
18-Oct-21,Purchase,"1,242.31",00.00,"13,940.64",
18-Oct-21,IMPS,00.00,"3,485.16","10,455.48",
18-Oct-21,Transportellaneous,00.00,"1,742.58","8,712.90",
18-Oct-21,NEFT,00.00,871.29,"7,841.61",
18-Oct-21,ATM,00.00,"2,613.87","5,227.74",
18-Oct-21,Transportellaneous,08.00,00.00,"5,235.74",
18-Oct-21,Transfer,00.00,"1,745.25","3,490.49",
18-Oct-21,Transfer,348.39,00.00,"3,838.88",
18-Oct-21,IMPS,664,00.00,"4,502.88",
18-Oct-21,Transportellaneous,00.00,562.86,"3,940.02",
18-Oct-21,Cheque,00.00,492.5,"3,447.52",
18-Oct-21,Purchase,145,00.00,"3,592.52",
19-Oct-21,Interest,63.14,00.00,"3,655.66",
19-Oct-21,Cheque,00.98,00.00,"3,656.64",
19-Oct-21,Transportellaneous,00.00,731.33,"2,925.31",
19-Oct-21,Tax,00.00,731.33,"2,193.98",
20-Oct-21,Commission,00.00,219.4,"1,974.58",
20-Oct-21,Tax,00.00,658.19,"1,316.39",
20-Oct-21,NEFT,00.00,219.4,"1,096.99",
20-Oct-21,Tax,00.00,548.5,548.5,
20-Oct-21,RTGS,00.00,78.36,470.14,
20-Oct-21,IMPS,56.6,00.00,526.74,
20-Oct-21,Bill,05.20,00.00,531.94,
20-Oct-21,Commission,00.00,265.97,265.97,
20-Oct-21,Cash,"19,170.40",00.00,"19,436.37",
20-Oct-21,ATM,00.00,"2,429.55","17,006.82",
20-Oct-21,Transfer,00.00,"8,503.41","8,503.41",
20-Oct-21,Tax,00.00,"1,062.93","7,440.48",
20-Oct-21,Bill,00.00,"1,488.10","5,952.38",
20-Oct-21,Reversal,00.00,595.24,"5,357.14",
20-Oct-21,Reversal,"3,424.35",00.00,"8,781.49",
20-Oct-21,Reversal,00.00,"2,927.16","5,854.33",
20-Oct-21,Transfer,25.52,00.00,"5,879.85",
20-Oct-21,Cash,286,00.00,"6,165.85",
20-Oct-21,Reversal,"7,093.60",00.00,"13,259.45",
20-Oct-21,Bill,00.00,"1,473.27","11,786.18",
20-Oct-21,Tax,00.00,"1,309.58","10,476.60",
20-Oct-21,ATM,00.00,"5,238.30","5,238.30",
20-Oct-21,Transfer,00.00,"1,746.10","3,492.20",
20-Oct-21,Interest,"16,41,375.50",00.00,"16,44,867.70",
20-Oct-21,Tax,"3,700.00",00.00,"16,48,567.70",
20-Oct-21,NEFT,00.00,"5,49,522.57","10,99,045.13",
20-Oct-21,Commission,33,00.00,"10,99,078.13",
20-Oct-21,Transportellaneous,01.31,00.00,"10,99,079.44",
20-Oct-21,NEFT,00.00,"2,74,769.86","8,24,309.58",
20-Oct-21,Transfer,"2,05,462.50",00.00,"10,29,772.08",
20-Oct-21,Tax,"53,224.00",00.00,"10,82,996.08",
20-Oct-21,RTGS,"7,013.00",00.00,"10,90,009.08",
20-Oct-21,Tax,00.00,"1,21,112.12","9,68,896.96",
20-Oct-21,NEFT,326.5,00.00,"9,69,223.46",
20-Oct-21,Commission,"2,96,563.00",00.00,"12,65,786.46",
20-Oct-21,IMPS,07.00,00.00,"12,65,793.46",
20-Oct-21,Cash,54.25,00.00,"12,65,847.71",
20-Oct-21,IMPS,"47,621.00",00.00,"13,13,468.71",
20-Oct-21,RTGS,274,00.00,"13,13,742.71",
20-Oct-21,NEFT,00.00,"4,37,914.24","8,75,828.47",
20-Oct-21,Tax,"3,057.00",00.00,"8,78,885.47",
20-Oct-21,Transportellaneous,00.00,"1,09,860.68","7,69,024.79",
20-Oct-21,RTGS,00.00,"1,53,804.96","6,15,219.83",
20-Oct-21,Tax,163.05,00.00,"6,15,382.88",
20-Oct-21,ATM,"18,159.72",00.00,"6,33,542.60",
20-Oct-21,IMPS,17.1,00.00,"6,33,559.70",
20-Oct-21,Purchase,"39,161.47",00.00,"6,72,721.17",
20-Oct-21,Interest,00.00,"6,72,721.17",00.00,
20-Oct-21,RTGS,"11,743.27",00.00,"11,743.27",
20-Oct-21,ATM,00.00,"1,304.81","10,438.46",
20-Oct-21,ATM,00.00,"1,043.85","9,394.61",
20-Oct-21,ATM,00.00,"9,394.61",00.00,
20-Oct-21,ATM,52.8,00.00,52.8,
20-Oct-21,Purchase,"1,053.29",00.00,"1,106.09",
20-Oct-21,Cheque,00.00,368.7,737.39,
21-Oct-21,Tax,04.56,00.00,741.95,
21-Oct-21,Cheque,00.00,105.99,635.96,
21-Oct-21,Debit Card,"15,245.02",00.00,"15,880.98",
21-Oct-21,Cheque,240.42,00.00,"16,121.40",
21-Oct-21,NEFT,301.47,00.00,"16,422.87",
21-Oct-21,Cheque,"77,415.00",00.00,"93,837.87",
21-Oct-21,Interest,00.00,"93,837.87",00.00,
21-Oct-21,Purchase,"8,809.37",00.00,"8,809.37",
21-Oct-21,Debit Card,"9,99,565.50",00.00,"10,08,374.87",
21-Oct-21,Transportellaneous,"5,683.70",00.00,"10,14,058.57",
21-Oct-21,Transfer,"14,821.86",00.00,"10,28,880.43",
21-Oct-21,Debit Card,587,00.00,"10,29,467.43",
21-Oct-21,Bill,00.00,"2,57,366.86","7,72,100.57",
21-Oct-21,Interest,00.00,"85,788.95","6,86,311.62",
21-Oct-21,Commission,"15,56,226.00",00.00,"22,42,537.62",
21-Oct-21,Commission,"19,35,197.75",00.00,"41,77,735.37",
21-Oct-21,IMPS,00.00,"8,35,547.07","33,42,188.30",
21-Oct-21,RTGS,"2,21,896.41",00.00,"35,64,084.71",
21-Oct-21,Purchase,00.00,"3,96,009.41","31,68,075.30",
21-Oct-21,Commission,00.00,"10,56,025.10","21,12,050.20",
21-Oct-21,Debit Card,00.00,"7,04,016.73","14,08,033.47",
21-Oct-21,Cash,00.00,"2,01,147.64","12,06,885.83",
21-Oct-21,Transfer,00.00,"12,06,885.83",00.00,
21-Oct-21,Commission,01.20,00.00,01.20,
21-Oct-21,Reversal,00.00,00.24,00.96,
21-Oct-21,Tax,00.00,00.10,00.86,
21-Oct-21,Purchase,"3,588.69",00.00,"3,589.55",
21-Oct-21,Interest,00.00,717.91,"2,871.64",
21-Oct-21,Transportellaneous,00.00,574.33,"2,297.31",
21-Oct-21,Bill,00.00,"2,297.31",00.00,
22-Oct-21,Commission,07.84,00.00,07.84,
22-Oct-21,Commission,00.00,03.92,03.92,
22-Oct-21,Purchase,404.9,00.00,408.82,
22-Oct-21,RTGS,00.00,136.27,272.55,
22-Oct-21,Debit Card,10,00.00,282.55,
22-Oct-21,Interest,"13,011.45",00.00,"13,294.00",
22-Oct-21,RTGS,390,00.00,"13,684.00",
22-Oct-21,Reversal,"2,735.91",00.00,"16,419.91",
22-Oct-21,Transfer,37.3,00.00,"16,457.21",
22-Oct-21,IMPS,00.00,"3,291.44","13,165.77",
22-Oct-21,IMPS,"18,06,310.00",00.00,"18,19,475.77",
22-Oct-21,NEFT,94.2,00.00,"18,19,569.97",
22-Oct-21,Tax,00.00,"3,63,913.99","14,55,655.98",
22-Oct-21,Transfer,00.00,"3,63,914.00","10,91,741.98",
22-Oct-21,Cash,"74,308.06",00.00,"11,66,050.04",
22-Oct-21,NEFT,00.00,"2,33,210.01","9,32,840.03",
22-Oct-21,Purchase,161.37,00.00,"9,33,001.40",
22-Oct-21,ATM,00.00,"1,55,500.23","7,77,501.17",
22-Oct-21,Tax,00.00,"1,55,500.23","6,22,000.94",
22-Oct-21,Bill,63,00.00,"6,22,063.94",
22-Oct-21,Interest,00.00,"77,757.99","5,44,305.95",
22-Oct-21,Transportellaneous,00.00,"1,08,861.19","4,35,444.76",
22-Oct-21,Tax,195,00.00,"4,35,639.76",
22-Oct-21,Transfer,04.00,00.00,"4,35,643.76",
22-Oct-21,Bill,00.00,"48,404.86","3,87,238.90",
22-Oct-21,IMPS,00.00,"55,319.84","3,31,919.06",
22-Oct-21,Transportellaneous,00.00,"66,383.81","2,65,535.25",
22-Oct-21,IMPS,00.00,"29,503.92","2,36,031.33",
22-Oct-21,ATM,243,00.00,"2,36,274.33",
22-Oct-21,Debit Card,03.00,00.00,"2,36,277.33",
22-Oct-21,RTGS,"21,661.00",00.00,"2,57,938.33",
22-Oct-21,RTGS,"3,97,188.00",00.00,"6,55,126.33",
22-Oct-21,Interest,"1,90,534.00",00.00,"8,45,660.33",
22-Oct-21,Transfer,"2,933.00",00.00,"8,48,593.33",
22-Oct-21,Cheque,00.00,"4,24,296.67","4,24,296.66",
22-Oct-21,RTGS,00.00,"84,859.33","3,39,437.33",
22-Oct-21,Debit Card,"16,734.10",00.00,"3,56,171.43",
22-Oct-21,RTGS,00.00,"3,56,171.43",00.00,
22-Oct-21,Debit Card,62.6,00.00,62.6,
22-Oct-21,RTGS,"48,781.30",00.00,"48,843.90",
22-Oct-21,Bill,"7,213.00",00.00,"56,056.90",
22-Oct-21,Commission,00.00,"14,014.23","42,042.68",
22-Oct-21,Transfer,00.00,"21,021.34","21,021.34",
22-Oct-21,Cash,00.00,"21,021.34",00.00,
22-Oct-21,Transportellaneous,"7,09,927.00",00.00,"7,09,927.00",
22-Oct-21,Debit Card,24.4,00.00,"7,09,951.40",
22-Oct-21,Cash,00.00,"1,41,990.28","5,67,961.12",
22-Oct-21,Commission,02.90,00.00,"5,67,964.02",
22-Oct-21,NEFT,00.00,"81,137.72","4,86,826.30",
22-Oct-21,RTGS,109,00.00,"4,86,935.30",
22-Oct-21,Transfer,00.00,"48,693.53","4,38,241.77",
22-Oct-21,Interest,"85,678.40",00.00,"5,23,920.17",
22-Oct-21,ATM,00.00,"1,30,980.04","3,92,940.13",
22-Oct-21,RTGS,"1,97,792.10",00.00,"5,90,732.23",
22-Oct-21,Debit Card,00.00,"1,47,683.06","4,43,049.17",
22-Oct-21,Interest,00.00,"49,227.69","3,93,821.48",
22-Oct-21,Reversal,210.3,00.00,"3,94,031.78",
22-Oct-21,Transportellaneous,00.00,"1,31,343.93","2,62,687.85",
23-Oct-21,Commission,00.00,"37,526.84","2,25,161.01",
23-Oct-21,ATM,00.00,"22,516.10","2,02,644.91",
23-Oct-21,Commission,00.00,"50,661.23","1,51,983.68",
23-Oct-21,Debit Card,00.00,"18,997.96","1,32,985.72",
23-Oct-21,Purchase,00.00,"26,597.14","1,06,388.58",
23-Oct-21,Interest,00.00,"1,06,388.58",00.00,
23-Oct-21,Transportellaneous,"11,116.47",00.00,"11,116.47",
23-Oct-21,Purchase,00.00,"1,588.07","9,528.40",
24-Oct-21,Transfer,275.1,00.00,"9,803.50",
24-Oct-21,Transportellaneous,"18,57,087.20",00.00,"18,66,890.70",
24-Oct-21,Reversal,00.00,"1,86,689.07","16,80,201.63",
24-Oct-21,Transfer,00.00,"8,40,100.82","8,40,100.82",
24-Oct-21,Cheque,30,00.00,"8,40,130.82",
24-Oct-21,Purchase,00.00,"1,40,021.80","7,00,109.02",
24-Oct-21,NEFT,00.00,"1,00,015.57","6,00,093.45",
24-Oct-21,Interest,00.00,"66,677.05","5,33,416.40",
24-Oct-21,Tax,"32,666.00",00.00,"5,66,082.40",
24-Oct-21,ATM,00.00,"1,13,216.48","4,52,865.92",
24-Oct-21,Tax,465.9,00.00,"4,53,331.82",
25-Oct-21,NEFT,00.00,"2,26,665.91","2,26,665.91",
25-Oct-21,NEFT,00.00,"37,777.65","1,88,888.26",
25-Oct-21,Transportellaneous,00.00,"47,222.07","1,41,666.20",
25-Oct-21,Interest,32,00.00,"1,41,698.20",
25-Oct-21,IMPS,"1,60,981.00",00.00,"3,02,679.20",
25-Oct-21,ATM,51,00.00,"3,02,730.20",
26-Oct-21,Bill,13,00.00,"3,02,743.20",
26-Oct-21,Commission,16.7,00.00,"3,02,759.90",
26-Oct-21,ATM,459.44,00.00,"3,03,219.34",
26-Oct-21,ATM,"1,896.60",00.00,"3,05,115.94",
26-Oct-21,IMPS,257,00.00,"3,05,372.94",
26-Oct-21,Bill,04.00,00.00,"3,05,376.94",
26-Oct-21,IMPS,52.9,00.00,"3,05,429.84",
26-Oct-21,Cheque,462.8,00.00,"3,05,892.64",
26-Oct-21,Cheque,00.00,"33,988.07","2,71,904.57",
26-Oct-21,NEFT,"10,027.67",00.00,"2,81,932.24",
26-Oct-21,Purchase,00.00,"2,81,932.24",00.00,
26-Oct-21,Transfer,"19,199.90",00.00,"19,199.90",
26-Oct-21,Cheque,197.8,00.00,"19,397.70",
26-Oct-21,IMPS,04.00,00.00,"19,401.70",
26-Oct-21,Transfer,00.00,"2,425.21","16,976.49",
26-Oct-21,Cheque,00.00,"2,829.42","14,147.08",
26-Oct-21,RTGS,00.00,"3,536.77","10,610.31",
26-Oct-21,Transfer,"19,274.50",00.00,"29,884.81",
26-Oct-21,Debit Card,"17,085.00",00.00,"46,969.81",
26-Oct-21,Transfer,"32,593.29",00.00,"79,563.10",
26-Oct-21,Commission,42,00.00,"79,605.10",
26-Oct-21,Interest,46.1,00.00,"79,651.20",
26-Oct-21,Commission,00.00,"9,956.40","69,694.80",
26-Oct-21,NEFT,"5,19,661.50",00.00,"5,89,356.30",
26-Oct-21,IMPS,00.00,"2,94,678.15","2,94,678.15",
26-Oct-21,RTGS,00.00,"29,467.82","2,65,210.34",
26-Oct-21,Debit Card,"68,829.34",00.00,"3,34,039.68",
26-Oct-21,Transportellaneous,"1,02,117.10",00.00,"4,36,156.78",
26-Oct-21,Bill,00.00,"1,45,385.59","2,90,771.19",
26-Oct-21,Tax,39.08,00.00,"2,90,810.27",
26-Oct-21,Purchase,"2,133.90",00.00,"2,92,944.17",
26-Oct-21,Transportellaneous,00.00,"41,849.17","2,51,095.00",
26-Oct-21,Cheque,04.10,00.00,"2,51,099.10",
26-Oct-21,NEFT,18.3,00.00,"2,51,117.40",
26-Oct-21,Transportellaneous,05.10,00.00,"2,51,122.50",
26-Oct-21,Tax,01.00,00.00,"2,51,123.50",
26-Oct-21,Purchase,00.00,"1,25,561.75","1,25,561.75",
26-Oct-21,RTGS,00.00,"13,951.31","1,11,610.44",
26-Oct-21,NEFT,417.63,00.00,"1,12,028.07",
26-Oct-21,Bill,55.82,00.00,"1,12,083.89",
26-Oct-21,Bill,00.00,"28,020.97","84,062.92",
26-Oct-21,ATM,152,00.00,"84,214.92",
27-Oct-21,Debit Card,00.00,"28,071.64","56,143.28",
27-Oct-21,RTGS,06.48,00.00,"56,149.76",
27-Oct-21,ATM,"3,775.60",00.00,"59,925.36",
27-Oct-21,Bill,00.00,"19,975.12","39,950.24",
27-Oct-21,ATM,"2,654.64",00.00,"42,604.88",
27-Oct-21,Cheque,01.40,00.00,"42,606.28",
27-Oct-21,Transfer,00.00,"6,086.61","36,519.67",
27-Oct-21,Cash,357,00.00,"36,876.67",
27-Oct-21,Tax,431.83,00.00,"37,308.50",
27-Oct-21,Tax,00.00,"12,436.17","24,872.33",
27-Oct-21,Debit Card,00.00,"12,436.17","12,436.16",
27-Oct-21,Interest,00.00,"12,436.16",00.00,
27-Oct-21,Commission,"2,492.91",00.00,"2,492.91",
27-Oct-21,RTGS,00.00,356.13,"2,136.78",
27-Oct-21,Purchase,"23,782.30",00.00,"25,919.08",
27-Oct-21,NEFT,00.00,"25,919.08",00.00,
27-Oct-21,Bill,"2,335.50",00.00,"2,335.50",
27-Oct-21,Transfer,00.00,333.64,"2,001.86",
27-Oct-21,Cash,00.00,285.98,"1,715.88",
27-Oct-21,Reversal,"3,008.61",00.00,"4,724.49",
27-Oct-21,Transportellaneous,00.00,674.93,"4,049.56",
27-Oct-21,Transportellaneous,00.00,"1,012.39","3,037.17",
27-Oct-21,Commission,63.9,00.00,"3,101.07",
27-Oct-21,IMPS,00.00,"1,550.54","1,550.54",
27-Oct-21,IMPS,"1,91,081.09",00.00,"1,92,631.63",
27-Oct-21,IMPS,"7,28,790.50",00.00,"9,21,422.13",
27-Oct-21,ATM,00.00,"1,53,570.36","7,67,851.78",
27-Oct-21,IMPS,07.00,00.00,"7,67,858.78",
27-Oct-21,Purchase,"26,857.43",00.00,"7,94,716.21",
27-Oct-21,Debit Card,"11,056.00",00.00,"8,05,772.21",
27-Oct-21,Tax,"5,57,409.25",00.00,"13,63,181.46",
27-Oct-21,RTGS,"81,875.38",00.00,"14,45,056.84",
27-Oct-21,Bill,00.00,"1,60,561.87","12,84,494.97",
27-Oct-21,Commission,447.5,00.00,"12,84,942.47",
27-Oct-21,Reversal,"1,700.95",00.00,"12,86,643.42",
27-Oct-21,RTGS,00.00,"2,57,328.68","10,29,314.74",
27-Oct-21,Reversal,111.9,00.00,"10,29,426.64",
27-Oct-21,Commission,"21,828.12",00.00,"10,51,254.76",
27-Oct-21,Debit Card,"1,41,728.91",00.00,"11,92,983.67",
27-Oct-21,Commission,02.50,00.00,"11,92,986.17",
28-Oct-21,ATM,"2,33,067.00",00.00,"14,26,053.17",
28-Oct-21,Transportellaneous,"4,100.00",00.00,"14,30,153.17",
28-Oct-21,ATM,45.68,00.00,"14,30,198.85",
28-Oct-21,Cheque,266.91,00.00,"14,30,465.76",
28-Oct-21,RTGS,"1,346.50",00.00,"14,31,812.26",
28-Oct-21,Transfer,55,00.00,"14,31,867.26",
28-Oct-21,Bill,00.67,00.00,"14,31,867.93",
28-Oct-21,Tax,00.00,"7,15,933.97","7,15,933.96",
28-Oct-21,NEFT,00.00,"89,491.75","6,26,442.22",
29-Oct-21,NEFT,"54,011.00",00.00,"6,80,453.22",
29-Oct-21,ATM,"1,559.10",00.00,"6,82,012.32",
29-Oct-21,Debit Card,00.00,"97,430.33","5,84,581.99",
29-Oct-21,Debit Card,00.00,"64,953.55","5,19,628.44",
29-Oct-21,Transfer,00.00,"74,232.63","4,45,395.81",
29-Oct-21,Bill,209.24,00.00,"4,45,605.05",
29-Oct-21,Tax,41.9,00.00,"4,45,646.95",
29-Oct-21,NEFT,07.00,00.00,"4,45,653.95",
29-Oct-21,Commission,00.00,"89,130.79","3,56,523.16",
30-Oct-21,Transportellaneous,00.00,"59,420.53","2,97,102.63",
30-Oct-21,Commission,00.00,"74,275.66","2,22,826.97",
30-Oct-21,Commission,374,00.00,"2,23,200.97",
30-Oct-21,IMPS,00.00,"2,23,200.97",00.00,
30-Oct-21,Transportellaneous,18,00.00,18,
30-Oct-21,Interest,451.28,00.00,469.28,
30-Oct-21,Interest,00.00,52.14,417.14,
30-Oct-21,Interest,00.00,69.52,347.62,
30-Oct-21,Reversal,00.00,49.66,297.96,
30-Oct-21,Interest,06.00,00.00,303.96,
30-Oct-21,Commission,"44,271.22",00.00,"44,575.18",
30-Oct-21,Reversal,"64,203.94",00.00,"1,08,779.12",
30-Oct-21,Interest,00.00,"15,539.87","93,239.25",
30-Oct-21,Reversal,00.00,"23,309.81","69,929.44",
30-Oct-21,Bill,"1,07,054.00",00.00,"1,76,983.44",
30-Oct-21,Cash,"7,629.00",00.00,"1,84,612.44",
30-Oct-21,Commission,00.00,"61,537.48","1,23,074.96",
30-Oct-21,RTGS,00.00,"15,384.37","1,07,690.59",
30-Oct-21,Bill,"12,92,288.00",00.00,"13,99,978.59",
30-Oct-21,Bill,"24,015.80",00.00,"14,23,994.39",
31-Oct-21,NEFT,477.3,00.00,"14,24,471.69",
31-Oct-21,RTGS,00.00,"1,58,274.63","12,66,197.06",
31-Oct-21,Transfer,00.00,"1,80,885.29","10,85,311.77",
31-Oct-21,RTGS,352.26,00.00,"10,85,664.03",
31-Oct-21,Bill,00.00,"3,61,888.01","7,23,776.02",
31-Oct-21,Cheque,00.00,"7,23,776.02",00.00,
31-Oct-21,Transfer,"2,02,080.72",00.00,"2,02,080.72",
31-Oct-21,Reversal,125,00.00,"2,02,205.72",
31-Oct-21,ATM,32,00.00,"2,02,237.72",
01-Nov-21,Debit Card,"2,044.54",00.00,"2,04,282.26",
01-Nov-21,IMPS,"31,293.90",00.00,"2,35,576.16",
01-Nov-21,Transportellaneous,00.00,"78,525.39","1,57,050.77",
01-Nov-21,Purchase,00.00,"19,631.35","1,37,419.42",
01-Nov-21,Commission,00.00,"1,37,419.42",00.00,
01-Nov-21,Transportellaneous,298.03,00.00,298.03,
01-Nov-21,Cheque,06.07,00.00,304.1,
01-Nov-21,ATM,76,00.00,380.1,
01-Nov-21,Interest,00.00,76.02,304.08,
01-Nov-21,ATM,00.00,33.79,270.29,
01-Nov-21,Transportellaneous,00.00,45.05,225.24,
01-Nov-21,Transfer,00.00,75.08,150.16,
01-Nov-21,Cheque,"2,35,051.00",00.00,"2,35,201.16",
01-Nov-21,Interest,00.00,"78,400.39","1,56,800.77",
01-Nov-21,Debit Card,260,00.00,"1,57,060.77",
01-Nov-21,RTGS,"3,698.00",00.00,"1,60,758.77",
01-Nov-21,Cash,212.1,00.00,"1,60,970.87",
01-Nov-21,Purchase,00.00,"80,485.44","80,485.44",
01-Nov-21,Reversal,188.86,00.00,"80,674.30",
01-Nov-21,Tax,00.00,"20,168.58","60,505.73",
01-Nov-21,Tax,00.00,"8,643.68","51,862.05",
01-Nov-21,Reversal,00.00,"17,287.35","34,574.70",
01-Nov-21,Debit Card,00.00,"3,457.47","31,117.23",
01-Nov-21,IMPS,01.20,00.00,"31,118.43",
01-Nov-21,Cash,03.30,00.00,"31,121.73",
01-Nov-21,RTGS,07.70,00.00,"31,129.43",
01-Nov-21,Cash,00.00,"3,458.83","27,670.60",
01-Nov-21,Purchase,"3,633.70",00.00,"31,304.30",
01-Nov-21,Purchase,"22,359.00",00.00,"53,663.30",
01-Nov-21,ATM,00.00,"26,831.65","26,831.65",
01-Nov-21,ATM,451.1,00.00,"27,282.75",
01-Nov-21,NEFT,332,00.00,"27,614.75",
01-Nov-21,RTGS,00.00,"5,522.95","22,091.80",
01-Nov-21,Cash,303,00.00,"22,394.80",
01-Nov-21,RTGS,"1,769.00",00.00,"24,163.80",
01-Nov-21,Commission,01.00,00.00,"24,164.80",
01-Nov-21,Transportellaneous,00.00,"3,020.60","21,144.20",
01-Nov-21,Bill,00.00,"10,572.10","10,572.10",
01-Nov-21,Cheque,00.00,"3,524.03","7,048.07",
01-Nov-21,ATM,00.00,"1,006.87","6,041.20",
01-Nov-21,IMPS,00.00,604.12,"5,437.08",
01-Nov-21,Reversal,00.00,776.73,"4,660.35",
01-Nov-21,NEFT,"12,84,532.50",00.00,"12,89,192.85",
01-Nov-21,Reversal,"37,686.00",00.00,"13,26,878.85",
01-Nov-21,IMPS,"15,12,494.00",00.00,"28,39,372.85",
01-Nov-21,Cash,107.1,00.00,"28,39,479.95",
01-Nov-21,IMPS,01.65,00.00,"28,39,481.60",
01-Nov-21,Debit Card,"29,871.20",00.00,"28,69,352.80",
01-Nov-21,Debit Card,00.00,"2,86,935.28","25,82,417.52",
01-Nov-21,Reversal,00.00,"2,86,935.28","22,95,482.24",
01-Nov-21,Debit Card,00.00,"7,65,160.75","15,30,321.49",
01-Nov-21,Purchase,00.00,"1,70,035.72","13,60,285.77",
01-Nov-21,Cash,"16,49,956.00",00.00,"30,10,241.77",
01-Nov-21,Debit Card,00.00,"3,34,471.31","26,75,770.46",
01-Nov-21,ATM,"6,99,045.50",00.00,"33,74,815.96",
01-Nov-21,Cash,49,00.00,"33,74,864.96",
01-Nov-21,NEFT,00.00,"8,43,716.24","25,31,148.72",
01-Nov-21,RTGS,26.4,00.00,"25,31,175.12",
02-Nov-21,Commission,"18,004.00",00.00,"25,49,179.12",
02-Nov-21,Bill,00.00,"12,74,589.56","12,74,589.56",
02-Nov-21,NEFT,00.00,"3,18,647.39","9,55,942.17",
02-Nov-21,RTGS,00.00,"1,06,215.80","8,49,726.37",
02-Nov-21,Transportellaneous,167.7,00.00,"8,49,894.07",
02-Nov-21,Tax,00.00,"1,06,236.76","7,43,657.31",
02-Nov-21,IMPS,00.00,"2,47,885.77","4,95,771.54",
02-Nov-21,Debit Card,04.60,00.00,"4,95,776.14",
03-Nov-21,Debit Card,00.00,"61,972.02","4,33,804.12",
03-Nov-21,Cash,02.00,00.00,"4,33,806.12",
03-Nov-21,Transfer,00.00,"4,33,806.12",00.00,
03-Nov-21,Purchase,"3,738.93",00.00,"3,738.93",
03-Nov-21,Transfer,86.58,00.00,"3,825.51",
03-Nov-21,Bill,"16,031.00",00.00,"19,856.51",
03-Nov-21,ATM,06.82,00.00,"19,863.33",
03-Nov-21,Cash,"2,44,557.80",00.00,"2,64,421.13",
03-Nov-21,Cash,00.00,"44,070.19","2,20,350.94",
03-Nov-21,IMPS,"20,32,708.00",00.00,"22,53,058.94",
03-Nov-21,Debit Card,00.00,"2,25,305.89","20,27,753.05",
03-Nov-21,Purchase,00.00,"2,53,469.13","17,74,283.92",
03-Nov-21,ATM,"23,244.94",00.00,"17,97,528.86",
03-Nov-21,RTGS,"9,90,055.20",00.00,"27,87,584.06",
03-Nov-21,Reversal,00.00,"3,48,448.01","24,39,136.05",
03-Nov-21,NEFT,19.7,00.00,"24,39,155.75",
03-Nov-21,Reversal,00.00,"3,04,894.47","21,34,261.28",
03-Nov-21,Debit Card,00.00,"3,55,710.21","17,78,551.07",
03-Nov-21,RTGS,00.00,"17,78,551.07",00.00,
03-Nov-21,Transfer,"1,568.64",00.00,"1,568.64",
03-Nov-21,Tax,00.00,261.44,"1,307.20",
03-Nov-21,Cash,00.00,130.72,"1,176.48",
03-Nov-21,Commission,41,00.00,"1,217.48",
03-Nov-21,Commission,"16,25,978.75",00.00,"16,27,196.23",
03-Nov-21,IMPS,"1,12,423.00",00.00,"17,39,619.23",
03-Nov-21,Tax,"23,778.25",00.00,"17,63,397.48",
03-Nov-21,Transportellaneous,00.00,"2,20,424.69","15,42,972.80",
03-Nov-21,Tax,00.00,"2,57,162.13","12,85,810.67",
03-Nov-21,Tax,03.00,00.00,"12,85,813.67",
03-Nov-21,Cheque,00.00,"3,21,453.42","9,64,360.25",
03-Nov-21,Bill,"2,746.00",00.00,"9,67,106.25",
03-Nov-21,IMPS,00.00,"1,38,158.04","8,28,948.21",
03-Nov-21,Interest,02.40,00.00,"8,28,950.61",
03-Nov-21,ATM,"18,825.80",00.00,"8,47,776.41",
03-Nov-21,Interest,"29,742.00",00.00,"8,77,518.41",
03-Nov-21,Purchase,00.00,"2,92,506.14","5,85,012.27",
03-Nov-21,Tax,00.00,"1,46,253.07","4,38,759.20",
03-Nov-21,IMPS,00.00,"87,751.84","3,51,007.36",
03-Nov-21,Cheque,00.80,00.00,"3,51,008.16",
03-Nov-21,Bill,34,00.00,"3,51,042.16",
03-Nov-21,Cheque,00.00,"3,51,042.16",00.00,
03-Nov-21,Debit Card,"2,059.40",00.00,"2,059.40",
03-Nov-21,Cash,00.00,686.47,"1,372.93",
03-Nov-21,Transportellaneous,00.00,171.62,"1,201.31",
03-Nov-21,Purchase,07.00,00.00,"1,208.31",
03-Nov-21,Debit Card,03.00,00.00,"1,211.31",
03-Nov-21,IMPS,"9,73,193.00",00.00,"9,74,404.31",
03-Nov-21,RTGS,"58,170.00",00.00,"10,32,574.31",
03-Nov-21,Transportellaneous,00.00,"2,06,514.86","8,26,059.45",
04-Nov-21,ATM,09.40,00.00,"8,26,068.85",
04-Nov-21,Bill,00.00,"8,26,068.85",00.00,
04-Nov-21,IMPS,225.3,00.00,225.3,
04-Nov-21,NEFT,00.00,45.06,180.24,
04-Nov-21,Transportellaneous,"56,676.66",00.00,"56,856.90",
04-Nov-21,Interest,00.00,"9,476.15","47,380.75",
04-Nov-21,Cheque,00.00,"5,922.59","41,458.16",
04-Nov-21,Reversal,17.5,00.00,"41,475.66",
04-Nov-21,Cash,00.00,"10,368.92","31,106.75",
04-Nov-21,Cash,"15,61,162.00",00.00,"15,92,268.75",
04-Nov-21,RTGS,23.7,00.00,"15,92,292.45",
04-Nov-21,ATM,00.00,"2,27,470.35","13,64,822.10",
04-Nov-21,NEFT,00.00,"1,94,974.59","11,69,847.51",
04-Nov-21,Transportellaneous,00.00,"2,33,969.50","9,35,878.01",
04-Nov-21,Commission,00.00,"1,55,979.67","7,79,898.34",
04-Nov-21,Reversal,"3,670.50",00.00,"7,83,568.84",
04-Nov-21,Commission,195.19,00.00,"7,83,764.03",
04-Nov-21,Transportellaneous,00.00,"78,376.40","7,05,387.63",
04-Nov-21,Cash,26.6,00.00,"7,05,414.23",
04-Nov-21,Commission,00.00,"1,17,569.04","5,87,845.19",
04-Nov-21,Transportellaneous,00.00,"1,95,948.40","3,91,896.79",
04-Nov-21,Interest,00.00,"97,974.20","2,93,922.59",
04-Nov-21,ATM,01.40,00.00,"2,93,923.99",
04-Nov-21,Debit Card,00.00,"29,392.40","2,64,531.59",
04-Nov-21,Transfer,00.00,"52,906.32","2,11,625.27",
04-Nov-21,Interest,00.00,"35,270.88","1,76,354.39",
04-Nov-21,IMPS,00.00,"19,594.93","1,56,759.46",
04-Nov-21,Transportellaneous,00.00,"31,351.89","1,25,407.57",
04-Nov-21,Cheque,00.00,"41,802.52","83,605.05",
04-Nov-21,ATM,00.00,"8,360.51","75,244.54",
04-Nov-21,NEFT,00.00,"18,811.14","56,433.40",
04-Nov-21,Transportellaneous,00.00,"28,216.70","28,216.70",
04-Nov-21,Bill,00.00,"7,054.18","21,162.52",
04-Nov-21,Purchase,00.00,"2,645.32","18,517.21",
04-Nov-21,Commission,00.00,"2,057.47","16,459.74",
05-Nov-21,Tax,00.00,"2,351.39","14,108.35",
06-Nov-21,Reversal,00.00,"1,763.54","12,344.81",
06-Nov-21,Commission,00.00,"1,234.48","11,110.33",
06-Nov-21,Debit Card,964,00.00,"12,074.33",
06-Nov-21,Debit Card,"17,51,528.00",00.00,"17,63,602.33",
06-Nov-21,Purchase,07.17,00.00,"17,63,609.50",
06-Nov-21,IMPS,"3,920.57",00.00,"17,67,530.07",
06-Nov-21,Bill,"3,898.20",00.00,"17,71,428.27",
06-Nov-21,NEFT,00.00,"17,71,428.27",00.00,
06-Nov-21,Transfer,"87,596.40",00.00,"87,596.40",
06-Nov-21,Cheque,00.00,"21,899.10","65,697.30",
06-Nov-21,Debit Card,00.00,"32,848.65","32,848.65",
06-Nov-21,RTGS,98,00.00,"32,946.65",
06-Nov-21,Cheque,00.00,"10,982.22","21,964.43",
06-Nov-21,IMPS,00.00,"2,440.49","19,523.94",
06-Nov-21,Interest,117.8,00.00,"19,641.74",
06-Nov-21,ATM,00.00,"3,273.62","16,368.12",
06-Nov-21,IMPS,"23,970.00",00.00,"40,338.12",
06-Nov-21,Transportellaneous,"1,22,864.00",00.00,"1,63,202.12",
06-Nov-21,Transportellaneous,05.00,00.00,"1,63,207.12",
06-Nov-21,ATM,444.7,00.00,"1,63,651.82",
06-Nov-21,Tax,"14,55,116.00",00.00,"16,18,767.82",
06-Nov-21,Transfer,25.37,00.00,"16,18,793.19",
06-Nov-21,RTGS,"17,79,209.75",00.00,"33,98,002.94",
06-Nov-21,IMPS,"7,20,495.50",00.00,"41,18,498.44",
06-Nov-21,Commission,08.00,00.00,"41,18,506.44",
06-Nov-21,IMPS,07.20,00.00,"41,18,513.64",
06-Nov-21,RTGS,240.9,00.00,"41,18,754.54",
06-Nov-21,Commission,00.00,"5,14,844.32","36,03,910.22",
06-Nov-21,Transportellaneous,00.00,"3,60,391.02","32,43,519.20",
06-Nov-21,Cheque,00.00,"4,63,359.89","27,80,159.31",
06-Nov-21,NEFT,00.00,"9,26,719.77","18,53,439.54",
07-Nov-21,Interest,08.00,00.00,"18,53,447.54",
07-Nov-21,Reversal,00.00,"6,17,815.85","12,35,631.69",
07-Nov-21,Commission,213.59,00.00,"12,35,845.28",
07-Nov-21,Interest,00.00,"1,37,316.14","10,98,529.14",
07-Nov-21,Commission,00.00,"1,22,058.79","9,76,470.35",
07-Nov-21,Transportellaneous,"32,145.00",00.00,"10,08,615.35",
07-Nov-21,Purchase,93.5,00.00,"10,08,708.85",
07-Nov-21,Reversal,78,00.00,"10,08,786.85",
07-Nov-21,Bill,00.00,"3,36,262.28","6,72,524.57",
07-Nov-21,Cheque,01.86,00.00,"6,72,526.43",
07-Nov-21,Reversal,25.51,00.00,"6,72,551.94",
07-Nov-21,NEFT,00.00,"6,72,551.94",00.00,
07-Nov-21,ATM,327.1,00.00,327.1,
07-Nov-21,Interest,00.00,36.34,290.76,
07-Nov-21,Bill,"17,432.00",00.00,"17,722.76",
07-Nov-21,Cash,00.00,"3,544.55","14,178.21",
07-Nov-21,Purchase,07.63,00.00,"14,185.84",
07-Nov-21,Debit Card,"1,41,764.20",00.00,"1,55,950.04",
07-Nov-21,IMPS,"2,00,027.00",00.00,"3,55,977.04",
07-Nov-21,Bill,00.00,"59,329.51","2,96,647.53",
07-Nov-21,Debit Card,00.00,"42,378.22","2,54,269.31",
07-Nov-21,Reversal,00.00,"28,252.15","2,26,017.16",
07-Nov-21,Commission,"13,83,014.00",00.00,"16,09,031.16",
07-Nov-21,Cheque,00.00,"3,21,806.23","12,87,224.93",
07-Nov-21,Cash,00.00,"2,57,444.99","10,29,779.94",
07-Nov-21,NEFT,00.00,"3,43,259.98","6,86,519.96",
07-Nov-21,RTGS,00.00,"6,86,519.96",00.00,
07-Nov-21,Tax,"80,002.59",00.00,"80,002.59",
07-Nov-21,Cheque,06.00,00.00,"80,008.59",
07-Nov-21,Cheque,"15,79,914.25",00.00,"16,59,922.84",
07-Nov-21,Reversal,00.00,"2,07,490.36","14,52,432.48",
07-Nov-21,IMPS,00.00,"2,42,072.08","12,10,360.40",
07-Nov-21,Cheque,113,00.00,"12,10,473.40",
08-Nov-21,Interest,"2,320.00",00.00,"12,12,793.40",
08-Nov-21,RTGS,"3,470.00",00.00,"12,16,263.40",
08-Nov-21,Bill,"7,12,667.00",00.00,"19,28,930.40",
08-Nov-21,Tax,53.66,00.00,"19,28,984.06",
08-Nov-21,ATM,00.00,"4,82,246.02","14,46,738.04",
08-Nov-21,Interest,00.00,"7,23,369.02","7,23,369.02",
08-Nov-21,Transfer,"93,909.70",00.00,"8,17,278.72",
08-Nov-21,Transfer,00.00,"81,727.87","7,35,550.85",
08-Nov-21,Debit Card,00.00,"7,35,550.85",00.00,
08-Nov-21,Transportellaneous,"12,751.95",00.00,"12,751.95",
08-Nov-21,Commission,00.00,"1,275.20","11,476.76",
08-Nov-21,Commission,"4,056.00",00.00,"15,532.76",
08-Nov-21,Purchase,"3,786.42",00.00,"19,319.18",
08-Nov-21,Bill,"20,987.10",00.00,"40,306.28",
08-Nov-21,Debit Card,00.00,"4,030.63","36,275.65",
08-Nov-21,Tax,"1,68,513.20",00.00,"2,04,788.85",
08-Nov-21,ATM,00.00,"40,957.77","1,63,831.08",
08-Nov-21,Reversal,00.00,"1,63,831.08",00.00,
08-Nov-21,Reversal,06.00,00.00,06.00,
08-Nov-21,Tax,"86,980.50",00.00,"86,986.50",
08-Nov-21,RTGS,00.00,"10,873.31","76,113.19",
08-Nov-21,Cheque,00.00,"76,113.19",00.00,
08-Nov-21,Transportellaneous,"9,38,042.00",00.00,"9,38,042.00",
08-Nov-21,Commission,00.00,"1,56,340.33","7,81,701.67",
08-Nov-21,Debit Card,"2,09,963.90",00.00,"9,91,665.57",
08-Nov-21,NEFT,"5,67,529.00",00.00,"15,59,194.57",
08-Nov-21,Interest,00.00,"2,22,742.08","13,36,452.49",
08-Nov-21,Tax,00.00,"6,68,226.25","6,68,226.24",
08-Nov-21,Tax,00.00,"1,33,645.25","5,34,580.99",
08-Nov-21,Interest,00.00,"89,096.83","4,45,484.16",
08-Nov-21,Reversal,00.00,"1,11,371.04","3,34,113.12",
08-Nov-21,Bill,00.00,"3,34,113.12",00.00,
08-Nov-21,ATM,"1,344.80",00.00,"1,344.80",
08-Nov-21,RTGS,00.00,134.48,"1,210.32",
08-Nov-21,RTGS,"2,083.97",00.00,"3,294.29",
08-Nov-21,RTGS,00.00,823.57,"2,470.72",
08-Nov-21,ATM,00.00,274.52,"2,196.20",
08-Nov-21,Tax,00.00,313.74,"1,882.46",
08-Nov-21,Commission,00.00,470.62,"1,411.84",
08-Nov-21,ATM,00.00,"1,411.84",00.00,
08-Nov-21,Transfer,"2,286.08",00.00,"2,286.08",
08-Nov-21,Debit Card,43.49,00.00,"2,329.57",
08-Nov-21,Purchase,00.00,258.84,"2,070.73",
08-Nov-21,Cheque,509.39,00.00,"2,580.12",
08-Nov-21,ATM,00.00,645.03,"1,935.09",
08-Nov-21,Cheque,"19,90,560.00",00.00,"19,92,495.09",
08-Nov-21,Tax,00.00,"4,98,123.77","14,94,371.32",
08-Nov-21,ATM,168,00.00,"14,94,539.32",
08-Nov-21,NEFT,"8,261.00",00.00,"15,02,800.32",
08-Nov-21,Debit Card,00.00,"1,50,280.03","13,52,520.29",
08-Nov-21,Purchase,"2,476.00",00.00,"13,54,996.29",
08-Nov-21,RTGS,00.00,"1,69,374.54","11,85,621.75",
08-Nov-21,Cheque,00.00,"11,85,621.75",00.00,
08-Nov-21,Cash,02.79,00.00,02.79,
08-Nov-21,Interest,00.00,00.47,02.33,
08-Nov-21,RTGS,00.00,00.78,01.55,
08-Nov-21,ATM,00.00,00.31,01.24,
08-Nov-21,Purchase,00.00,00.62,00.62,
08-Nov-21,IMPS,00.00,00.31,00.31,
08-Nov-21,NEFT,31,00.00,31.31,
08-Nov-21,Bill,00.00,03.91,27.4,
08-Nov-21,Cash,"1,244.20",00.00,"1,271.60",
08-Nov-21,Bill,"10,18,840.00",00.00,"10,20,111.60",
08-Nov-21,Transportellaneous,17.92,00.00,"10,20,129.52",
08-Nov-21,Transfer,00.00,"2,55,032.38","7,65,097.14",
08-Nov-21,Tax,"1,21,566.90",00.00,"8,86,664.04",
08-Nov-21,Debit Card,05.69,00.00,"8,86,669.73",
08-Nov-21,Transfer,00.00,"2,95,556.58","5,91,113.15",
08-Nov-21,Tax,"7,649.00",00.00,"5,98,762.15",
08-Nov-21,Cheque,"1,782.25",00.00,"6,00,544.40",
08-Nov-21,Reversal,00.00,"75,068.05","5,25,476.35",
08-Nov-21,Transportellaneous,00.96,00.00,"5,25,477.31",
08-Nov-21,IMPS,00.00,"1,05,095.46","4,20,381.85",
08-Nov-21,ATM,00.00,"46,709.09","3,73,672.76",
08-Nov-21,NEFT,00.00,"1,24,557.59","2,49,115.17",
08-Nov-21,Tax,00.00,"49,823.03","1,99,292.14",
08-Nov-21,RTGS,00.00,"24,911.52","1,74,380.62",
08-Nov-21,Tax,13.3,00.00,"1,74,393.92",
08-Nov-21,Interest,00.00,"34,878.78","1,39,515.14",
08-Nov-21,Cheque,00.00,"17,439.39","1,22,075.75",
08-Nov-21,Cheque,00.00,"17,439.39","1,04,636.36",
08-Nov-21,Transportellaneous,00.00,"13,079.55","91,556.82",
08-Nov-21,IMPS,72.9,00.00,"91,629.72",
08-Nov-21,Cash,36.97,00.00,"91,666.69",
08-Nov-21,Purchase,00.00,"15,277.78","76,388.91",
08-Nov-21,Bill,"72,029.75",00.00,"1,48,418.66",
08-Nov-21,IMPS,04.50,00.00,"1,48,423.16",
08-Nov-21,Transfer,00.00,"29,684.63","1,18,738.53",
08-Nov-21,Debit Card,06.76,00.00,"1,18,745.29",
09-Nov-21,Transfer,"2,304.30",00.00,"1,21,049.59",
09-Nov-21,IMPS,"2,667.00",00.00,"1,23,716.59",
09-Nov-21,Bill,"2,529.40",00.00,"1,26,245.99",
09-Nov-21,RTGS,00.00,"25,249.20","1,00,996.79",
09-Nov-21,Tax,"26,319.56",00.00,"1,27,316.35",
09-Nov-21,ATM,00.00,"18,188.05","1,09,128.30",
09-Nov-21,Reversal,00.00,"15,589.76","93,538.54",
09-Nov-21,Transportellaneous,"6,70,901.20",00.00,"7,64,439.74",
09-Nov-21,Interest,616,00.00,"7,65,055.74",
09-Nov-21,IMPS,00.00,"85,006.19","6,80,049.55",
09-Nov-21,Transfer,"2,571.81",00.00,"6,82,621.36",
09-Nov-21,NEFT,"3,15,064.25",00.00,"9,97,685.61",
09-Nov-21,Interest,13.53,00.00,"9,97,699.14",
09-Nov-21,Debit Card,00.00,"1,66,283.19","8,31,415.95",
09-Nov-21,Transfer,00.00,"8,31,415.95",00.00,
09-Nov-21,Cheque,04.73,00.00,04.73,
09-Nov-21,Commission,"17,886.08",00.00,"17,890.81",
09-Nov-21,Tax,00.00,"17,890.81",00.00,
09-Nov-21,RTGS,493.69,00.00,493.69,
09-Nov-21,Debit Card,00.00,49.37,444.32,
09-Nov-21,ATM,00.00,222.16,222.16,
09-Nov-21,Cheque,"3,840.00",00.00,"4,062.16",
09-Nov-21,Commission,"1,81,378.20",00.00,"1,85,440.36",
09-Nov-21,NEFT,00.00,"37,088.07","1,48,352.29",
09-Nov-21,Transfer,"1,363.00",00.00,"1,49,715.29",
09-Nov-21,Cheque,00.00,"18,714.41","1,31,000.88",
09-Nov-21,Debit Card,00.00,"43,666.96","87,333.92",
09-Nov-21,Purchase,253,00.00,"87,586.92",
09-Nov-21,Cash,00.00,"14,597.82","72,989.10",
09-Nov-21,Cash,"4,08,450.00",00.00,"4,81,439.10",
09-Nov-21,ATM,00.00,"60,179.89","4,21,259.21",
09-Nov-21,Interest,"3,356.10",00.00,"4,24,615.31",
09-Nov-21,RTGS,00.00,"2,12,307.66","2,12,307.66",
09-Nov-21,Cash,"3,606.00",00.00,"2,15,913.66",
09-Nov-21,RTGS,"6,01,378.50",00.00,"8,17,292.16",
09-Nov-21,Cheque,02.00,00.00,"8,17,294.16",
09-Nov-21,ATM,41,00.00,"8,17,335.16",
09-Nov-21,Purchase,00.00,"1,02,166.90","7,15,168.26",
09-Nov-21,ATM,00.00,"79,463.14","6,35,705.12",
09-Nov-21,Tax,"1,04,013.00",00.00,"7,39,718.12",
09-Nov-21,Purchase,"24,778.60",00.00,"7,64,496.72",
09-Nov-21,Interest,00.00,"1,52,899.34","6,11,597.38",
09-Nov-21,Debit Card,120,00.00,"6,11,717.38",
09-Nov-21,Reversal,"1,04,874.03",00.00,"7,16,591.41",
09-Nov-21,RTGS,00.00,"89,573.93","6,27,017.48",
09-Nov-21,ATM,"7,532.21",00.00,"6,34,549.69",
09-Nov-21,Cheque,"11,03,571.50",00.00,"17,38,121.19",
09-Nov-21,Interest,05.00,00.00,"17,38,126.19",
09-Nov-21,Commission,00.00,"1,93,125.13","15,45,001.06",
09-Nov-21,Purchase,448,00.00,"15,45,449.06",
09-Nov-21,Cheque,03.00,00.00,"15,45,452.06",
09-Nov-21,Transportellaneous,00.00,"2,20,778.87","13,24,673.19",
09-Nov-21,RTGS,"1,51,109.00",00.00,"14,75,782.19",
09-Nov-21,Purchase,"13,75,891.80",00.00,"28,51,673.99",
09-Nov-21,IMPS,00.00,"3,16,852.67","25,34,821.32",
09-Nov-21,Interest,"9,864.39",00.00,"25,44,685.71",
09-Nov-21,Debit Card,00.00,"3,63,526.53","21,81,159.18",
09-Nov-21,Cash,00.00,"3,11,594.17","18,69,565.01",
09-Nov-21,RTGS,00.00,"3,73,913.00","14,95,652.01",
09-Nov-21,Commission,00.00,"4,98,550.67","9,97,101.34",
09-Nov-21,Tax,00.00,"9,97,101.34",00.00,
09-Nov-21,Tax,104,00.00,104,
09-Nov-21,Reversal,00.00,104,00.00,
09-Nov-21,Interest,"25,079.91",00.00,"25,079.91",
09-Nov-21,Bill,"2,04,553.10",00.00,"2,29,633.01",
09-Nov-21,NEFT,04.70,00.00,"2,29,637.71",
09-Nov-21,Bill,120,00.00,"2,29,757.71",
09-Nov-21,NEFT,00.00,"2,29,757.71",00.00,
09-Nov-21,Commission,20,00.00,20,
09-Nov-21,NEFT,21,00.00,41,
09-Nov-21,Bill,"13,83,445.50",00.00,"13,83,486.50",
09-Nov-21,Cheque,"8,800.00",00.00,"13,92,286.50",
09-Nov-21,Tax,00.00,"13,92,286.50",00.00,
09-Nov-21,ATM,"16,69,203.00",00.00,"16,69,203.00",
09-Nov-21,NEFT,"26,401.00",00.00,"16,95,604.00",
09-Nov-21,Cheque,"15,37,000.20",00.00,"32,32,604.20",
09-Nov-21,Reversal,"26,276.20",00.00,"32,58,880.40",
09-Nov-21,Transportellaneous,00.00,"4,07,360.05","28,51,520.35",
09-Nov-21,Transportellaneous,00.00,"7,12,880.09","21,38,640.26",
09-Nov-21,NEFT,"86,865.40",00.00,"22,25,505.66",
09-Nov-21,Commission,03.50,00.00,"22,25,509.16",
09-Nov-21,Tax,38.2,00.00,"22,25,547.36",
09-Nov-21,Cash,"17,918.60",00.00,"22,43,465.96",
09-Nov-21,Bill,00.00,"3,73,910.99","18,69,554.97",
09-Nov-21,Debit Card,"6,092.00",00.00,"18,75,646.97",
09-Nov-21,Interest,"83,125.00",00.00,"19,58,771.97",
09-Nov-21,IMPS,00.00,00.00,"19,58,771.97",
09-Nov-21,ATM,00.00,"19,58,771.97",00.00,
09-Nov-21,Transfer,"1,140.20",00.00,"1,140.20",
09-Nov-21,ATM,"2,293.69",00.00,"3,433.89",
09-Nov-21,Cheque,"2,070.00",00.00,"5,503.89",
09-Nov-21,ATM,00.00,550.39,"4,953.50",
09-Nov-21,Transfer,00.00,"1,238.38","3,715.12",
09-Nov-21,Transfer,00.00,928.78,"2,786.34",
09-Nov-21,Tax,00.00,"2,786.34",00.00,
09-Nov-21,Reversal,"1,11,082.91",00.00,"1,11,082.91",
09-Nov-21,NEFT,07.10,00.00,"1,11,090.01",
09-Nov-21,Interest,"10,69,221.00",00.00,"11,80,311.01",
09-Nov-21,Interest,00.00,"3,93,437.00","7,86,874.01",
09-Nov-21,Tax,00.00,"1,96,718.50","5,90,155.51",
09-Nov-21,ATM,282,00.00,"5,90,437.51",
09-Nov-21,Debit Card,00.00,"1,96,812.50","3,93,625.01",
09-Nov-21,Transportellaneous,55.3,00.00,"3,93,680.31",
09-Nov-21,Interest,00.00,"49,210.04","3,44,470.27",
09-Nov-21,Transportellaneous,"1,89,898.88",00.00,"5,34,369.15",
09-Nov-21,RTGS,00.00,"89,061.53","4,45,307.62",
09-Nov-21,Debit Card,01.00,00.00,"4,45,308.62",
09-Nov-21,Commission,07.19,00.00,"4,45,315.81",
09-Nov-21,Commission,00.00,"2,22,657.91","2,22,657.90",
10-Nov-21,Transfer,06.00,00.00,"2,22,663.90",
10-Nov-21,IMPS,00.00,"1,11,331.95","1,11,331.95",
10-Nov-21,NEFT,00.00,"22,266.39","89,065.56",
10-Nov-21,Interest,00.00,"44,532.78","44,532.78",
10-Nov-21,Tax,07.00,00.00,"44,539.78",
10-Nov-21,Cheque,00.00,"44,539.78",00.00,
10-Nov-21,Transportellaneous,"18,497.60",00.00,"18,497.60",
10-Nov-21,Transportellaneous,00.00,"2,312.20","16,185.40",
10-Nov-21,Purchase,00.00,"2,312.20","13,873.20",
10-Nov-21,Bill,07.72,00.00,"13,880.92",
10-Nov-21,IMPS,00.00,"2,776.18","11,104.74",
10-Nov-21,Cash,05.70,00.00,"11,110.44",
10-Nov-21,Cheque,"5,69,206.75",00.00,"5,80,317.19",
10-Nov-21,Commission,"24,247.00",00.00,"6,04,564.19",
10-Nov-21,Cash,"16,32,460.25",00.00,"22,37,024.44",
11-Nov-21,ATM,00.00,"5,59,256.11","16,77,768.33",
11-Nov-21,Transfer,00.00,"4,19,442.08","12,58,326.25",
11-Nov-21,Cash,"1,25,222.00",00.00,"13,83,548.25",
11-Nov-21,Transfer,35.43,00.00,"13,83,583.68",
11-Nov-21,Cheque,00.00,"1,38,358.37","12,45,225.31",
11-Nov-21,Purchase,00.00,"2,49,045.06","9,96,180.25",
11-Nov-21,Tax,"20,22,442.00",00.00,"30,18,622.25",
11-Nov-21,Cheque,"3,71,634.20",00.00,"33,90,256.45",
11-Nov-21,ATM,59,00.00,"33,90,315.45",
11-Nov-21,Transfer,00.00,"11,30,105.15","22,60,210.30",
11-Nov-21,Commission,00.00,"11,30,105.15","11,30,105.15",
11-Nov-21,Purchase,"45,667.00",00.00,"11,75,772.15",
11-Nov-21,Debit Card,00.00,"1,95,962.03","9,79,810.12",
12-Nov-21,ATM,"8,52,098.75",00.00,"18,31,908.87",
12-Nov-21,Cash,54.2,00.00,"18,31,963.07",
12-Nov-21,Interest,05.18,00.00,"18,31,968.25",
12-Nov-21,Transportellaneous,00.00,"3,66,393.65","14,65,574.60",
12-Nov-21,ATM,60,00.00,"14,65,634.60",
12-Nov-21,Cheque,00.00,"1,62,848.29","13,02,786.31",
12-Nov-21,Bill,"3,189.00",00.00,"13,05,975.31",
12-Nov-21,ATM,00.00,"1,63,246.91","11,42,728.40",
12-Nov-21,RTGS,"1,53,241.10",00.00,"12,95,969.50",
12-Nov-21,Reversal,"15,57,590.50",00.00,"28,53,560.00",
12-Nov-21,Bill,00.00,"7,13,390.00","21,40,170.00",
12-Nov-21,Interest,00.00,"21,40,170.00",00.00,
12-Nov-21,Bill,238.7,00.00,238.7,
13-Nov-21,Commission,00.00,59.68,179.02,
13-Nov-21,Transportellaneous,00.00,89.51,89.51,
13-Nov-21,Cheque,44.2,00.00,133.71,
13-Nov-21,Reversal,33.22,00.00,166.93,
13-Nov-21,IMPS,00.00,55.64,111.29,
13-Nov-21,ATM,"19,661.57",00.00,"19,772.86",
13-Nov-21,Transfer,00.00,"2,471.61","17,301.25",
13-Nov-21,Purchase,40,00.00,"17,341.25",
13-Nov-21,Commission,00.00,"17,341.25",00.00,
13-Nov-21,Interest,"61,648.91",00.00,"61,648.91",
13-Nov-21,Transportellaneous,495.5,00.00,"62,144.41",
13-Nov-21,RTGS,00.00,"62,144.41",00.00,
14-Nov-21,Cheque,"1,011.00",00.00,"1,011.00",
14-Nov-21,ATM,00.80,00.00,"1,011.80",
14-Nov-21,RTGS,00.00,126.48,885.32,
14-Nov-21,RTGS,00.00,885.32,00.00,
14-Nov-21,Transfer,"1,589.10",00.00,"1,589.10",
14-Nov-21,ATM,00.00,397.28,"1,191.82",
14-Nov-21,Transfer,00.00,297.96,893.86,
14-Nov-21,ATM,832,00.00,"1,725.86",
14-Nov-21,Reversal,"17,11,448.50",00.00,"17,13,174.36",
14-Nov-21,Purchase,00.00,"2,14,146.80","14,99,027.57",
14-Nov-21,Debit Card,"11,17,586.00",00.00,"26,16,613.57",
14-Nov-21,ATM,00.00,"13,08,306.79","13,08,306.78",
14-Nov-21,Reversal,00.00,"13,08,306.78",00.00,
14-Nov-21,Transportellaneous,00.14,00.00,00.14,
14-Nov-21,Cheque,00.00,00.01,00.13,
14-Nov-21,Tax,22.49,00.00,22.62,
14-Nov-21,Bill,00.00,05.66,16.96,
14-Nov-21,Cash,"12,76,310.20",00.00,"12,76,327.16",
14-Nov-21,ATM,366.35,00.00,"12,76,693.51",
14-Nov-21,Interest,00.00,"2,55,338.70","10,21,354.81",
14-Nov-21,Interest,03.00,00.00,"10,21,357.81",
14-Nov-21,Commission,00.00,"1,02,135.78","9,19,222.03",
14-Nov-21,Commission,00.00,"91,922.20","8,27,299.83",
14-Nov-21,IMPS,03.37,00.00,"8,27,303.20",
14-Nov-21,Cash,"11,994.10",00.00,"8,39,297.30",
14-Nov-21,IMPS,00.00,"4,19,648.65","4,19,648.65",
14-Nov-21,ATM,114.2,00.00,"4,19,762.85",
14-Nov-21,IMPS,156,00.00,"4,19,918.85",
14-Nov-21,Bill,00.00,"59,988.41","3,59,930.44",
14-Nov-21,Reversal,111.9,00.00,"3,60,042.34",
14-Nov-21,RTGS,00.00,"36,004.23","3,24,038.11",
14-Nov-21,Debit Card,00.00,"1,62,019.06","1,62,019.06",
14-Nov-21,Interest,00.00,"18,002.12","1,44,016.94",
14-Nov-21,Reversal,00.00,"14,401.69","1,29,615.25",
14-Nov-21,Commission,14.32,00.00,"1,29,629.57",
14-Nov-21,RTGS,"12,454.00",00.00,"1,42,083.57",
14-Nov-21,Cash,00.00,"47,361.19","94,722.38",
14-Nov-21,RTGS,02.36,00.00,"94,724.74",
14-Nov-21,NEFT,00.00,"10,524.97","84,199.77",
14-Nov-21,NEFT,"21,666.80",00.00,"1,05,866.57",
14-Nov-21,NEFT,06.00,00.00,"1,05,872.57",
14-Nov-21,Cheque,00.00,"11,763.62","94,108.95",
14-Nov-21,Cheque,69.3,00.00,"94,178.25",
14-Nov-21,Reversal,91.78,00.00,"94,270.03",
14-Nov-21,Cash,04.66,00.00,"94,274.69",
14-Nov-21,Cheque,00.00,"9,427.47","84,847.22",
14-Nov-21,Transportellaneous,00.00,"16,969.44","67,877.78",
14-Nov-21,Cheque,"20,27,768.75",00.00,"20,95,646.53",
14-Nov-21,Transportellaneous,00.00,"3,49,274.42","17,46,372.11",
14-Nov-21,Debit Card,01.30,00.00,"17,46,373.41",
14-Nov-21,Debit Card,00.00,"2,49,481.92","14,96,891.49",
14-Nov-21,Tax,00.00,"3,74,222.87","11,22,668.62",
14-Nov-21,ATM,"14,90,977.50",00.00,"26,13,646.12",
14-Nov-21,Tax,00.00,"3,73,378.02","22,40,268.10",
14-Nov-21,IMPS,00.00,"7,46,756.03","14,93,512.07",
14-Nov-21,Debit Card,319,00.00,"14,93,831.07",
15-Nov-21,Reversal,00.00,"1,65,981.23","13,27,849.84",
15-Nov-21,RTGS,60,00.00,"13,27,909.84",
15-Nov-21,Purchase,00.00,"1,89,701.41","11,38,208.43",
15-Nov-21,Cheque,"4,12,178.00",00.00,"15,50,386.43",
15-Nov-21,Bill,00.00,"1,72,265.16","13,78,121.27",
15-Nov-21,ATM,129.9,00.00,"13,78,251.17",
16-Nov-21,RTGS,00.00,"1,72,281.40","12,05,969.77",
16-Nov-21,RTGS,"9,48,484.80",00.00,"21,54,454.57",
16-Nov-21,RTGS,00.00,"5,38,613.64","16,15,840.93",
16-Nov-21,Commission,00.00,"4,03,960.23","12,11,880.70",
16-Nov-21,Transportellaneous,00.00,"4,03,960.23","8,07,920.47",
16-Nov-21,Purchase,"1,32,248.00",00.00,"9,40,168.47",
16-Nov-21,Bill,00.00,"1,88,033.69","7,52,134.78",
16-Nov-21,Cheque,"3,900.00",00.00,"7,56,034.78",
16-Nov-21,Interest,00.00,"1,08,004.97","6,48,029.81",
16-Nov-21,Cheque,00.00,"1,08,004.97","5,40,024.84",
16-Nov-21,Cash,00.00,"1,08,004.97","4,32,019.87",
16-Nov-21,Cheque,00.00,"48,002.21","3,84,017.66",
16-Nov-21,RTGS,00.00,00.00,"3,84,017.66",
16-Nov-21,Transportellaneous,00.00,"54,859.67","3,29,157.99",
16-Nov-21,RTGS,01.40,00.00,"3,29,159.39",
16-Nov-21,Commission,17.6,00.00,"3,29,176.99",
16-Nov-21,Interest,00.00,"1,64,588.50","1,64,588.50",
16-Nov-21,RTGS,"47,458.09",00.00,"2,12,046.59",
16-Nov-21,Tax,01.49,00.00,"2,12,048.08",
16-Nov-21,RTGS,47.02,00.00,"2,12,095.10",
16-Nov-21,ATM,00.00,"42,419.02","1,69,676.08",
16-Nov-21,Debit Card,00.50,00.00,"1,69,676.58",
16-Nov-21,Reversal,00.00,"84,838.29","84,838.29",
16-Nov-21,ATM,00.00,"8,483.83","76,354.46",
16-Nov-21,IMPS,00.00,"19,088.62","57,265.84",
16-Nov-21,Debit Card,00.00,"5,726.58","51,539.26",
16-Nov-21,IMPS,"1,455.60",00.00,"52,994.86",
16-Nov-21,RTGS,00.00,"13,248.72","39,746.15",
16-Nov-21,Interest,00.00,"5,678.02","34,068.13",
16-Nov-21,Purchase,00.00,"11,356.04","22,712.09",
16-Nov-21,RTGS,00.00,"4,542.42","18,169.67",
16-Nov-21,Cash,00.00,"18,169.67",00.00,
16-Nov-21,Tax,"2,59,051.10",00.00,"2,59,051.10",
16-Nov-21,Cheque,47.8,00.00,"2,59,098.90",
16-Nov-21,Transportellaneous,00.00,"32,387.36","2,26,711.54",
16-Nov-21,Interest,00.00,"75,570.51","1,51,141.03",
16-Nov-21,Tax,"2,589.00",00.00,"1,53,730.03",
16-Nov-21,Bill,52.1,00.00,"1,53,782.13",
16-Nov-21,Cash,366,00.00,"1,54,148.13",
16-Nov-21,Interest,00.00,"17,127.57","1,37,020.56",
16-Nov-21,Transfer,05.80,00.00,"1,37,026.36",
16-Nov-21,Cash,00.00,"22,837.73","1,14,188.63",
16-Nov-21,Transfer,"2,125.19",00.00,"1,16,313.82",
16-Nov-21,ATM,00.00,"23,262.76","93,051.06",
16-Nov-21,Debit Card,00.00,"10,339.01","82,712.05",
16-Nov-21,Cheque,03.55,00.00,"82,715.60",
16-Nov-21,Reversal,05.00,00.00,"82,720.60",
17-Nov-21,Interest,00.00,"10,340.08","72,380.53",
17-Nov-21,Cheque,331,00.00,"72,711.53",
17-Nov-21,Purchase,"24,372.64",00.00,"97,084.17",
17-Nov-21,Purchase,00.00,"9,708.42","87,375.75",
17-Nov-21,Debit Card,05.03,00.00,"87,380.78",
17-Nov-21,ATM,00.00,"87,380.78",00.00,
17-Nov-21,Transportellaneous,"1,53,660.00",00.00,"1,53,660.00",
17-Nov-21,RTGS,02.00,00.00,"1,53,662.00",
17-Nov-21,ATM,00.00,"21,951.71","1,31,710.29",
17-Nov-21,Bill,22.22,00.00,"1,31,732.51",
17-Nov-21,Transfer,00.00,"14,636.95","1,17,095.56",
17-Nov-21,Tax,00.00,"14,636.95","1,02,458.62",
17-Nov-21,Transfer,"1,22,296.53",00.00,"2,24,755.15",
17-Nov-21,Purchase,230.26,00.00,"2,24,985.41",
17-Nov-21,Purchase,00.00,"22,498.54","2,02,486.87",
17-Nov-21,Cheque,00.00,"50,621.72","1,51,865.15",
17-Nov-21,IMPS,"15,700.00",00.00,"1,67,565.15",
17-Nov-21,Commission,00.00,"33,513.03","1,34,052.12",
17-Nov-21,Commission,00.00,"16,756.52","1,17,295.60",
17-Nov-21,Reversal,"2,704.00",00.00,"1,19,999.60",
17-Nov-21,Cash,02.20,00.00,"1,20,001.80",
17-Nov-21,Tax,00.00,"1,20,001.80",00.00,
17-Nov-21,IMPS,24.4,00.00,24.4,
17-Nov-21,Purchase,00.00,02.44,21.96,
17-Nov-21,NEFT,"1,31,169.66",00.00,"1,31,191.62",
17-Nov-21,Transfer,00.00,"18,741.66","1,12,449.96",
17-Nov-21,Cheque,00.00,"18,741.66","93,708.30",
17-Nov-21,Commission,00.00,"10,412.03","83,296.27",
17-Nov-21,IMPS,198.13,00.00,"83,494.40",
17-Nov-21,Interest,00.00,"13,915.73","69,578.67",
17-Nov-21,Cheque,00.00,"23,192.89","46,385.78",
17-Nov-21,IMPS,"11,14,516.00",00.00,"11,60,901.78",
17-Nov-21,Interest,981.85,00.00,"11,61,883.63",
17-Nov-21,Interest,00.00,"1,45,235.45","10,16,648.18",
17-Nov-21,Cheque,00.00,"2,03,329.64","8,13,318.54",
17-Nov-21,NEFT,"13,95,726.50",00.00,"22,09,045.04",
17-Nov-21,Transfer,00.00,"2,20,904.50","19,88,140.54",
17-Nov-21,Transportellaneous,00.00,"19,88,140.54",00.00,
17-Nov-21,Commission,21.2,00.00,21.2,
17-Nov-21,Reversal,00.00,10.6,10.6,
17-Nov-21,RTGS,"15,035.39",00.00,"15,045.99",
17-Nov-21,Transportellaneous,63.4,00.00,"15,109.39",
17-Nov-21,Purchase,00.00,"15,109.39",00.00,
17-Nov-21,Bill,362,00.00,362,
18-Nov-21,Reversal,21,00.00,383,
18-Nov-21,Tax,04.90,00.00,387.9,
18-Nov-21,Interest,487,00.00,874.9,
18-Nov-21,Transfer,"1,68,255.50",00.00,"1,69,130.40",
18-Nov-21,Bill,01.00,00.00,"1,69,131.40",
18-Nov-21,Interest,00.00,"16,913.14","1,52,218.26",
18-Nov-21,Cash,00.00,"50,739.42","1,01,478.84",
18-Nov-21,Debit Card,00.00,"11,275.43","90,203.41",
18-Nov-21,Bill,735.6,00.00,"90,939.01",
18-Nov-21,Commission,00.00,"22,734.75","68,204.26",
18-Nov-21,RTGS,00.00,"11,367.38","56,836.88",
18-Nov-21,Commission,00.00,"7,104.61","49,732.27",
18-Nov-21,Cash,00.00,"7,104.61","42,627.66",
18-Nov-21,Cash,00.00,"10,656.92","31,970.75",
18-Nov-21,Tax,53.57,00.00,"32,024.32",
19-Nov-21,Purchase,01.20,00.00,"32,025.52",
19-Nov-21,Debit Card,00.00,"8,006.38","24,019.14",
19-Nov-21,Debit Card,344,00.00,"24,363.14",
19-Nov-21,Tax,00.00,"3,045.39","21,317.75",
19-Nov-21,Purchase,00.00,"2,368.64","18,949.11",
19-Nov-21,Purchase,185.5,00.00,"19,134.61",
19-Nov-21,Purchase,00.00,"6,378.20","12,756.41",
19-Nov-21,Commission,00.00,"1,275.64","11,480.77",
19-Nov-21,Tax,00.00,"11,480.77",00.00,
19-Nov-21,Interest,04.97,00.00,04.97,
19-Nov-21,Cheque,02.20,00.00,07.17,
19-Nov-21,Cash,"1,39,213.47",00.00,"1,39,220.64",
19-Nov-21,Interest,00.00,"34,805.16","1,04,415.48",
19-Nov-21,Interest,00.00,"52,207.74","52,207.74",
19-Nov-21,Cheque,00.00,"5,220.77","46,986.97",
19-Nov-21,RTGS,134.76,00.00,"47,121.73",
19-Nov-21,Reversal,01.00,00.00,"47,122.73",
19-Nov-21,Commission,00.00,"6,731.82","40,390.91",
19-Nov-21,Transfer,00.00,"40,390.91",00.00,
19-Nov-21,Transportellaneous,66,00.00,66,
19-Nov-21,ATM,00.00,11,55,
20-Nov-21,Cheque,00.00,05.50,49.5,
20-Nov-21,Cheque,00.00,49.5,00.00,
20-Nov-21,Purchase,"20,40,164.80",00.00,"20,40,164.80",
20-Nov-21,IMPS,19,00.00,"20,40,183.80",
20-Nov-21,Transfer,47,00.00,"20,40,230.80",
20-Nov-21,Tax,00.00,"10,20,115.40","10,20,115.40",
20-Nov-21,Commission,496,00.00,"10,20,611.40",
20-Nov-21,Transportellaneous,"3,647.09",00.00,"10,24,258.49",
20-Nov-21,Transportellaneous,00.00,"10,24,258.49",00.00,
20-Nov-21,Transportellaneous,03.00,00.00,03.00,
20-Nov-21,Cheque,00.00,01.50,01.50,
20-Nov-21,Transportellaneous,10.5,00.00,12,
20-Nov-21,Cash,00.00,04.00,08.00,
20-Nov-21,Cheque,00.00,08.00,00.00,
20-Nov-21,Tax,48.05,00.00,48.05,
20-Nov-21,IMPS,"2,69,380.00",00.00,"2,69,428.05",
20-Nov-21,Reversal,00.00,"26,942.81","2,42,485.24",
20-Nov-21,Debit Card,"26,759.20",00.00,"2,69,244.44",
20-Nov-21,Purchase,00.00,"2,69,244.44",00.00,
20-Nov-21,RTGS,"15,89,438.50",00.00,"15,89,438.50",
20-Nov-21,Cheque,00.00,"5,29,812.83","10,59,625.67",
20-Nov-21,Cash,03.44,00.00,"10,59,629.11",
20-Nov-21,Bill,00.00,"2,11,925.82","8,47,703.29",
20-Nov-21,Commission,00.00,"2,82,567.76","5,65,135.53",
20-Nov-21,Tax,"1,02,465.00",00.00,"6,67,600.53",
20-Nov-21,Interest,"3,150.50",00.00,"6,70,751.03",
20-Nov-21,Purchase,00.00,"2,23,583.68","4,47,167.35",
20-Nov-21,Debit Card,"8,88,980.50",00.00,"13,36,147.85",
20-Nov-21,Purchase,00.00,"6,68,073.93","6,68,073.93",
20-Nov-21,ATM,00.00,"3,34,036.97","3,34,036.97",
20-Nov-21,Transportellaneous,763.77,00.00,"3,34,800.74",
20-Nov-21,NEFT,"1,11,229.94",00.00,"4,46,030.68",
20-Nov-21,RTGS,"9,55,311.00",00.00,"14,01,341.68",
20-Nov-21,Tax,00.00,"1,75,167.71","12,26,173.97",
20-Nov-21,Transfer,00.00,"1,75,167.71","10,51,006.26",
21-Nov-21,IMPS,00.00,"10,51,006.26",00.00,
21-Nov-21,RTGS,"1,77,678.28",00.00,"1,77,678.28",
22-Nov-21,Debit Card,"92,096.50",00.00,"2,69,774.78",
22-Nov-21,Cheque,00.00,"53,954.96","2,15,819.82",
22-Nov-21,Tax,790.76,00.00,"2,16,610.58",
22-Nov-21,Purchase,"96,250.70",00.00,"3,12,861.28",
22-Nov-21,IMPS,"2,331.47",00.00,"3,15,192.75",
22-Nov-21,Transfer,150.1,00.00,"3,15,342.85",
22-Nov-21,Commission,41,00.00,"3,15,383.85",
22-Nov-21,Commission,05.00,00.00,"3,15,388.85",
22-Nov-21,ATM,264.3,00.00,"3,15,653.15",
22-Nov-21,Commission,00.00,"3,15,653.15",00.00,
22-Nov-21,Cash,"69,811.40",00.00,"69,811.40",
22-Nov-21,RTGS,"20,890.00",00.00,"90,701.40",
22-Nov-21,Cash,"66,228.60",00.00,"1,56,930.00",
22-Nov-21,Transportellaneous,00.00,"31,386.00","1,25,544.00",
22-Nov-21,Cash,"2,699.50",00.00,"1,28,243.50",
22-Nov-21,Commission,00.00,"64,121.75","64,121.75",
22-Nov-21,Tax,00.00,"21,373.92","42,747.83",
22-Nov-21,Debit Card,00.00,"5,343.48","37,404.35",
22-Nov-21,Reversal,00.00,"5,343.48","32,060.87",
22-Nov-21,Cheque,00.00,"32,060.87",00.00,
22-Nov-21,Bill,405.4,00.00,405.4,
22-Nov-21,RTGS,409.77,00.00,815.17,
22-Nov-21,NEFT,00.00,116.45,698.72,
22-Nov-21,Reversal,"21,664.57",00.00,"22,363.29",
22-Nov-21,Transfer,04.80,00.00,"22,368.09",
22-Nov-21,IMPS,447.54,00.00,"22,815.63",
22-Nov-21,Transfer,"1,30,600.90",00.00,"1,53,416.53",
22-Nov-21,RTGS,"18,061.11",00.00,"1,71,477.64",
22-Nov-21,ATM,"2,667.00",00.00,"1,74,144.64",
22-Nov-21,Purchase,00.00,"1,74,144.64",00.00,
22-Nov-21,Reversal,"11,04,194.00",00.00,"11,04,194.00",
22-Nov-21,Tax,00.00,"1,38,024.25","9,66,169.75",
22-Nov-21,Reversal,"2,433.43",00.00,"9,68,603.18",
22-Nov-21,Transportellaneous,423,00.00,"9,69,026.18",
22-Nov-21,Interest,00.00,"2,42,256.55","7,26,769.64",
22-Nov-21,Transportellaneous,00.00,"1,45,353.93","5,81,415.71",
22-Nov-21,Cash,360,00.00,"5,81,775.71",
22-Nov-21,ATM,00.00,"1,45,443.93","4,36,331.78",
23-Nov-21,Reversal,"89,091.10",00.00,"5,25,422.88",
23-Nov-21,ATM,02.98,00.00,"5,25,425.86",
23-Nov-21,IMPS,"23,185.30",00.00,"5,48,611.16",
23-Nov-21,Interest,"82,181.72",00.00,"6,30,792.88",
23-Nov-21,RTGS,493.4,00.00,"6,31,286.28",
23-Nov-21,Cheque,00.00,"2,10,428.76","4,20,857.52",
23-Nov-21,Transportellaneous,00.00,"1,40,285.84","2,80,571.68",
23-Nov-21,Commission,00.00,"2,80,571.68",00.00,
23-Nov-21,ATM,03.71,00.00,03.71,
23-Nov-21,Tax,"12,69,334.00",00.00,"12,69,337.71",
23-Nov-21,Bill,00.00,"1,81,333.96","10,88,003.75",
23-Nov-21,Tax,146,00.00,"10,88,149.75",
23-Nov-21,Tax,00.00,"3,62,716.58","7,25,433.17",
23-Nov-21,Interest,00.00,"90,679.15","6,34,754.02",
23-Nov-21,Bill,"23,682.80",00.00,"6,58,436.82",
23-Nov-21,Debit Card,"1,63,341.00",00.00,"8,21,777.82",
23-Nov-21,Transfer,00.00,"1,36,962.97","6,84,814.85",
23-Nov-21,RTGS,00.00,"76,090.54","6,08,724.31",
23-Nov-21,Debit Card,01.59,00.00,"6,08,725.90",
23-Nov-21,Transfer,"2,46,839.00",00.00,"8,55,564.90",
23-Nov-21,Debit Card,00.00,"1,42,594.15","7,12,970.75",
23-Nov-21,Transportellaneous,00.00,"71,297.08","6,41,673.68",
23-Nov-21,RTGS,00.00,"1,06,945.61","5,34,728.07",
23-Nov-21,Transportellaneous,"2,52,021.60",00.00,"7,86,749.67",
23-Nov-21,Tax,"10,286.40",00.00,"7,97,036.07",
24-Nov-21,IMPS,388.1,00.00,"7,97,424.17",
24-Nov-21,Interest,00.00,"1,13,917.74","6,83,506.43",
24-Nov-21,IMPS,00.00,"85,438.30","5,98,068.13",
24-Nov-21,Transportellaneous,10.5,00.00,"5,98,078.63",
24-Nov-21,Transfer,00.00,"5,98,078.63",00.00,
24-Nov-21,Transportellaneous,258,00.00,258,
24-Nov-21,Cash,00.00,129,129,
24-Nov-21,Transportellaneous,00.00,129,00.00,
24-Nov-21,NEFT,103.2,00.00,103.2,
24-Nov-21,NEFT,00.00,20.64,82.56,
24-Nov-21,IMPS,"1,443.00",00.00,"1,525.56",
24-Nov-21,Cash,00.00,152.56,"1,373.00",
24-Nov-21,Purchase,00.00,196.14,"1,176.86",
24-Nov-21,Bill,00.00,168.12,"1,008.74",
24-Nov-21,Reversal,00.00,201.75,806.99,
24-Nov-21,Tax,00.00,80.7,726.29,
24-Nov-21,Cash,03.00,00.00,729.29,
24-Nov-21,Transfer,00.00,364.65,364.64,
24-Nov-21,Transfer,"1,97,977.47",00.00,"1,98,342.11",
24-Nov-21,Transportellaneous,00.00,"19,834.21","1,78,507.90",
24-Nov-21,IMPS,"8,30,161.20",00.00,"10,08,669.10",
24-Nov-21,NEFT,00.00,"2,52,167.28","7,56,501.82",
24-Nov-21,Debit Card,00.00,"1,51,300.36","6,05,201.46",
25-Nov-21,Transfer,00.00,"86,457.35","5,18,744.11",
25-Nov-21,ATM,00.00,"86,457.35","4,32,286.76",
25-Nov-21,RTGS,00.00,"61,755.25","3,70,531.51",
25-Nov-21,Tax,569.4,00.00,"3,71,100.91",
25-Nov-21,RTGS,817.98,00.00,"3,71,918.89",
25-Nov-21,Purchase,"13,033.86",00.00,"3,84,952.75",
25-Nov-21,ATM,01.00,00.00,"3,84,953.75",
25-Nov-21,Reversal,04.60,00.00,"3,84,958.35",
25-Nov-21,RTGS,01.04,00.00,"3,84,959.39",
25-Nov-21,IMPS,00.00,"96,239.85","2,88,719.54",
25-Nov-21,IMPS,02.44,00.00,"2,88,721.98",
25-Nov-21,Reversal,487.8,00.00,"2,89,209.78",
25-Nov-21,Transfer,00.00,"72,302.45","2,16,907.34",
25-Nov-21,Cash,"3,634.30",00.00,"2,20,541.64",
25-Nov-21,Purchase,46.4,00.00,"2,20,588.04",
25-Nov-21,IMPS,00.00,"73,529.35","1,47,058.69",
25-Nov-21,Tax,"12,419.13",00.00,"1,59,477.82",
25-Nov-21,Commission,"2,26,356.00",00.00,"3,85,833.82",
25-Nov-21,Bill,193.63,00.00,"3,86,027.45",
25-Nov-21,NEFT,57.33,00.00,"3,86,084.78",
25-Nov-21,Commission,00.00,"3,86,084.78",00.00,
25-Nov-21,RTGS,"7,88,803.20",00.00,"7,88,803.20",
25-Nov-21,Cheque,00.00,"3,94,401.60","3,94,401.60",
25-Nov-21,Transportellaneous,00.00,"78,880.32","3,15,521.28",
26-Nov-21,RTGS,400.63,00.00,"3,15,921.91",
26-Nov-21,Interest,00.00,00.00,"3,15,921.91",
27-Nov-21,Purchase,36.92,00.00,"3,15,958.83",
27-Nov-21,Transportellaneous,"3,756.90",00.00,"3,19,715.73",
27-Nov-21,RTGS,"76,487.20",00.00,"3,96,202.93",
27-Nov-21,Tax,"2,564.20",00.00,"3,98,767.13",
27-Nov-21,Purchase,00.00,"44,307.46","3,54,459.67",
27-Nov-21,NEFT,00.00,"1,77,229.84","1,77,229.84",
27-Nov-21,Debit Card,00.00,"17,722.98","1,59,506.86",
27-Nov-21,Tax,00.00,"39,876.72","1,19,630.14",
27-Nov-21,Bill,00.00,"13,292.24","1,06,337.90",
27-Nov-21,Cheque,14,00.00,"1,06,351.90",
27-Nov-21,Interest,"85,802.00",00.00,"1,92,153.90",
27-Nov-21,Transfer,332.13,00.00,"1,92,486.03",
27-Nov-21,Debit Card,00.00,"64,162.01","1,28,324.02",
27-Nov-21,ATM,"5,087.45",00.00,"1,33,411.47",
27-Nov-21,Transfer,00.00,"16,676.43","1,16,735.04",
27-Nov-21,NEFT,"1,721.40",00.00,"1,18,456.44",
27-Nov-21,Purchase,140.09,00.00,"1,18,596.53",
27-Nov-21,IMPS,992,00.00,"1,19,588.53",
27-Nov-21,Tax,00.00,"17,084.08","1,02,504.45",
27-Nov-21,Reversal,00.00,"12,813.06","89,691.39",
27-Nov-21,Debit Card,00.00,"44,845.70","44,845.70",
27-Nov-21,Reversal,"12,66,083.00",00.00,"13,10,928.70",
27-Nov-21,Commission,911,00.00,"13,11,839.70",
27-Nov-21,RTGS,00.00,"6,55,919.85","6,55,919.85",
27-Nov-21,NEFT,183.1,00.00,"6,56,102.95",
27-Nov-21,IMPS,"14,55,989.80",00.00,"21,12,092.75",
27-Nov-21,Bill,"3,741.50",00.00,"21,15,834.25",
27-Nov-21,Interest,20,00.00,"21,15,854.25",
27-Nov-21,Debit Card,00.00,"3,52,642.38","17,63,211.88",
27-Nov-21,Tax,00.00,"2,20,401.49","15,42,810.40",
27-Nov-21,RTGS,"26,113.85",00.00,"15,68,924.25",
27-Nov-21,Purchase,00.00,"2,61,487.38","13,07,436.88",
27-Nov-21,Cheque,00.00,"1,63,429.61","11,44,007.27",
27-Nov-21,Debit Card,00.00,"1,90,667.88","9,53,339.39",
27-Nov-21,Transportellaneous,"45,874.20",00.00,"9,99,213.59",
27-Nov-21,RTGS,112.9,00.00,"9,99,326.49",
27-Nov-21,Cheque,00.00,"1,11,036.28","8,88,290.21",
27-Nov-21,NEFT,02.50,00.00,"8,88,292.71",
27-Nov-21,Cheque,00.00,"8,88,292.71",00.00,
27-Nov-21,Commission,753.3,00.00,753.3,
27-Nov-21,Cash,00.00,188.33,564.97,
27-Nov-21,Transfer,00.00,56.5,508.47,
27-Nov-21,Tax,"13,41,095.50",00.00,"13,41,603.97",
27-Nov-21,ATM,00.00,"2,68,320.79","10,73,283.18",
27-Nov-21,Transfer,00.00,"1,78,880.53","8,94,402.65",
27-Nov-21,Purchase,00.00,"89,440.27","8,04,962.38",
27-Nov-21,Cheque,00.00,"89,440.26","7,15,522.12",
27-Nov-21,Transfer,00.00,"1,19,253.69","5,96,268.43",
27-Nov-21,Transfer,20.3,00.00,"5,96,288.73",
27-Nov-21,RTGS,179,00.00,"5,96,467.73",
27-Nov-21,Tax,00.00,"74,558.47","5,21,909.26",
27-Nov-21,ATM,00.00,"1,73,969.75","3,47,939.51",
27-Nov-21,IMPS,"1,736.10",00.00,"3,49,675.61",
27-Nov-21,Tax,427.11,00.00,"3,50,102.72",
27-Nov-21,ATM,00.00,"1,16,700.91","2,33,401.81",
27-Nov-21,Debit Card,00.00,"33,343.12","2,00,058.69",
27-Nov-21,Reversal,50.98,00.00,"2,00,109.67",
27-Nov-21,ATM,31.85,00.00,"2,00,141.52",
27-Nov-21,IMPS,"91,530.40",00.00,"2,91,671.92",
27-Nov-21,Transfer,00.00,"1,45,835.96","1,45,835.96",
27-Nov-21,Purchase,"1,38,779.62",00.00,"2,84,615.58",
27-Nov-21,Reversal,16,00.00,"2,84,631.58",
27-Nov-21,IMPS,"1,87,353.81",00.00,"4,71,985.39",
27-Nov-21,Cash,305.04,00.00,"4,72,290.43",
27-Nov-21,NEFT,180,00.00,"4,72,470.43",
27-Nov-21,Cash,00.00,"1,18,117.61","3,54,352.82",
27-Nov-21,ATM,"6,40,234.00",00.00,"9,94,586.82",
27-Nov-21,Purchase,00.00,"99,458.68","8,95,128.14",
27-Nov-21,Bill,00.00,"4,47,564.07","4,47,564.07",
27-Nov-21,Transfer,00.00,"55,945.51","3,91,618.56",
27-Nov-21,Bill,48.08,00.00,"3,91,666.64",
27-Nov-21,ATM,00.00,"48,958.33","3,42,708.31",
27-Nov-21,Bill,00.00,"34,270.83","3,08,437.48",
28-Nov-21,Debit Card,"2,755.22",00.00,"3,11,192.70",
28-Nov-21,Transfer,00.00,"34,576.97","2,76,615.73",
28-Nov-21,Commission,"11,65,631.20",00.00,"14,42,246.93",
28-Nov-21,Bill,00.00,"1,60,249.66","12,81,997.27",
28-Nov-21,Commission,00.00,"4,27,332.42","8,54,664.85",
28-Nov-21,Cash,"64,671.30",00.00,"9,19,336.15",
28-Nov-21,ATM,00.00,"1,31,333.74","7,88,002.41",
28-Nov-21,Bill,762,00.00,"7,88,764.41",
28-Nov-21,Transfer,762.5,00.00,"7,89,526.91",
28-Nov-21,Commission,"2,345.00",00.00,"7,91,871.91",
28-Nov-21,Debit Card,159.09,00.00,"7,92,031.00",
28-Nov-21,Transportellaneous,00.00,"1,58,406.20","6,33,624.80",
28-Nov-21,Cash,00.00,"79,203.10","5,54,421.70",
28-Nov-21,Purchase,"10,039.00",00.00,"5,64,460.70",
28-Nov-21,RTGS,"11,381.63",00.00,"5,75,842.33",
28-Nov-21,NEFT,00.00,"1,43,960.58","4,31,881.75",
28-Nov-21,Interest,"1,17,157.75",00.00,"5,49,039.50",
28-Nov-21,Transportellaneous,00.00,"5,49,039.50",00.00,
28-Nov-21,Debit Card,"23,120.00",00.00,"23,120.00",
28-Nov-21,Cheque,00.00,"2,568.89","20,551.11",
28-Nov-21,IMPS,35,00.00,"20,586.11",
28-Nov-21,Commission,00.00,"6,862.04","13,724.07",
28-Nov-21,Debit Card,"18,76,302.00",00.00,"18,90,026.07",
28-Nov-21,Reversal,00.00,"9,45,013.04","9,45,013.04",
28-Nov-21,Cash,236,00.00,"9,45,249.04",
28-Nov-21,Reversal,27.69,00.00,"9,45,276.73",
28-Nov-21,Purchase,00.00,"1,57,546.12","7,87,730.61",
28-Nov-21,Transfer,00.00,"1,31,288.44","6,56,442.18",
28-Nov-21,Cheque,00.00,"2,18,814.06","4,37,628.12",
28-Nov-21,Cash,00.00,"54,703.52","3,82,924.60",
28-Nov-21,Tax,00.00,"54,703.51","3,28,221.09",
28-Nov-21,Reversal,273.1,00.00,"3,28,494.19",
28-Nov-21,NEFT,15,00.00,"3,28,509.19",
28-Nov-21,Purchase,00.00,"36,501.02","2,92,008.17",
28-Nov-21,Purchase,00.00,"36,501.02","2,55,507.15",
28-Nov-21,Interest,00.00,"28,389.68","2,27,117.47",
29-Nov-21,Bill,"3,065.10",00.00,"2,30,182.57",
29-Nov-21,Commission,345.96,00.00,"2,30,528.53",
29-Nov-21,Interest,00.00,"57,632.13","1,72,896.40",
29-Nov-21,Transportellaneous,00.00,"24,699.49","1,48,196.91",
29-Nov-21,Interest,00.00,00.00,"1,48,196.91",
29-Nov-21,Commission,"1,91,261.70",00.00,"3,39,458.61",
29-Nov-21,Cash,00.00,"56,576.44","2,82,882.18",
29-Nov-21,Tax,00.00,"35,360.27","2,47,521.91",
29-Nov-21,Transfer,117,00.00,"2,47,638.91",
29-Nov-21,Purchase,00.00,"2,47,638.91",00.00,
29-Nov-21,NEFT,"2,20,544.03",00.00,"2,20,544.03",
29-Nov-21,Debit Card,"28,565.53",00.00,"2,49,109.56",
29-Nov-21,Tax,"2,49,534.00",00.00,"4,98,643.56",
29-Nov-21,Cheque,"18,85,955.50",00.00,"23,84,599.06",
29-Nov-21,Interest,00.00,"3,40,657.01","20,43,942.05",
29-Nov-21,Cash,"1,168.28",00.00,"20,45,110.33",
29-Nov-21,Tax,00.00,"4,09,022.07","16,36,088.26",
29-Nov-21,Tax,00.00,"5,45,362.75","10,90,725.51",
29-Nov-21,Purchase,110,00.00,"10,90,835.51",
29-Nov-21,Tax,"30,373.00",00.00,"11,21,208.51",
29-Nov-21,Cheque,03.90,00.00,"11,21,212.41",
29-Nov-21,Reversal,00.00,"2,80,303.10","8,40,909.31",
29-Nov-21,NEFT,"22,587.00",00.00,"8,63,496.31",
29-Nov-21,Commission,00.00,"1,23,356.62","7,40,139.69",
29-Nov-21,NEFT,00.00,"1,23,356.62","6,16,783.07",
30-Nov-21,IMPS,471,00.00,"6,17,254.07",
30-Nov-21,Transportellaneous,"3,625.00",00.00,"6,20,879.07",
30-Nov-21,Transfer,00.00,"77,609.88","5,43,269.19",
30-Nov-21,Debit Card,00.00,"1,35,817.30","4,07,451.89",
30-Nov-21,Transportellaneous,"48,085.94",00.00,"4,55,537.83",
01-Dec-21,ATM,00.00,"65,076.83","3,90,461.00",
01-Dec-21,Transfer,00.00,"78,092.20","3,12,368.80",
01-Dec-21,Interest,00.00,"1,04,122.93","2,08,245.87",
01-Dec-21,Reversal,452.1,00.00,"2,08,697.97",
01-Dec-21,ATM,03.93,00.00,"2,08,701.90",
01-Dec-21,Reversal,00.00,"52,175.48","1,56,526.42",
01-Dec-21,Cash,00.00,"1,56,526.42",00.00,
01-Dec-21,Cash,"2,313.00",00.00,"2,313.00",
01-Dec-21,Commission,00.00,257,"2,056.00",
01-Dec-21,IMPS,"11,926.70",00.00,"13,982.70",
01-Dec-21,Cheque,00.00,"2,796.54","11,186.16",
01-Dec-21,Cheque,00.00,"3,728.72","7,457.44",
01-Dec-21,NEFT,00.00,745.74,"6,711.70",
01-Dec-21,NEFT,00.00,"1,342.34","5,369.36",
01-Dec-21,Tax,00.00,"1,073.87","4,295.49",
01-Dec-21,RTGS,32.9,00.00,"4,328.39",
01-Dec-21,Bill,52,00.00,"4,380.39",
01-Dec-21,IMPS,05.00,00.00,"4,385.39",
01-Dec-21,Interest,00.00,626.48,"3,758.91",
01-Dec-21,Interest,00.00,939.73,"2,819.18",
01-Dec-21,NEFT,00.00,704.8,"2,114.38",
01-Dec-21,Cash,"1,597.00",00.00,"3,711.38",
01-Dec-21,Transportellaneous,00.00,927.85,"2,783.54",
01-Dec-21,Interest,00.00,397.65,"2,385.89",
01-Dec-21,RTGS,"63,116.16",00.00,"65,502.05",
01-Dec-21,Transfer,"83,763.40",00.00,"1,49,265.45",
01-Dec-21,Cash,00.00,"37,316.36","1,11,949.09",
01-Dec-21,Cheque,00.00,"12,438.79","99,510.30",
01-Dec-21,Commission,00.00,"99,510.30",00.00,
01-Dec-21,Commission,143.92,00.00,143.92,
01-Dec-21,RTGS,00.00,143.92,00.00,
01-Dec-21,Transfer,46.97,00.00,46.97,
01-Dec-21,Purchase,00.00,23.49,23.48,
01-Dec-21,NEFT,00.00,11.74,11.74,
01-Dec-21,Transportellaneous,00.00,02.35,09.39,
02-Dec-21,Purchase,00.00,01.34,08.05,
02-Dec-21,Cash,00.00,01.01,07.04,
02-Dec-21,Debit Card,00.00,02.35,04.69,
02-Dec-21,Interest,00.00,00.47,04.22,
03-Dec-21,IMPS,00.00,02.11,02.11,
03-Dec-21,Transfer,454,00.00,456.11,
04-Dec-21,Tax,434.47,00.00,890.58,
04-Dec-21,Cash,00.00,98.95,791.63,
04-Dec-21,Interest,"2,769.00",00.00,"3,560.63",
04-Dec-21,Debit Card,00.00,890.16,"2,670.47",
04-Dec-21,Cash,355.69,00.00,"3,026.16",
04-Dec-21,Purchase,00.00,378.27,"2,647.89",
04-Dec-21,Transportellaneous,352.1,00.00,"2,999.99",
04-Dec-21,Purchase,07.01,00.00,"3,007.00",
04-Dec-21,Tax,00.00,601.4,"2,405.60",
04-Dec-21,IMPS,"1,153.50",00.00,"3,559.10",
04-Dec-21,Bill,00.00,711.82,"2,847.28",
04-Dec-21,ATM,"3,746.00",00.00,"6,593.28",
04-Dec-21,Reversal,"6,35,656.00",00.00,"6,42,249.28",
04-Dec-21,Transportellaneous,00.00,"1,28,449.86","5,13,799.42",
04-Dec-21,Cash,19.02,00.00,"5,13,818.44",
04-Dec-21,Transportellaneous,00.00,"51,381.84","4,62,436.60",
04-Dec-21,Debit Card,"6,18,355.00",00.00,"10,80,791.60",
04-Dec-21,ATM,00.00,"1,80,131.93","9,00,659.67",
04-Dec-21,Cash,"1,854.00",00.00,"9,02,513.67",
04-Dec-21,Transportellaneous,00.00,"1,00,279.30","8,02,234.37",
04-Dec-21,Transportellaneous,00.00,"80,223.44","7,22,010.93",
04-Dec-21,Cheque,645.24,00.00,"7,22,656.17",
04-Dec-21,Purchase,00.00,"2,40,885.39","4,81,770.78",
04-Dec-21,NEFT,07.93,00.00,"4,81,778.71",
04-Dec-21,NEFT,00.00,"53,530.97","4,28,247.74",
04-Dec-21,Transfer,426.2,00.00,"4,28,673.94",
04-Dec-21,Cash,00.00,"61,239.13","3,67,434.81",
04-Dec-21,ATM,"29,465.50",00.00,"3,96,900.31",
04-Dec-21,Cash,467.4,00.00,"3,97,367.71",
04-Dec-21,Purchase,"1,613.00",00.00,"3,98,980.71",
05-Dec-21,IMPS,"30,588.00",00.00,"4,29,568.71",
05-Dec-21,Reversal,"1,603.90",00.00,"4,31,172.61",
05-Dec-21,IMPS,01.09,00.00,"4,31,173.70",
05-Dec-21,Commission,00.00,"43,117.37","3,88,056.33",
06-Dec-21,IMPS,00.00,"3,88,056.33",00.00,
06-Dec-21,Commission,"2,15,289.00",00.00,"2,15,289.00",
06-Dec-21,NEFT,04.00,00.00,"2,15,293.00",
06-Dec-21,Cheque,07.00,00.00,"2,15,300.00",
06-Dec-21,ATM,00.00,"1,07,650.00","1,07,650.00",
06-Dec-21,NEFT,"1,62,381.41",00.00,"2,70,031.41",
07-Dec-21,Transfer,"2,938.00",00.00,"2,72,969.41",
07-Dec-21,Cheque,937.2,00.00,"2,73,906.61",
07-Dec-21,Debit Card,00.00,"1,36,953.31","1,36,953.30",
07-Dec-21,Transportellaneous,"3,257.84",00.00,"1,40,211.14",
07-Dec-21,Tax,00.00,"28,042.23","1,12,168.91",
07-Dec-21,Tax,"1,14,801.00",00.00,"2,26,969.91",
07-Dec-21,Purchase,"19,14,273.50",00.00,"21,41,243.41",
07-Dec-21,IMPS,00.00,"4,28,248.68","17,12,994.73",
07-Dec-21,Cheque,"6,58,763.00",00.00,"23,71,757.73",
07-Dec-21,IMPS,00.00,"3,38,822.53","20,32,935.20",
07-Dec-21,Transfer,181.8,00.00,"20,33,117.00",
07-Dec-21,ATM,"6,824.30",00.00,"20,39,941.30",
07-Dec-21,ATM,37,00.00,"20,39,978.30",
07-Dec-21,Bill,00.00,"5,09,994.58","15,29,983.72",
07-Dec-21,ATM,"8,14,775.50",00.00,"23,44,759.22",
07-Dec-21,Debit Card,00.00,"2,60,528.80","20,84,230.42",
07-Dec-21,Interest,00.00,"5,21,057.61","15,63,172.82",
07-Dec-21,Bill,00.00,00.00,"15,63,172.82",
07-Dec-21,NEFT,43,00.00,"15,63,215.82",
07-Dec-21,Debit Card,00.00,"2,23,316.55","13,39,899.27",
07-Dec-21,Purchase,00.00,"6,69,949.64","6,69,949.64",
07-Dec-21,RTGS,00.00,"3,34,974.82","3,34,974.82",
07-Dec-21,NEFT,00.00,"3,34,974.82",00.00,
07-Dec-21,Transfer,01.08,00.00,01.08,
07-Dec-21,ATM,04.60,00.00,05.68,
07-Dec-21,Transportellaneous,"7,35,819.00",00.00,"7,35,824.68",
07-Dec-21,Tax,00.00,"3,67,912.34","3,67,912.34",
08-Dec-21,Commission,00.00,"1,83,956.17","1,83,956.17",
08-Dec-21,Bill,291,00.00,"1,84,247.17",
08-Dec-21,Transportellaneous,27,00.00,"1,84,274.17",
08-Dec-21,Transfer,"14,98,212.00",00.00,"16,82,486.17",
08-Dec-21,Purchase,06.00,00.00,"16,82,492.17",
08-Dec-21,ATM,00.00,"16,82,492.17",00.00,
08-Dec-21,Interest,86.3,00.00,86.3,
08-Dec-21,Debit Card,00.00,43.15,43.15,
08-Dec-21,Cash,00.00,06.16,36.99,
08-Dec-21,Interest,00.00,07.40,29.59,
08-Dec-21,Transfer,08.90,00.00,38.49,
08-Dec-21,Transportellaneous,141.1,00.00,179.59,
08-Dec-21,RTGS,37,00.00,216.59,
08-Dec-21,Bill,00.00,108.3,108.3,
08-Dec-21,Tax,00.00,18.05,90.25,
08-Dec-21,Interest,178.3,00.00,268.55,
08-Dec-21,NEFT,00.00,33.57,234.98,
08-Dec-21,IMPS,"16,99,630.00",00.00,"16,99,864.98",
08-Dec-21,Transportellaneous,00.00,"2,83,310.83","14,16,554.15",
08-Dec-21,Commission,"2,60,225.94",00.00,"16,76,780.09",
09-Dec-21,Transportellaneous,265.9,00.00,"16,77,045.99",
09-Dec-21,Cash,00.00,"5,59,015.33","11,18,030.66",
09-Dec-21,Bill,00.00,"1,24,225.63","9,93,805.03",
09-Dec-21,Transportellaneous,31.7,00.00,"9,93,836.73",
09-Dec-21,ATM,"29,150.29",00.00,"10,22,987.02",
09-Dec-21,ATM,46.56,00.00,"10,23,033.58",
09-Dec-21,IMPS,503.57,00.00,"10,23,537.15",
09-Dec-21,Commission,00.00,"2,55,884.29","7,67,652.86",
09-Dec-21,NEFT,07.00,00.00,"7,67,659.86",
09-Dec-21,Transfer,00.00,"1,91,914.97","5,75,744.90",
09-Dec-21,Bill,61,00.00,"5,75,805.90",
09-Dec-21,RTGS,00.00,"71,975.74","5,03,830.16",
09-Dec-21,Cheque,00.00,"5,03,830.16",00.00,
09-Dec-21,ATM,"13,61,818.00",00.00,"13,61,818.00",
09-Dec-21,Reversal,00.00,"4,53,939.33","9,07,878.67",
09-Dec-21,Cheque,00.54,00.00,"9,07,879.21",
09-Dec-21,Cheque,00.00,"4,53,939.61","4,53,939.60",
09-Dec-21,Transfer,00.00,"1,51,313.20","3,02,626.40",
09-Dec-21,Debit Card,663.3,00.00,"3,03,289.70",
09-Dec-21,ATM,27.7,00.00,"3,03,317.40",
09-Dec-21,Debit Card,00.00,"75,829.35","2,27,488.05",
09-Dec-21,Interest,00.00,"75,829.35","1,51,658.70",
09-Dec-21,Bill,"1,156.87",00.00,"1,52,815.57",
10-Dec-21,NEFT,00.00,"76,407.79","76,407.78",
10-Dec-21,Cheque,"2,923.00",00.00,"79,330.78",
10-Dec-21,IMPS,00.00,"15,866.16","63,464.62",
10-Dec-21,Reversal,"1,22,223.00",00.00,"1,85,687.62",
10-Dec-21,NEFT,00.00,"92,843.81","92,843.81",
10-Dec-21,Reversal,00.00,"30,947.94","61,895.87",
10-Dec-21,Debit Card,"1,12,449.00",00.00,"1,74,344.87",
10-Dec-21,Interest,131.36,00.00,"1,74,476.23",
10-Dec-21,Cheque,"3,201.00",00.00,"1,77,677.23",
10-Dec-21,Cash,00.00,"22,209.65","1,55,467.58",
10-Dec-21,Transfer,00.00,"31,093.52","1,24,374.06",
10-Dec-21,Bill,00.00,"24,874.81","99,499.25",
10-Dec-21,Debit Card,"3,459.00",00.00,"1,02,958.25",
10-Dec-21,Transportellaneous,00.00,"34,319.42","68,638.83",
11-Dec-21,Debit Card,00.00,"17,159.71","51,479.12",
11-Dec-21,Reversal,05.00,00.00,"51,484.12",
11-Dec-21,Tax,249,00.00,"51,733.12",
11-Dec-21,Cash,00.00,"12,933.28","38,799.84",
11-Dec-21,Cash,00.00,"3,879.98","34,919.86",
11-Dec-21,Purchase,00.00,"6,983.97","27,935.89",
11-Dec-21,RTGS,"17,168.90",00.00,"45,104.79",
11-Dec-21,NEFT,00.00,"15,034.93","30,069.86",
11-Dec-21,Reversal,"16,154.00",00.00,"46,223.86",
11-Dec-21,Interest,"26,281.72",00.00,"72,505.58",
11-Dec-21,ATM,"20,53,908.00",00.00,"21,26,413.58",
11-Dec-21,Tax,00.00,"4,25,282.72","17,01,130.86",
11-Dec-21,ATM,"2,25,181.00",00.00,"19,26,311.86",
11-Dec-21,Cheque,03.21,00.00,"19,26,315.07",
11-Dec-21,Debit Card,"1,51,090.00",00.00,"20,77,405.07",
12-Dec-21,Cheque,00.00,"3,46,234.18","17,31,170.89",
12-Dec-21,Cash,00.00,"3,46,234.18","13,84,936.71",
12-Dec-21,NEFT,316.6,00.00,"13,85,253.31",
12-Dec-21,IMPS,992,00.00,"13,86,245.31",
12-Dec-21,Transportellaneous,45.6,00.00,"13,86,290.91",
12-Dec-21,Debit Card,"4,443.30",00.00,"13,90,734.21",
12-Dec-21,Interest,"2,13,552.84",00.00,"16,04,287.05",
12-Dec-21,Cash,38.85,00.00,"16,04,325.90",
13-Dec-21,Commission,25.8,00.00,"16,04,351.70",
13-Dec-21,NEFT,"6,067.00",00.00,"16,10,418.70",
13-Dec-21,Commission,"1,00,315.20",00.00,"17,10,733.90",
13-Dec-21,Commission,00.00,"2,85,122.32","14,25,611.58",
13-Dec-21,NEFT,130.4,00.00,"14,25,741.98",
13-Dec-21,IMPS,00.00,"2,03,677.43","12,22,064.55",
13-Dec-21,Purchase,00.00,"2,03,677.43","10,18,387.12",
13-Dec-21,Purchase,"15,454.90",00.00,"10,33,842.02",
13-Dec-21,ATM,04.00,00.00,"10,33,846.02",
13-Dec-21,ATM,"27,623.30",00.00,"10,61,469.32",
13-Dec-21,Reversal,00.00,"1,17,941.04","9,43,528.28",
13-Dec-21,Bill,"64,906.70",00.00,"10,08,434.98",
13-Dec-21,Debit Card,00.00,"2,52,108.75","7,56,326.24",
13-Dec-21,NEFT,00.00,"1,89,081.56","5,67,244.68",
13-Dec-21,Purchase,00.00,"81,034.95","4,86,209.73",
13-Dec-21,Cash,17.6,00.00,"4,86,227.33",
13-Dec-21,Debit Card,"13,07,176.00",00.00,"17,93,403.33",
13-Dec-21,ATM,54.4,00.00,"17,93,457.73",
13-Dec-21,Debit Card,"14,62,885.75",00.00,"32,56,343.48",
13-Dec-21,Debit Card,103,00.00,"32,56,446.48",
14-Dec-21,Transfer,00.00,"8,14,111.62","24,42,334.86",
14-Dec-21,Cash,00.00,"8,14,111.62","16,28,223.24",
14-Dec-21,Debit Card,"10,26,776.75",00.00,"26,54,999.99",
14-Dec-21,Interest,02.99,00.00,"26,55,002.98",
14-Dec-21,Reversal,00.00,"26,55,002.98",00.00,
14-Dec-21,RTGS,06.98,00.00,06.98,
14-Dec-21,Interest,00.00,00.78,06.20,
14-Dec-21,Reversal,00.00,01.55,04.65,
15-Dec-21,Interest,00.00,02.33,02.33,
15-Dec-21,Tax,53.2,00.00,55.53,
15-Dec-21,Transfer,"12,73,247.00",00.00,"12,73,302.53",
15-Dec-21,Commission,00.00,"3,18,325.63","9,54,976.90",
15-Dec-21,Commission,00.00,"9,54,976.90",00.00,
15-Dec-21,Purchase,53.1,00.00,53.1,
15-Dec-21,Reversal,"2,615.97",00.00,"2,669.07",
15-Dec-21,Tax,00.00,266.91,"2,402.16",
15-Dec-21,IMPS,00.00,266.91,"2,135.25",
16-Dec-21,ATM,"16,049.50",00.00,"18,184.75",
16-Dec-21,Transportellaneous,"27,403.60",00.00,"45,588.35",
16-Dec-21,Transfer,521.04,00.00,"46,109.39",
16-Dec-21,Interest,"11,189.00",00.00,"57,298.39",
16-Dec-21,Cheque,56.9,00.00,"57,355.29",
16-Dec-21,Transfer,00.00,"14,338.82","43,016.47",
16-Dec-21,RTGS,00.00,"10,754.12","32,262.35",
16-Dec-21,ATM,00.00,"5,377.06","26,885.29",
17-Dec-21,NEFT,00.00,"26,885.29",00.00,
17-Dec-21,ATM,"1,029.30",00.00,"1,029.30",
17-Dec-21,Transfer,00.00,128.66,900.64,
17-Dec-21,RTGS,00.00,112.58,788.06,
18-Dec-21,Cheque,29.97,00.00,818.03,
18-Dec-21,Transfer,00.00,102.25,715.78,
18-Dec-21,Bill,03.86,00.00,719.64,
18-Dec-21,Reversal,00.00,89.96,629.68,
18-Dec-21,RTGS,"2,320.00",00.00,"2,949.68",
18-Dec-21,Debit Card,01.41,00.00,"2,951.09",
18-Dec-21,Interest,"1,50,728.00",00.00,"1,53,679.09",
18-Dec-21,NEFT,"16,634.60",00.00,"1,70,313.69",
18-Dec-21,Interest,00.00,"56,771.23","1,13,542.46",
18-Dec-21,Interest,06.90,00.00,"1,13,549.36",
18-Dec-21,Tax,00.00,"56,774.68","56,774.68",
18-Dec-21,NEFT,00.00,"14,193.67","42,581.01",
18-Dec-21,Commission,00.00,"10,645.25","31,935.76",
18-Dec-21,IMPS,01.50,00.00,"31,937.26",
18-Dec-21,IMPS,"4,80,788.00",00.00,"5,12,725.26",
18-Dec-21,Tax,00.00,"51,272.53","4,61,452.73",
18-Dec-21,Tax,00.00,"2,30,726.37","2,30,726.36",
18-Dec-21,Bill,50,00.00,"2,30,776.36",
18-Dec-21,Cash,"1,97,934.00",00.00,"4,28,710.36",
18-Dec-21,NEFT,01.58,00.00,"4,28,711.94",
18-Dec-21,ATM,438.76,00.00,"4,29,150.70",
18-Dec-21,Interest,"3,396.00",00.00,"4,32,546.70",
18-Dec-21,ATM,00.00,"72,091.12","3,60,455.58",
18-Dec-21,ATM,04.90,00.00,"3,60,460.48",
18-Dec-21,RTGS,00.00,"1,20,153.49","2,40,306.99",
18-Dec-21,Cheque,00.00,"24,030.70","2,16,276.29",
18-Dec-21,Reversal,05.10,00.00,"2,16,281.39",
18-Dec-21,Cash,00.00,"30,897.34","1,85,384.05",
18-Dec-21,Debit Card,00.00,"18,538.41","1,66,845.64",
18-Dec-21,RTGS,00.00,"1,66,845.64",00.00,
18-Dec-21,Cheque,346.1,00.00,346.1,
18-Dec-21,Transfer,"1,36,939.03",00.00,"1,37,285.13",
18-Dec-21,Debit Card,00.00,"1,37,285.13",00.00,
18-Dec-21,Reversal,10.04,00.00,10.04,
19-Dec-21,Cash,"1,50,371.40",00.00,"1,50,381.44",
19-Dec-21,Cheque,00.00,"50,127.15","1,00,254.29",
19-Dec-21,Debit Card,00.00,"12,531.79","87,722.50",
19-Dec-21,Reversal,01.69,00.00,"87,724.19",
19-Dec-21,Reversal,"19,48,822.50",00.00,"20,36,546.69",
19-Dec-21,Cheque,"15,97,246.20",00.00,"36,33,792.89",
19-Dec-21,Transfer,154,00.00,"36,33,946.89",
19-Dec-21,Cheque,17.92,00.00,"36,33,964.81",
19-Dec-21,RTGS,00.00,"6,05,660.80","30,28,304.01",
19-Dec-21,NEFT,"16,05,921.25",00.00,"46,34,225.26",
19-Dec-21,Debit Card,22.57,00.00,"46,34,247.83",
19-Dec-21,Tax,02.00,00.00,"46,34,249.83",
19-Dec-21,Tax,"19,43,148.50",00.00,"65,77,398.33",
19-Dec-21,Cheque,00.00,"8,22,174.79","57,55,223.54",
19-Dec-21,Cash,00.00,"7,19,402.94","50,35,820.60",
19-Dec-21,Reversal,00.00,"8,39,303.43","41,96,517.17",
19-Dec-21,Reversal,00.00,"5,24,564.65","36,71,952.52",
19-Dec-21,Reversal,07.70,00.00,"36,71,960.22",
19-Dec-21,ATM,04.00,00.00,"36,71,964.22",
19-Dec-21,Tax,00.00,"36,71,964.22",00.00,
19-Dec-21,Transportellaneous,04.20,00.00,04.20,
19-Dec-21,Purchase,00.30,00.00,04.50,
19-Dec-21,Debit Card,"23,105.00",00.00,"23,109.50",
19-Dec-21,Reversal,00.00,"5,777.38","17,332.12",
19-Dec-21,Tax,00.00,"2,166.52","15,165.60",
19-Dec-21,Cash,00.00,"2,166.51","12,999.09",
19-Dec-21,Tax,"3,307.00",00.00,"16,306.09",
19-Dec-21,Transfer,"2,737.00",00.00,"19,043.09",
19-Dec-21,IMPS,00.00,"2,115.90","16,927.19",
19-Dec-21,RTGS,00.00,"2,821.20","14,105.99",
19-Dec-21,NEFT,31.6,00.00,"14,137.59",
19-Dec-21,Tax,00.00,"2,356.27","11,781.32",
19-Dec-21,ATM,00.00,"3,927.11","7,854.21",
19-Dec-21,IMPS,"3,170.00",00.00,"11,024.21",
19-Dec-21,Debit Card,00.00,"2,204.84","8,819.37",
19-Dec-21,Cheque,00.00,"2,204.84","6,614.53",
19-Dec-21,Reversal,01.50,00.00,"6,616.03",
19-Dec-21,Cheque,"17,567.30",00.00,"24,183.33",
19-Dec-21,Reversal,00.00,"2,687.04","21,496.29",
19-Dec-21,RTGS,07.08,00.00,"21,503.37",
19-Dec-21,Transportellaneous,00.00,"10,751.69","10,751.68",
19-Dec-21,RTGS,00.00,"2,687.92","8,063.76",
19-Dec-21,Purchase,43,00.00,"8,106.76",
19-Dec-21,Bill,00.00,"1,013.35","7,093.42",
19-Dec-21,Purchase,00.00,"2,364.47","4,728.95",
19-Dec-21,Interest,00.00,"1,576.32","3,152.63",
19-Dec-21,Purchase,00.00,525.44,"2,627.19",
19-Dec-21,Cash,"1,79,815.20",00.00,"1,82,442.39",
19-Dec-21,Interest,00.00,"22,805.30","1,59,637.09",
19-Dec-21,Transportellaneous,22,00.00,"1,59,659.09",
19-Dec-21,Reversal,00.00,"1,59,659.09",00.00,
19-Dec-21,IMPS,"1,46,597.60",00.00,"1,46,597.60",
19-Dec-21,Transportellaneous,391.07,00.00,"1,46,988.67",
19-Dec-21,NEFT,"1,446.00",00.00,"1,48,434.67",
19-Dec-21,Transportellaneous,00.00,"14,843.47","1,33,591.20",
19-Dec-21,Transfer,00.00,"33,397.80","1,00,193.40",
19-Dec-21,Bill,00.00,"16,698.90","83,494.50",
19-Dec-21,Transfer,"78,981.20",00.00,"1,62,475.70",
19-Dec-21,Bill,00.00,"40,618.93","1,21,856.78",
19-Dec-21,Purchase,00.00,"12,185.68","1,09,671.10",
19-Dec-21,Bill,00.00,"10,967.11","98,703.99",
19-Dec-21,Bill,00.00,"12,338.00","86,365.99",
19-Dec-21,Cheque,00.00,"17,273.20","69,092.79",
19-Dec-21,Cheque,325,00.00,"69,417.79",
19-Dec-21,Commission,"6,039.20",00.00,"75,456.99",
19-Dec-21,IMPS,00.00,"7,545.70","67,911.29",
19-Dec-21,NEFT,"2,265.40",00.00,"70,176.69",
19-Dec-21,Purchase,"10,765.00",00.00,"80,941.69",
19-Dec-21,Purchase,"2,05,126.50",00.00,"2,86,068.19",
19-Dec-21,Reversal,00.00,"47,678.03","2,38,390.16",
19-Dec-21,ATM,00.00,"39,731.69","1,98,658.47",
19-Dec-21,Bill,28,00.00,"1,98,686.47",
19-Dec-21,Transportellaneous,"3,000.00",00.00,"2,01,686.47",
19-Dec-21,Tax,00.00,"25,210.81","1,76,475.66",
19-Dec-21,Interest,00.00,00.00,"1,76,475.66",
19-Dec-21,Transportellaneous,"4,536.00",00.00,"1,81,011.66",
19-Dec-21,Commission,54,00.00,"1,81,065.66",
19-Dec-21,Purchase,00.00,"60,355.22","1,20,710.44",
19-Dec-21,Commission,00.00,"40,236.81","80,473.63",
19-Dec-21,Reversal,00.00,"8,047.36","72,426.27",
19-Dec-21,Interest,"1,597.00",00.00,"74,023.27",
19-Dec-21,Cheque,00.00,"10,574.75","63,448.52",
19-Dec-21,Cheque,03.00,00.00,"63,451.52",
19-Dec-21,Tax,"1,013.60",00.00,"64,465.12",
19-Dec-21,Transportellaneous,00.00,"64,465.12",00.00,
19-Dec-21,IMPS,"6,59,386.00",00.00,"6,59,386.00",
19-Dec-21,Purchase,"2,15,618.00",00.00,"8,75,004.00",
19-Dec-21,Cash,00.00,"1,25,000.57","7,50,003.43",
19-Dec-21,IMPS,00.00,"1,07,143.35","6,42,860.08",
19-Dec-21,Transfer,44.49,00.00,"6,42,904.57",
19-Dec-21,Interest,"4,96,119.00",00.00,"11,39,023.57",
19-Dec-21,Reversal,00.00,"1,42,377.95","9,96,645.62",
19-Dec-21,Purchase,394.39,00.00,"9,97,040.01",
19-Dec-21,ATM,05.95,00.00,"9,97,045.96",
19-Dec-21,Cash,00.00,"1,66,174.33","8,30,871.63",
19-Dec-21,Reversal,"8,431.00",00.00,"8,39,302.63",
19-Dec-21,Transportellaneous,00.00,"2,79,767.54","5,59,535.09",
20-Dec-21,Reversal,00.00,"93,255.85","4,66,279.24",
20-Dec-21,ATM,00.00,"58,284.91","4,07,994.34",
20-Dec-21,Reversal,"2,38,506.09",00.00,"6,46,500.43",
20-Dec-21,Purchase,00.00,"1,29,300.09","5,17,200.34",
20-Dec-21,NEFT,00.00,"73,885.76","4,43,314.58",
20-Dec-21,Interest,802,00.00,"4,44,116.58",
20-Dec-21,IMPS,"2,757.70",00.00,"4,46,874.28",
20-Dec-21,Debit Card,00.60,00.00,"4,46,874.88",
20-Dec-21,Bill,00.00,"49,652.76","3,97,222.12",
20-Dec-21,Cash,00.00,"1,32,407.37","2,64,814.75",
20-Dec-21,Cash,"11,848.40",00.00,"2,76,663.15",
21-Dec-21,Debit Card,"11,81,556.00",00.00,"14,58,219.15",
22-Dec-21,Debit Card,210.1,00.00,"14,58,429.25",
22-Dec-21,Reversal,00.00,"2,08,347.04","12,50,082.21",
22-Dec-21,Debit Card,479,00.00,"12,50,561.21",
22-Dec-21,Interest,00.00,"2,50,112.24","10,00,448.97",
22-Dec-21,ATM,06.00,00.00,"10,00,454.97",
22-Dec-21,RTGS,01.12,00.00,"10,00,456.09",
22-Dec-21,NEFT,00.00,"1,00,045.61","9,00,410.48",
22-Dec-21,Tax,00.00,"9,00,410.48",00.00,
22-Dec-21,IMPS,343.77,00.00,343.77,
22-Dec-21,Tax,00.00,34.38,309.39,
22-Dec-21,Tax,"78,320.00",00.00,"78,629.39",
22-Dec-21,Interest,451,00.00,"79,080.39",
22-Dec-21,Cheque,"7,16,725.00",00.00,"7,95,805.39",
22-Dec-21,Interest,00.00,"1,98,951.35","5,96,854.04",
22-Dec-21,Tax,40,00.00,"5,96,894.04",
22-Dec-21,Transportellaneous,00.00,"5,96,894.04",00.00,
22-Dec-21,Transportellaneous,20.26,00.00,20.26,
22-Dec-21,Transfer,00.00,02.53,17.73,
22-Dec-21,Interest,01.00,00.00,18.73,
22-Dec-21,Cash,00.00,18.73,00.00,
22-Dec-21,Tax,"1,135.20",00.00,"1,135.20",
22-Dec-21,Interest,00.00,126.13,"1,009.07",
22-Dec-21,Transportellaneous,"2,20,141.00",00.00,"2,21,150.07",
22-Dec-21,Interest,07.00,00.00,"2,21,157.07",
22-Dec-21,Debit Card,247.1,00.00,"2,21,404.17",
22-Dec-21,ATM,04.50,00.00,"2,21,408.67",
22-Dec-21,Cash,00.00,"55,352.17","1,66,056.50",
22-Dec-21,IMPS,00.00,"16,605.65","1,49,450.85",
22-Dec-21,Transfer,"8,862.02",00.00,"1,58,312.87",
22-Dec-21,Cash,00.00,"15,831.29","1,42,481.58",
22-Dec-21,Interest,00.00,"71,240.79","71,240.79",
22-Dec-21,NEFT,00.00,"35,620.40","35,620.39",
22-Dec-21,NEFT,"18,224.07",00.00,"53,844.46",
22-Dec-21,Tax,00.00,"13,461.12","40,383.34",
22-Dec-21,Reversal,"29,562.00",00.00,"69,945.34",
22-Dec-21,IMPS,00.00,"8,743.17","61,202.17",
22-Dec-21,Transportellaneous,00.00,"15,300.54","45,901.63",
22-Dec-21,Commission,"43,118.00",00.00,"89,019.63",
23-Dec-21,Transfer,00.00,"29,673.21","59,346.42",
23-Dec-21,Transportellaneous,41.94,00.00,"59,388.36",
23-Dec-21,Debit Card,00.00,"29,694.18","29,694.18",
23-Dec-21,Debit Card,00.00,"9,898.06","19,796.12",
23-Dec-21,Bill,00.00,"6,598.71","13,197.41",
23-Dec-21,Cash,"32,670.96",00.00,"45,868.37",
23-Dec-21,Transportellaneous,00.00,"5,733.55","40,134.82",
23-Dec-21,IMPS,00.00,"10,033.71","30,101.12",
23-Dec-21,Commission,00.00,"6,020.22","24,080.90",
23-Dec-21,RTGS,00.00,"4,013.48","20,067.42",
23-Dec-21,Tax,"58,378.00",00.00,"78,445.42",
23-Dec-21,Bill,00.00,"11,206.49","67,238.93",
23-Dec-21,RTGS,00.00,"67,238.93",00.00,
23-Dec-21,Reversal,"8,85,204.00",00.00,"8,85,204.00",
23-Dec-21,Purchase,61.77,00.00,"8,85,265.77",
23-Dec-21,Bill,00.00,"1,77,053.15","7,08,212.62",
23-Dec-21,RTGS,00.00,"78,690.29","6,29,522.33",
23-Dec-21,Commission,00.00,"2,09,840.78","4,19,681.55",
23-Dec-21,Cheque,"3,437.11",00.00,"4,23,118.66",
23-Dec-21,IMPS,00.00,"1,05,779.67","3,17,339.00",
23-Dec-21,RTGS,00.00,"1,05,779.67","2,11,559.33",
23-Dec-21,NEFT,00.00,"21,155.93","1,90,403.40",
23-Dec-21,Bill,00.00,"21,155.93","1,69,247.47",
23-Dec-21,Cash,"3,794.80",00.00,"1,73,042.27",
23-Dec-21,Commission,"43,592.84",00.00,"2,16,635.11",
23-Dec-21,Transfer,00.00,"72,211.70","1,44,423.41",
23-Dec-21,Interest,"1,679.30",00.00,"1,46,102.71",
23-Dec-21,Interest,00.00,"73,051.36","73,051.36",
23-Dec-21,Commission,00.00,"73,051.36",00.00,
23-Dec-21,Cash,"19,62,367.50",00.00,"19,62,367.50",
23-Dec-21,Debit Card,136,00.00,"19,62,503.50",
23-Dec-21,Reversal,00.00,"9,81,251.75","9,81,251.75",
23-Dec-21,Purchase,00.00,"4,90,625.88","4,90,625.88",
23-Dec-21,RTGS,00.00,"81,770.98","4,08,854.90",
23-Dec-21,RTGS,"1,49,936.28",00.00,"5,58,791.18",
23-Dec-21,Bill,00.00,"1,39,697.80","4,19,093.38",
23-Dec-21,Transfer,62.38,00.00,"4,19,155.76",
23-Dec-21,NEFT,00.00,"52,394.47","3,66,761.29",
23-Dec-21,RTGS,00.00,"52,394.47","3,14,366.82",
23-Dec-21,Cash,11.47,00.00,"3,14,378.29",
23-Dec-21,Reversal,00.00,"31,437.83","2,82,940.46",
23-Dec-21,Transfer,"1,19,632.50",00.00,"4,02,572.96",
23-Dec-21,Debit Card,00.00,"1,34,190.99","2,68,381.97",
23-Dec-21,Transportellaneous,00.00,"1,34,190.99","1,34,190.98",
23-Dec-21,Reversal,333.7,00.00,"1,34,524.68",
23-Dec-21,ATM,00.00,"67,262.34","67,262.34",
23-Dec-21,ATM,00.00,"16,815.59","50,446.76",
23-Dec-21,Purchase,33.64,00.00,"50,480.40",
23-Dec-21,ATM,00.00,"6,310.05","44,170.35",
23-Dec-21,RTGS,140.7,00.00,"44,311.05",
24-Dec-21,Transportellaneous,"9,77,614.00",00.00,"10,21,925.05",
25-Dec-21,Reversal,"12,856.00",00.00,"10,34,781.05",
25-Dec-21,IMPS,00.00,"10,34,781.05",00.00,
25-Dec-21,Tax,36.86,00.00,36.86,
25-Dec-21,ATM,00.00,12.29,24.57,
25-Dec-21,ATM,00.00,02.46,22.11,
25-Dec-21,ATM,00.00,07.37,14.74,
25-Dec-21,Transfer,00.00,01.84,12.9,
25-Dec-21,IMPS,00.00,01.61,11.29,
25-Dec-21,Transfer,479.9,00.00,491.19,
25-Dec-21,Interest,00.00,122.8,368.39,
25-Dec-21,Bill,419.93,00.00,788.32,
25-Dec-21,RTGS,16,00.00,804.32,
25-Dec-21,RTGS,58.09,00.00,862.41,
25-Dec-21,Tax,121,00.00,983.41,
25-Dec-21,Cheque,"12,819.00",00.00,"13,802.41",
25-Dec-21,Transfer,39.4,00.00,"13,841.81",
25-Dec-21,Transportellaneous,00.00,"1,384.18","12,457.63",
25-Dec-21,Bill,00.00,"12,457.63",00.00,
25-Dec-21,Transportellaneous,"3,463.20",00.00,"3,463.20",
25-Dec-21,IMPS,367,00.00,"3,830.20",
25-Dec-21,Bill,00.00,"1,915.10","1,915.10",
25-Dec-21,Commission,00.00,239.39,"1,675.71",
25-Dec-21,NEFT,16,00.00,"1,691.71",
25-Dec-21,Transfer,00.00,"1,691.71",00.00,
25-Dec-21,Interest,"2,29,980.00",00.00,"2,29,980.00",
25-Dec-21,Bill,00.00,"28,747.50","2,01,232.50",
25-Dec-21,Transfer,07.00,00.00,"2,01,239.50",
25-Dec-21,Cash,00.00,"1,00,619.75","1,00,619.75",
25-Dec-21,IMPS,"2,703.00",00.00,"1,03,322.75",
25-Dec-21,Transportellaneous,907,00.00,"1,04,229.75",
25-Dec-21,Purchase,00.00,"13,028.72","91,201.03",
25-Dec-21,Cash,00.00,"45,600.52","45,600.52",
25-Dec-21,Tax,"7,51,320.00",00.00,"7,96,920.52",
26-Dec-21,Commission,"18,271.00",00.00,"8,15,191.52",
26-Dec-21,IMPS,461,00.00,"8,15,652.52",
26-Dec-21,RTGS,00.00,"2,71,884.17","5,43,768.35",
26-Dec-21,Purchase,"17,06,307.00",00.00,"22,50,075.35",
26-Dec-21,Interest,59.2,00.00,"22,50,134.55",
26-Dec-21,Debit Card,180,00.00,"22,50,314.55",
26-Dec-21,Tax,123.74,00.00,"22,50,438.29",
27-Dec-21,Cheque,"6,72,078.00",00.00,"29,22,516.29",
27-Dec-21,RTGS,00.00,"4,87,086.05","24,35,430.24",
27-Dec-21,Interest,00.00,"12,17,715.12","12,17,715.12",
27-Dec-21,Tax,00.00,"12,17,715.12",00.00,
27-Dec-21,ATM,64.69,00.00,64.69,
27-Dec-21,Debit Card,"1,200.87",00.00,"1,265.56",
27-Dec-21,IMPS,00.00,"1,265.56",00.00,
27-Dec-21,Bill,"1,787.00",00.00,"1,787.00",
27-Dec-21,Commission,00.00,178.7,"1,608.30",
27-Dec-21,Cheque,00.00,804.15,804.15,
27-Dec-21,ATM,00.00,804.15,00.00,
27-Dec-21,NEFT,"17,21,877.20",00.00,"17,21,877.20",
27-Dec-21,Interest,00.00,"4,30,469.30","12,91,407.90",
27-Dec-21,ATM,00.00,"1,43,489.77","11,47,918.13",
27-Dec-21,Transportellaneous,00.00,"1,14,791.81","10,33,126.32",
27-Dec-21,Transfer,00.00,"2,06,625.26","8,26,501.06",
27-Dec-21,Commission,00.00,"1,18,071.58","7,08,429.48",
27-Dec-21,Cash,00.00,"3,54,214.74","3,54,214.74",
27-Dec-21,Debit Card,228,00.00,"3,54,442.74",
27-Dec-21,Reversal,00.00,"3,54,442.74",00.00,
28-Dec-21,Interest,"13,64,453.00",00.00,"13,64,453.00",
28-Dec-21,IMPS,"1,503.00",00.00,"13,65,956.00",
28-Dec-21,Commission,00.00,"4,55,318.67","9,10,637.33",
28-Dec-21,ATM,"17,423.97",00.00,"9,28,061.30",
28-Dec-21,IMPS,01.60,00.00,"9,28,062.90",
28-Dec-21,Purchase,"16,699.40",00.00,"9,44,762.30",
28-Dec-21,Transportellaneous,00.00,"3,14,920.77","6,29,841.53",
28-Dec-21,NEFT,00.00,"89,977.36","5,39,864.17",
28-Dec-21,Debit Card,"6,492.40",00.00,"5,46,356.57",
28-Dec-21,ATM,00.00,"91,059.43","4,55,297.14",
28-Dec-21,Cheque,00.00,"56,912.14","3,98,385.00",
28-Dec-21,Bill,00.00,"49,798.13","3,48,586.88",
28-Dec-21,Commission,00.00,"3,48,586.88",00.00,
28-Dec-21,Bill,175.18,00.00,175.18,
28-Dec-21,Purchase,00.00,25.03,150.15,
28-Dec-21,Bill,00.00,37.54,112.61,
28-Dec-21,Transportellaneous,00.00,18.77,93.84,
28-Dec-21,Tax,00.00,93.84,00.00,
28-Dec-21,ATM,"63,024.31",00.00,"63,024.31",
28-Dec-21,Reversal,00.00,"9,003.47","54,020.84",
28-Dec-21,Transfer,00.00,"5,402.08","48,618.76",
28-Dec-21,NEFT,00.00,"24,309.38","24,309.38",
28-Dec-21,Reversal,00.00,"12,154.69","12,154.69",
28-Dec-21,Cheque,"2,719.84",00.00,"14,874.53",
28-Dec-21,RTGS,"18,964.10",00.00,"33,838.63",
28-Dec-21,Reversal,00.00,"4,229.83","29,608.80",
28-Dec-21,Commission,00.00,"3,701.10","25,907.70",
28-Dec-21,Transfer,"46,422.00",00.00,"72,329.70",
28-Dec-21,Transportellaneous,01.00,00.00,"72,330.70",
29-Dec-21,Debit Card,"2,417.21",00.00,"74,747.91",
29-Dec-21,NEFT,00.00,"12,457.99","62,289.92",
29-Dec-21,Cash,00.00,"6,228.99","56,060.93",
29-Dec-21,RTGS,00.00,"18,686.98","37,373.95",
29-Dec-21,ATM,00.00,"3,737.40","33,636.56",
29-Dec-21,Reversal,06.00,00.00,"33,642.56",
29-Dec-21,ATM,241,00.00,"33,883.56",
29-Dec-21,Interest,"36,881.00",00.00,"70,764.56",
29-Dec-21,IMPS,00.00,"10,109.22","60,655.34",
29-Dec-21,IMPS,"3,259.89",00.00,"63,915.23",
29-Dec-21,NEFT,00.00,"63,915.23",00.00,
29-Dec-21,Interest,"3,590.47",00.00,"3,590.47",
29-Dec-21,NEFT,00.00,"1,196.82","2,393.65",
29-Dec-21,Bill,"3,232.76",00.00,"5,626.41",
29-Dec-21,Reversal,"18,98,748.20",00.00,"19,04,374.61",
29-Dec-21,Transportellaneous,00.00,"1,90,437.46","17,13,937.15",
29-Dec-21,Cheque,"17,263.90",00.00,"17,31,201.05",
29-Dec-21,Interest,00.00,"17,31,201.05",00.00,
29-Dec-21,Reversal,"28,959.20",00.00,"28,959.20",
29-Dec-21,IMPS,00.10,00.00,"28,959.30",
29-Dec-21,Cheque,"85,693.59",00.00,"1,14,652.89",
29-Dec-21,NEFT,00.00,"14,331.61","1,00,321.28",
29-Dec-21,Interest,00.00,"50,160.64","50,160.64",
29-Dec-21,NEFT,"17,86,868.00",00.00,"18,37,028.64",
29-Dec-21,Reversal,"1,72,431.97",00.00,"20,09,460.61",
29-Dec-21,Bill,465,00.00,"20,09,925.61",
29-Dec-21,RTGS,"20,89,285.00",00.00,"40,99,210.61",
30-Dec-21,Tax,222.93,00.00,"40,99,433.54",
30-Dec-21,Bill,00.00,"10,24,858.39","30,74,575.16",
30-Dec-21,Tax,00.00,"4,39,225.02","26,35,350.14",
30-Dec-21,Interest,"4,088.64",00.00,"26,39,438.78",
30-Dec-21,Interest,00.00,"13,19,719.39","13,19,719.39",
30-Dec-21,RTGS,05.97,00.00,"13,19,725.36",
31-Dec-21,NEFT,01.00,00.00,"13,19,726.36",
31-Dec-21,Tax,"2,278.00",00.00,"13,22,004.36",
31-Dec-21,IMPS,00.00,"4,40,668.12","8,81,336.24",
31-Dec-21,NEFT,00.00,"1,10,167.03","7,71,169.21",
31-Dec-21,Tax,00.00,"77,116.92","6,94,052.29",
01-Jan-22,Cheque,00.00,"99,150.33","5,94,901.96",
01-Jan-22,Purchase,00.00,"1,18,980.39","4,75,921.57",
01-Jan-22,Transportellaneous,00.00,"59,490.20","4,16,431.37",
01-Jan-22,Debit Card,00.00,"1,04,107.84","3,12,323.53",
01-Jan-22,NEFT,"1,864.50",00.00,"3,14,188.03",
01-Jan-22,Debit Card,00.00,"52,364.67","2,61,823.36",
01-Jan-22,Commission,00.00,"26,182.34","2,35,641.02",
01-Jan-22,Cash,00.00,"1,17,820.51","1,17,820.51",
01-Jan-22,ATM,00.00,"19,636.75","98,183.76",
01-Jan-22,Debit Card,51,00.00,"98,234.76",
01-Jan-22,RTGS,430.8,00.00,"98,665.56",
01-Jan-22,Debit Card,13,00.00,"98,678.56",
01-Jan-22,IMPS,"14,78,839.25",00.00,"15,77,517.81",
02-Jan-22,NEFT,00.00,"7,88,758.91","7,88,758.90",
02-Jan-22,Transfer,412,00.00,"7,89,170.90",
02-Jan-22,Cash,00.00,"2,63,056.97","5,26,113.93",
02-Jan-22,Commission,125.28,00.00,"5,26,239.21",
02-Jan-22,IMPS,00.00,"1,75,413.07","3,50,826.14",
02-Jan-22,Bill,254.5,00.00,"3,51,080.64",
02-Jan-22,ATM,"1,914.00",00.00,"3,52,994.64",
02-Jan-22,NEFT,"11,90,621.25",00.00,"15,43,615.89",
02-Jan-22,Transfer,"1,86,391.00",00.00,"17,30,006.89",
03-Jan-22,Cheque,27,00.00,"17,30,033.89",
03-Jan-22,ATM,00.00,"8,65,016.95","8,65,016.94",
03-Jan-22,Reversal,00.00,"1,23,573.85","7,41,443.09",
03-Jan-22,Cheque,00.00,"1,85,360.77","5,56,082.32",
03-Jan-22,Debit Card,00.00,"1,11,216.46","4,44,865.86",
03-Jan-22,Interest,00.00,"74,144.31","3,70,721.55",
03-Jan-22,Purchase,04.00,00.00,"3,70,725.55",
03-Jan-22,Transfer,"68,526.00",00.00,"4,39,251.55",
03-Jan-22,IMPS,00.00,"2,19,625.78","2,19,625.78",
03-Jan-22,Commission,"9,34,494.50",00.00,"11,54,120.28",
03-Jan-22,Purchase,00.00,"1,15,412.03","10,38,708.25",
03-Jan-22,Purchase,00.00,"1,29,838.53","9,08,869.72",
03-Jan-22,Cheque,266,00.00,"9,09,135.72",
03-Jan-22,ATM,"1,78,383.19",00.00,"10,87,518.91",
03-Jan-22,Transfer,00.00,"2,17,503.78","8,70,015.13",
03-Jan-22,Cheque,00.00,"4,35,007.57","4,35,007.56",
03-Jan-22,Cash,04.00,00.00,"4,35,011.56",
03-Jan-22,IMPS,00.00,"72,501.93","3,62,509.63",
03-Jan-22,IMPS,00.00,"72,501.93","2,90,007.70",
03-Jan-22,NEFT,15,00.00,"2,90,022.70",
03-Jan-22,Bill,00.00,"2,90,022.70",00.00,
03-Jan-22,Cash,"15,95,792.00",00.00,"15,95,792.00",
03-Jan-22,Interest,12.7,00.00,"15,95,804.70",
03-Jan-22,IMPS,"3,341.17",00.00,"15,99,145.87",
04-Jan-22,NEFT,00.00,"5,33,048.62","10,66,097.25",
04-Jan-22,NEFT,03.81,00.00,"10,66,101.06",
04-Jan-22,Reversal,"25,092.29",00.00,"10,91,193.35",
04-Jan-22,Transportellaneous,00.00,"10,91,193.35",00.00,
04-Jan-22,IMPS,"8,46,511.80",00.00,"8,46,511.80",
04-Jan-22,RTGS,00.00,"2,82,170.60","5,64,341.20",
04-Jan-22,Debit Card,00.00,"2,82,170.60","2,82,170.60",
04-Jan-22,ATM,"3,26,287.00",00.00,"6,08,457.60",
04-Jan-22,Cheque,"19,919.54",00.00,"6,28,377.14",
04-Jan-22,ATM,"54,444.00",00.00,"6,82,821.14",
04-Jan-22,ATM,"29,146.00",00.00,"7,11,967.14",
04-Jan-22,Bill,00.00,"1,01,709.59","6,10,257.55",
04-Jan-22,Transportellaneous,00.00,"1,52,564.39","4,57,693.16",
04-Jan-22,Purchase,00.00,"50,854.80","4,06,838.36",
04-Jan-22,Tax,05.80,00.00,"4,06,844.16",
04-Jan-22,NEFT,"46,632.60",00.00,"4,53,476.76",
04-Jan-22,Cheque,00.00,"50,386.31","4,03,090.45",
04-Jan-22,Cheque,"36,631.00",00.00,"4,39,721.45",
04-Jan-22,Cash,"2,38,283.78",00.00,"6,78,005.23",
04-Jan-22,RTGS,"2,829.53",00.00,"6,80,834.76",
04-Jan-22,RTGS,00.00,"85,104.35","5,95,730.42",
04-Jan-22,NEFT,"16,167.27",00.00,"6,11,897.69",
04-Jan-22,ATM,06.00,00.00,"6,11,903.69",
04-Jan-22,NEFT,00.00,"3,05,951.85","3,05,951.84",
04-Jan-22,Transportellaneous,"2,031.00",00.00,"3,07,982.84",
04-Jan-22,Cheque,00.00,"34,220.32","2,73,762.52",
04-Jan-22,Transfer,00.00,"91,254.17","1,82,508.35",
04-Jan-22,Transportellaneous,00.00,"1,82,508.35",00.00,
04-Jan-22,NEFT,"3,524.00",00.00,"3,524.00",
04-Jan-22,Cash,00.00,587.33,"2,936.67",
04-Jan-22,Commission,00.00,978.89,"1,957.78",
04-Jan-22,RTGS,"1,81,318.12",00.00,"1,83,275.90",
04-Jan-22,Tax,00.00,"36,655.18","1,46,620.72",
05-Jan-22,Bill,"5,84,418.50",00.00,"7,31,039.22",
05-Jan-22,Interest,00.00,"1,46,207.84","5,84,831.38",
05-Jan-22,Reversal,"3,773.00",00.00,"5,88,604.38",
05-Jan-22,Tax,00.00,"2,94,302.19","2,94,302.19",
05-Jan-22,Transfer,00.00,"73,575.55","2,20,726.64",
05-Jan-22,Commission,00.00,"44,145.33","1,76,581.31",
05-Jan-22,Cheque,00.00,"29,430.22","1,47,151.09",
05-Jan-22,IMPS,"14,79,675.00",00.00,"16,26,826.09",
05-Jan-22,IMPS,"1,828.90",00.00,"16,28,654.99",
05-Jan-22,RTGS,00.00,"3,25,731.00","13,02,923.99",
05-Jan-22,ATM,00.00,"1,62,865.50","11,40,058.49",
05-Jan-22,Bill,00.00,"3,80,019.50","7,60,038.99",
05-Jan-22,Cash,05.40,00.00,"7,60,044.39",
05-Jan-22,Commission,"17,44,563.00",00.00,"25,04,607.39",
05-Jan-22,Reversal,00.00,"3,13,075.92","21,91,531.47",
05-Jan-22,NEFT,00.00,"3,13,075.92","18,78,455.55",
05-Jan-22,ATM,00.00,"2,34,806.94","16,43,648.61",
05-Jan-22,Cash,"9,00,854.00",00.00,"25,44,502.61",
05-Jan-22,Cheque,00.00,"12,72,251.31","12,72,251.30",
06-Jan-22,Transfer,"3,26,227.75",00.00,"15,98,479.05",
06-Jan-22,Cheque,00.00,"2,66,413.18","13,32,065.88",
06-Jan-22,Bill,00.00,"4,44,021.96","8,88,043.92",
06-Jan-22,Purchase,00.00,"1,48,007.32","7,40,036.60",
06-Jan-22,Debit Card,425.2,00.00,"7,40,461.80",
06-Jan-22,Cash,00.00,"92,557.73","6,47,904.08",
06-Jan-22,Transfer,373,00.00,"6,48,277.08",
06-Jan-22,Cheque,00.00,"6,48,277.08",00.00,
06-Jan-22,Debit Card,264,00.00,264,
06-Jan-22,Commission,11.5,00.00,275.5,
06-Jan-22,NEFT,00.00,45.92,229.58,
07-Jan-22,NEFT,00.00,38.26,191.32,
07-Jan-22,Reversal,00.00,191.32,00.00,
07-Jan-22,NEFT,"1,470.60",00.00,"1,470.60",
07-Jan-22,Cheque,"20,85,442.20",00.00,"20,86,912.80",
07-Jan-22,Reversal,38.1,00.00,"20,86,950.90",
07-Jan-22,RTGS,00.00,"4,17,390.18","16,69,560.72",
07-Jan-22,Tax,00.00,"16,69,560.72",00.00,
07-Jan-22,Debit Card,"4,56,613.25",00.00,"4,56,613.25",
07-Jan-22,Cash,00.00,"76,102.21","3,80,511.04",
07-Jan-22,Bill,00.00,"76,102.21","3,04,408.83",
07-Jan-22,RTGS,"21,336.30",00.00,"3,25,745.13",
07-Jan-22,Cash,01.00,00.00,"3,25,746.13",
07-Jan-22,RTGS,00.00,"1,08,582.04","2,17,164.09",
07-Jan-22,Reversal,"3,762.00",00.00,"2,20,926.09",
07-Jan-22,Transfer,"3,491.00",00.00,"2,24,417.09",
07-Jan-22,Interest,00.00,"32,059.58","1,92,357.51",
07-Jan-22,Purchase,"12,16,757.00",00.00,"14,09,114.51",
07-Jan-22,Tax,00.00,"3,52,278.63","10,56,835.88",
07-Jan-22,Transfer,00.00,"1,05,683.59","9,51,152.29",
07-Jan-22,NEFT,00.00,"3,17,050.76","6,34,101.53",
07-Jan-22,Debit Card,46.4,00.00,"6,34,147.93",
07-Jan-22,NEFT,"1,34,189.00",00.00,"7,68,336.93",
07-Jan-22,NEFT,05.00,00.00,"7,68,341.93",
07-Jan-22,Transportellaneous,"17,373.77",00.00,"7,85,715.70",
07-Jan-22,Purchase,00.00,"78,571.57","7,07,144.13",
07-Jan-22,Interest,"6,588.48",00.00,"7,13,732.61",
07-Jan-22,Transfer,00.00,"71,373.26","6,42,359.35",
07-Jan-22,Debit Card,"1,84,767.00",00.00,"8,27,126.35",
07-Jan-22,NEFT,439,00.00,"8,27,565.35",
07-Jan-22,Transfer,"8,35,954.00",00.00,"16,63,519.35",
08-Jan-22,IMPS,04.30,00.00,"16,63,523.65",
08-Jan-22,Reversal,00.00,"1,66,352.37","14,97,171.28",
08-Jan-22,Purchase,00.00,"7,48,585.64","7,48,585.64",
08-Jan-22,Tax,"31,121.57",00.00,"7,79,707.21",
08-Jan-22,Transportellaneous,"9,80,882.50",00.00,"17,60,589.71",
08-Jan-22,Tax,00.00,"5,86,863.24","11,73,726.47",
08-Jan-22,Tax,"17,68,492.00",00.00,"29,42,218.47",
09-Jan-22,RTGS,"58,360.00",00.00,"30,00,578.47",
09-Jan-22,ATM,01.00,00.00,"30,00,579.47",
09-Jan-22,Interest,"5,16,413.20",00.00,"35,16,992.67",
09-Jan-22,Commission,00.00,"35,16,992.67",00.00,
09-Jan-22,Tax,325,00.00,325,
09-Jan-22,IMPS,"1,49,837.06",00.00,"1,50,162.06",
09-Jan-22,Commission,"2,453.13",00.00,"1,52,615.19",
09-Jan-22,NEFT,404.82,00.00,"1,53,020.01",
09-Jan-22,Purchase,51,00.00,"1,53,071.01",
09-Jan-22,ATM,44.45,00.00,"1,53,115.46",
09-Jan-22,ATM,00.00,"17,012.83","1,36,102.63",
09-Jan-22,Cheque,"18,547.00",00.00,"1,54,649.63",
09-Jan-22,Transfer,00.00,"25,774.94","1,28,874.69",
09-Jan-22,ATM,"13,46,494.50",00.00,"14,75,369.19",
09-Jan-22,Commission,"8,452.78",00.00,"14,83,821.97",
09-Jan-22,IMPS,00.00,"4,94,607.32","9,89,214.65",
09-Jan-22,Debit Card,"1,46,960.50",00.00,"11,36,175.15",
09-Jan-22,Commission,03.00,00.00,"11,36,178.15",
09-Jan-22,Cheque,"15,060.10",00.00,"11,51,238.25",
09-Jan-22,Cheque,00.00,"5,75,619.13","5,75,619.12",
09-Jan-22,RTGS,03.00,00.00,"5,75,622.12",
09-Jan-22,Interest,00.00,"1,91,874.04","3,83,748.08",
09-Jan-22,Transfer,00.00,"42,638.68","3,41,109.40",
09-Jan-22,IMPS,"11,232.22",00.00,"3,52,341.62",
09-Jan-22,Bill,00.00,"50,334.52","3,02,007.10",
09-Jan-22,Reversal,00.00,"75,501.78","2,26,505.32",
09-Jan-22,Cash,00.00,"1,13,252.66","1,13,252.66",
10-Jan-22,Transfer,107,00.00,"1,13,359.66",
10-Jan-22,Commission,00.00,"14,169.96","99,189.70",
11-Jan-22,IMPS,"11,623.70",00.00,"1,10,813.40",
11-Jan-22,NEFT,00.00,"12,312.60","98,500.80",
12-Jan-22,Transfer,00.00,"19,700.16","78,800.64",
12-Jan-22,Cash,00.00,"9,850.08","68,950.56",
12-Jan-22,IMPS,00.00,"17,237.64","51,712.92",
12-Jan-22,RTGS,02.00,00.00,"51,714.92",
12-Jan-22,Debit Card,"2,552.97",00.00,"54,267.89",
12-Jan-22,ATM,00.00,"5,426.79","48,841.10",
12-Jan-22,Bill,"31,387.00",00.00,"80,228.10",
12-Jan-22,Cash,"21,891.00",00.00,"1,02,119.10",
12-Jan-22,IMPS,60,00.00,"1,02,179.10",
12-Jan-22,NEFT,04.00,00.00,"1,02,183.10",
12-Jan-22,Tax,00.00,"51,091.55","51,091.55",
12-Jan-22,Transfer,101.59,00.00,"51,193.14",
12-Jan-22,ATM,209,00.00,"51,402.14",
12-Jan-22,Cheque,00.00,"25,701.07","25,701.07",
12-Jan-22,Purchase,"1,841.00",00.00,"27,542.07",
12-Jan-22,Tax,00.00,"3,934.58","23,607.49",
12-Jan-22,Purchase,04.48,00.00,"23,611.97",
12-Jan-22,NEFT,00.00,"23,611.97",00.00,
12-Jan-22,NEFT,"23,452.77",00.00,"23,452.77",
12-Jan-22,Tax,"15,79,681.20",00.00,"16,03,133.97",
13-Jan-22,Transportellaneous,00.00,"1,78,126.00","14,25,007.97",
13-Jan-22,Cheque,03.20,00.00,"14,25,011.17",
13-Jan-22,NEFT,"1,782.00",00.00,"14,26,793.17",
13-Jan-22,RTGS,00.00,"14,26,793.17",00.00,
13-Jan-22,Cheque,13.77,00.00,13.77,
13-Jan-22,Tax,233.73,00.00,247.5,
13-Jan-22,Transfer,00.00,61.88,185.62,
13-Jan-22,Bill,"19,71,783.20",00.00,"19,71,968.82",
13-Jan-22,RTGS,00.00,"3,28,661.47","16,43,307.35",
14-Jan-22,Transfer,00.00,"4,10,826.84","12,32,480.51",
15-Jan-22,NEFT,00.00,"1,54,060.06","10,78,420.45",
15-Jan-22,Bill,"2,268.00",00.00,"10,80,688.45",
15-Jan-22,Tax,00.53,00.00,"10,80,688.98",
15-Jan-22,Transportellaneous,00.00,"5,40,344.49","5,40,344.49",
15-Jan-22,Reversal,00.00,"1,08,068.90","4,32,275.59",
15-Jan-22,Cheque,00.00,"4,32,275.59",00.00,
15-Jan-22,Debit Card,"3,40,935.00",00.00,"3,40,935.00",
15-Jan-22,Cheque,"6,801.42",00.00,"3,47,736.42",
15-Jan-22,Cheque,36,00.00,"3,47,772.42",
15-Jan-22,Transportellaneous,288,00.00,"3,48,060.42",
15-Jan-22,Cash,00.00,"58,010.07","2,90,050.35",
15-Jan-22,Reversal,"31,916.71",00.00,"3,21,967.06",
15-Jan-22,ATM,00.00,"40,245.88","2,81,721.18",
15-Jan-22,Commission,"10,64,211.20",00.00,"13,45,932.38",
15-Jan-22,Tax,"17,97,245.00",00.00,"31,43,177.38",
15-Jan-22,Bill,00.00,"3,14,317.74","28,28,859.64",
15-Jan-22,Interest,10.25,00.00,"28,28,869.89",
15-Jan-22,Tax,00.00,"3,53,608.74","24,75,261.15",
15-Jan-22,Cash,"72,937.00",00.00,"25,48,198.15",
15-Jan-22,RTGS,06.00,00.00,"25,48,204.15",
15-Jan-22,RTGS,00.00,"8,49,401.38","16,98,802.77",
15-Jan-22,RTGS,00.00,"8,49,401.39","8,49,401.38",
15-Jan-22,Interest,"18,58,483.00",00.00,"27,07,884.38",
15-Jan-22,IMPS,00.00,"27,07,884.38",00.00,
15-Jan-22,Cash,"5,777.00",00.00,"5,777.00",
15-Jan-22,NEFT,00.00,641.89,"5,135.11",
15-Jan-22,Debit Card,00.00,"1,711.70","3,423.41",
15-Jan-22,Transfer,00.00,489.06,"2,934.35",
15-Jan-22,Purchase,00.00,978.12,"1,956.23",
15-Jan-22,ATM,00.00,195.62,"1,760.61",
15-Jan-22,Bill,"16,63,337.00",00.00,"16,65,097.61",
15-Jan-22,Cheque,26.1,00.00,"16,65,123.71",
15-Jan-22,Cash,30,00.00,"16,65,153.71",
15-Jan-22,RTGS,"51,860.30",00.00,"17,17,014.01",
15-Jan-22,Cash,00.00,"2,86,169.00","14,30,845.01",
15-Jan-22,Transfer,00.00,"4,76,948.34","9,53,896.67",
15-Jan-22,RTGS,"2,41,461.50",00.00,"11,95,358.17",
15-Jan-22,NEFT,"1,095.01",00.00,"11,96,453.18",
15-Jan-22,Purchase,189.9,00.00,"11,96,643.08",
15-Jan-22,Transportellaneous,00.00,"5,98,321.54","5,98,321.54",
15-Jan-22,Purchase,08.18,00.00,"5,98,329.72",
15-Jan-22,Debit Card,"18,200.00",00.00,"6,16,529.72",
15-Jan-22,ATM,"21,016.70",00.00,"6,37,546.42",
15-Jan-22,Debit Card,692,00.00,"6,38,238.42",
15-Jan-22,RTGS,00.00,"91,176.92","5,47,061.50",
15-Jan-22,IMPS,00.00,"1,09,412.30","4,37,649.20",
15-Jan-22,ATM,05.30,00.00,"4,37,654.50",
15-Jan-22,IMPS,00.00,"87,530.90","3,50,123.60",
15-Jan-22,Bill,"2,147.40",00.00,"3,52,271.00",
16-Jan-22,Purchase,00.00,"3,52,271.00",00.00,
16-Jan-22,Tax,"4,11,680.00",00.00,"4,11,680.00",
16-Jan-22,RTGS,00.00,"1,02,920.00","3,08,760.00",
16-Jan-22,Debit Card,06.00,00.00,"3,08,766.00",
16-Jan-22,ATM,28,00.00,"3,08,794.00",
16-Jan-22,Cash,00.00,"30,879.40","2,77,914.60",
16-Jan-22,Transfer,"94,078.75",00.00,"3,71,993.35",
16-Jan-22,Reversal,00.00,"1,23,997.78","2,47,995.57",
16-Jan-22,Debit Card,12.1,00.00,"2,48,007.67",
17-Jan-22,IMPS,00.00,"1,24,003.84","1,24,003.84",
17-Jan-22,IMPS,00.00,"1,24,003.84",00.00,
17-Jan-22,NEFT,"17,40,535.50",00.00,"17,40,535.50",
17-Jan-22,Transportellaneous,50.8,00.00,"17,40,586.30",
17-Jan-22,ATM,00.00,"1,93,398.48","15,47,187.82",
17-Jan-22,Tax,"14,12,292.80",00.00,"29,59,480.62",
17-Jan-22,Bill,"48,670.00",00.00,"30,08,150.62",
17-Jan-22,Bill,31,00.00,"30,08,181.62",
17-Jan-22,Transportellaneous,00.00,"5,01,363.60","25,06,818.02",
17-Jan-22,Debit Card,00.00,"3,58,116.86","21,48,701.16",
17-Jan-22,Transportellaneous,00.00,"10,74,350.58","10,74,350.58",
17-Jan-22,Commission,48.2,00.00,"10,74,398.78",
17-Jan-22,Cheque,00.00,"1,07,439.88","9,66,958.90",
17-Jan-22,Bill,00.00,"1,93,391.78","7,73,567.12",
17-Jan-22,Tax,00.00,"1,54,713.42","6,18,853.70",
17-Jan-22,Commission,"2,29,012.00",00.00,"8,47,865.70",
17-Jan-22,RTGS,"3,744.00",00.00,"8,51,609.70",
17-Jan-22,Interest,00.00,"94,623.30","7,56,986.40",
17-Jan-22,IMPS,318,00.00,"7,57,304.40",
17-Jan-22,RTGS,00.00,"75,730.44","6,81,573.96",
17-Jan-22,Bill,293.8,00.00,"6,81,867.76",
17-Jan-22,Cheque,00.00,"97,409.68","5,84,458.08",
17-Jan-22,Reversal,"1,195.00",00.00,"5,85,653.08",
17-Jan-22,Cheque,247.66,00.00,"5,85,900.74",
17-Jan-22,Debit Card,00.00,"5,85,900.74",00.00,
17-Jan-22,Cheque,"1,78,076.50",00.00,"1,78,076.50",
17-Jan-22,Cheque,00.00,"89,038.25","89,038.25",
17-Jan-22,Interest,"1,309.70",00.00,"90,347.95",
17-Jan-22,Purchase,07.00,00.00,"90,354.95",
17-Jan-22,Commission,06.77,00.00,"90,361.72",
17-Jan-22,IMPS,03.00,00.00,"90,364.72",
17-Jan-22,Commission,00.00,"11,295.59","79,069.13",
17-Jan-22,Cash,00.00,"11,295.59","67,773.54",
17-Jan-22,Cash,00.00,"22,591.18","45,182.36",
17-Jan-22,Transportellaneous,00.00,"5,020.26","40,162.10",
17-Jan-22,Bill,"13,583.25",00.00,"53,745.35",
17-Jan-22,Cheque,00.00,"13,436.34","40,309.01",
17-Jan-22,Bill,"29,931.40",00.00,"70,240.41",
17-Jan-22,Bill,00.00,"10,034.34","60,206.07",
17-Jan-22,Tax,00.00,"30,103.04","30,103.04",
17-Jan-22,Cheque,494,00.00,"30,597.04",
17-Jan-22,NEFT,00.00,"30,597.04",00.00,
17-Jan-22,Transfer,198.4,00.00,198.4,
17-Jan-22,RTGS,15,00.00,213.4,
17-Jan-22,Purchase,00.00,26.68,186.72,
17-Jan-22,Interest,"2,36,180.30",00.00,"2,36,367.02",
17-Jan-22,NEFT,01.29,00.00,"2,36,368.31",
17-Jan-22,Tax,00.00,"29,546.04","2,06,822.27",
17-Jan-22,Transfer,25.59,00.00,"2,06,847.86",
17-Jan-22,RTGS,"3,373.20",00.00,"2,10,221.06",
17-Jan-22,RTGS,"8,45,308.00",00.00,"10,55,529.06",
17-Jan-22,Reversal,04.00,00.00,"10,55,533.06",
17-Jan-22,Purchase,00.00,"2,63,883.27","7,91,649.80",
17-Jan-22,RTGS,00.00,"3,95,824.90","3,95,824.90",
17-Jan-22,ATM,"55,662.80",00.00,"4,51,487.70",
17-Jan-22,Transfer,00.00,"64,498.24","3,86,989.46",
17-Jan-22,Purchase,00.00,"55,284.21","3,31,705.25",
17-Jan-22,Transportellaneous,00.00,"66,341.05","2,65,364.20",
17-Jan-22,Transfer,00.00,"29,484.91","2,35,879.29",
17-Jan-22,Tax,37,00.00,"2,35,916.29",
17-Jan-22,Transfer,00.00,"78,638.76","1,57,277.53",
17-Jan-22,RTGS,00.00,"78,638.77","78,638.76",
17-Jan-22,Tax,04.00,00.00,"78,642.76",
17-Jan-22,Cheque,01.43,00.00,"78,644.19",
17-Jan-22,Debit Card,00.00,"13,107.37","65,536.82",
17-Jan-22,Transportellaneous,"2,74,433.75",00.00,"3,39,970.57",
17-Jan-22,NEFT,00.00,"3,39,970.57",00.00,
17-Jan-22,Transportellaneous,"1,906.00",00.00,"1,906.00",
17-Jan-22,Reversal,00.00,"1,906.00",00.00,
17-Jan-22,Tax,56,00.00,56,
17-Jan-22,Cheque,"23,414.54",00.00,"23,470.54",
17-Jan-22,Bill,00.00,"23,470.54",00.00,
17-Jan-22,RTGS,"1,08,584.00",00.00,"1,08,584.00",
17-Jan-22,Cheque,00.00,"27,146.00","81,438.00",
17-Jan-22,Cash,00.00,"16,287.60","65,150.40",
17-Jan-22,Transportellaneous,226,00.00,"65,376.40",
17-Jan-22,Tax,00.00,"10,896.07","54,480.33",
17-Jan-22,Debit Card,"1,178.40",00.00,"55,658.73",
17-Jan-22,Cheque,00.00,"27,829.37","27,829.36",
17-Jan-22,RTGS,00.00,"27,829.36",00.00,
17-Jan-22,Purchase,"1,43,702.20",00.00,"1,43,702.20",
17-Jan-22,Transfer,06.27,00.00,"1,43,708.47",
17-Jan-22,Tax,00.00,"17,963.56","1,25,744.91",
17-Jan-22,IMPS,00.70,00.00,"1,25,745.61",
17-Jan-22,Reversal,05.70,00.00,"1,25,751.31",
17-Jan-22,IMPS,00.00,"15,718.91","1,10,032.40",
17-Jan-22,RTGS,"76,238.00",00.00,"1,86,270.40",
17-Jan-22,Transfer,00.00,"46,567.60","1,39,702.80",
17-Jan-22,Bill,00.00,"19,957.54","1,19,745.26",
17-Jan-22,Commission,00.00,"29,936.32","89,808.94",
17-Jan-22,Bill,"30,399.60",00.00,"1,20,208.54",
17-Jan-22,Reversal,"2,45,203.16",00.00,"3,65,411.70",
17-Jan-22,RTGS,00.00,"36,541.17","3,28,870.53",
17-Jan-22,Commission,"26,447.00",00.00,"3,55,317.53",
17-Jan-22,Bill,00.00,"3,55,317.53",00.00,
17-Jan-22,Bill,"94,467.53",00.00,"94,467.53",
17-Jan-22,ATM,05.10,00.00,"94,472.63",
17-Jan-22,Interest,00.00,"23,618.16","70,854.47",
17-Jan-22,Transfer,120.4,00.00,"70,974.87",
18-Jan-22,Tax,00.00,"23,658.29","47,316.58",
18-Jan-22,Cash,00.00,"5,914.57","41,402.01",
18-Jan-22,Purchase,00.00,"10,350.50","31,051.51",
18-Jan-22,Commission,88,00.00,"31,139.51",
18-Jan-22,Transportellaneous,00.00,"3,892.44","27,247.07",
18-Jan-22,Transportellaneous,00.00,"3,892.44","23,354.63",
18-Jan-22,NEFT,00.00,"11,677.32","11,677.32",
18-Jan-22,Transportellaneous,09.47,00.00,"11,686.79",
18-Jan-22,Cheque,00.00,"5,843.40","5,843.40",
18-Jan-22,Debit Card,"29,268.00",00.00,"35,111.40",
18-Jan-22,Bill,00.00,"8,777.85","26,333.55",
18-Jan-22,Commission,00.00,"26,333.55",00.00,
18-Jan-22,Transfer,"6,84,136.00",00.00,"6,84,136.00",
18-Jan-22,Reversal,00.00,"2,28,045.33","4,56,090.67",
18-Jan-22,ATM,03.98,00.00,"4,56,094.65",
18-Jan-22,Tax,00.00,"1,14,023.66","3,42,070.99",
18-Jan-22,Bill,00.00,"1,14,023.66","2,28,047.33",
18-Jan-22,IMPS,00.00,"45,609.47","1,82,437.86",
18-Jan-22,Cash,00.00,"91,218.93","91,218.93",
18-Jan-22,Cash,04.10,00.00,"91,223.03",
18-Jan-22,Transportellaneous,147,00.00,"91,370.03",
18-Jan-22,Debit Card,"18,25,664.00",00.00,"19,17,034.03",
18-Jan-22,Purchase,"9,448.68",00.00,"19,26,482.71",
18-Jan-22,Interest,"20,16,066.00",00.00,"39,42,548.71",
18-Jan-22,Cheque,01.00,00.00,"39,42,549.71",
18-Jan-22,Tax,00.00,"5,63,221.39","33,79,328.32",
18-Jan-22,Purchase,00.00,"6,75,865.66","27,03,462.66",
18-Jan-22,Reversal,00.00,"2,70,346.27","24,33,116.39",
18-Jan-22,NEFT,10.8,00.00,"24,33,127.19",
18-Jan-22,IMPS,00.00,"4,05,521.20","20,27,605.99",
18-Jan-22,Purchase,00.00,"2,53,450.75","17,74,155.24",
18-Jan-22,Transportellaneous,"19,082.90",00.00,"17,93,238.14",
18-Jan-22,Bill,02.50,00.00,"17,93,240.64",
18-Jan-22,Cash,00.00,"8,96,620.32","8,96,620.32",
18-Jan-22,Transfer,499,00.00,"8,97,119.32",
18-Jan-22,Bill,02.90,00.00,"8,97,122.22",
18-Jan-22,Bill,00.00,"4,48,561.11","4,48,561.11",
18-Jan-22,ATM,00.00,"74,760.19","3,73,800.92",
18-Jan-22,Tax,00.00,"93,450.23","2,80,350.69",
18-Jan-22,IMPS,"6,927.71",00.00,"2,87,278.40",
18-Jan-22,RTGS,00.00,"2,87,278.40",00.00,
18-Jan-22,Commission,"14,59,927.00",00.00,"14,59,927.00",
18-Jan-22,Commission,51,00.00,"14,59,978.00",
18-Jan-22,ATM,45.1,00.00,"14,60,023.10",
18-Jan-22,Transportellaneous,"1,24,896.00",00.00,"15,84,919.10",
18-Jan-22,Bill,08.50,00.00,"15,84,927.60",
19-Jan-22,Interest,45.89,00.00,"15,84,973.49",
19-Jan-22,ATM,441,00.00,"15,85,414.49",
19-Jan-22,IMPS,"3,373.00",00.00,"15,88,787.49",
19-Jan-22,Purchase,"74,609.62",00.00,"16,63,397.11",
19-Jan-22,Cash,00.00,"5,54,465.70","11,08,931.41",
19-Jan-22,Tax,"12,922.00",00.00,"11,21,853.41",
19-Jan-22,RTGS,00.00,"3,73,951.14","7,47,902.27",
19-Jan-22,Reversal,162.2,00.00,"7,48,064.47",
19-Jan-22,Commission,00.00,"83,118.27","6,64,946.20",
19-Jan-22,Cheque,00.00,"83,118.28","5,81,827.92",
19-Jan-22,Transportellaneous,"2,105.16",00.00,"5,83,933.08",
19-Jan-22,RTGS,122.42,00.00,"5,84,055.50",
19-Jan-22,RTGS,00.00,"58,405.55","5,25,649.95",
19-Jan-22,ATM,00.00,"5,25,649.95",00.00,
19-Jan-22,Tax,"3,474.60",00.00,"3,474.60",
19-Jan-22,Cash,727.4,00.00,"4,202.00",
19-Jan-22,Cheque,13,00.00,"4,215.00",
19-Jan-22,Interest,177,00.00,"4,392.00",
19-Jan-22,Cash,00.00,627.43,"3,764.57",
19-Jan-22,Bill,420.2,00.00,"4,184.77",
19-Jan-22,Commission,00.00,597.82,"3,586.95",
19-Jan-22,Cheque,03.80,00.00,"3,590.75",
19-Jan-22,ATM,55.56,00.00,"3,646.31",
19-Jan-22,Transfer,00.00,455.79,"3,190.52",
19-Jan-22,Transfer,"1,41,305.97",00.00,"1,44,496.49",
19-Jan-22,IMPS,00.00,"36,124.12","1,08,372.37",
19-Jan-22,Transfer,"5,107.00",00.00,"1,13,479.37",
19-Jan-22,Cash,"1,75,125.88",00.00,"2,88,605.25",
19-Jan-22,Purchase,00.00,"57,721.05","2,30,884.20",
19-Jan-22,Cheque,"17,14,560.50",00.00,"19,45,444.70",
19-Jan-22,Cheque,00.00,"6,48,481.57","12,96,963.13",
19-Jan-22,Tax,00.00,"12,96,963.13",00.00,
19-Jan-22,RTGS,98,00.00,98,
19-Jan-22,Transfer,"1,64,715.00",00.00,"1,64,813.00",
19-Jan-22,Cash,40,00.00,"1,64,853.00",
19-Jan-22,Cash,"20,51,941.00",00.00,"22,16,794.00",
19-Jan-22,Debit Card,00.00,"3,16,684.86","19,00,109.14",
19-Jan-22,Debit Card,00.00,"3,80,021.83","15,20,087.31",
19-Jan-22,Cash,00.00,"15,20,087.31",00.00,
19-Jan-22,Purchase,"19,05,968.00",00.00,"19,05,968.00",
19-Jan-22,IMPS,00.00,"1,90,596.80","17,15,371.20",
19-Jan-22,Cash,10,00.00,"17,15,381.20",
19-Jan-22,IMPS,"56,556.16",00.00,"17,71,937.36",
19-Jan-22,Purchase,00.00,"4,42,984.34","13,28,953.02",
19-Jan-22,ATM,00.00,"1,47,661.45","11,81,291.57",
19-Jan-22,IMPS,00.00,"1,18,129.16","10,63,162.41",
19-Jan-22,Tax,00.00,"1,51,880.34","9,11,282.07",
19-Jan-22,Debit Card,"4,966.60",00.00,"9,16,248.67",
19-Jan-22,Cheque,07.10,00.00,"9,16,255.77",
19-Jan-22,NEFT,"2,10,144.90",00.00,"11,26,400.67",
19-Jan-22,Reversal,"26,828.11",00.00,"11,53,228.78",
19-Jan-22,Commission,00.00,"3,84,409.59","7,68,819.19",
19-Jan-22,Tax,00.00,"76,881.92","6,91,937.27",
19-Jan-22,Debit Card,07.18,00.00,"6,91,944.45",
19-Jan-22,Bill,00.00,"86,493.06","6,05,451.39",
19-Jan-22,ATM,00.00,"60,545.14","5,44,906.25",
19-Jan-22,Transfer,00.00,"90,817.71","4,54,088.54",
19-Jan-22,Tax,00.00,"90,817.71","3,63,270.83",
19-Jan-22,Cash,"1,81,029.70",00.00,"5,44,300.53",
19-Jan-22,Bill,00.00,"90,716.76","4,53,583.78",
19-Jan-22,Bill,00.00,"45,358.38","4,08,225.40",
19-Jan-22,ATM,74.87,00.00,"4,08,300.27",
19-Jan-22,Debit Card,"72,326.00",00.00,"4,80,626.27",
19-Jan-22,Tax,00.00,"60,078.28","4,20,547.99",
19-Jan-22,Transfer,43,00.00,"4,20,590.99",
19-Jan-22,Reversal,00.00,"52,573.87","3,68,017.12",
19-Jan-22,RTGS,00.00,"92,004.28","2,76,012.84",
19-Jan-22,Bill,"5,84,509.00",00.00,"8,60,521.84",
19-Jan-22,IMPS,09.78,00.00,"8,60,531.62",
19-Jan-22,Cash,00.00,"2,15,132.91","6,45,398.72",
19-Jan-22,RTGS,00.00,"2,15,132.91","4,30,265.81",
19-Jan-22,Reversal,"4,78,728.00",00.00,"9,08,993.81",
19-Jan-22,Transfer,00.00,"4,54,496.91","4,54,496.90",
19-Jan-22,RTGS,04.00,00.00,"4,54,500.90",
19-Jan-22,Transportellaneous,00.00,"75,750.15","3,78,750.75",
19-Jan-22,Bill,363,00.00,"3,79,113.75",
19-Jan-22,Tax,00.00,"1,89,556.88","1,89,556.88",
19-Jan-22,Transfer,"98,528.56",00.00,"2,88,085.44",
19-Jan-22,Transfer,00.00,"1,44,042.72","1,44,042.72",
19-Jan-22,Debit Card,00.00,"48,014.24","96,028.48",
19-Jan-22,NEFT,00.00,"48,014.24","48,014.24",
19-Jan-22,ATM,01.54,00.00,"48,015.78",
19-Jan-22,Commission,18,00.00,"48,033.78",
19-Jan-22,Tax,"1,02,405.00",00.00,"1,50,438.78",
19-Jan-22,IMPS,51.18,00.00,"1,50,489.96",
19-Jan-22,Cash,00.00,"1,50,489.96",00.00,
19-Jan-22,Purchase,301.6,00.00,301.6,
19-Jan-22,Cash,00.00,301.6,00.00,
19-Jan-22,Cash,11,00.00,11,
19-Jan-22,Debit Card,549,00.00,560,
19-Jan-22,Cash,00.00,62.22,497.78,
19-Jan-22,NEFT,486.19,00.00,983.97,
19-Jan-22,Bill,00.00,491.99,491.98,
19-Jan-22,ATM,00.00,98.4,393.58,
19-Jan-22,Transportellaneous,00.00,78.72,314.86,
19-Jan-22,RTGS,62.73,00.00,377.59,
19-Jan-22,Debit Card,463.1,00.00,840.69,
19-Jan-22,Purchase,00.00,840.69,00.00,
19-Jan-22,IMPS,380,00.00,380,
20-Jan-22,Reversal,00.00,38,342,
20-Jan-22,Interest,00.00,57,285,
20-Jan-22,Cash,"20,05,382.50",00.00,"20,05,667.50",
20-Jan-22,Cash,52.1,00.00,"20,05,719.60",
20-Jan-22,Bill,47.9,00.00,"20,05,767.50",
20-Jan-22,Cash,02.40,00.00,"20,05,769.90",
20-Jan-22,Transfer,"17,428.20",00.00,"20,23,198.10",
20-Jan-22,RTGS,00.00,"2,52,899.76","17,70,298.34",
20-Jan-22,RTGS,00.00,"8,85,149.17","8,85,149.17",
20-Jan-22,RTGS,00.00,"1,77,029.83","7,08,119.34",
20-Jan-22,Cheque,"48,363.56",00.00,"7,56,482.90",
20-Jan-22,Cash,"2,94,164.00",00.00,"10,50,646.90",
20-Jan-22,IMPS,"1,076.00",00.00,"10,51,722.90",
20-Jan-22,Purchase,276,00.00,"10,51,998.90",
20-Jan-22,NEFT,00.00,"3,50,666.30","7,01,332.60",
20-Jan-22,Commission,"3,301.11",00.00,"7,04,633.71",
20-Jan-22,Transfer,"8,416.00",00.00,"7,13,049.71",
20-Jan-22,Tax,06.84,00.00,"7,13,056.55",
20-Jan-22,Interest,07.85,00.00,"7,13,064.40",
20-Jan-22,Tax,00.00,"7,13,064.40",00.00,
20-Jan-22,Cash,"22,681.19",00.00,"22,681.19",
20-Jan-22,Transfer,365,00.00,"23,046.19",
20-Jan-22,Cash,"3,89,453.50",00.00,"4,12,499.69",
20-Jan-22,Interest,00.00,"1,37,499.90","2,74,999.79",
20-Jan-22,Transfer,"25,543.00",00.00,"3,00,542.79",
20-Jan-22,Cash,"1,94,473.00",00.00,"4,95,015.79",
20-Jan-22,Transportellaneous,"1,18,225.10",00.00,"6,13,240.89",
20-Jan-22,Debit Card,"8,54,368.20",00.00,"14,67,609.09",
20-Jan-22,Interest,04.00,00.00,"14,67,613.09",
20-Jan-22,Bill,"1,68,643.70",00.00,"16,36,256.79",
20-Jan-22,Interest,"17,949.60",00.00,"16,54,206.39",
20-Jan-22,Commission,00.00,"2,75,701.07","13,78,505.32",
20-Jan-22,Transfer,00.00,"1,96,929.33","11,81,575.99",
20-Jan-22,Debit Card,00.00,"2,36,315.20","9,45,260.79",
20-Jan-22,Interest,60.81,00.00,"9,45,321.60",
20-Jan-22,Transportellaneous,"7,78,054.00",00.00,"17,23,375.60",
20-Jan-22,Purchase,00.00,"5,74,458.53","11,48,917.07",
20-Jan-22,Cash,"39,604.47",00.00,"11,88,521.54",
20-Jan-22,Interest,171.75,00.00,"11,88,693.29",
20-Jan-22,Interest,00.00,"1,98,115.55","9,90,577.74",
20-Jan-22,Commission,180.9,00.00,"9,90,758.64",
20-Jan-22,RTGS,00.00,"1,65,126.44","8,25,632.20",
20-Jan-22,ATM,"22,006.60",00.00,"8,47,638.80",
21-Jan-22,Bill,00.00,"2,11,909.70","6,35,729.10",
21-Jan-22,Cash,00.00,"70,636.57","5,65,092.53",
21-Jan-22,Purchase,"2,12,725.00",00.00,"7,77,817.53",
21-Jan-22,NEFT,"3,191.53",00.00,"7,81,009.06",
22-Jan-22,Commission,08.14,00.00,"7,81,017.20",
22-Jan-22,Bill,"1,58,459.12",00.00,"9,39,476.32",
22-Jan-22,NEFT,"2,31,795.59",00.00,"11,71,271.91",
22-Jan-22,Commission,45.3,00.00,"11,71,317.21",
22-Jan-22,Commission,00.00,"1,30,146.36","10,41,170.85",
22-Jan-22,Transportellaneous,"2,737.60",00.00,"10,43,908.45",
22-Jan-22,Purchase,"2,416.70",00.00,"10,46,325.15",
23-Jan-22,IMPS,00.00,"2,61,581.29","7,84,743.86",
23-Jan-22,Debit Card,00.00,"1,12,106.27","6,72,637.59",
23-Jan-22,Tax,"8,032.00",00.00,"6,80,669.59",
23-Jan-22,Interest,259.34,00.00,"6,80,928.93",
23-Jan-22,Debit Card,474.68,00.00,"6,81,403.61",
23-Jan-22,Purchase,00.00,"68,140.36","6,13,263.25",
23-Jan-22,ATM,00.00,"61,326.33","5,51,936.93",
23-Jan-22,NEFT,"13,36,118.00",00.00,"18,88,054.93",
23-Jan-22,NEFT,"2,11,479.00",00.00,"20,99,533.93",
23-Jan-22,RTGS,00.00,"3,49,922.32","17,49,611.61",
23-Jan-22,Interest,"6,67,333.00",00.00,"24,16,944.61",
23-Jan-22,ATM,00.00,"3,02,118.08","21,14,826.53",
23-Jan-22,ATM,00.00,"21,14,826.53",00.00,
23-Jan-22,Reversal,"2,864.00",00.00,"2,864.00",
23-Jan-22,RTGS,00.00,716,"2,148.00",
23-Jan-22,Tax,231,00.00,"2,379.00",
23-Jan-22,Purchase,52,00.00,"2,431.00",
23-Jan-22,Purchase,"1,80,664.00",00.00,"1,83,095.00",
23-Jan-22,RTGS,00.00,"91,547.50","91,547.50",
23-Jan-22,IMPS,12,00.00,"91,559.50",
23-Jan-22,Debit Card,"3,376.02",00.00,"94,935.52",
23-Jan-22,Cash,00.00,"18,987.10","75,948.42",
23-Jan-22,Cheque,00.00,"7,594.84","68,353.58",
23-Jan-22,Transfer,"14,97,281.80",00.00,"15,65,635.38",
23-Jan-22,Transportellaneous,00.00,"3,13,127.08","12,52,508.30",
24-Jan-22,Cash,00.00,00.00,"12,52,508.30",
24-Jan-22,Debit Card,00.00,"6,26,254.15","6,26,254.15",
25-Jan-22,Transfer,00.00,"89,464.88","5,36,789.27",
25-Jan-22,IMPS,00.00,"53,678.93","4,83,110.34",
25-Jan-22,Interest,00.00,"53,678.93","4,29,431.41",
25-Jan-22,Reversal,05.76,00.00,"4,29,437.17",
25-Jan-22,Interest,00.00,"47,715.24","3,81,721.93",
25-Jan-22,Bill,00.00,"76,344.39","3,05,377.54",
25-Jan-22,RTGS,"25,150.21",00.00,"3,30,527.75",
25-Jan-22,Transfer,00.00,"82,631.94","2,47,895.81",
25-Jan-22,IMPS,00.00,"1,23,947.91","1,23,947.90",
25-Jan-22,Purchase,"20,285.00",00.00,"1,44,232.90",
25-Jan-22,Reversal,56,00.00,"1,44,288.90",
25-Jan-22,Interest,00.00,"72,144.45","72,144.45",
25-Jan-22,Interest,"13,33,325.75",00.00,"14,05,470.20",
25-Jan-22,Commission,00.00,"2,00,781.46","12,04,688.74",
25-Jan-22,ATM,04.02,00.00,"12,04,692.76",
25-Jan-22,Interest,00.00,"2,00,782.13","10,03,910.63",
26-Jan-22,Interest,"37,752.09",00.00,"10,41,662.72",
26-Jan-22,Bill,09.47,00.00,"10,41,672.19",
26-Jan-22,Transportellaneous,00.00,"1,73,612.03","8,68,060.16",
26-Jan-22,Transfer,"16,744.00",00.00,"8,84,804.16",
27-Jan-22,Transportellaneous,"30,895.30",00.00,"9,15,699.46",
27-Jan-22,Transfer,469.33,00.00,"9,16,168.79",
27-Jan-22,Purchase,00.00,"91,616.88","8,24,551.91",
27-Jan-22,ATM,00.00,"4,12,275.96","4,12,275.96",
27-Jan-22,Commission,49.3,00.00,"4,12,325.26",
27-Jan-22,Tax,00.00,"2,06,162.63","2,06,162.63",
27-Jan-22,RTGS,00.00,"51,540.66","1,54,621.97",
27-Jan-22,Debit Card,"2,847.47",00.00,"1,57,469.44",
27-Jan-22,Tax,"4,080.93",00.00,"1,61,550.37",
27-Jan-22,Cheque,"3,398.99",00.00,"1,64,949.36",
27-Jan-22,RTGS,"45,855.90",00.00,"2,10,805.26",
27-Jan-22,Cash,00.00,"26,350.66","1,84,454.60",
27-Jan-22,Purchase,"3,535.90",00.00,"1,87,990.50",
27-Jan-22,ATM,00.00,"37,598.10","1,50,392.40",
27-Jan-22,Debit Card,00.00,"18,799.05","1,31,593.35",
27-Jan-22,Commission,00.00,"21,932.23","1,09,661.12",
27-Jan-22,Cash,"5,14,655.80",00.00,"6,24,316.92",
27-Jan-22,Transfer,"19,178.70",00.00,"6,43,495.62",
27-Jan-22,IMPS,00.00,"1,60,873.91","4,82,621.72",
27-Jan-22,Interest,00.00,"4,82,621.72",00.00,
27-Jan-22,Transportellaneous,"2,126.79",00.00,"2,126.79",
27-Jan-22,Reversal,17.72,00.00,"2,144.51",
28-Jan-22,Transportellaneous,"3,490.60",00.00,"5,635.11",
28-Jan-22,Transfer,00.00,563.51,"5,071.60",
28-Jan-22,Reversal,00.00,"1,267.90","3,803.70",
28-Jan-22,Debit Card,00.00,475.46,"3,328.24",
28-Jan-22,Interest,00.88,00.00,"3,329.12",
28-Jan-22,Reversal,00.00,"1,664.56","1,664.56",
28-Jan-22,RTGS,00.00,416.14,"1,248.42",
28-Jan-22,Bill,"3,489.00",00.00,"4,737.42",
28-Jan-22,Transportellaneous,00.00,676.77,"4,060.65",
28-Jan-22,Transfer,"27,145.00",00.00,"31,205.65",
28-Jan-22,Cheque,00.00,"7,801.41","23,404.24",
28-Jan-22,Transportellaneous,00.00,"11,702.12","11,702.12",
28-Jan-22,RTGS,00.00,"5,851.06","5,851.06",
28-Jan-22,Tax,00.00,"1,950.35","3,900.71",
28-Jan-22,Interest,"11,795.80",00.00,"15,696.51",
28-Jan-22,RTGS,06.60,00.00,"15,703.11",
28-Jan-22,Tax,00.00,"2,243.30","13,459.81",
28-Jan-22,NEFT,00.00,"6,729.91","6,729.90",
28-Jan-22,Cash,"1,673.50",00.00,"8,403.40",
28-Jan-22,IMPS,"1,712.00",00.00,"10,115.40",
28-Jan-22,Tax,03.20,00.00,"10,118.60",
28-Jan-22,Debit Card,00.00,"10,118.60",00.00,
28-Jan-22,Bill,"82,109.00",00.00,"82,109.00",
28-Jan-22,Cheque,238.54,00.00,"82,347.54",
28-Jan-22,Commission,160,00.00,"82,507.54",
28-Jan-22,Purchase,00.40,00.00,"82,507.94",
28-Jan-22,ATM,"30,549.90",00.00,"1,13,057.84",
28-Jan-22,NEFT,00.00,"56,528.92","56,528.92",
28-Jan-22,Purchase,989.4,00.00,"57,518.32",
28-Jan-22,Tax,826.8,00.00,"58,345.12",
28-Jan-22,IMPS,00.00,"19,448.37","38,896.75",
29-Jan-22,Reversal,"1,70,493.06",00.00,"2,09,389.81",
29-Jan-22,Cash,00.00,"29,912.83","1,79,476.98",
29-Jan-22,Interest,00.00,"17,947.70","1,61,529.28",
29-Jan-22,IMPS,00.00,"23,075.61","1,38,453.67",
29-Jan-22,Transfer,"2,46,680.44",00.00,"3,85,134.11",
29-Jan-22,Commission,"37,612.40",00.00,"4,22,746.51",
29-Jan-22,Reversal,06.50,00.00,"4,22,753.01",
30-Jan-22,Debit Card,00.00,"1,40,917.67","2,81,835.34",
30-Jan-22,Transportellaneous,00.00,"28,183.53","2,53,651.81",
30-Jan-22,RTGS,52,00.00,"2,53,703.81",
30-Jan-22,ATM,"2,453.50",00.00,"2,56,157.31",
30-Jan-22,Commission,00.00,"42,692.89","2,13,464.42",
30-Jan-22,Debit Card,00.00,"23,718.27","1,89,746.15",
30-Jan-22,Debit Card,"3,559.00",00.00,"1,93,305.15",
30-Jan-22,Tax,00.00,"96,652.58","96,652.58",
30-Jan-22,Commission,00.00,"12,081.57","84,571.01",
30-Jan-22,Cash,00.00,"14,095.17","70,475.84",
30-Jan-22,Tax,61.63,00.00,"70,537.47",
30-Jan-22,IMPS,422,00.00,"70,959.47",
30-Jan-22,Commission,"2,870.00",00.00,"73,829.47",
30-Jan-22,Purchase,"5,457.74",00.00,"79,287.21",
30-Jan-22,Interest,"9,01,167.25",00.00,"9,80,454.46",
30-Jan-22,Cheque,00.00,"1,08,939.38","8,71,515.08",
30-Jan-22,Cheque,00.00,"1,08,939.39","7,62,575.70",
30-Jan-22,Tax,00.00,"1,90,643.93","5,71,931.77",
30-Jan-22,Purchase,998.47,00.00,"5,72,930.24",
30-Jan-22,Reversal,00.00,"63,658.92","5,09,271.32",
30-Jan-22,Transportellaneous,00.00,"72,753.05","4,36,518.27",
30-Jan-22,Cheque,18,00.00,"4,36,536.27",
30-Jan-22,Reversal,01.00,00.00,"4,36,537.27",
30-Jan-22,RTGS,00.00,"72,756.21","3,63,781.06",
30-Jan-22,ATM,00.00,"1,81,890.53","1,81,890.53",
30-Jan-22,Cash,00.00,"36,378.11","1,45,512.42",
30-Jan-22,Cheque,"1,33,720.00",00.00,"2,79,232.42",
30-Jan-22,Commission,"36,346.00",00.00,"3,15,578.42",
31-Jan-22,Transportellaneous,00.00,"1,57,789.21","1,57,789.21",
31-Jan-22,ATM,"30,744.40",00.00,"1,88,533.61",
31-Jan-22,Debit Card,00.00,"47,133.40","1,41,400.21",
31-Jan-22,RTGS,"1,479.07",00.00,"1,42,879.28",
31-Jan-22,Purchase,00.00,"28,575.86","1,14,303.42",
01-Feb-22,RTGS,00.00,"38,101.14","76,202.28",
01-Feb-22,RTGS,45.9,00.00,"76,248.18",
01-Feb-22,IMPS,00.00,"76,248.18",00.00,
01-Feb-22,Interest,37.57,00.00,37.57,
01-Feb-22,IMPS,00.00,18.79,18.78,
01-Feb-22,IMPS,00.00,01.88,16.9,
01-Feb-22,Transportellaneous,00.00,02.41,14.49,
01-Feb-22,Interest,208.4,00.00,222.89,
01-Feb-22,Debit Card,793,00.00,"1,015.89",
01-Feb-22,ATM,00.00,169.32,846.58,
01-Feb-22,Transfer,00.00,84.66,761.92,
01-Feb-22,Interest,318.82,00.00,"1,080.74",
01-Feb-22,IMPS,"3,271.10",00.00,"4,351.84",
01-Feb-22,Purchase,00.00,"4,351.84",00.00,
01-Feb-22,Transportellaneous,"17,07,793.00",00.00,"17,07,793.00",
01-Feb-22,Bill,57,00.00,"17,07,850.00",
01-Feb-22,Commission,00.00,"5,69,283.33","11,38,566.67",
01-Feb-22,Transportellaneous,164,00.00,"11,38,730.67",
01-Feb-22,RTGS,00.00,"1,62,675.81","9,76,054.86",
01-Feb-22,IMPS,00.00,"3,25,351.62","6,50,703.24",
01-Feb-22,NEFT,"10,133.50",00.00,"6,60,836.74",
01-Feb-22,Cheque,"1,76,317.70",00.00,"8,37,154.44",
01-Feb-22,Reversal,00.00,"1,04,644.31","7,32,510.14",
01-Feb-22,Cash,08.00,00.00,"7,32,518.14",
01-Feb-22,Cheque,"2,232.30",00.00,"7,34,750.44",
01-Feb-22,Tax,"3,252.47",00.00,"7,38,002.91",
01-Feb-22,Commission,06.54,00.00,"7,38,009.45",
01-Feb-22,IMPS,347.79,00.00,"7,38,357.24",
01-Feb-22,Cash,00.00,"1,47,671.45","5,90,685.79",
01-Feb-22,RTGS,"2,011.29",00.00,"5,92,697.08",
01-Feb-22,IMPS,00.00,"98,782.85","4,93,914.23",
01-Feb-22,Cash,"2,922.10",00.00,"4,96,836.33",
01-Feb-22,Transportellaneous,"1,570.97",00.00,"4,98,407.30",
01-Feb-22,Purchase,"38,746.78",00.00,"5,37,154.08",
01-Feb-22,Debit Card,07.90,00.00,"5,37,161.98",
01-Feb-22,Commission,427.51,00.00,"5,37,589.49",
01-Feb-22,NEFT,"13,37,354.00",00.00,"18,74,943.49",
01-Feb-22,Tax,"59,447.20",00.00,"19,34,390.69",
01-Feb-22,ATM,"7,19,155.00",00.00,"26,53,545.69",
01-Feb-22,IMPS,311.3,00.00,"26,53,856.99",
01-Feb-22,RTGS,"8,13,508.50",00.00,"34,67,365.49",
01-Feb-22,Cheque,"25,180.90",00.00,"34,92,546.39",
01-Feb-22,Transfer,00.00,"17,46,273.20","17,46,273.20",
01-Feb-22,Reversal,"30,296.90",00.00,"17,76,570.10",
01-Feb-22,Bill,495.45,00.00,"17,77,065.55",
01-Feb-22,Tax,"29,213.49",00.00,"18,06,279.04",
01-Feb-22,Purchase,"2,09,885.00",00.00,"20,16,164.04",
01-Feb-22,Transfer,00.00,"3,36,027.34","16,80,136.70",
01-Feb-22,ATM,00.00,"3,36,027.34","13,44,109.36",
01-Feb-22,Reversal,"1,199.00",00.00,"13,45,308.36",
01-Feb-22,Debit Card,"11,617.00",00.00,"13,56,925.36",
01-Feb-22,ATM,00.00,"3,39,231.34","10,17,694.02",
01-Feb-22,Bill,07.72,00.00,"10,17,701.74",
01-Feb-22,Commission,382.5,00.00,"10,18,084.24",
01-Feb-22,Interest,00.00,"1,45,440.61","8,72,643.63",
01-Feb-22,Bill,00.00,"1,74,528.73","6,98,114.90",
01-Feb-22,Interest,00.00,"1,16,352.48","5,81,762.42",
01-Feb-22,Transfer,"2,487.80",00.00,"5,84,250.22",
01-Feb-22,Purchase,00.00,"2,92,125.11","2,92,125.11",
01-Feb-22,Cash,"2,49,656.72",00.00,"5,41,781.83",
01-Feb-22,Cash,00.00,"1,35,445.46","4,06,336.37",
01-Feb-22,Tax,19.5,00.00,"4,06,355.87",
01-Feb-22,Cash,695,00.00,"4,07,050.87",
01-Feb-22,RTGS,"2,23,431.10",00.00,"6,30,481.97",
01-Feb-22,Transportellaneous,822.14,00.00,"6,31,304.11",
01-Feb-22,Purchase,"3,478.00",00.00,"6,34,782.11",
01-Feb-22,IMPS,00.00,"3,17,391.06","3,17,391.06",
01-Feb-22,Bill,00.00,"52,898.51","2,64,492.55",
01-Feb-22,Tax,00.00,"1,32,246.28","1,32,246.28",
01-Feb-22,Cheque,00.00,"33,061.57","99,184.71",
01-Feb-22,NEFT,00.00,"49,592.36","49,592.36",
01-Feb-22,NEFT,00.00,"16,530.79","33,061.57",
01-Feb-22,Debit Card,00.00,"3,306.16","29,755.41",
01-Feb-22,Transfer,00.00,"5,951.08","23,804.33",
01-Feb-22,Debit Card,00.00,"7,934.78","15,869.55",
02-Feb-22,Cheque,00.00,"3,967.39","11,902.16",
02-Feb-22,Cheque,00.00,"1,983.69","9,918.47",
02-Feb-22,Transfer,07.00,00.00,"9,925.47",
02-Feb-22,Tax,"10,87,169.00",00.00,"10,97,094.47",
02-Feb-22,Transportellaneous,00.00,"2,74,273.62","8,22,820.85",
02-Feb-22,Bill,00.00,"1,37,136.81","6,85,684.04",
03-Feb-22,Cheque,"2,38,679.30",00.00,"9,24,363.34",
03-Feb-22,Bill,"1,59,138.00",00.00,"10,83,501.34",
03-Feb-22,ATM,00.00,"1,20,389.04","9,63,112.30",
03-Feb-22,Interest,00.00,"96,311.23","8,66,801.07",
03-Feb-22,Transportellaneous,00.00,"8,66,801.07",00.00,
03-Feb-22,Interest,"19,703.00",00.00,"19,703.00",
03-Feb-22,Purchase,00.00,"4,925.75","14,777.25",
03-Feb-22,Cheque,155,00.00,"14,932.25",
03-Feb-22,Interest,00.00,"4,977.42","9,954.83",
04-Feb-22,Commission,00.00,"1,244.35","8,710.48",
04-Feb-22,Reversal,00.00,"1,088.81","7,621.67",
04-Feb-22,Transportellaneous,"6,02,659.50",00.00,"6,10,281.17",
04-Feb-22,IMPS,279,00.00,"6,10,560.17",
04-Feb-22,ATM,"1,66,710.00",00.00,"7,77,270.17",
04-Feb-22,RTGS,00.00,"1,29,545.03","6,47,725.14",
04-Feb-22,Cash,00.00,"1,29,545.03","5,18,180.11",
04-Feb-22,Debit Card,00.00,"86,363.35","4,31,816.76",
04-Feb-22,Commission,00.00,"2,15,908.38","2,15,908.38",
04-Feb-22,Transfer,00.00,"21,590.84","1,94,317.54",
04-Feb-22,NEFT,24,00.00,"1,94,341.54",
04-Feb-22,Debit Card,"87,273.00",00.00,"2,81,614.54",
04-Feb-22,Transportellaneous,00.00,"40,230.65","2,41,383.89",
04-Feb-22,Cash,00.00,"40,230.65","2,01,153.24",
04-Feb-22,Reversal,"2,249.20",00.00,"2,03,402.44",
04-Feb-22,Interest,00.00,"67,800.81","1,35,601.63",
04-Feb-22,ATM,61,00.00,"1,35,662.63",
04-Feb-22,Transportellaneous,"14,00,938.00",00.00,"15,36,600.63",
04-Feb-22,Cash,"1,32,921.94",00.00,"16,69,522.57",
04-Feb-22,NEFT,04.48,00.00,"16,69,527.05",
04-Feb-22,Transportellaneous,"2,939.30",00.00,"16,72,466.35",
04-Feb-22,ATM,686.18,00.00,"16,73,152.53",
04-Feb-22,Interest,00.00,"2,78,858.76","13,94,293.78",
04-Feb-22,NEFT,"19,37,234.25",00.00,"33,31,528.03",
04-Feb-22,Tax,00.00,"16,65,764.02","16,65,764.02",
04-Feb-22,Debit Card,193,00.00,"16,65,957.02",
04-Feb-22,Purchase,590,00.00,"16,66,547.02",
04-Feb-22,Debit Card,"95,319.00",00.00,"17,61,866.02",
04-Feb-22,Tax,"16,667.20",00.00,"17,78,533.22",
04-Feb-22,Transfer,00.00,"3,55,706.64","14,22,826.58",
04-Feb-22,Reversal,"1,32,532.00",00.00,"15,55,358.58",
04-Feb-22,Tax,00.00,"3,11,071.72","12,44,286.86",
04-Feb-22,NEFT,02.37,00.00,"12,44,289.23",
04-Feb-22,Cash,00.00,"1,55,536.15","10,88,753.08",
04-Feb-22,Commission,00.00,"10,88,753.08",00.00,
04-Feb-22,IMPS,"20,19,675.00",00.00,"20,19,675.00",
04-Feb-22,Tax,01.00,00.00,"20,19,676.00",
04-Feb-22,ATM,00.00,"2,88,525.14","17,31,150.86",
04-Feb-22,Transfer,00.00,"2,16,393.86","15,14,757.00",
04-Feb-22,Debit Card,00.00,"15,14,757.00",00.00,
04-Feb-22,Debit Card,"20,02,768.00",00.00,"20,02,768.00",
04-Feb-22,Tax,"2,02,927.47",00.00,"22,05,695.47",
04-Feb-22,Reversal,00.00,"11,02,847.74","11,02,847.74",
04-Feb-22,Tax,"2,52,545.25",00.00,"13,55,392.99",
04-Feb-22,Commission,00.00,"1,50,599.22","12,04,793.77",
04-Feb-22,RTGS,"10,40,686.75",00.00,"22,45,480.52",
04-Feb-22,Cash,00.00,"22,45,480.52",00.00,
04-Feb-22,Cheque,"13,280.53",00.00,"13,280.53",
04-Feb-22,Reversal,05.00,00.00,"13,285.53",
05-Feb-22,IMPS,312.09,00.00,"13,597.62",
06-Feb-22,RTGS,00.00,"1,942.52","11,655.10",
06-Feb-22,ATM,00.00,"1,295.01","10,360.09",
06-Feb-22,ATM,"38,862.00",00.00,"49,222.09",
06-Feb-22,Bill,45.4,00.00,"49,267.49",
06-Feb-22,RTGS,00.00,"49,267.49",00.00,
06-Feb-22,ATM,"2,704.00",00.00,"2,704.00",
06-Feb-22,Cheque,"3,431.40",00.00,"6,135.40",
06-Feb-22,Interest,00.00,766.93,"5,368.48",
06-Feb-22,Tax,00.00,"2,684.24","2,684.24",
06-Feb-22,ATM,207.8,00.00,"2,892.04",
06-Feb-22,ATM,00.00,289.2,"2,602.84",
06-Feb-22,Commission,"1,595.11",00.00,"4,197.95",
06-Feb-22,Commission,00.00,419.8,"3,778.16",
06-Feb-22,Purchase,00.00,"3,778.16",00.00,
06-Feb-22,Interest,"13,57,874.00",00.00,"13,57,874.00",
06-Feb-22,Commission,410.1,00.00,"13,58,284.10",
06-Feb-22,Interest,"6,66,836.00",00.00,"20,25,120.10",
06-Feb-22,Cash,157.31,00.00,"20,25,277.41",
06-Feb-22,Cash,01.00,00.00,"20,25,278.41",
06-Feb-22,Cash,440.8,00.00,"20,25,719.21",
06-Feb-22,RTGS,00.00,"20,25,719.21",00.00,
06-Feb-22,ATM,"19,878.78",00.00,"19,878.78",
06-Feb-22,ATM,00.00,"9,939.39","9,939.39",
06-Feb-22,Cash,"2,11,090.00",00.00,"2,21,029.39",
06-Feb-22,ATM,466.71,00.00,"2,21,496.10",
06-Feb-22,RTGS,00.00,"55,374.03","1,66,122.08",
06-Feb-22,Interest,00.00,"55,374.03","1,10,748.05",
06-Feb-22,Debit Card,00.00,"15,821.15","94,926.90",
06-Feb-22,Purchase,00.00,"94,926.90",00.00,
06-Feb-22,Interest,287.1,00.00,287.1,
06-Feb-22,Reversal,00.00,71.78,215.32,
07-Feb-22,Transportellaneous,00.00,21.53,193.79,
07-Feb-22,Transportellaneous,06.00,00.00,199.79,
07-Feb-22,Purchase,00.00,39.96,159.83,
07-Feb-22,ATM,"1,46,889.00",00.00,"1,47,048.83",
07-Feb-22,Commission,371.03,00.00,"1,47,419.86",
07-Feb-22,Cash,"2,05,487.30",00.00,"3,52,907.16",
07-Feb-22,Tax,00.00,"1,76,453.58","1,76,453.58",
07-Feb-22,RTGS,00.00,"44,113.40","1,32,340.18",
07-Feb-22,Commission,321.2,00.00,"1,32,661.38",
07-Feb-22,Reversal,"3,321.00",00.00,"1,35,982.38",
07-Feb-22,Reversal,00.00,"13,598.24","1,22,384.14",
08-Feb-22,ATM,00.10,00.00,"1,22,384.24",
08-Feb-22,Purchase,00.00,"1,22,384.24",00.00,
08-Feb-22,Interest,02.47,00.00,02.47,
08-Feb-22,Debit Card,"2,829.00",00.00,"2,831.47",
09-Feb-22,Transfer,00.00,471.91,"2,359.56",
09-Feb-22,Commission,00.00,393.26,"1,966.30",
09-Feb-22,Cash,"19,34,891.50",00.00,"19,36,857.80",
09-Feb-22,ATM,"10,754.20",00.00,"19,47,612.00",
09-Feb-22,NEFT,"2,535.00",00.00,"19,50,147.00",
09-Feb-22,Commission,"29,306.40",00.00,"19,79,453.40",
09-Feb-22,Purchase,00.00,00.00,"19,79,453.40",
09-Feb-22,ATM,00.00,"4,94,863.35","14,84,590.05",
09-Feb-22,Tax,"2,452.50",00.00,"14,87,042.55",
09-Feb-22,Transportellaneous,49.84,00.00,"14,87,092.39",
09-Feb-22,Transfer,"3,299.00",00.00,"14,90,391.39",
09-Feb-22,ATM,"12,151.00",00.00,"15,02,542.39",
09-Feb-22,Cash,42.74,00.00,"15,02,585.13",
09-Feb-22,ATM,00.00,"1,50,258.51","13,52,326.62",
10-Feb-22,Transportellaneous,03.80,00.00,"13,52,330.42",
10-Feb-22,Cash,00.00,"2,25,388.40","11,26,942.02",
10-Feb-22,Transfer,00.00,"2,25,388.40","9,01,553.62",
10-Feb-22,Purchase,00.00,"2,25,388.41","6,76,165.22",
10-Feb-22,Purchase,00.00,"1,12,694.20","5,63,471.02",
10-Feb-22,Transfer,315,00.00,"5,63,786.02",
10-Feb-22,Bill,00.00,"70,473.25","4,93,312.77",
10-Feb-22,Bill,00.00,"49,331.28","4,43,981.49",
10-Feb-22,IMPS,00.00,"73,996.92","3,69,984.58",
10-Feb-22,Cash,06.70,00.00,"3,69,991.28",
10-Feb-22,Tax,00.00,"92,497.82","2,77,493.46",
10-Feb-22,Transfer,00.00,"30,832.61","2,46,660.85",
10-Feb-22,Transportellaneous,00.00,"27,406.76","2,19,254.09",
10-Feb-22,Transportellaneous,00.00,"27,406.76","1,91,847.33",
10-Feb-22,NEFT,04.00,00.00,"1,91,851.33",
10-Feb-22,Debit Card,26.9,00.00,"1,91,878.23",
10-Feb-22,Cash,"1,673.30",00.00,"1,93,551.53",
10-Feb-22,Debit Card,00.00,"96,775.77","96,775.76",
10-Feb-22,Interest,00.00,"13,825.11","82,950.65",
10-Feb-22,ATM,"18,68,605.80",00.00,"19,51,556.45",
10-Feb-22,Bill,00.00,"3,25,259.41","16,26,297.04",
10-Feb-22,Purchase,00.00,"2,03,287.13","14,23,009.91",
10-Feb-22,Transfer,00.00,"7,11,504.96","7,11,504.96",
10-Feb-22,ATM,00.00,"1,18,584.16","5,92,920.80",
10-Feb-22,Cheque,00.00,"1,48,230.20","4,44,690.60",
10-Feb-22,Commission,00.00,"63,527.23","3,81,163.37",
10-Feb-22,IMPS,497.12,00.00,"3,81,660.49",
10-Feb-22,Cheque,00.00,"76,332.10","3,05,328.39",
10-Feb-22,Cheque,"27,344.40",00.00,"3,32,672.79",
10-Feb-22,Tax,"11,113.00",00.00,"3,43,785.79",
10-Feb-22,Tax,"19,18,019.00",00.00,"22,61,804.79",
10-Feb-22,Cash,00.00,"2,26,180.48","20,35,624.31",
10-Feb-22,RTGS,00.00,"2,03,562.43","18,32,061.88",
10-Feb-22,Transportellaneous,00.00,"2,29,007.74","16,03,054.14",
10-Feb-22,Transfer,00.00,"5,34,351.38","10,68,702.76",
10-Feb-22,Reversal,00.00,"1,33,587.85","9,35,114.92",
10-Feb-22,Cheque,"16,79,151.50",00.00,"26,14,266.42",
10-Feb-22,Cash,00.00,"4,35,711.07","21,78,555.35",
10-Feb-22,NEFT,00.00,"5,44,638.84","16,33,916.51",
10-Feb-22,Tax,01.41,00.00,"16,33,917.92",
10-Feb-22,Cheque,00.00,"8,16,958.96","8,16,958.96",
11-Feb-22,Debit Card,00.00,"81,695.90","7,35,263.06",
11-Feb-22,RTGS,00.00,"91,907.88","6,43,355.18",
11-Feb-22,ATM,00.00,"3,21,677.59","3,21,677.59",
11-Feb-22,Tax,00.00,"32,167.76","2,89,509.83",
12-Feb-22,Transfer,00.00,"57,901.97","2,31,607.86",
12-Feb-22,IMPS,"51,141.88",00.00,"2,82,749.74",
12-Feb-22,ATM,"5,25,955.00",00.00,"8,08,704.74",
12-Feb-22,RTGS,00.00,"80,870.47","7,27,834.27",
12-Feb-22,IMPS,"60,387.00",00.00,"7,88,221.27",
12-Feb-22,Interest,"3,186.40",00.00,"7,91,407.67",
12-Feb-22,Tax,"14,529.00",00.00,"8,05,936.67",
12-Feb-22,Debit Card,248,00.00,"8,06,184.67",
12-Feb-22,Debit Card,"13,118.93",00.00,"8,19,303.60",
12-Feb-22,IMPS,35.6,00.00,"8,19,339.20",
12-Feb-22,NEFT,00.00,"1,36,556.53","6,82,782.67",
12-Feb-22,Tax,00.00,"75,864.74","6,06,917.93",
12-Feb-22,Reversal,00.00,"75,864.74","5,31,053.19",
12-Feb-22,Transportellaneous,00.00,"5,31,053.19",00.00,
12-Feb-22,RTGS,"11,59,643.80",00.00,"11,59,643.80",
12-Feb-22,Cheque,00.00,"11,59,643.80",00.00,
12-Feb-22,Bill,05.00,00.00,05.00,
12-Feb-22,Debit Card,00.00,00.63,04.38,
12-Feb-22,Purchase,"2,129.00",00.00,"2,133.38",
12-Feb-22,Commission,00.00,711.13,"1,422.25",
12-Feb-22,Transfer,00.00,158.03,"1,264.22",
12-Feb-22,Tax,"15,133.00",00.00,"16,397.22",
12-Feb-22,Interest,00.00,"2,342.46","14,054.76",
12-Feb-22,NEFT,862.3,00.00,"14,917.06",
12-Feb-22,RTGS,00.00,"2,486.18","12,430.88",
12-Feb-22,Transportellaneous,759,00.00,"13,189.88",
13-Feb-22,Reversal,57.68,00.00,"13,247.56",
13-Feb-22,NEFT,00.00,"4,415.85","8,831.71",
13-Feb-22,Bill,00.00,"4,415.86","4,415.85",
13-Feb-22,Bill,825.1,00.00,"5,240.95",
13-Feb-22,Transfer,00.00,"1,746.98","3,493.97",
13-Feb-22,Interest,500,00.00,"3,993.97",
13-Feb-22,Transfer,00.00,399.4,"3,594.57",
13-Feb-22,Transfer,"16,54,791.00",00.00,"16,58,385.57",
13-Feb-22,Purchase,03.00,00.00,"16,58,388.57",
13-Feb-22,Commission,"24,781.00",00.00,"16,83,169.57",
13-Feb-22,Purchase,"13,10,128.25",00.00,"29,93,297.82",
13-Feb-22,Tax,44,00.00,"29,93,341.82",
13-Feb-22,Cheque,00.00,00.00,"29,93,341.82",
13-Feb-22,Interest,00.00,"29,93,341.82",00.00,
13-Feb-22,Commission,"31,181.00",00.00,"31,181.00",
13-Feb-22,Transportellaneous,00.00,"5,196.83","25,984.17",
13-Feb-22,Interest,300,00.00,"26,284.17",
13-Feb-22,ATM,00.00,"8,761.39","17,522.78",
13-Feb-22,Transportellaneous,"10,878.35",00.00,"28,401.13",
13-Feb-22,ATM,00.00,"4,733.52","23,667.61",
13-Feb-22,Reversal,"17,90,196.00",00.00,"18,13,863.61",
13-Feb-22,Reversal,00.00,"3,02,310.60","15,11,553.01",
13-Feb-22,Commission,00.00,"5,03,851.00","10,07,702.01",
13-Feb-22,Tax,00.00,"1,25,962.75","8,81,739.26",
13-Feb-22,NEFT,"7,67,398.75",00.00,"16,49,138.01",
13-Feb-22,Interest,108.78,00.00,"16,49,246.79",
13-Feb-22,Cash,00.00,"2,35,606.68","14,13,640.11",
13-Feb-22,Tax,00.00,"1,76,705.01","12,36,935.10",
13-Feb-22,Commission,00.00,"12,36,935.10",00.00,
13-Feb-22,Reversal,"18,183.00",00.00,"18,183.00",
13-Feb-22,Transportellaneous,"26,512.00",00.00,"44,695.00",
13-Feb-22,NEFT,"6,069.10",00.00,"50,764.10",
13-Feb-22,Transportellaneous,00.00,"8,460.68","42,303.42",
14-Feb-22,Commission,"19,899.00",00.00,"62,202.42",
14-Feb-22,Purchase,00.00,"15,550.61","46,651.82",
14-Feb-22,Interest,"15,739.80",00.00,"62,391.62",
14-Feb-22,NEFT,"19,61,855.80",00.00,"20,24,247.42",
14-Feb-22,Reversal,00.00,"2,89,178.20","17,35,069.22",
14-Feb-22,Purchase,"3,914.10",00.00,"17,38,983.32",
14-Feb-22,Cheque,00.42,00.00,"17,38,983.74",
14-Feb-22,Reversal,"4,282.80",00.00,"17,43,266.54",
14-Feb-22,Transfer,"1,32,086.00",00.00,"18,75,352.54",
14-Feb-22,IMPS,00.00,"9,37,676.27","9,37,676.27",
14-Feb-22,Cash,"3,113.70",00.00,"9,40,789.97",
14-Feb-22,Transfer,00.00,"2,35,197.49","7,05,592.48",
14-Feb-22,Cheque,00.00,"1,41,118.50","5,64,473.98",
14-Feb-22,NEFT,00.00,"2,82,236.99","2,82,236.99",
14-Feb-22,Tax,07.00,00.00,"2,82,243.99",
14-Feb-22,RTGS,00.00,"47,040.67","2,35,203.32",
14-Feb-22,IMPS,02.00,00.00,"2,35,205.32",
14-Feb-22,Transfer,00.00,"1,17,602.66","1,17,602.66",
14-Feb-22,Transportellaneous,00.00,"39,200.89","78,401.77",
14-Feb-22,Debit Card,06.00,00.00,"78,407.77",
14-Feb-22,Cheque,00.00,"78,407.77",00.00,
14-Feb-22,Transportellaneous,994.03,00.00,994.03,
14-Feb-22,Transfer,00.00,99.4,894.63,
14-Feb-22,Cash,"65,080.00",00.00,"65,974.63",
14-Feb-22,Transfer,"1,24,315.56",00.00,"1,90,290.19",
15-Feb-22,Reversal,00.00,"19,029.02","1,71,261.17",
15-Feb-22,Commission,00.00,"17,126.12","1,54,135.05",
15-Feb-22,Reversal,"1,27,490.22",00.00,"2,81,625.27",
15-Feb-22,Tax,299,00.00,"2,81,924.27",
15-Feb-22,Purchase,80,00.00,"2,82,004.27",
15-Feb-22,Cheque,00.00,"47,000.71","2,35,003.56",
15-Feb-22,Purchase,00.00,"1,17,501.78","1,17,501.78",
15-Feb-22,NEFT,"2,342.31",00.00,"1,19,844.09",
15-Feb-22,Commission,46.5,00.00,"1,19,890.59",
15-Feb-22,Tax,"7,01,388.00",00.00,"8,21,278.59",
15-Feb-22,Tax,00.00,"82,127.86","7,39,150.73",
15-Feb-22,Reversal,00.00,"1,05,592.96","6,33,557.77",
15-Feb-22,RTGS,00.00,"3,16,778.89","3,16,778.88",
15-Feb-22,NEFT,00.00,"39,597.36","2,77,181.52",
15-Feb-22,Transfer,00.00,"69,295.38","2,07,886.14",
15-Feb-22,Transportellaneous,00.00,"20,788.61","1,87,097.53",
15-Feb-22,Tax,00.00,"37,419.51","1,49,678.02",
15-Feb-22,Tax,"2,02,536.20",00.00,"3,52,214.22",
15-Feb-22,IMPS,"2,72,285.75",00.00,"6,24,499.97",
15-Feb-22,Transfer,429.81,00.00,"6,24,929.78",
15-Feb-22,NEFT,"17,49,635.25",00.00,"23,74,565.03",
15-Feb-22,NEFT,00.00,"5,93,641.26","17,80,923.77",
15-Feb-22,ATM,00.00,"17,80,923.77",00.00,
15-Feb-22,Transportellaneous,"1,84,747.80",00.00,"1,84,747.80",
15-Feb-22,Bill,00.00,"1,84,747.80",00.00,
15-Feb-22,Reversal,61.54,00.00,61.54,
15-Feb-22,Transportellaneous,00.00,61.54,00.00,
15-Feb-22,Bill,15.39,00.00,15.39,
15-Feb-22,Commission,00.00,01.71,13.68,
15-Feb-22,Commission,00.00,01.52,12.16,
15-Feb-22,Interest,00.00,01.22,10.94,
15-Feb-22,IMPS,423.3,00.00,434.24,
15-Feb-22,ATM,"10,26,348.00",00.00,"10,26,782.24",
15-Feb-22,Commission,"26,846.72",00.00,"10,53,628.96",
15-Feb-22,Tax,"2,19,429.00",00.00,"12,73,057.96",
15-Feb-22,Cash,00.00,"12,73,057.96",00.00,
15-Feb-22,Cheque,156.7,00.00,156.7,
15-Feb-22,Cheque,00.00,22.39,134.31,
15-Feb-22,RTGS,00.00,16.79,117.52,
15-Feb-22,Purchase,00.00,58.76,58.76,
15-Feb-22,Transfer,"1,098.00",00.00,"1,156.76",
15-Feb-22,ATM,04.10,00.00,"1,160.86",
15-Feb-22,Transfer,00.00,116.09,"1,044.77",
15-Feb-22,Purchase,00.00,130.6,914.17,
15-Feb-22,RTGS,"1,640.00",00.00,"2,554.17",
15-Feb-22,Cash,00.00,425.7,"2,128.48",
15-Feb-22,Tax,00.00,304.07,"1,824.41",
15-Feb-22,IMPS,57.4,00.00,"1,881.81",
15-Feb-22,Debit Card,02.40,00.00,"1,884.21",
15-Feb-22,Debit Card,00.00,376.84,"1,507.37",
15-Feb-22,Commission,00.00,502.46,"1,004.91",
15-Feb-22,ATM,00.00,"1,004.91",00.00,
15-Feb-22,Purchase,"21,816.40",00.00,"21,816.40",
15-Feb-22,Cash,00.00,"2,727.05","19,089.35",
15-Feb-22,Bill,00.00,"1,908.94","17,180.41",
15-Feb-22,Bill,"79,990.81",00.00,"97,171.22",
15-Feb-22,Tax,00.00,"12,146.40","85,024.82",
15-Feb-22,Tax,00.00,"21,256.21","63,768.62",
15-Feb-22,Cheque,"1,07,463.50",00.00,"1,71,232.12",
15-Feb-22,Transfer,00.00,"17,123.21","1,54,108.91",
15-Feb-22,Debit Card,00.00,"17,123.21","1,36,985.70",
15-Feb-22,Transportellaneous,"10,086.00",00.00,"1,47,071.70",
15-Feb-22,Transportellaneous,00.00,"73,535.85","73,535.85",
15-Feb-22,RTGS,82.8,00.00,"73,618.65",
15-Feb-22,Cheque,"3,913.88",00.00,"77,532.53",
15-Feb-22,Cash,00.00,"77,532.53",00.00,
15-Feb-22,Transportellaneous,"3,349.00",00.00,"3,349.00",
15-Feb-22,Commission,"14,58,663.50",00.00,"14,62,012.50",
15-Feb-22,NEFT,00.00,"14,62,012.50",00.00,
15-Feb-22,Cheque,"19,40,785.00",00.00,"19,40,785.00",
15-Feb-22,Purchase,385.6,00.00,"19,41,170.60",
15-Feb-22,IMPS,00.00,"2,15,685.62","17,25,484.98",
15-Feb-22,Transfer,00.00,"2,87,580.83","14,37,904.15",
15-Feb-22,Cheque,"16,11,132.00",00.00,"30,49,036.15",
15-Feb-22,Cheque,55.94,00.00,"30,49,092.09",
15-Feb-22,RTGS,00.00,"3,81,136.51","26,67,955.58",
15-Feb-22,IMPS,00.00,"6,66,988.90","20,00,966.68",
15-Feb-22,ATM,00.00,"5,00,241.67","15,00,725.01",
15-Feb-22,Bill,"2,38,303.30",00.00,"17,39,028.31",
15-Feb-22,Transportellaneous,00.00,"17,39,028.31",00.00,
15-Feb-22,Purchase,"11,16,176.00",00.00,"11,16,176.00",
15-Feb-22,Bill,"30,011.80",00.00,"11,46,187.80",
15-Feb-22,Debit Card,143,00.00,"11,46,330.80",
15-Feb-22,RTGS,421.47,00.00,"11,46,752.27",
15-Feb-22,Reversal,217.1,00.00,"11,46,969.37",
15-Feb-22,Transportellaneous,00.00,"1,63,852.77","9,83,116.60",
15-Feb-22,Cash,"3,646.63",00.00,"9,86,763.23",
15-Feb-22,Debit Card,"2,12,034.00",00.00,"11,98,797.23",
15-Feb-22,Commission,"3,753.00",00.00,"12,02,550.23",
15-Feb-22,ATM,80.93,00.00,"12,02,631.16",
15-Feb-22,ATM,00.00,"1,20,263.12","10,82,368.04",
15-Feb-22,ATM,474.01,00.00,"10,82,842.05",
15-Feb-22,Tax,00.00,"1,08,284.21","9,74,557.85",
15-Feb-22,Cheque,00.00,"9,74,557.85",00.00,
15-Feb-22,Interest,"2,507.01",00.00,"2,507.01",
15-Feb-22,ATM,00.00,278.56,"2,228.45",
15-Feb-22,ATM,00.00,"1,114.23","1,114.22",
15-Feb-22,Cash,00.00,222.84,891.38,
15-Feb-22,RTGS,00.00,445.69,445.69,
15-Feb-22,Bill,142,00.00,587.69,
15-Feb-22,Reversal,00.00,587.69,00.00,
15-Feb-22,Commission,96.8,00.00,96.8,
15-Feb-22,Cash,00.00,10.76,86.04,
15-Feb-22,Cash,00.00,09.56,76.48,
15-Feb-22,Purchase,51.8,00.00,128.28,
15-Feb-22,Transportellaneous,06.78,00.00,135.06,
15-Feb-22,Purchase,20.6,00.00,155.66,
15-Feb-22,Purchase,23.1,00.00,178.76,
15-Feb-22,Commission,00.00,19.86,158.9,
15-Feb-22,Cash,"2,07,911.90",00.00,"2,08,070.80",
15-Feb-22,Purchase,"27,004.29",00.00,"2,35,075.09",
15-Feb-22,RTGS,00.00,"1,17,537.55","1,17,537.54",
15-Feb-22,Tax,07.00,00.00,"1,17,544.54",
15-Feb-22,Commission,"18,48,778.00",00.00,"19,66,322.54",
15-Feb-22,Cheque,56.43,00.00,"19,66,378.97",
15-Feb-22,RTGS,"2,37,085.00",00.00,"22,03,463.97",
15-Feb-22,Transportellaneous,00.00,"2,44,829.33","19,58,634.64",
15-Feb-22,Purchase,00.00,"1,95,863.46","17,62,771.18",
15-Feb-22,RTGS,00.00,"2,20,346.40","15,42,424.78",
15-Feb-22,IMPS,"31,650.00",00.00,"15,74,074.78",
15-Feb-22,Commission,"11,914.20",00.00,"15,85,988.98",
15-Feb-22,Debit Card,00.00,"7,92,994.49","7,92,994.49",
15-Feb-22,Debit Card,00.00,"1,58,598.90","6,34,395.59",
15-Feb-22,Reversal,00.00,"70,488.40","5,63,907.19",
15-Feb-22,ATM,00.00,"56,390.72","5,07,516.47",
15-Feb-22,Transfer,55.85,00.00,"5,07,572.32",
15-Feb-22,Transfer,00.00,"2,53,786.16","2,53,786.16",
16-Feb-22,ATM,00.00,"25,378.62","2,28,407.54",
16-Feb-22,RTGS,"1,99,710.53",00.00,"4,28,118.07",
16-Feb-22,Purchase,00.00,"61,159.72","3,66,958.35",
16-Feb-22,Transfer,00.00,"52,422.62","3,14,535.73",
16-Feb-22,Purchase,279.29,00.00,"3,14,815.02",
16-Feb-22,Tax,00.00,"3,14,815.02",00.00,
16-Feb-22,Transportellaneous,12,00.00,12,
16-Feb-22,Reversal,59,00.00,71,
16-Feb-22,RTGS,00.00,07.89,63.11,
16-Feb-22,NEFT,"2,756.93",00.00,"2,820.04",
16-Feb-22,Tax,00.00,470.01,"2,350.03",
16-Feb-22,Debit Card,00.00,"2,350.03",00.00,
16-Feb-22,Purchase,"11,600.70",00.00,"11,600.70",
16-Feb-22,Bill,249.26,00.00,"11,849.96",
16-Feb-22,Interest,00.00,"1,692.85","10,157.11",
16-Feb-22,ATM,"39,397.00",00.00,"49,554.11",
16-Feb-22,Interest,00.00,"4,955.41","44,598.70",
16-Feb-22,ATM,503.8,00.00,"45,102.50",
16-Feb-22,RTGS,"28,820.20",00.00,"73,922.70",
16-Feb-22,Cash,00.00,"14,784.54","59,138.16",
16-Feb-22,Cheque,00.00,"59,138.16",00.00,
16-Feb-22,Bill,"1,88,956.41",00.00,"1,88,956.41",
16-Feb-22,Transportellaneous,00.00,"47,239.10","1,41,717.31",
16-Feb-22,Purchase,00.00,"70,858.66","70,858.66",
16-Feb-22,Transportellaneous,"11,03,550.50",00.00,"11,74,409.16",
16-Feb-22,RTGS,"2,17,956.78",00.00,"13,92,365.94",
16-Feb-22,NEFT,80,00.00,"13,92,445.94",
16-Feb-22,Tax,06.00,00.00,"13,92,451.94",
16-Feb-22,Commission,00.00,"2,32,075.32","11,60,376.62",
16-Feb-22,RTGS,00.00,"1,93,396.10","9,66,980.52",
16-Feb-22,RTGS,00.00,"1,93,396.10","7,73,584.42",
16-Feb-22,IMPS,"14,809.00",00.00,"7,88,393.42",
16-Feb-22,IMPS,"3,04,788.50",00.00,"10,93,181.92",
16-Feb-22,Purchase,00.00,"1,56,168.85","9,37,013.07",
16-Feb-22,Purchase,36,00.00,"9,37,049.07",
16-Feb-22,NEFT,00.00,"9,37,049.07",00.00,
16-Feb-22,Cash,126.62,00.00,126.62,
16-Feb-22,IMPS,"2,41,461.91",00.00,"2,41,588.53",
16-Feb-22,IMPS,00.00,"34,512.65","2,07,075.88",
16-Feb-22,Bill,"30,421.90",00.00,"2,37,497.78",
16-Feb-22,NEFT,00.00,"33,928.25","2,03,569.53",
16-Feb-22,Transfer,00.00,"20,356.95","1,83,212.58",
16-Feb-22,Transportellaneous,"15,824.10",00.00,"1,99,036.68",
16-Feb-22,Interest,"2,40,961.97",00.00,"4,39,998.65",
16-Feb-22,Cheque,00.00,"87,999.73","3,51,998.92",
16-Feb-22,RTGS,00.00,"1,75,999.46","1,75,999.46",
16-Feb-22,Transfer,346.81,00.00,"1,76,346.27",
16-Feb-22,RTGS,"13,37,155.00",00.00,"15,13,501.27",
16-Feb-22,Cash,17,00.00,"15,13,518.27",
16-Feb-22,Transportellaneous,00.00,"1,89,189.78","13,24,328.49",
16-Feb-22,RTGS,03.00,00.00,"13,24,331.49",
16-Feb-22,Commission,"1,252.30",00.00,"13,25,583.79",
16-Feb-22,Transportellaneous,"4,078.00",00.00,"13,29,661.79",
16-Feb-22,Purchase,00.00,"1,66,207.72","11,63,454.07",
16-Feb-22,Transfer,"11,82,629.00",00.00,"23,46,083.07",
16-Feb-22,NEFT,00.00,"2,34,608.31","21,11,474.76",
16-Feb-22,Tax,00.00,"7,03,824.92","14,07,649.84",
16-Feb-22,Purchase,"18,295.78",00.00,"14,25,945.62",
16-Feb-22,Cash,53.1,00.00,"14,25,998.72",
16-Feb-22,RTGS,00.00,"3,56,499.68","10,69,499.04",
16-Feb-22,Tax,52,00.00,"10,69,551.04",
16-Feb-22,ATM,"15,670.50",00.00,"10,85,221.54",
16-Feb-22,ATM,"1,60,795.38",00.00,"12,46,016.92",
16-Feb-22,Bill,00.00,"3,11,504.23","9,34,512.69",
16-Feb-22,NEFT,00.00,"3,11,504.23","6,23,008.46",
16-Feb-22,Debit Card,"13,113.00",00.00,"6,36,121.46",
16-Feb-22,Debit Card,00.00,"70,680.16","5,65,441.30",
16-Feb-22,Transfer,00.00,"5,65,441.30",00.00,
16-Feb-22,Transfer,68.45,00.00,68.45,
16-Feb-22,Tax,02.60,00.00,71.05,
16-Feb-22,Tax,00.00,17.76,53.29,
16-Feb-22,RTGS,00.00,07.61,45.68,
16-Feb-22,Bill,00.00,00.00,45.68,
16-Feb-22,Purchase,00.00,11.42,34.26,
16-Feb-22,RTGS,"2,204.43",00.00,"2,238.69",
16-Feb-22,Transportellaneous,"1,49,157.00",00.00,"1,51,395.69",
16-Feb-22,Transportellaneous,03.70,00.00,"1,51,399.39",
16-Feb-22,NEFT,00.00,"25,233.23","1,26,166.16",
16-Feb-22,Reversal,00.00,"18,023.74","1,08,142.42",
16-Feb-22,Transportellaneous,00.00,"1,08,142.42",00.00,
16-Feb-22,IMPS,"2,04,483.06",00.00,"2,04,483.06",
16-Feb-22,Tax,00.00,"25,560.38","1,78,922.68",
16-Feb-22,Cash,181.6,00.00,"1,79,104.28",
16-Feb-22,Cheque,325,00.00,"1,79,429.28",
16-Feb-22,Reversal,00.00,"29,904.88","1,49,524.40",
16-Feb-22,RTGS,371,00.00,"1,49,895.40",
16-Feb-22,IMPS,00.00,"29,979.08","1,19,916.32",
16-Feb-22,Cash,00.00,"14,989.54","1,04,926.78",
16-Feb-22,IMPS,00.00,"11,658.53","93,268.25",
16-Feb-22,Tax,00.00,"10,363.14","82,905.11",
16-Feb-22,Debit Card,"31,241.10",00.00,"1,14,146.21",
16-Feb-22,IMPS,"3,87,507.80",00.00,"5,01,654.01",
17-Feb-22,NEFT,00.00,"1,67,218.00","3,34,436.01",
17-Feb-22,ATM,00.00,"55,739.34","2,78,696.68",
17-Feb-22,Transportellaneous,00.00,"2,78,696.68",00.00,
17-Feb-22,Purchase,03.50,00.00,03.50,
17-Feb-22,Commission,"27,837.10",00.00,"27,840.60",
17-Feb-22,Cheque,00.00,"2,784.06","25,056.54",
17-Feb-22,Debit Card,129,00.00,"25,185.54",
17-Feb-22,Transfer,00.00,"5,037.11","20,148.43",
17-Feb-22,Transportellaneous,00.00,"2,014.84","18,133.59",
17-Feb-22,RTGS,02.50,00.00,"18,136.09",
17-Feb-22,Interest,"15,245.12",00.00,"33,381.21",
17-Feb-22,ATM,"27,942.70",00.00,"61,323.91",
17-Feb-22,ATM,00.00,"8,760.56","52,563.35",
17-Feb-22,Purchase,326,00.00,"52,889.35",
17-Feb-22,Debit Card,"1,09,750.50",00.00,"1,62,639.85",
17-Feb-22,Bill,50,00.00,"1,62,689.85",
17-Feb-22,Transportellaneous,00.00,"1,62,689.85",00.00,
17-Feb-22,Bill,244,00.00,244,
17-Feb-22,ATM,00.00,81.33,162.67,
17-Feb-22,RTGS,"2,00,563.00",00.00,"2,00,725.67",
17-Feb-22,Debit Card,"66,638.00",00.00,"2,67,363.67",
17-Feb-22,Cheque,"2,38,369.00",00.00,"5,05,732.67",
17-Feb-22,Debit Card,00.00,"56,192.52","4,49,540.15",
17-Feb-22,Transportellaneous,"4,037.60",00.00,"4,53,577.75",
17-Feb-22,Bill,00.00,"1,13,394.44","3,40,183.31",
17-Feb-22,ATM,00.00,"85,045.83","2,55,137.48",
17-Feb-22,Commission,00.00,"36,448.21","2,18,689.27",
18-Feb-22,Commission,00.00,"43,737.85","1,74,951.42",
18-Feb-22,Bill,00.00,"87,475.71","87,475.71",
18-Feb-22,Interest,00.00,"9,719.52","77,756.19",
18-Feb-22,IMPS,00.00,"25,918.73","51,837.46",
18-Feb-22,Transfer,00.00,"5,183.75","46,653.71",
18-Feb-22,IMPS,"23,363.50",00.00,"70,017.21",
18-Feb-22,Debit Card,00.00,"14,003.44","56,013.77",
18-Feb-22,RTGS,271.3,00.00,"56,285.07",
18-Feb-22,Reversal,"2,489.20",00.00,"58,774.27",
18-Feb-22,Tax,00.00,"6,530.47","52,243.80",
18-Feb-22,Debit Card,00.00,"5,804.87","46,438.93",
18-Feb-22,ATM,04.45,00.00,"46,443.38",
18-Feb-22,Transfer,"2,43,482.20",00.00,"2,89,925.58",
18-Feb-22,Cheque,235.62,00.00,"2,90,161.20",
18-Feb-22,IMPS,06.00,00.00,"2,90,167.20",
18-Feb-22,NEFT,00.00,"58,033.44","2,32,133.76",
18-Feb-22,RTGS,"9,023.10",00.00,"2,41,156.86",
18-Feb-22,Commission,00.00,"80,385.62","1,60,771.24",
18-Feb-22,Commission,00.00,"26,795.21","1,33,976.03",
18-Feb-22,Purchase,56,00.00,"1,34,032.03",
18-Feb-22,RTGS,"6,72,599.80",00.00,"8,06,631.83",
18-Feb-22,Commission,"98,702.00",00.00,"9,05,333.83",
18-Feb-22,NEFT,"1,62,131.70",00.00,"10,67,465.53",
18-Feb-22,Tax,00.00,"3,55,821.84","7,11,643.69",
18-Feb-22,Commission,36.25,00.00,"7,11,679.94",
18-Feb-22,Tax,00.00,"1,42,335.99","5,69,343.95",
18-Feb-22,Reversal,00.00,"63,260.44","5,06,083.51",
18-Feb-22,IMPS,41.6,00.00,"5,06,125.11",
18-Feb-22,ATM,00.00,"56,236.12","4,49,888.99",
18-Feb-22,Reversal,"53,492.00",00.00,"5,03,380.99",
18-Feb-22,RTGS,03.00,00.00,"5,03,383.99",
18-Feb-22,Cheque,"3,883.59",00.00,"5,07,267.58",
18-Feb-22,ATM,00.00,"56,363.06","4,50,904.52",
18-Feb-22,ATM,00.00,"50,100.50","4,00,804.02",
18-Feb-22,Cash,00.00,"40,080.40","3,60,723.62",
18-Feb-22,Tax,00.00,"60,120.60","3,00,603.02",
18-Feb-22,ATM,28.2,00.00,"3,00,631.22",
18-Feb-22,Tax,58,00.00,"3,00,689.22",
18-Feb-22,Interest,00.00,"3,00,689.22",00.00,
18-Feb-22,Purchase,411.65,00.00,411.65,
18-Feb-22,IMPS,"1,48,178.80",00.00,"1,48,590.45",
18-Feb-22,Bill,00.00,"14,859.05","1,33,731.40",
19-Feb-22,Transportellaneous,00.00,"1,33,731.40",00.00,
19-Feb-22,ATM,31.9,00.00,31.9,
19-Feb-22,Interest,03.00,00.00,34.9,
19-Feb-22,Debit Card,00.00,06.98,27.92,
19-Feb-22,ATM,00.00,06.98,20.94,
19-Feb-22,Cheque,03.05,00.00,23.99,
20-Feb-22,Cheque,"22,007.00",00.00,"22,030.99",
20-Feb-22,ATM,41,00.00,"22,071.99",
20-Feb-22,Debit Card,00.00,"2,207.20","19,864.79",
20-Feb-22,Bill,00.00,"2,837.83","17,026.96",
20-Feb-22,NEFT,"3,779.00",00.00,"20,805.96",
20-Feb-22,NEFT,00.00,"10,402.98","10,402.98",
20-Feb-22,Cheque,00.00,"1,300.37","9,102.61",
20-Feb-22,Transfer,00.00,"1,820.52","7,282.09",
20-Feb-22,Bill,"6,495.00",00.00,"13,777.09",
20-Feb-22,Tax,00.00,"13,777.09",00.00,
20-Feb-22,Reversal,225.89,00.00,225.89,
20-Feb-22,Interest,00.00,45.18,180.71,
20-Feb-22,Bill,07.60,00.00,188.31,
20-Feb-22,Cash,00.00,20.92,167.39,
20-Feb-22,Cheque,"14,28,187.20",00.00,"14,28,354.59",
20-Feb-22,Transfer,501.51,00.00,"14,28,856.10",
20-Feb-22,NEFT,00.00,"2,85,771.22","11,43,084.88",
20-Feb-22,Transfer,"13,16,470.50",00.00,"24,59,555.38",
20-Feb-22,RTGS,00.00,"3,07,444.42","21,52,110.96",
20-Feb-22,Transfer,00.00,"3,58,685.16","17,93,425.80",
20-Feb-22,Interest,22.93,00.00,"17,93,448.73",
20-Feb-22,Transfer,00.00,"2,56,206.96","15,37,241.77",
20-Feb-22,Reversal,00.00,"1,53,724.18","13,83,517.59",
20-Feb-22,Reversal,"13,04,635.00",00.00,"26,88,152.59",
20-Feb-22,Tax,00.00,"26,88,152.59",00.00,
20-Feb-22,IMPS,53.6,00.00,53.6,
20-Feb-22,IMPS,00.00,26.8,26.8,
20-Feb-22,Commission,"3,388.64",00.00,"3,415.44",
20-Feb-22,Transportellaneous,00.00,853.86,"2,561.58",
21-Feb-22,Reversal,"11,00,968.00",00.00,"11,03,529.58",
21-Feb-22,Tax,"1,25,684.90",00.00,"12,29,214.48",
21-Feb-22,Interest,33,00.00,"12,29,247.48",
21-Feb-22,Commission,00.00,"1,53,655.94","10,75,591.54",
21-Feb-22,Cheque,00.00,"1,79,265.26","8,96,326.28",
21-Feb-22,Debit Card,26,00.00,"8,96,352.28",
21-Feb-22,Reversal,00.00,"1,49,392.05","7,46,960.23",
21-Feb-22,Tax,"7,17,191.75",00.00,"14,64,151.98",
21-Feb-22,Debit Card,516.12,00.00,"14,64,668.10",
21-Feb-22,Interest,"20,311.21",00.00,"14,84,979.31",
22-Feb-22,Transfer,"1,55,845.00",00.00,"16,40,824.31",
22-Feb-22,Tax,00.00,"2,05,103.04","14,35,721.27",
22-Feb-22,Reversal,62.18,00.00,"14,35,783.45",
22-Feb-22,Reversal,"10,867.30",00.00,"14,46,650.75",
22-Feb-22,ATM,510,00.00,"14,47,160.75",
22-Feb-22,Commission,"1,44,013.80",00.00,"15,91,174.55",
22-Feb-22,Transfer,"36,938.40",00.00,"16,28,112.95",
22-Feb-22,Tax,00.00,"1,80,901.44","14,47,211.51",
22-Feb-22,ATM,00.00,"1,44,721.15","13,02,490.36",
22-Feb-22,Interest,00.00,"4,34,163.45","8,68,326.91",
22-Feb-22,Tax,00.00,"2,17,081.73","6,51,245.18",
22-Feb-22,Tax,"18,134.78",00.00,"6,69,379.96",
22-Feb-22,Transfer,00.00,"66,938.00","6,02,441.96",
22-Feb-22,NEFT,00.00,"1,20,488.39","4,81,953.57",
22-Feb-22,Transfer,"2,253.00",00.00,"4,84,206.57",
22-Feb-22,NEFT,00.00,"48,420.66","4,35,785.91",
23-Feb-22,NEFT,00.00,"54,473.24","3,81,312.67",
23-Feb-22,Tax,"17,58,918.80",00.00,"21,40,231.47",
23-Feb-22,Tax,00.00,"5,35,057.87","16,05,173.60",
23-Feb-22,Cheque,00.00,"16,05,173.60",00.00,
23-Feb-22,Commission,"77,187.80",00.00,"77,187.80",
23-Feb-22,IMPS,"1,93,411.20",00.00,"2,70,599.00",
23-Feb-22,Cheque,"12,25,215.50",00.00,"14,95,814.50",
23-Feb-22,Bill,07.17,00.00,"14,95,821.67",
23-Feb-22,ATM,00.00,"2,13,688.81","12,82,132.86",
23-Feb-22,NEFT,00.00,"3,20,533.22","9,61,599.64",
23-Feb-22,ATM,00.00,"1,20,199.96","8,41,399.68",
23-Feb-22,Tax,50.8,00.00,"8,41,450.48",
23-Feb-22,NEFT,"6,308.30",00.00,"8,47,758.78",
23-Feb-22,Purchase,"86,164.00",00.00,"9,33,922.78",
23-Feb-22,Cheque,"15,17,461.50",00.00,"24,51,384.28",
23-Feb-22,Transfer,00.00,"2,45,138.43","22,06,245.85",
23-Feb-22,Cash,"1,00,863.88",00.00,"23,07,109.73",
23-Feb-22,Commission,00.00,"2,30,710.97","20,76,398.76",
23-Feb-22,Transfer,00.00,"2,30,710.97","18,45,687.79",
23-Feb-22,Purchase,19.5,00.00,"18,45,707.29",
23-Feb-22,Cash,04.10,00.00,"18,45,711.39",
23-Feb-22,Tax,60.1,00.00,"18,45,771.49",
23-Feb-22,Cash,"1,83,157.00",00.00,"20,28,928.49",
23-Feb-22,Cheque,00.00,"2,53,616.06","17,75,312.43",
23-Feb-22,Purchase,165,00.00,"17,75,477.43",
23-Feb-22,RTGS,00.00,"1,97,275.27","15,78,202.16",
23-Feb-22,Transfer,00.00,"1,97,275.27","13,80,926.89",
23-Feb-22,Interest,"1,78,410.00",00.00,"15,59,336.89",
23-Feb-22,RTGS,00.00,"2,59,889.48","12,99,447.41",
23-Feb-22,Tax,"10,88,811.75",00.00,"23,88,259.16",
23-Feb-22,Purchase,"16,057.00",00.00,"24,04,316.16",
23-Feb-22,Purchase,"3,387.60",00.00,"24,07,703.76",
23-Feb-22,Cash,455.7,00.00,"24,08,159.46",
23-Feb-22,Cheque,00.00,"3,44,022.78","20,64,136.68",
23-Feb-22,NEFT,00.00,"10,32,068.34","10,32,068.34",
23-Feb-22,Commission,00.00,"2,58,017.09","7,74,051.26",
23-Feb-22,Reversal,00.00,"1,10,578.75","6,63,472.51",
23-Feb-22,Commission,"70,054.20",00.00,"7,33,526.71",
23-Feb-22,IMPS,168,00.00,"7,33,694.71",
23-Feb-22,Tax,02.92,00.00,"7,33,697.63",
23-Feb-22,Cheque,30.5,00.00,"7,33,728.13",
23-Feb-22,Cash,103.5,00.00,"7,33,831.63",
23-Feb-22,IMPS,"79,186.50",00.00,"8,13,018.13",
23-Feb-22,RTGS,421,00.00,"8,13,439.13",
23-Feb-22,Cash,28.7,00.00,"8,13,467.83",
23-Feb-22,Bill,"1,65,879.00",00.00,"9,79,346.83",
23-Feb-22,Reversal,00.00,"1,39,906.69","8,39,440.14",
23-Feb-22,Bill,00.00,"1,39,906.69","6,99,533.45",
23-Feb-22,Transfer,00.00,"1,16,588.91","5,82,944.54",
23-Feb-22,Tax,00.00,"97,157.42","4,85,787.12",
23-Feb-22,Reversal,00.00,"1,21,446.78","3,64,340.34",
23-Feb-22,Bill,00.00,"1,82,170.17","1,82,170.17",
23-Feb-22,Cheque,"1,03,276.25",00.00,"2,85,446.42",
23-Feb-22,Reversal,"10,323.00",00.00,"2,95,769.42",
23-Feb-22,IMPS,02.50,00.00,"2,95,771.92",
23-Feb-22,Transportellaneous,00.00,"29,577.19","2,66,194.73",
23-Feb-22,Interest,02.27,00.00,"2,66,197.00",
23-Feb-22,ATM,00.00,"2,66,197.00",00.00,
23-Feb-22,Tax,"1,38,544.00",00.00,"1,38,544.00",
23-Feb-22,RTGS,"6,55,334.25",00.00,"7,93,878.25",
23-Feb-22,Cheque,00.00,"3,96,939.13","3,96,939.12",
23-Feb-22,Purchase,00.00,"1,32,313.04","2,64,626.08",
23-Feb-22,IMPS,"46,387.20",00.00,"3,11,013.28",
23-Feb-22,Bill,00.00,"77,753.32","2,33,259.96",
23-Feb-22,Cheque,00.00,"25,917.77","2,07,342.19",
23-Feb-22,Bill,16.43,00.00,"2,07,358.62",
23-Feb-22,Transfer,00.00,"1,03,679.31","1,03,679.31",
23-Feb-22,Cash,"3,324.15",00.00,"1,07,003.46",
23-Feb-22,Reversal,328.61,00.00,"1,07,332.07",
23-Feb-22,Transportellaneous,00.00,"15,333.15","91,998.92",
23-Feb-22,Bill,"10,62,063.50",00.00,"11,54,062.42",
23-Feb-22,Bill,"2,603.22",00.00,"11,56,665.64",
23-Feb-22,ATM,00.00,"1,28,518.40","10,28,147.24",
23-Feb-22,Reversal,00.00,"1,02,814.72","9,25,332.52",
23-Feb-22,NEFT,"1,20,746.00",00.00,"10,46,078.52",
23-Feb-22,NEFT,00.00,"3,48,692.84","6,97,385.68",
23-Feb-22,ATM,00.00,"6,97,385.68",00.00,
23-Feb-22,Bill,"8,911.75",00.00,"8,911.75",
23-Feb-22,NEFT,00.00,"1,113.97","7,797.78",
23-Feb-22,NEFT,85,00.00,"7,882.78",
23-Feb-22,RTGS,08.00,00.00,"7,890.78",
23-Feb-22,Cheque,00.00,"1,972.70","5,918.08",
23-Feb-22,Debit Card,"99,984.10",00.00,"1,05,902.18",
23-Feb-22,Reversal,00.00,"17,650.36","88,251.82",
23-Feb-22,Transfer,"24,137.00",00.00,"1,12,388.82",
23-Feb-22,ATM,07.60,00.00,"1,12,396.42",
23-Feb-22,Purchase,00.00,"14,049.55","98,346.87",
23-Feb-22,ATM,27.57,00.00,"98,374.44",
23-Feb-22,RTGS,00.00,"24,593.61","73,780.83",
23-Feb-22,Purchase,00.00,"10,540.12","63,240.71",
23-Feb-22,Purchase,00.00,"12,648.14","50,592.57",
23-Feb-22,Purchase,00.00,"6,324.07","44,268.50",
23-Feb-22,Bill,"1,752.10",00.00,"46,020.60",
23-Feb-22,Commission,00.00,"9,204.12","36,816.48",
23-Feb-22,Cheque,00.00,"9,204.12","27,612.36",
23-Feb-22,Debit Card,00.00,"13,806.18","13,806.18",
23-Feb-22,Transfer,00.00,"3,451.55","10,354.64",
23-Feb-22,Cheque,00.00,"2,588.66","7,765.98",
23-Feb-22,Purchase,59.2,00.00,"7,825.18",
23-Feb-22,Bill,"8,971.60",00.00,"16,796.78",
23-Feb-22,RTGS,00.00,"16,796.78",00.00,
23-Feb-22,Bill,"2,931.70",00.00,"2,931.70",
23-Feb-22,Purchase,445.1,00.00,"3,376.80",
23-Feb-22,NEFT,"9,60,007.25",00.00,"9,63,384.05",
23-Feb-22,NEFT,00.00,"2,40,846.01","7,22,538.04",
23-Feb-22,Cash,32,00.00,"7,22,570.04",
23-Feb-22,Interest,05.00,00.00,"7,22,575.04",
24-Feb-22,Commission,06.50,00.00,"7,22,581.54",
24-Feb-22,ATM,"2,815.80",00.00,"7,25,397.34",
24-Feb-22,NEFT,"6,327.60",00.00,"7,31,724.94",
24-Feb-22,Transfer,"1,96,275.69",00.00,"9,28,000.63",
24-Feb-22,Commission,00.00,"1,85,600.13","7,42,400.50",
24-Feb-22,Bill,"5,64,615.00",00.00,"13,07,015.50",
24-Feb-22,Interest,00.00,"13,07,015.50",00.00,
24-Feb-22,Tax,04.93,00.00,04.93,
24-Feb-22,Debit Card,00.00,01.64,03.29,
24-Feb-22,Transportellaneous,"3,448.50",00.00,"3,451.79",
24-Feb-22,Cash,37.2,00.00,"3,488.99",
24-Feb-22,Commission,"23,903.00",00.00,"27,391.99",
24-Feb-22,Cash,"2,12,378.00",00.00,"2,39,769.99",
24-Feb-22,Purchase,00.00,"2,39,769.99",00.00,
24-Feb-22,Cash,"70,860.09",00.00,"70,860.09",
24-Feb-22,NEFT,"10,232.73",00.00,"81,092.82",
24-Feb-22,Interest,40.8,00.00,"81,133.62",
24-Feb-22,Reversal,00.00,"40,566.81","40,566.81",
24-Feb-22,Cheque,00.00,"4,507.42","36,059.39",
24-Feb-22,RTGS,00.00,"4,507.42","31,551.97",
24-Feb-22,Reversal,692,00.00,"32,243.97",
24-Feb-22,Transfer,"31,918.38",00.00,"64,162.35",
24-Feb-22,Debit Card,00.00,"7,129.15","57,033.20",
24-Feb-22,Tax,00.00,"19,011.07","38,022.13",
24-Feb-22,Cheque,227.34,00.00,"38,249.47",
24-Feb-22,Cash,"17,694.00",00.00,"55,943.47",
24-Feb-22,Purchase,"35,343.22",00.00,"91,286.69",
24-Feb-22,Reversal,00.00,"45,643.35","45,643.34",
25-Feb-22,NEFT,297.9,00.00,"45,941.24",
25-Feb-22,Cheque,"18,99,305.00",00.00,"19,45,246.24",
25-Feb-22,Interest,00.00,"3,89,049.25","15,56,196.99",
25-Feb-22,Cash,27.66,00.00,"15,56,224.65",
25-Feb-22,Reversal,00.00,"5,18,741.55","10,37,483.10",
25-Feb-22,IMPS,"3,55,444.00",00.00,"13,92,927.10",
25-Feb-22,IMPS,"19,90,911.75",00.00,"33,83,838.85",
25-Feb-22,Reversal,00.00,"8,45,959.71","25,37,879.14",
25-Feb-22,Transportellaneous,"81,336.66",00.00,"26,19,215.80",
25-Feb-22,Debit Card,00.00,"8,73,071.93","17,46,143.87",
25-Feb-22,Cash,00.00,"4,36,535.97","13,09,607.90",
25-Feb-22,Cheque,00.00,"1,45,511.99","11,64,095.91",
25-Feb-22,Cheque,00.00,"11,64,095.91",00.00,
25-Feb-22,Bill,235,00.00,235,
25-Feb-22,ATM,"31,824.09",00.00,"32,059.09",
25-Feb-22,Reversal,13.07,00.00,"32,072.16",
25-Feb-22,RTGS,00.00,"3,563.57","28,508.59",
25-Feb-22,Interest,00.00,"14,254.30","14,254.30",
25-Feb-22,RTGS,00.00,"1,781.79","12,472.51",
25-Feb-22,Bill,414,00.00,"12,886.51",
25-Feb-22,Commission,"2,17,909.78",00.00,"2,30,796.29",
25-Feb-22,Purchase,00.00,"2,30,796.29",00.00,
25-Feb-22,Debit Card,612.77,00.00,612.77,
25-Feb-22,RTGS,"57,716.00",00.00,"58,328.77",
25-Feb-22,Bill,00.00,"58,328.77",00.00,
25-Feb-22,Commission,"19,99,691.00",00.00,"19,99,691.00",
25-Feb-22,Bill,00.00,"6,66,563.67","13,33,127.33",
25-Feb-22,Debit Card,00.00,"13,33,127.33",00.00,
25-Feb-22,Bill,04.63,00.00,04.63,
25-Feb-22,RTGS,"19,83,062.00",00.00,"19,83,066.63",
25-Feb-22,Cash,00.00,"2,83,295.23","16,99,771.40",
25-Feb-22,IMPS,00.00,"8,49,885.70","8,49,885.70",
25-Feb-22,RTGS,"3,102.61",00.00,"8,52,988.31",
25-Feb-22,IMPS,91,00.00,"8,53,079.31",
25-Feb-22,Tax,00.00,"1,06,634.91","7,46,444.40",
25-Feb-22,Debit Card,"6,01,778.00",00.00,"13,48,222.40",
25-Feb-22,ATM,00.00,"3,37,055.60","10,11,166.80",
25-Feb-22,NEFT,928.6,00.00,"10,12,095.40",
25-Feb-22,Bill,94.05,00.00,"10,12,189.45",
25-Feb-22,Bill,"76,681.69",00.00,"10,88,871.14",
25-Feb-22,RTGS,"7,67,837.00",00.00,"18,56,708.14",
25-Feb-22,Commission,"20,325.00",00.00,"18,77,033.14",
25-Feb-22,Reversal,544,00.00,"18,77,577.14",
26-Feb-22,ATM,00.00,"2,34,697.14","16,42,880.00",
26-Feb-22,Cash,00.00,"2,34,697.14","14,08,182.86",
26-Feb-22,Commission,"11,163.03",00.00,"14,19,345.89",
26-Feb-22,IMPS,00.00,"1,57,705.10","12,61,640.79",
26-Feb-22,RTGS,00.00,"3,15,410.20","9,46,230.59",
26-Feb-22,Transfer,"91,520.00",00.00,"10,37,750.59",
26-Feb-22,Interest,"1,322.96",00.00,"10,39,073.55",
26-Feb-22,RTGS,00.00,"1,15,452.62","9,23,620.93",
26-Feb-22,IMPS,00.00,"1,15,452.62","8,08,168.31",
26-Feb-22,Purchase,23,00.00,"8,08,191.31",
26-Feb-22,Cash,489.2,00.00,"8,08,680.51",
26-Feb-22,Interest,00.00,"4,04,340.26","4,04,340.26",
26-Feb-22,Bill,25.3,00.00,"4,04,365.56",
26-Feb-22,Cheque,"1,22,725.16",00.00,"5,27,090.72",
26-Feb-22,Cheque,00.00,"87,848.45","4,39,242.27",
26-Feb-22,ATM,00.00,"73,207.05","3,66,035.22",
26-Feb-22,Tax,06.60,00.00,"3,66,041.82",
26-Feb-22,Transfer,07.30,00.00,"3,66,049.12",
26-Feb-22,RTGS,00.00,"36,604.91","3,29,444.21",
26-Feb-22,Cheque,"2,36,201.75",00.00,"5,65,645.96",
26-Feb-22,Interest,36.2,00.00,"5,65,682.16",
27-Feb-22,Bill,"15,41,327.00",00.00,"21,07,009.16",
27-Feb-22,Commission,00.00,"2,10,700.92","18,96,308.24",
27-Feb-22,Transfer,00.00,"2,10,700.92","16,85,607.32",
27-Feb-22,Bill,07.36,00.00,"16,85,614.68",
27-Feb-22,RTGS,57,00.00,"16,85,671.68",
27-Feb-22,Interest,"12,77,476.00",00.00,"29,63,147.68",
27-Feb-22,Interest,00.00,"14,81,573.84","14,81,573.84",
27-Feb-22,Transportellaneous,"97,652.70",00.00,"15,79,226.54",
27-Feb-22,Transfer,00.00,"3,15,845.31","12,63,381.23",
27-Feb-22,Cash,00.00,"6,31,690.62","6,31,690.62",
27-Feb-22,Commission,220.19,00.00,"6,31,910.81",
27-Feb-22,Commission,59.4,00.00,"6,31,970.21",
27-Feb-22,Transfer,00.00,"70,218.91","5,61,751.30",
27-Feb-22,ATM,00.00,"1,87,250.43","3,74,500.87",
27-Feb-22,Tax,"4,294.70",00.00,"3,78,795.57",
27-Feb-22,Cash,"2,238.00",00.00,"3,81,033.57",
27-Feb-22,Reversal,"18,331.00",00.00,"3,99,364.57",
27-Feb-22,Cash,00.00,"99,841.14","2,99,523.43",
27-Feb-22,ATM,171.3,00.00,"2,99,694.73",
27-Feb-22,ATM,00.00,"37,461.84","2,62,232.89",
27-Feb-22,Bill,00.00,"2,62,232.89",00.00,
27-Feb-22,Debit Card,"11,15,024.00",00.00,"11,15,024.00",
27-Feb-22,Tax,00.00,"1,59,289.14","9,55,734.86",
27-Feb-22,Commission,00.00,"9,55,734.86",00.00,
27-Feb-22,Transfer,"6,06,401.25",00.00,"6,06,401.25",
27-Feb-22,Bill,00.00,"75,800.16","5,30,601.09",
27-Feb-22,Interest,00.00,"1,32,650.27","3,97,950.82",
27-Feb-22,Transfer,00.00,"79,590.16","3,18,360.66",
27-Feb-22,Transportellaneous,00.00,"39,795.08","2,78,565.58",
27-Feb-22,Transfer,"1,10,080.75",00.00,"3,88,646.33",
28-Feb-22,ATM,00.00,"1,94,323.17","1,94,323.16",
28-Feb-22,Commission,00.00,"97,161.58","97,161.58",
28-Feb-22,Cash,00.00,"32,387.19","64,774.39",
28-Feb-22,NEFT,00.00,"6,477.44","58,296.95",
28-Feb-22,IMPS,"16,80,564.80",00.00,"17,38,861.75",
28-Feb-22,Bill,00.00,"17,38,861.75",00.00,
28-Feb-22,Purchase,"1,42,917.00",00.00,"1,42,917.00",
28-Feb-22,Purchase,00.00,"1,42,917.00",00.00,
28-Feb-22,Bill,00.98,00.00,00.98,
28-Feb-22,Bill,21,00.00,21.98,
28-Feb-22,RTGS,01.56,00.00,23.54,
28-Feb-22,Bill,"1,69,628.88",00.00,"1,69,652.42",
28-Feb-22,Cheque,00.00,"18,850.27","1,50,802.15",
28-Feb-22,Bill,00.00,"18,850.27","1,31,951.88",
28-Feb-22,RTGS,00.00,"26,390.38","1,05,561.50",
28-Feb-22,Tax,00.00,"11,729.06","93,832.44",
28-Feb-22,Commission,00.00,"46,916.22","46,916.22",
01-Mar-22,IMPS,138.82,00.00,"47,055.04",
01-Mar-22,Interest,00.00,"7,842.51","39,212.53",
02-Mar-22,IMPS,"20,57,629.00",00.00,"20,96,841.53",
02-Mar-22,Cash,00.00,"2,32,982.39","18,63,859.14",
02-Mar-22,Transfer,"23,582.20",00.00,"18,87,441.34",
02-Mar-22,Reversal,"2,190.00",00.00,"18,89,631.34",
02-Mar-22,Tax,00.00,"3,14,938.56","15,74,692.78",
02-Mar-22,Tax,00.00,"5,24,897.59","10,49,795.19",
02-Mar-22,Tax,00.00,"1,04,979.52","9,44,815.67",
02-Mar-22,Debit Card,00.00,"3,14,938.56","6,29,877.11",
02-Mar-22,ATM,00.00,"2,09,959.04","4,19,918.07",
02-Mar-22,Transportellaneous,00.00,"1,04,979.52","3,14,938.55",
03-Mar-22,Transportellaneous,05.60,00.00,"3,14,944.15",
03-Mar-22,ATM,840,00.00,"3,15,784.15",
03-Mar-22,Transportellaneous,00.00,"31,578.42","2,84,205.74",
03-Mar-22,Purchase,00.00,"40,600.82","2,43,604.92",
03-Mar-22,IMPS,00.00,"30,450.62","2,13,154.31",
03-Mar-22,Bill,00.80,00.00,"2,13,155.11",
03-Mar-22,Cash,"28,970.00",00.00,"2,42,125.11",
03-Mar-22,Purchase,94.2,00.00,"2,42,219.31",
04-Mar-22,Commission,"17,078.90",00.00,"2,59,298.21",
04-Mar-22,Debit Card,"24,024.00",00.00,"2,83,322.21",
04-Mar-22,IMPS,00.00,"70,830.55","2,12,491.66",
04-Mar-22,Transportellaneous,"1,69,899.97",00.00,"3,82,391.63",
04-Mar-22,Cash,00.00,"42,487.96","3,39,903.67",
04-Mar-22,RTGS,00.00,"67,980.73","2,71,922.94",
04-Mar-22,NEFT,"25,851.00",00.00,"2,97,773.94",
04-Mar-22,IMPS,00.00,"74,443.49","2,23,330.46",
04-Mar-22,IMPS,00.00,"74,443.49","1,48,886.97",
04-Mar-22,Tax,01.00,00.00,"1,48,887.97",
04-Mar-22,Commission,00.00,"1,48,887.97",00.00,
04-Mar-22,Purchase,"2,657.59",00.00,"2,657.59",
04-Mar-22,Cheque,"80,077.40",00.00,"82,734.99",
04-Mar-22,RTGS,"2,24,985.00",00.00,"3,07,719.99",
04-Mar-22,Cash,00.00,"30,772.00","2,76,947.99",
05-Mar-22,Commission,00.00,"92,316.00","1,84,631.99",
05-Mar-22,Cash,00.00,"46,158.00","1,38,473.99",
05-Mar-22,Transfer,"10,160.20",00.00,"1,48,634.19",
05-Mar-22,Purchase,402,00.00,"1,49,036.19",
05-Mar-22,RTGS,"28,119.70",00.00,"1,77,155.89",
05-Mar-22,Cheque,"2,36,832.20",00.00,"4,13,988.09",
05-Mar-22,ATM,00.00,"4,13,988.09",00.00,
05-Mar-22,Bill,"2,949.00",00.00,"2,949.00",
05-Mar-22,RTGS,"1,978.00",00.00,"4,927.00",
05-Mar-22,ATM,00.00,"1,642.33","3,284.67",
05-Mar-22,Purchase,677,00.00,"3,961.67",
05-Mar-22,Cheque,227.9,00.00,"4,189.57",
05-Mar-22,Reversal,730.97,00.00,"4,920.54",
05-Mar-22,Transfer,00.00,492.05,"4,428.49",
05-Mar-22,Transportellaneous,00.00,442.85,"3,985.64",
05-Mar-22,Cheque,37.27,00.00,"4,022.91",
06-Mar-22,NEFT,00.00,502.86,"3,520.05",
06-Mar-22,Cheque,00.00,352.01,"3,168.04",
06-Mar-22,Transportellaneous,"5,94,778.00",00.00,"5,97,946.04",
06-Mar-22,Transfer,"4,35,372.00",00.00,"10,33,318.04",
06-Mar-22,Cash,"16,097.87",00.00,"10,49,415.91",
06-Mar-22,Transfer,00.00,"1,16,601.77","9,32,814.14",
06-Mar-22,Reversal,00.00,"93,281.41","8,39,532.73",
06-Mar-22,Cheque,179,00.00,"8,39,711.73",
06-Mar-22,Cash,00.00,"2,79,903.91","5,59,807.82",
06-Mar-22,Commission,"1,46,269.06",00.00,"7,06,076.88",
06-Mar-22,NEFT,04.00,00.00,"7,06,080.88",
06-Mar-22,RTGS,00.00,"1,41,216.18","5,64,864.70",
06-Mar-22,Tax,"2,031.00",00.00,"5,66,895.70",
06-Mar-22,Cash,00.00,"1,41,723.93","4,25,171.78",
06-Mar-22,Tax,35,00.00,"4,25,206.78",
06-Mar-22,NEFT,"2,133.20",00.00,"4,27,339.98",
06-Mar-22,Debit Card,"9,388.00",00.00,"4,36,727.98",
06-Mar-22,ATM,"89,991.81",00.00,"5,26,719.79",
06-Mar-22,Interest,00.00,"2,63,359.90","2,63,359.90",
06-Mar-22,Tax,"31,512.00",00.00,"2,94,871.90",
06-Mar-22,Commission,579,00.00,"2,95,450.90",
06-Mar-22,Tax,00.00,"49,241.82","2,46,209.08",
06-Mar-22,Cheque,"9,17,897.00",00.00,"11,64,106.08",
06-Mar-22,Purchase,"5,648.00",00.00,"11,69,754.08",
06-Mar-22,ATM,00.00,"2,92,438.52","8,77,315.56",
06-Mar-22,Purchase,00.00,"87,731.56","7,89,584.00",
06-Mar-22,Tax,"10,932.20",00.00,"8,00,516.20",
06-Mar-22,Transfer,00.00,"1,33,419.37","6,67,096.83",
06-Mar-22,Transfer,00.00,"95,299.55","5,71,797.28",
06-Mar-22,Bill,"2,368.00",00.00,"5,74,165.28",
06-Mar-22,ATM,"1,73,669.90",00.00,"7,47,835.18",
06-Mar-22,Reversal,00.00,"93,479.40","6,54,355.78",
06-Mar-22,Cash,"1,515.50",00.00,"6,55,871.28",
06-Mar-22,Debit Card,00.00,"2,18,623.76","4,37,247.52",
06-Mar-22,Commission,00.00,"48,583.06","3,88,664.46",
06-Mar-22,NEFT,"1,601.00",00.00,"3,90,265.46",
06-Mar-22,Commission,"13,166.00",00.00,"4,03,431.46",
06-Mar-22,NEFT,00.00,"40,343.15","3,63,088.31",
06-Mar-22,IMPS,"10,15,637.20",00.00,"13,78,725.51",
06-Mar-22,Interest,"20,813.88",00.00,"13,99,539.39",
06-Mar-22,Transportellaneous,"11,427.00",00.00,"14,10,966.39",
06-Mar-22,Tax,155.5,00.00,"14,11,121.89",
06-Mar-22,Debit Card,"12,69,080.20",00.00,"26,80,202.09",
06-Mar-22,Cash,00.00,"2,68,020.21","24,12,181.88",
06-Mar-22,Transportellaneous,10.6,00.00,"24,12,192.48",
06-Mar-22,Transportellaneous,"1,241.00",00.00,"24,13,433.48",
06-Mar-22,Debit Card,"8,69,883.00",00.00,"32,83,316.48",
06-Mar-22,Interest,549,00.00,"32,83,865.48",
06-Mar-22,ATM,41,00.00,"32,83,906.48",
06-Mar-22,Debit Card,"10,69,718.50",00.00,"43,53,624.98",
06-Mar-22,Commission,00.00,"6,21,946.43","37,31,678.55",
06-Mar-22,Tax,"2,19,870.00",00.00,"39,51,548.55",
06-Mar-22,Cash,443.8,00.00,"39,51,992.35",
06-Mar-22,ATM,372,00.00,"39,52,364.35",
06-Mar-22,Cash,00.00,"13,17,454.78","26,34,909.57",
06-Mar-22,Tax,00.00,"2,92,767.73","23,42,141.84",
06-Mar-22,Commission,"16,80,334.75",00.00,"40,22,476.59",
06-Mar-22,Tax,"9,65,740.50",00.00,"49,88,217.09",
06-Mar-22,IMPS,00.00,"9,97,643.42","39,90,573.67",
06-Mar-22,Purchase,"5,484.75",00.00,"39,96,058.42",
06-Mar-22,Purchase,"14,78,690.00",00.00,"54,74,748.42",
06-Mar-22,Reversal,"1,710.40",00.00,"54,76,458.82",
07-Mar-22,Debit Card,"3,681.00",00.00,"54,80,139.82",
07-Mar-22,Tax,"5,672.00",00.00,"54,85,811.82",
07-Mar-22,Bill,"14,12,372.80",00.00,"68,98,184.62",
07-Mar-22,Tax,00.00,"68,98,184.62",00.00,
07-Mar-22,Cash,"2,474.27",00.00,"2,474.27",
07-Mar-22,Interest,"21,273.00",00.00,"23,747.27",
07-Mar-22,Reversal,00.00,"11,873.64","11,873.64",
07-Mar-22,Reversal,00.00,"1,319.29","10,554.35",
07-Mar-22,Tax,00.00,"1,319.29","9,235.06",
07-Mar-22,Debit Card,00.00,"1,154.38","8,080.68",
07-Mar-22,Commission,00.00,"2,020.17","6,060.51",
07-Mar-22,Commission,"1,086.00",00.00,"7,146.51",
07-Mar-22,Reversal,00.00,714.65,"6,431.86",
07-Mar-22,NEFT,"2,96,914.00",00.00,"3,03,345.86",
07-Mar-22,Transfer,"3,439.80",00.00,"3,06,785.66",
07-Mar-22,Bill,49.02,00.00,"3,06,834.68",
07-Mar-22,Tax,00.00,"1,02,278.23","2,04,556.45",
07-Mar-22,Bill,00.00,"34,092.74","1,70,463.71",
07-Mar-22,Interest,00.00,"1,70,463.71",00.00,
07-Mar-22,Transfer,05.00,00.00,05.00,
07-Mar-22,Cheque,00.00,00.63,04.38,
07-Mar-22,Cash,84.99,00.00,89.37,
07-Mar-22,Debit Card,00.00,11.17,78.2,
07-Mar-22,Purchase,00.00,39.1,39.1,
07-Mar-22,Transportellaneous,00.00,19.55,19.55,
07-Mar-22,Reversal,00.00,19.55,00.00,
07-Mar-22,Transfer,04.12,00.00,04.12,
07-Mar-22,Cash,"2,298.40",00.00,"2,302.52",
07-Mar-22,Cash,00.00,767.51,"1,535.01",
08-Mar-22,RTGS,00.00,219.29,"1,315.72",
08-Mar-22,Cash,668.61,00.00,"1,984.33",
08-Mar-22,Purchase,00.00,992.17,992.16,
08-Mar-22,RTGS,03.50,00.00,995.66,
08-Mar-22,ATM,00.00,165.94,829.72,
08-Mar-22,Bill,"1,18,118.00",00.00,"1,18,947.72",
09-Mar-22,RTGS,259.55,00.00,"1,19,207.27",
09-Mar-22,RTGS,00.00,"39,735.76","79,471.51",
09-Mar-22,IMPS,05.86,00.00,"79,477.37",
09-Mar-22,IMPS,217.6,00.00,"79,694.97",
09-Mar-22,Bill,00.00,"15,938.99","63,755.98",
09-Mar-22,Bill,"14,954.10",00.00,"78,710.08",
09-Mar-22,Reversal,03.00,00.00,"78,713.08",
09-Mar-22,Bill,"20,19,570.80",00.00,"20,98,283.88",
09-Mar-22,Commission,00.00,"10,49,141.94","10,49,141.94",
09-Mar-22,IMPS,29.52,00.00,"10,49,171.46",
10-Mar-22,Transportellaneous,00.00,"1,16,574.61","9,32,596.85",
10-Mar-22,Interest,00.00,"3,10,865.62","6,21,731.23",
10-Mar-22,Transfer,275.74,00.00,"6,22,006.97",
10-Mar-22,Transfer,05.00,00.00,"6,22,011.97",
10-Mar-22,RTGS,"1,28,283.00",00.00,"7,50,294.97",
10-Mar-22,Cash,00.00,"1,87,573.74","5,62,721.23",
10-Mar-22,Cash,02.40,00.00,"5,62,723.63",
10-Mar-22,ATM,00.00,"2,81,361.82","2,81,361.82",
10-Mar-22,Purchase,00.00,"40,194.55","2,41,167.27",
10-Mar-22,Bill,"2,641.10",00.00,"2,43,808.37",
10-Mar-22,IMPS,00.00,"40,634.73","2,03,173.64",
10-Mar-22,Cash,"18,13,073.25",00.00,"20,16,246.89",
10-Mar-22,Reversal,"6,216.00",00.00,"20,22,462.89",
10-Mar-22,Tax,00.00,"6,74,154.30","13,48,308.59",
10-Mar-22,RTGS,00.00,"13,48,308.59",00.00,
10-Mar-22,RTGS,"1,53,754.53",00.00,"1,53,754.53",
10-Mar-22,Purchase,00.00,"76,877.27","76,877.26",
10-Mar-22,ATM,00.00,"9,609.66","67,267.60",
10-Mar-22,Cash,333,00.00,"67,600.60",
10-Mar-22,Transportellaneous,00.00,"67,600.60",00.00,
10-Mar-22,ATM,"14,46,337.00",00.00,"14,46,337.00",
10-Mar-22,ATM,"9,46,501.00",00.00,"23,92,838.00",
10-Mar-22,NEFT,592.7,00.00,"23,93,430.70",
10-Mar-22,Commission,"2,075.00",00.00,"23,95,505.70",
10-Mar-22,Interest,"1,02,657.50",00.00,"24,98,163.20",
10-Mar-22,Transfer,00.00,"24,98,163.20",00.00,
10-Mar-22,Debit Card,"11,484.00",00.00,"11,484.00",
10-Mar-22,Reversal,"1,746.06",00.00,"13,230.06",
10-Mar-22,Commission,00.00,"1,653.76","11,576.30",
10-Mar-22,NEFT,49,00.00,"11,625.30",
10-Mar-22,Bill,00.00,"1,291.70","10,333.60",
10-Mar-22,NEFT,00.00,"1,291.70","9,041.90",
10-Mar-22,Debit Card,54,00.00,"9,095.90",
10-Mar-22,Commission,104,00.00,"9,199.90",
10-Mar-22,Transfer,00.00,"2,299.98","6,899.92",
10-Mar-22,Reversal,04.60,00.00,"6,904.52",
10-Mar-22,ATM,"2,090.34",00.00,"8,994.86",
10-Mar-22,Debit Card,"1,105.70",00.00,"10,100.56",
10-Mar-22,NEFT,"1,762.80",00.00,"11,863.36",
10-Mar-22,Transportellaneous,"10,38,086.00",00.00,"10,49,949.36",
10-Mar-22,Reversal,00.00,"5,24,974.68","5,24,974.68",
10-Mar-22,Tax,12.6,00.00,"5,24,987.28",
10-Mar-22,Cash,354.11,00.00,"5,25,341.39",
11-Mar-22,Tax,964,00.00,"5,26,305.39",
11-Mar-22,Cash,00.00,"2,63,152.70","2,63,152.70",
11-Mar-22,RTGS,06.40,00.00,"2,63,159.10",
11-Mar-22,Purchase,00.00,"43,859.85","2,19,299.25",
11-Mar-22,Cash,00.00,"2,19,299.25",00.00,
11-Mar-22,RTGS,149.75,00.00,149.75,
11-Mar-22,Interest,112,00.00,261.75,
11-Mar-22,Debit Card,"1,42,490.00",00.00,"1,42,751.75",
11-Mar-22,IMPS,03.00,00.00,"1,42,754.75",
11-Mar-22,Cash,"6,18,905.00",00.00,"7,61,659.75",
11-Mar-22,ATM,03.00,00.00,"7,61,662.75",
11-Mar-22,Commission,00.00,"7,61,662.75",00.00,
11-Mar-22,ATM,721.16,00.00,721.16,
11-Mar-22,Interest,192.31,00.00,913.47,
11-Mar-22,Bill,"15,05,264.00",00.00,"15,06,177.47",
12-Mar-22,IMPS,"1,06,701.00",00.00,"16,12,878.47",
12-Mar-22,NEFT,"1,01,046.66",00.00,"17,13,925.13",
12-Mar-22,Bill,00.00,"2,44,846.45","14,69,078.68",
12-Mar-22,Cash,00.00,"4,89,692.89","9,79,385.79",
12-Mar-22,Interest,00.00,"97,938.58","8,81,447.21",
12-Mar-22,IMPS,"21,278.88",00.00,"9,02,726.09",
12-Mar-22,Purchase,00.00,"1,00,302.90","8,02,423.19",
12-Mar-22,Transfer,25,00.00,"8,02,448.19",
12-Mar-22,ATM,00.00,"8,02,448.19",00.00,
12-Mar-22,Transfer,332.27,00.00,332.27,
12-Mar-22,Bill,00.00,83.07,249.2,
12-Mar-22,Purchase,04.10,00.00,253.3,
12-Mar-22,NEFT,363.7,00.00,617,
12-Mar-22,Cheque,41,00.00,658,
12-Mar-22,Debit Card,"91,466.00",00.00,"92,124.00",
12-Mar-22,Transfer,00.00,"46,062.00","46,062.00",
12-Mar-22,Cash,00.00,"11,515.50","34,546.50",
12-Mar-22,IMPS,00.00,"3,454.65","31,091.85",
12-Mar-22,ATM,00.00,"4,441.69","26,650.16",
12-Mar-22,Debit Card,"3,570.09",00.00,"30,220.25",
12-Mar-22,Purchase,00.00,"3,022.03","27,198.22",
12-Mar-22,Reversal,"11,43,300.20",00.00,"11,70,498.42",
12-Mar-22,Cheque,"17,30,246.00",00.00,"29,00,744.42",
12-Mar-22,Interest,02.54,00.00,"29,00,746.96",
12-Mar-22,Bill,00.00,"4,14,392.42","24,86,354.54",
12-Mar-22,Cash,"94,757.00",00.00,"25,81,111.54",
12-Mar-22,Bill,00.00,"12,90,555.77","12,90,555.77",
12-Mar-22,ATM,00.00,"6,45,277.89","6,45,277.88",
12-Mar-22,Transportellaneous,00.00,"1,61,319.47","4,83,958.41",
12-Mar-22,NEFT,00.00,"48,395.84","4,35,562.57",
12-Mar-22,Transfer,"1,780.90",00.00,"4,37,343.47",
12-Mar-22,Reversal,"4,51,335.80",00.00,"8,88,679.27",
12-Mar-22,Reversal,00.00,"2,22,169.82","6,66,509.45",
12-Mar-22,Purchase,00.00,"6,66,509.45",00.00,
12-Mar-22,Cheque,"10,74,087.00",00.00,"10,74,087.00",
12-Mar-22,Commission,00.00,"2,68,521.75","8,05,565.25",
12-Mar-22,Debit Card,"5,64,472.50",00.00,"13,70,037.75",
12-Mar-22,Cash,00.00,"1,52,226.42","12,17,811.33",
12-Mar-22,Transportellaneous,00.00,"2,02,968.56","10,14,842.78",
12-Mar-22,Cheque,00.00,"1,69,140.46","8,45,702.32",
12-Mar-22,Purchase,"4,48,467.50",00.00,"12,94,169.82",
12-Mar-22,ATM,"21,279.80",00.00,"13,15,449.62",
12-Mar-22,NEFT,"2,28,491.60",00.00,"15,43,941.22",
12-Mar-22,IMPS,437,00.00,"15,44,378.22",
12-Mar-22,Debit Card,07.15,00.00,"15,44,385.37",
12-Mar-22,IMPS,"6,55,414.00",00.00,"21,99,799.37",
12-Mar-22,Cheque,"20,48,808.00",00.00,"42,48,607.37",
12-Mar-22,Cash,00.00,"10,62,151.84","31,86,455.53",
12-Mar-22,Debit Card,00.00,"10,62,151.84","21,24,303.69",
12-Mar-22,NEFT,00.00,"2,36,033.74","18,88,269.95",
12-Mar-22,Transfer,32.2,00.00,"18,88,302.15",
12-Mar-22,RTGS,00.00,"6,29,434.05","12,58,868.10",
12-Mar-22,Cheque,"28,568.60",00.00,"12,87,436.70",
12-Mar-22,Tax,364.29,00.00,"12,87,800.99",
12-Mar-22,Transportellaneous,00.00,"2,57,560.20","10,30,240.79",
12-Mar-22,Cheque,00.00,"1,28,780.10","9,01,460.69",
12-Mar-22,Cash,00.00,"1,28,780.10","7,72,680.59",
12-Mar-22,Reversal,00.00,"1,10,382.94","6,62,297.65",
12-Mar-22,RTGS,00.00,"66,229.77","5,96,067.88",
12-Mar-22,Cheque,00.00,"1,98,689.29","3,97,378.59",
12-Mar-22,NEFT,"1,23,002.00",00.00,"5,20,380.59",
12-Mar-22,Transportellaneous,00.00,"65,047.57","4,55,333.02",
12-Mar-22,NEFT,00.00,"1,13,833.26","3,41,499.76",
12-Mar-22,Bill,143.4,00.00,"3,41,643.16",
13-Mar-22,RTGS,00.00,"37,960.35","3,03,682.81",
13-Mar-22,IMPS,00.00,"1,01,227.60","2,02,455.21",
13-Mar-22,Transportellaneous,182,00.00,"2,02,637.21",
13-Mar-22,NEFT,"32,810.34",00.00,"2,35,447.55",
13-Mar-22,Purchase,00.00,"39,241.26","1,96,206.29",
13-Mar-22,Debit Card,86.81,00.00,"1,96,293.10",
13-Mar-22,Cheque,06.90,00.00,"1,96,300.00",
13-Mar-22,Interest,"17,541.00",00.00,"2,13,841.00",
13-Mar-22,Bill,"15,19,916.00",00.00,"17,33,757.00",
14-Mar-22,Debit Card,00.00,"4,33,439.25","13,00,317.75",
14-Mar-22,Transfer,00.00,"1,62,539.72","11,37,778.03",
14-Mar-22,Cash,"90,520.80",00.00,"12,28,298.83",
14-Mar-22,Tax,00.00,"1,53,537.35","10,74,761.48",
14-Mar-22,Purchase,00.00,"3,58,253.83","7,16,507.65",
14-Mar-22,RTGS,412,00.00,"7,16,919.65",
14-Mar-22,Bill,00.00,"1,19,486.61","5,97,433.04",
14-Mar-22,IMPS,"2,71,298.00",00.00,"8,68,731.04",
14-Mar-22,ATM,00.00,"1,44,788.51","7,23,942.53",
14-Mar-22,Bill,"11,877.70",00.00,"7,35,820.23",
14-Mar-22,ATM,"20,433.00",00.00,"7,56,253.23",
14-Mar-22,Reversal,00.00,"3,78,126.62","3,78,126.62",
14-Mar-22,RTGS,"88,038.50",00.00,"4,66,165.12",
14-Mar-22,Transfer,00.00,"4,66,165.12",00.00,
14-Mar-22,IMPS,"8,43,441.75",00.00,"8,43,441.75",
14-Mar-22,RTGS,00.00,"2,10,860.44","6,32,581.31",
14-Mar-22,Purchase,00.00,"63,258.13","5,69,323.18",
14-Mar-22,Commission,00.00,"94,887.20","4,74,435.98",
14-Mar-22,RTGS,06.00,00.00,"4,74,441.98",
14-Mar-22,Bill,06.03,00.00,"4,74,448.01",
14-Mar-22,Commission,00.00,"4,74,448.01",00.00,
14-Mar-22,Cash,"16,33,132.00",00.00,"16,33,132.00",
14-Mar-22,RTGS,05.30,00.00,"16,33,137.30",
14-Mar-22,Transfer,51.8,00.00,"16,33,189.10",
14-Mar-22,RTGS,"14,64,957.00",00.00,"30,98,146.10",
14-Mar-22,Transportellaneous,58.74,00.00,"30,98,204.84",
14-Mar-22,RTGS,00.00,"7,74,551.21","23,23,653.63",
14-Mar-22,Purchase,"1,48,405.10",00.00,"24,72,058.73",
14-Mar-22,IMPS,00.00,"6,18,014.68","18,54,044.05",
14-Mar-22,Tax,"8,37,858.00",00.00,"26,91,902.05",
14-Mar-22,Commission,00.00,"2,69,190.21","24,22,711.84",
14-Mar-22,NEFT,18.89,00.00,"24,22,730.73",
14-Mar-22,Tax,00.00,"4,84,546.15","19,38,184.58",
14-Mar-22,Tax,42,00.00,"19,38,226.58",
14-Mar-22,Cash,"27,247.00",00.00,"19,65,473.58",
14-Mar-22,Purchase,00.00,"1,96,547.36","17,68,926.22",
14-Mar-22,NEFT,00.00,"5,89,642.07","11,79,284.15",
14-Mar-22,Transfer,00.00,"1,96,547.36","9,82,736.79",
14-Mar-22,IMPS,00.00,"2,45,684.20","7,37,052.59",
14-Mar-22,Commission,00.00,"92,131.57","6,44,921.02",
14-Mar-22,Commission,"3,527.10",00.00,"6,48,448.12",
14-Mar-22,Interest,"4,072.00",00.00,"6,52,520.12",
14-Mar-22,Cheque,"16,85,622.75",00.00,"23,38,142.87",
14-Mar-22,Commission,"11,99,828.50",00.00,"35,37,971.37",
14-Mar-22,ATM,86.1,00.00,"35,38,057.47",
14-Mar-22,Transportellaneous,00.00,"11,79,352.49","23,58,704.98",
14-Mar-22,IMPS,"29,151.00",00.00,"23,87,855.98",
14-Mar-22,Cash,03.70,00.00,"23,87,859.68",
14-Mar-22,Cheque,63.74,00.00,"23,87,923.42",
14-Mar-22,Cash,"2,176.00",00.00,"23,90,099.42",
14-Mar-22,NEFT,00.00,"23,90,099.42",00.00,
14-Mar-22,Interest,"7,413.00",00.00,"7,413.00",
14-Mar-22,Tax,00.00,823.67,"6,589.33",
14-Mar-22,Debit Card,"2,308.13",00.00,"8,897.46",
14-Mar-22,NEFT,"29,321.97",00.00,"38,219.43",
14-Mar-22,Cheque,00.00,"4,246.60","33,972.83",
14-Mar-22,Commission,00.00,"16,986.42","16,986.42",
14-Mar-22,Reversal,00.00,"1,698.64","15,287.78",
14-Mar-22,Debit Card,00.00,"2,183.97","13,103.81",
14-Mar-22,Cheque,00.30,00.00,"13,104.11",
14-Mar-22,Tax,01.39,00.00,"13,105.50",
14-Mar-22,Bill,08.00,00.00,"13,113.50",
14-Mar-22,Transportellaneous,"1,82,891.00",00.00,"1,96,004.50",
14-Mar-22,ATM,00.00,"28,000.64","1,68,003.86",
14-Mar-22,RTGS,00.00,"21,000.48","1,47,003.38",
14-Mar-22,Reversal,"1,892.00",00.00,"1,48,895.38",
14-Mar-22,Debit Card,61.98,00.00,"1,48,957.36",
14-Mar-22,Bill,23.3,00.00,"1,48,980.66",
14-Mar-22,RTGS,"2,47,103.80",00.00,"3,96,084.46",
14-Mar-22,Purchase,00.50,00.00,"3,96,084.96",
14-Mar-22,Cash,38.2,00.00,"3,96,123.16",
14-Mar-22,ATM,00.00,"39,612.32","3,56,510.84",
14-Mar-22,Transportellaneous,00.00,"59,418.47","2,97,092.37",
14-Mar-22,Debit Card,00.00,"99,030.79","1,98,061.58",
14-Mar-22,Commission,04.20,00.00,"1,98,065.78",
14-Mar-22,Bill,00.00,"22,007.31","1,76,058.47",
14-Mar-22,Cash,00.00,"17,605.85","1,58,452.62",
14-Mar-22,RTGS,"3,409.00",00.00,"1,61,861.62",
14-Mar-22,Commission,00.00,"1,61,861.62",00.00,
14-Mar-22,Transfer,"25,502.12",00.00,"25,502.12",
14-Mar-22,NEFT,"2,672.00",00.00,"28,174.12",
14-Mar-22,Transportellaneous,"26,019.27",00.00,"54,193.39",
14-Mar-22,Debit Card,00.00,"27,096.70","27,096.70",
14-Mar-22,Cash,00.00,"9,032.23","18,064.47",
14-Mar-22,NEFT,"2,892.60",00.00,"20,957.07",
14-Mar-22,Debit Card,00.00,"4,191.41","16,765.66",
14-Mar-22,Interest,00.00,"4,191.42","12,574.24",
14-Mar-22,Purchase,"25,260.50",00.00,"37,834.74",
14-Mar-22,Reversal,00.00,"12,611.58","25,223.16",
14-Mar-22,RTGS,08.00,00.00,"25,231.16",
14-Mar-22,Debit Card,00.00,"2,523.12","22,708.04",
14-Mar-22,Interest,00.00,"2,838.51","19,869.54",
14-Mar-22,Transfer,00.58,00.00,"19,870.12",
14-Mar-22,RTGS,16.24,00.00,"19,886.36",
14-Mar-22,Transportellaneous,00.00,"3,977.27","15,909.09",
14-Mar-22,ATM,00.00,"2,272.73","13,636.36",
14-Mar-22,NEFT,00.00,"1,363.64","12,272.72",
14-Mar-22,Cash,00.00,"1,363.64","10,909.08",
14-Mar-22,IMPS,104.49,00.00,"11,013.57",
14-Mar-22,Purchase,"21,647.00",00.00,"32,660.57",
14-Mar-22,Interest,00.00,"16,330.29","16,330.28",
14-Mar-22,Interest,00.00,"1,633.03","14,697.25",
14-Mar-22,RTGS,00.00,"14,697.25",00.00,
14-Mar-22,Cash,149,00.00,149,
14-Mar-22,NEFT,"94,255.16",00.00,"94,404.16",
14-Mar-22,Bill,"2,881.00",00.00,"97,285.16",
14-Mar-22,NEFT,00.00,"16,214.19","81,070.97",
14-Mar-22,Reversal,00.00,"11,581.57","69,489.40",
14-Mar-22,Transfer,00.00,"13,897.88","55,591.52",
14-Mar-22,Cash,00.00,"9,265.25","46,326.27",
14-Mar-22,Purchase,00.00,"7,721.05","38,605.22",
14-Mar-22,Transfer,00.00,"38,605.22",00.00,
14-Mar-22,Transportellaneous,309,00.00,309,
14-Mar-22,Debit Card,00.00,309,00.00,
14-Mar-22,Commission,46,00.00,46,
14-Mar-22,NEFT,"10,63,386.50",00.00,"10,63,432.50",
14-Mar-22,Cash,255,00.00,"10,63,687.50",
14-Mar-22,ATM,56,00.00,"10,63,743.50",
14-Mar-22,Tax,00.00,"3,54,581.17","7,09,162.33",
14-Mar-22,Debit Card,20,00.00,"7,09,182.33",
14-Mar-22,Bill,00.00,"70,918.23","6,38,264.10",
15-Mar-22,RTGS,00.00,"91,180.59","5,47,083.51",
15-Mar-22,ATM,00.00,"60,787.06","4,86,296.45",
15-Mar-22,Cash,03.00,00.00,"4,86,299.45",
15-Mar-22,Transfer,13.18,00.00,"4,86,312.63",
15-Mar-22,Cheque,04.80,00.00,"4,86,317.43",
15-Mar-22,Bill,"28,822.10",00.00,"5,15,139.53",
15-Mar-22,Transportellaneous,00.00,"57,237.73","4,57,901.80",
15-Mar-22,Reversal,"26,311.70",00.00,"4,84,213.50",
15-Mar-22,Cheque,"2,612.00",00.00,"4,86,825.50",
16-Mar-22,Interest,02.31,00.00,"4,86,827.81",
16-Mar-22,Cheque,"12,80,518.50",00.00,"17,67,346.31",
16-Mar-22,Transportellaneous,"2,929.60",00.00,"17,70,275.91",
16-Mar-22,IMPS,"31,468.00",00.00,"18,01,743.91",
16-Mar-22,Cash,"9,49,003.75",00.00,"27,50,747.66",
16-Mar-22,Cheque,05.40,00.00,"27,50,753.06",
16-Mar-22,Purchase,124,00.00,"27,50,877.06",
16-Mar-22,Commission,122,00.00,"27,50,999.06",
16-Mar-22,Cheque,00.00,"4,58,499.84","22,92,499.22",
16-Mar-22,Purchase,00.00,"2,54,722.14","20,37,777.08",
16-Mar-22,Bill,"1,08,338.53",00.00,"21,46,115.61",
17-Mar-22,Cash,01.30,00.00,"21,46,116.91",
17-Mar-22,NEFT,00.00,"10,73,058.46","10,73,058.46",
17-Mar-22,ATM,00.00,"1,07,305.85","9,65,752.61",
17-Mar-22,Interest,"1,59,446.90",00.00,"11,25,199.51",
17-Mar-22,Reversal,00.00,"11,25,199.51",00.00,
17-Mar-22,Cheque,260,00.00,260,
17-Mar-22,ATM,00.00,28.89,231.11,
17-Mar-22,Commission,00.00,23.11,208,
17-Mar-22,Cheque,23.6,00.00,231.6,
18-Mar-22,Interest,00.00,57.9,173.7,
18-Mar-22,Purchase,"7,239.20",00.00,"7,412.90",
18-Mar-22,Tax,00.00,926.61,"6,486.29",
18-Mar-22,Bill,387.42,00.00,"6,873.71",
18-Mar-22,Transportellaneous,"53,305.34",00.00,"60,179.05",
18-Mar-22,Interest,00.00,"7,522.38","52,656.67",
18-Mar-22,Cash,00.00,"26,328.34","26,328.34",
18-Mar-22,ATM,00.00,"13,164.17","13,164.17",
18-Mar-22,Bill,"17,88,573.80",00.00,"18,01,737.97",
19-Mar-22,NEFT,707.94,00.00,"18,02,445.91",
19-Mar-22,Transfer,"29,872.00",00.00,"18,32,317.91",
19-Mar-22,Purchase,"16,717.70",00.00,"18,49,035.61",
19-Mar-22,Cheque,"2,54,594.10",00.00,"21,03,629.71",
19-Mar-22,Transfer,"31,585.00",00.00,"21,35,214.71",
19-Mar-22,Tax,00.00,"7,11,738.24","14,23,476.47",
19-Mar-22,Debit Card,00.00,"7,11,738.24","7,11,738.24",
19-Mar-22,Commission,00.00,"1,18,623.04","5,93,115.20",
19-Mar-22,Transportellaneous,00.00,"65,901.69","5,27,213.51",
19-Mar-22,Bill,00.00,"1,31,803.38","3,95,410.13",
19-Mar-22,Purchase,00.00,"65,901.69","3,29,508.44",
19-Mar-22,Transfer,03.09,00.00,"3,29,511.53",
19-Mar-22,NEFT,00.00,"3,29,511.53",00.00,
19-Mar-22,Cheque,"2,366.09",00.00,"2,366.09",
19-Mar-22,IMPS,00.00,473.22,"1,892.87",
19-Mar-22,Interest,326.8,00.00,"2,219.67",
19-Mar-22,IMPS,170.97,00.00,"2,390.64",
19-Mar-22,Cash,00.00,478.13,"1,912.51",
19-Mar-22,Commission,00.00,382.5,"1,530.01",
19-Mar-22,Tax,00.00,510,"1,020.01",
19-Mar-22,Reversal,"18,89,930.00",00.00,"18,90,950.01",
20-Mar-22,ATM,49.3,00.00,"18,90,999.31",
20-Mar-22,RTGS,00.00,"1,89,099.93","17,01,899.38",
20-Mar-22,Interest,"2,392.00",00.00,"17,04,291.38",
21-Mar-22,Purchase,00.00,"5,68,097.13","11,36,194.25",
21-Mar-22,Reversal,"22,025.80",00.00,"11,58,220.05",
22-Mar-22,Bill,00.00,"11,58,220.05",00.00,
22-Mar-22,NEFT,"14,72,994.80",00.00,"14,72,994.80",
22-Mar-22,Purchase,"19,181.51",00.00,"14,92,176.31",
22-Mar-22,Cheque,00.00,"1,86,522.04","13,05,654.27",
22-Mar-22,Bill,00.00,"4,35,218.09","8,70,436.18",
22-Mar-22,Interest,00.65,00.00,"8,70,436.83",
22-Mar-22,Reversal,"9,541.00",00.00,"8,79,977.83",
22-Mar-22,RTGS,00.00,"1,25,711.12","7,54,266.71",
22-Mar-22,Bill,00.00,"2,51,422.24","5,02,844.47",
22-Mar-22,Debit Card,00.00,"5,02,844.47",00.00,
22-Mar-22,Debit Card,"15,419.00",00.00,"15,419.00",
22-Mar-22,Reversal,36.5,00.00,"15,455.50",
22-Mar-22,Reversal,00.00,"1,545.55","13,909.95",
22-Mar-22,Bill,05.00,00.00,"13,914.95",
22-Mar-22,Commission,00.00,"2,782.99","11,131.96",
22-Mar-22,Cheque,493.6,00.00,"11,625.56",
22-Mar-22,Bill,00.00,"2,325.11","9,300.45",
22-Mar-22,Reversal,"15,65,934.80",00.00,"15,75,235.25",
22-Mar-22,Commission,664.27,00.00,"15,75,899.52",
22-Mar-22,Cheque,"14,68,100.25",00.00,"30,43,999.77",
22-Mar-22,Reversal,00.00,"30,43,999.77",00.00,
22-Mar-22,Tax,"3,175.00",00.00,"3,175.00",
22-Mar-22,Debit Card,57,00.00,"3,232.00",
22-Mar-22,Interest,00.00,404,"2,828.00",
22-Mar-22,Interest,10.2,00.00,"2,838.20",
22-Mar-22,Cash,"24,856.82",00.00,"27,695.02",
22-Mar-22,Cheque,00.00,"4,615.84","23,079.18",
22-Mar-22,IMPS,"1,96,469.00",00.00,"2,19,548.18",
22-Mar-22,ATM,39.38,00.00,"2,19,587.56",
22-Mar-22,RTGS,39.72,00.00,"2,19,627.28",
22-Mar-22,Transportellaneous,00.00,"1,09,813.64","1,09,813.64",
22-Mar-22,Reversal,00.00,"36,604.55","73,209.09",
22-Mar-22,IMPS,00.00,"36,604.55","36,604.54",
22-Mar-22,Reversal,00.00,"18,302.27","18,302.27",
22-Mar-22,Purchase,00.00,"2,614.61","15,687.66",
23-Mar-22,Tax,00.00,"2,241.09","13,446.57",
23-Mar-22,Transfer,"30,014.25",00.00,"43,460.82",
23-Mar-22,Tax,"6,58,637.75",00.00,"7,02,098.57",
23-Mar-22,Purchase,00.00,"70,209.86","6,31,888.71",
23-Mar-22,Transportellaneous,00.00,"6,31,888.71",00.00,
23-Mar-22,Transfer,"2,353.56",00.00,"2,353.56",
23-Mar-22,Bill,"4,353.00",00.00,"6,706.56",
23-Mar-22,Cheque,00.00,745.17,"5,961.39",
23-Mar-22,ATM,00.00,"1,192.28","4,769.11",
23-Mar-22,IMPS,"4,36,712.00",00.00,"4,41,481.11",
23-Mar-22,Cash,00.00,"49,053.46","3,92,427.65",
23-Mar-22,Cash,"6,25,450.00",00.00,"10,17,877.65",
23-Mar-22,Commission,00.00,"1,27,234.71","8,90,642.94",
23-Mar-22,Bill,"2,485.16",00.00,"8,93,128.10",
23-Mar-22,IMPS,"1,612.51",00.00,"8,94,740.61",
23-Mar-22,Transportellaneous,00.00,"99,415.62","7,95,324.99",
23-Mar-22,Cash,00.00,"1,32,554.17","6,62,770.82",
23-Mar-22,Commission,"3,336.00",00.00,"6,66,106.82",
23-Mar-22,Reversal,02.00,00.00,"6,66,108.82",
24-Mar-22,IMPS,00.00,"1,66,527.21","4,99,581.62",
24-Mar-22,Purchase,"14,101.99",00.00,"5,13,683.61",
24-Mar-22,IMPS,07.00,00.00,"5,13,690.61",
24-Mar-22,Transportellaneous,05.75,00.00,"5,13,696.36",
24-Mar-22,Purchase,00.00,"1,02,739.27","4,10,957.09",
24-Mar-22,Transfer,00.00,"58,708.16","3,52,248.93",
24-Mar-22,Transfer,"2,12,308.00",00.00,"5,64,556.93",
24-Mar-22,Purchase,"7,355.50",00.00,"5,71,912.43",
24-Mar-22,RTGS,"22,495.00",00.00,"5,94,407.43",
24-Mar-22,RTGS,00.00,"1,48,601.86","4,45,805.57",
24-Mar-22,Cash,00.00,"4,45,805.57",00.00,
24-Mar-22,RTGS,"3,85,554.75",00.00,"3,85,554.75",
24-Mar-22,RTGS,"2,678.03",00.00,"3,88,232.78",
24-Mar-22,Transportellaneous,00.00,"64,705.46","3,23,527.32",
24-Mar-22,Cheque,00.00,"64,705.46","2,58,821.86",
24-Mar-22,NEFT,00.00,"64,705.47","1,94,116.40",
24-Mar-22,Transportellaneous,08.00,00.00,"1,94,124.40",
24-Mar-22,ATM,00.90,00.00,"1,94,125.30",
24-Mar-22,RTGS,00.00,"64,708.43","1,29,416.87",
24-Mar-22,IMPS,57,00.00,"1,29,473.87",
24-Mar-22,Interest,00.00,"12,947.39","1,16,526.48",
24-Mar-22,Cash,"10,62,286.00",00.00,"11,78,812.48",
24-Mar-22,ATM,00.00,"1,68,401.78","10,10,410.70",
24-Mar-22,Transfer,00.00,"2,02,082.14","8,08,328.56",
24-Mar-22,RTGS,11,00.00,"8,08,339.56",
24-Mar-22,RTGS,"7,44,817.25",00.00,"15,53,156.81",
24-Mar-22,RTGS,"17,14,219.00",00.00,"32,67,375.81",
24-Mar-22,ATM,39.32,00.00,"32,67,415.13",
24-Mar-22,Cash,00.00,"3,63,046.13","29,04,369.00",
24-Mar-22,Commission,00.00,"3,22,707.67","25,81,661.33",
24-Mar-22,Commission,"1,941.60",00.00,"25,83,602.93",
24-Mar-22,Transfer,00.00,"2,58,360.29","23,25,242.64",
24-Mar-22,Interest,"18,046.00",00.00,"23,43,288.64",
24-Mar-22,RTGS,00.00,"11,71,644.32","11,71,644.32",
25-Mar-22,Cash,00.00,"3,90,548.11","7,81,096.21",
25-Mar-22,Transfer,00.00,"78,109.62","7,02,986.59",
25-Mar-22,Transfer,00.00,"1,75,746.65","5,27,239.94",
25-Mar-22,Transportellaneous,00.00,"2,63,619.97","2,63,619.97",
25-Mar-22,Tax,"42,566.00",00.00,"3,06,185.97",
25-Mar-22,Reversal,00.00,"1,53,092.99","1,53,092.98",
25-Mar-22,Commission,04.70,00.00,"1,53,097.68",
26-Mar-22,Cash,"15,25,565.00",00.00,"16,78,662.68",
26-Mar-22,Tax,19,00.00,"16,78,681.68",
26-Mar-22,Commission,00.00,"2,39,811.67","14,38,870.01",
26-Mar-22,Debit Card,00.00,"3,59,717.50","10,79,152.51",
26-Mar-22,Bill,02.95,00.00,"10,79,155.46",
26-Mar-22,Interest,00.00,"5,39,577.73","5,39,577.73",
26-Mar-22,ATM,00.00,"67,447.22","4,72,130.51",
26-Mar-22,Transportellaneous,00.00,"4,72,130.51",00.00,
26-Mar-22,Transportellaneous,"1,63,964.41",00.00,"1,63,964.41",
26-Mar-22,Reversal,"16,985.62",00.00,"1,80,950.03",
26-Mar-22,Transfer,00.00,"25,850.00","1,55,100.03",
26-Mar-22,Interest,"8,60,606.00",00.00,"10,15,706.03",
26-Mar-22,ATM,00.00,"1,45,100.86","8,70,605.17",
26-Mar-22,NEFT,00.00,"8,70,605.17",00.00,
26-Mar-22,Debit Card,427.4,00.00,427.4,
26-Mar-22,Interest,00.00,53.43,373.98,
26-Mar-22,Reversal,00.00,62.33,311.65,
26-Mar-22,Commission,"17,23,907.00",00.00,"17,24,218.65",
26-Mar-22,NEFT,00.00,"2,87,369.78","14,36,848.88",
26-Mar-22,Transportellaneous,00.05,00.00,"14,36,848.93",
26-Mar-22,Transfer,"10,330.20",00.00,"14,47,179.13",
26-Mar-22,Tax,"2,02,178.00",00.00,"16,49,357.13",
26-Mar-22,Transportellaneous,"9,74,985.80",00.00,"26,24,342.93",
26-Mar-22,Transfer,00.00,"13,12,171.47","13,12,171.47",
26-Mar-22,NEFT,05.00,00.00,"13,12,176.47",
26-Mar-22,Tax,00.91,00.00,"13,12,177.38",
26-Mar-22,RTGS,"2,017.90",00.00,"13,14,195.28",
26-Mar-22,ATM,960,00.00,"13,15,155.28",
26-Mar-22,Commission,00.00,"13,15,155.28",00.00,
26-Mar-22,Commission,"2,248.00",00.00,"2,248.00",
26-Mar-22,Cheque,00.00,"1,124.00","1,124.00",
26-Mar-22,Interest,38.86,00.00,"1,162.86",
26-Mar-22,RTGS,"1,891.30",00.00,"3,054.16",
26-Mar-22,Commission,00.00,381.77,"2,672.39",
26-Mar-22,Tax,"10,153.00",00.00,"12,825.39",
26-Mar-22,ATM,"1,53,496.00",00.00,"1,66,321.39",
26-Mar-22,Purchase,"15,74,616.00",00.00,"17,40,937.39",
26-Mar-22,Bill,"2,01,423.25",00.00,"19,42,360.64",
26-Mar-22,NEFT,04.34,00.00,"19,42,364.98",
26-Mar-22,ATM,00.00,"2,15,818.33","17,26,546.65",
26-Mar-22,Cheque,00.00,"4,31,636.66","12,94,909.99",
26-Mar-22,Commission,"2,947.00",00.00,"12,97,856.99",
26-Mar-22,Cash,00.00,"1,85,408.14","11,12,448.85",
27-Mar-22,Reversal,00.00,"11,12,448.85",00.00,
27-Mar-22,Cash,"2,151.00",00.00,"2,151.00",
27-Mar-22,ATM,402.22,00.00,"2,553.22",
27-Mar-22,Bill,00.00,364.75,"2,188.47",
27-Mar-22,Cheque,00.00,243.16,"1,945.31",
27-Mar-22,Commission,00.00,648.44,"1,296.87",
27-Mar-22,RTGS,00.00,324.22,972.65,
27-Mar-22,ATM,"11,56,431.00",00.00,"11,57,403.65",
27-Mar-22,NEFT,"31,751.70",00.00,"11,89,155.35",
27-Mar-22,Commission,49.26,00.00,"11,89,204.61",
27-Mar-22,ATM,00.00,"2,37,840.92","9,51,363.69",
27-Mar-22,IMPS,"20,359.00",00.00,"9,71,722.69",
27-Mar-22,Transfer,00.00,"97,172.27","8,74,550.42",
27-Mar-22,Commission,46,00.00,"8,74,596.42",
27-Mar-22,Transportellaneous,932,00.00,"8,75,528.42",
27-Mar-22,Transportellaneous,00.00,"87,552.84","7,87,975.58",
28-Mar-22,Transportellaneous,"8,425.00",00.00,"7,96,400.58",
28-Mar-22,RTGS,"2,53,450.25",00.00,"10,49,850.83",
28-Mar-22,NEFT,"21,468.00",00.00,"10,71,318.83",
28-Mar-22,Transportellaneous,"19,72,264.00",00.00,"30,43,582.83",
28-Mar-22,Cheque,"16,407.46",00.00,"30,59,990.29",
28-Mar-22,Cash,00.00,"15,29,995.15","15,29,995.14",
28-Mar-22,Bill,00.00,"15,29,995.14",00.00,
28-Mar-22,Reversal,"28,329.40",00.00,"28,329.40",
28-Mar-22,Purchase,00.00,"28,329.40",00.00,
28-Mar-22,Cash,29.79,00.00,29.79,
28-Mar-22,RTGS,"5,845.30",00.00,"5,875.09",
28-Mar-22,ATM,00.00,"1,958.36","3,916.73",
28-Mar-22,Purchase,"1,132.00",00.00,"5,048.73",
28-Mar-22,Debit Card,00.00,504.87,"4,543.86",
28-Mar-22,Cheque,00.00,454.39,"4,089.47",
28-Mar-22,NEFT,05.12,00.00,"4,094.59",
28-Mar-22,Reversal,00.00,682.43,"3,412.16",
28-Mar-22,Interest,"2,46,506.78",00.00,"2,49,918.94",
28-Mar-22,Reversal,322,00.00,"2,50,240.94",
28-Mar-22,Debit Card,00.00,"35,748.71","2,14,492.23",
28-Mar-22,Cheque,00.00,"71,497.41","1,42,994.82",
28-Mar-22,Reversal,59,00.00,"1,43,053.82",
28-Mar-22,Debit Card,00.00,"47,684.61","95,369.21",
28-Mar-22,Interest,53.9,00.00,"95,423.11",
28-Mar-22,ATM,"1,37,032.56",00.00,"2,32,455.67",
28-Mar-22,Reversal,59.65,00.00,"2,32,515.32",
28-Mar-22,Debit Card,00.00,"77,505.11","1,55,010.21",
28-Mar-22,Transfer,"3,30,426.00",00.00,"4,85,436.21",
28-Mar-22,IMPS,"2,779.81",00.00,"4,88,216.02",
29-Mar-22,Interest,00.00,"4,88,216.02",00.00,
29-Mar-22,Transportellaneous,"10,590.00",00.00,"10,590.00",
29-Mar-22,IMPS,19.1,00.00,"10,609.10",
29-Mar-22,Transportellaneous,00.00,"1,326.14","9,282.96",
29-Mar-22,Tax,"20,308.28",00.00,"29,591.24",
29-Mar-22,Commission,"77,846.00",00.00,"1,07,437.24",
29-Mar-22,NEFT,00.00,"26,859.31","80,577.93",
29-Mar-22,RTGS,00.00,"80,577.93",00.00,
29-Mar-22,Reversal,43.91,00.00,43.91,
29-Mar-22,Commission,53.2,00.00,97.11,
29-Mar-22,Transfer,05.14,00.00,102.25,
30-Mar-22,Interest,00.00,25.56,76.69,
30-Mar-22,Transportellaneous,00.00,25.56,51.13,
30-Mar-22,Cheque,51.76,00.00,102.89,
30-Mar-22,Commission,00.00,11.43,91.46,
30-Mar-22,Tax,00.00,91.46,00.00,
30-Mar-22,Cheque,"62,933.40",00.00,"62,933.40",
30-Mar-22,Cash,38,00.00,"62,971.40",
30-Mar-22,NEFT,00.00,"10,495.23","52,476.17",
30-Mar-22,Purchase,"1,91,384.80",00.00,"2,43,860.97",
30-Mar-22,Transportellaneous,00.00,"34,837.28","2,09,023.69",
30-Mar-22,Transfer,"1,471.10",00.00,"2,10,494.79",
30-Mar-22,RTGS,00.00,"35,082.47","1,75,412.32",
30-Mar-22,Purchase,00.00,"25,058.90","1,50,353.42",
30-Mar-22,Transfer,00.00,"25,058.90","1,25,294.52",
30-Mar-22,Purchase,06.00,00.00,"1,25,300.52",
30-Mar-22,Interest,00.00,"62,650.26","62,650.26",
30-Mar-22,RTGS,00.00,"12,530.05","50,120.21",
30-Mar-22,Cheque,283,00.00,"50,403.21",
30-Mar-22,Debit Card,00.00,"5,040.32","45,362.89",
30-Mar-22,Bill,00.00,"5,040.32","40,322.57",
30-Mar-22,Transportellaneous,"2,963.87",00.00,"43,286.44",
30-Mar-22,Commission,"1,31,694.90",00.00,"1,74,981.34",
30-Mar-22,IMPS,00.00,"87,490.67","87,490.67",
30-Mar-22,NEFT,"3,593.00",00.00,"91,083.67",
30-Mar-22,Transfer,00.00,"30,361.22","60,722.45",
30-Mar-22,Cheque,00.00,"8,674.64","52,047.81",
30-Mar-22,ATM,00.00,"26,023.91","26,023.90",
30-Mar-22,Commission,00.00,"26,023.90",00.00,
30-Mar-22,Interest,"29,618.00",00.00,"29,618.00",
30-Mar-22,Interest,00.00,"5,923.60","23,694.40",
30-Mar-22,ATM,"1,42,510.90",00.00,"1,66,205.30",
30-Mar-22,Transfer,"1,85,425.30",00.00,"3,51,630.60",
30-Mar-22,Interest,"1,952.89",00.00,"3,53,583.49",
30-Mar-22,Transportellaneous,00.00,"39,287.05","3,14,296.44",
30-Mar-22,Debit Card,00.00,"1,04,765.48","2,09,530.96",
30-Mar-22,Tax,00.00,"23,281.22","1,86,249.74",
30-Mar-22,IMPS,50.4,00.00,"1,86,300.14",
30-Mar-22,RTGS,00.00,"18,630.01","1,67,670.13",
30-Mar-22,Bill,"10,569.00",00.00,"1,78,239.13",
30-Mar-22,NEFT,00.00,"17,823.91","1,60,415.22",
30-Mar-22,Bill,"81,252.00",00.00,"2,41,667.22",
30-Mar-22,Interest,"10,882.00",00.00,"2,52,549.22",
30-Mar-22,NEFT,"1,308.00",00.00,"2,53,857.22",
30-Mar-22,IMPS,"6,667.60",00.00,"2,60,524.82",
30-Mar-22,NEFT,"15,13,274.00",00.00,"17,73,798.82",
30-Mar-22,Commission,00.00,"2,21,724.85","15,52,073.97",
30-Mar-22,Purchase,00.00,"1,94,009.25","13,58,064.72",
30-Mar-22,Reversal,"1,165.00",00.00,"13,59,229.72",
30-Mar-22,Commission,00.00,"2,71,845.94","10,87,383.78",
30-Mar-22,Cheque,00.00,"2,71,845.95","8,15,537.84",
30-Mar-22,Transfer,00.00,"2,03,884.46","6,11,653.38",
30-Mar-22,Transfer,00.00,"1,52,913.35","4,58,740.04",
30-Mar-22,Cash,07.00,00.00,"4,58,747.04",
30-Mar-22,Interest,"15,14,255.25",00.00,"19,73,002.29",
30-Mar-22,Transfer,00.00,"3,94,600.46","15,78,401.83",
30-Mar-22,Purchase,"1,12,668.00",00.00,"16,91,069.83",
30-Mar-22,Interest,00.00,"2,41,581.40","14,49,488.43",
30-Mar-22,Purchase,00.00,"2,07,069.78","12,42,418.65",
30-Mar-22,Cheque,00.00,"3,10,604.66","9,31,813.99",
30-Mar-22,ATM,00.00,"1,16,476.75","8,15,337.24",
30-Mar-22,Bill,"2,39,484.70",00.00,"10,54,821.94",
30-Mar-22,Interest,02.20,00.00,"10,54,824.14",
30-Mar-22,RTGS,00.00,"5,27,412.07","5,27,412.07",
30-Mar-22,RTGS,00.00,"1,05,482.41","4,21,929.66",
30-Mar-22,Cheque,00.00,"4,21,929.66",00.00,
30-Mar-22,Cheque,01.00,00.00,01.00,
30-Mar-22,Purchase,00.00,00.20,00.80,
30-Mar-22,Interest,"2,690.00",00.00,"2,690.80",
30-Mar-22,IMPS,"8,01,788.00",00.00,"8,04,478.80",
30-Mar-22,ATM,00.00,"89,386.53","7,15,092.27",
30-Mar-22,Cash,57.8,00.00,"7,15,150.07",
30-Mar-22,Transfer,00.00,"79,461.12","6,35,688.95",
30-Mar-22,Commission,00.00,00.00,"6,35,688.95",
30-Mar-22,Transfer,00.00,"70,632.11","5,65,056.84",
30-Mar-22,RTGS,00.00,"1,13,011.37","4,52,045.47",
30-Mar-22,Purchase,"5,80,091.75",00.00,"10,32,137.22",
30-Mar-22,Transfer,"6,78,546.00",00.00,"17,10,683.22",
30-Mar-22,Cheque,00.00,"5,70,227.74","11,40,455.48",
30-Mar-22,Commission,00.00,"11,40,455.48",00.00,
30-Mar-22,Reversal,07.00,00.00,07.00,
30-Mar-22,Transportellaneous,117.21,00.00,124.21,
30-Mar-22,Bill,86,00.00,210.21,
30-Mar-22,Purchase,"19,080.75",00.00,"19,290.96",
30-Mar-22,Reversal,279.4,00.00,"19,570.36",
30-Mar-22,Purchase,00.00,"1,957.04","17,613.32",
30-Mar-22,Cash,03.95,00.00,"17,617.27",
30-Mar-22,Tax,"32,731.77",00.00,"50,349.04",
30-Mar-22,Reversal,00.00,"6,293.63","44,055.41",
30-Mar-22,Cheque,"9,47,106.50",00.00,"9,91,161.91",
30-Mar-22,Interest,00.00,"1,10,129.10","8,81,032.81",
30-Mar-22,IMPS,00.00,"1,25,861.83","7,55,170.98",
30-Mar-22,IMPS,00.00,"1,88,792.75","5,66,378.24",
30-Mar-22,Reversal,51,00.00,"5,66,429.24",
30-Mar-22,Purchase,"2,09,177.66",00.00,"7,75,606.90",
30-Mar-22,IMPS,348,00.00,"7,75,954.90",
30-Mar-22,ATM,00.00,"3,87,977.45","3,87,977.45",
30-Mar-22,Tax,"17,12,760.00",00.00,"21,00,737.45",
30-Mar-22,ATM,00.00,"3,00,105.35","18,00,632.10",
30-Mar-22,Reversal,"1,16,758.25",00.00,"19,17,390.35",
30-Mar-22,Bill,"92,849.70",00.00,"20,10,240.05",
30-Mar-22,IMPS,00.00,"3,35,040.01","16,75,200.04",
30-Mar-22,Transportellaneous,"2,848.73",00.00,"16,78,048.77",
30-Mar-22,Purchase,368.93,00.00,"16,78,417.70",
30-Mar-22,ATM,00.00,"2,09,802.21","14,68,615.49",
30-Mar-22,Reversal,00.00,"2,09,802.21","12,58,813.28",
30-Mar-22,IMPS,00.00,"1,39,868.14","11,18,945.14",
30-Mar-22,Cash,"5,28,552.00",00.00,"16,47,497.14",
30-Mar-22,Interest,00.00,"2,74,582.86","13,72,914.28",
30-Mar-22,RTGS,11,00.00,"13,72,925.28",
30-Mar-22,Bill,00.00,"1,37,292.53","12,35,632.75",
30-Mar-22,Cheque,00.00,"2,05,938.79","10,29,693.96",
30-Mar-22,Purchase,55.7,00.00,"10,29,749.66",
30-Mar-22,Tax,"1,69,333.00",00.00,"11,99,082.66",
30-Mar-22,RTGS,"21,688.00",00.00,"12,20,770.66",
30-Mar-22,Cash,"3,875.56",00.00,"12,24,646.22",
30-Mar-22,Transfer,00.00,"6,12,323.11","6,12,323.11",
30-Mar-22,Cheque,00.00,"61,232.31","5,51,090.80",
30-Mar-22,RTGS,36.27,00.00,"5,51,127.07",
30-Mar-22,Transfer,"10,91,273.00",00.00,"16,42,400.07",
30-Mar-22,Cheque,233.32,00.00,"16,42,633.39",
30-Mar-22,Bill,00.00,"2,73,772.23","13,68,861.16",
30-Mar-22,Cash,"18,01,474.25",00.00,"31,70,335.41",
30-Mar-22,Bill,"1,82,402.00",00.00,"33,52,737.41",
30-Mar-22,Reversal,00.00,"6,70,547.48","26,82,189.93",
30-Mar-22,ATM,"78,418.69",00.00,"27,60,608.62",
30-Mar-22,Transportellaneous,417,00.00,"27,61,025.62",
30-Mar-22,Tax,00.00,"3,06,780.62","24,54,245.00",
30-Mar-22,Transportellaneous,"18,187.29",00.00,"24,72,432.29",
30-Mar-22,NEFT,"1,46,906.06",00.00,"26,19,338.35",
30-Mar-22,Transfer,00.00,"8,73,112.78","17,46,225.57",
30-Mar-22,Transportellaneous,58.8,00.00,"17,46,284.37",
30-Mar-22,Cheque,00.00,"4,36,571.09","13,09,713.28",
30-Mar-22,Debit Card,00.40,00.00,"13,09,713.68",
30-Mar-22,Purchase,00.00,"4,36,571.23","8,73,142.45",
30-Mar-22,Commission,00.00,"1,24,734.64","7,48,407.81",
30-Mar-22,Bill,00.00,"1,49,681.56","5,98,726.25",
30-Mar-22,Bill,"3,971.08",00.00,"6,02,697.33",
30-Mar-22,Purchase,38,00.00,"6,02,735.33",
30-Mar-22,Interest,"9,286.00",00.00,"6,12,021.33",
30-Mar-22,Interest,00.00,"76,502.67","5,35,518.66",
30-Mar-22,Cash,76.6,00.00,"5,35,595.26",
30-Mar-22,Cheque,"10,26,609.25",00.00,"15,62,204.51",
30-Mar-22,Debit Card,05.40,00.00,"15,62,209.91",
30-Mar-22,Bill,"3,451.00",00.00,"15,65,660.91",
30-Mar-22,Interest,00.00,"3,13,132.18","12,52,528.73",
30-Mar-22,Cash,00.00,"1,78,932.68","10,73,596.05",
30-Mar-22,Cash,00.00,"1,34,199.51","9,39,396.54",
30-Mar-22,Cheque,00.00,"1,17,424.57","8,21,971.97",
30-Mar-22,Commission,"1,52,906.94",00.00,"9,74,878.91",
30-Mar-22,Tax,"14,50,455.25",00.00,"24,25,334.16",
30-Mar-22,Commission,00.00,"3,03,166.77","21,22,167.39",
30-Mar-22,Commission,00.00,"4,24,433.48","16,97,733.91",
30-Mar-22,Debit Card,"23,553.30",00.00,"17,21,287.21",
30-Mar-22,IMPS,"1,42,387.28",00.00,"18,63,674.49",
30-Mar-22,Tax,00.00,"4,65,918.62","13,97,755.87",
30-Mar-22,Purchase,00.00,"1,39,775.59","12,57,980.28",
30-Mar-22,Cash,00.00,"6,28,990.14","6,28,990.14",
30-Mar-22,Tax,282,00.00,"6,29,272.14",
30-Mar-22,Debit Card,31.5,00.00,"6,29,303.64",
30-Mar-22,RTGS,00.00,"1,57,325.91","4,71,977.73",
31-Mar-22,RTGS,"5,221.06",00.00,"4,77,198.79",
31-Mar-22,NEFT,06.00,00.00,"4,77,204.79",
31-Mar-22,Purchase,335.4,00.00,"4,77,540.19",
31-Mar-22,Transportellaneous,00.00,"47,754.02","4,29,786.17",
31-Mar-22,RTGS,"17,184.10",00.00,"4,46,970.27",
31-Mar-22,Bill,"2,78,691.25",00.00,"7,25,661.52",
31-Mar-22,Reversal,145.1,00.00,"7,25,806.62",
01-Apr-22,Transportellaneous,55,00.00,"7,25,861.62",
01-Apr-22,Tax,00.00,"1,03,694.52","6,22,167.10",
01-Apr-22,Cash,00.00,"1,55,541.78","4,66,625.32",
01-Apr-22,NEFT,00.00,"1,55,541.77","3,11,083.55",
01-Apr-22,IMPS,00.00,"44,440.51","2,66,643.04",
01-Apr-22,Purchase,00.00,"38,091.86","2,28,551.18",
01-Apr-22,NEFT,41.3,00.00,"2,28,592.48",
01-Apr-22,Tax,28.2,00.00,"2,28,620.68",
01-Apr-22,Commission,04.81,00.00,"2,28,625.49",
01-Apr-22,Reversal,00.00,"76,208.50","1,52,416.99",
01-Apr-22,ATM,00.00,"19,052.12","1,33,364.87",
01-Apr-22,NEFT,00.80,00.00,"1,33,365.67",
01-Apr-22,Reversal,"92,457.20",00.00,"2,25,822.87",
01-Apr-22,RTGS,00.00,"32,260.41","1,93,562.46",
01-Apr-22,Commission,04.90,00.00,"1,93,567.36",
01-Apr-22,Commission,"16,633.89",00.00,"2,10,201.25",
01-Apr-22,Transportellaneous,00.00,"52,550.31","1,57,650.94",
01-Apr-22,RTGS,00.00,"22,521.56","1,35,129.38",
01-Apr-22,NEFT,00.00,"19,304.20","1,15,825.18",
01-Apr-22,IMPS,"11,351.10",00.00,"1,27,176.28",
01-Apr-22,ATM,04.00,00.00,"1,27,180.28",
01-Apr-22,ATM,11.07,00.00,"1,27,191.35",
01-Apr-22,Purchase,00.00,"31,797.84","95,393.51",
01-Apr-22,Purchase,00.00,"31,797.84","63,595.67",
01-Apr-22,Purchase,00.00,"21,198.56","42,397.11",
01-Apr-22,ATM,00.00,"4,239.71","38,157.40",
01-Apr-22,Interest,51,00.00,"38,208.40",
01-Apr-22,Cash,"13,237.00",00.00,"51,445.40",
01-Apr-22,Transportellaneous,"1,83,451.00",00.00,"2,34,896.40",
01-Apr-22,Cheque,00.00,"26,099.60","2,08,796.80",
01-Apr-22,Transportellaneous,15.5,00.00,"2,08,812.30",
01-Apr-22,Purchase,00.00,"26,101.54","1,82,710.76",
01-Apr-22,Transportellaneous,"12,04,041.00",00.00,"13,86,751.76",
01-Apr-22,Transportellaneous,04.10,00.00,"13,86,755.86",
01-Apr-22,Bill,00.00,"2,77,351.17","11,09,404.69",
01-Apr-22,Interest,"19,85,328.00",00.00,"30,94,732.69",
01-Apr-22,ATM,00.00,"3,09,473.27","27,85,259.42",
01-Apr-22,Tax,00.00,"3,48,157.43","24,37,101.99",
01-Apr-22,Transportellaneous,00.00,"12,18,551.00","12,18,551.00",
01-Apr-22,Purchase,00.00,"3,04,637.75","9,13,913.25",
01-Apr-22,Reversal,00.00,"1,01,545.92","8,12,367.33",
01-Apr-22,Commission,00.00,"81,236.73","7,31,130.60",
01-Apr-22,RTGS,00.00,"81,236.73","6,49,893.87",
01-Apr-22,Interest,456.98,00.00,"6,50,350.85",
01-Apr-22,ATM,00.00,"1,08,391.81","5,41,959.04",
01-Apr-22,Interest,00.00,"54,195.90","4,87,763.14",
01-Apr-22,Bill,00.00,"4,87,763.14",00.00,
02-Apr-22,Commission,"1,939.16",00.00,"1,939.16",
02-Apr-22,Debit Card,"1,533.30",00.00,"3,472.46",
02-Apr-22,IMPS,00.00,"3,472.46",00.00,
02-Apr-22,Transfer,06.78,00.00,06.78,
02-Apr-22,NEFT,26.2,00.00,32.98,
02-Apr-22,RTGS,00.00,03.66,29.32,
02-Apr-22,IMPS,00.00,29.32,00.00,
02-Apr-22,ATM,"1,216.00",00.00,"1,216.00",
02-Apr-22,Bill,00.00,121.6,"1,094.40",
02-Apr-22,Reversal,00.00,547.2,547.2,
02-Apr-22,Cheque,"1,81,208.50",00.00,"1,81,755.70",
02-Apr-22,Debit Card,01.37,00.00,"1,81,757.07",
02-Apr-22,ATM,00.00,"18,175.71","1,63,581.36",
03-Apr-22,Commission,31.45,00.00,"1,63,612.81",
03-Apr-22,Interest,00.00,"20,451.60","1,43,161.21",
03-Apr-22,IMPS,00.00,"47,720.40","95,440.81",
03-Apr-22,Purchase,"3,696.62",00.00,"99,137.43",
04-Apr-22,RTGS,00.00,"24,784.36","74,353.07",
04-Apr-22,Cheque,"5,43,022.50",00.00,"6,17,375.57",
04-Apr-22,Transfer,00.00,"61,737.56","5,55,638.01",
04-Apr-22,Reversal,"1,64,872.00",00.00,"7,20,510.01",
04-Apr-22,Debit Card,"17,301.81",00.00,"7,37,811.82",
04-Apr-22,Purchase,00.00,"7,37,811.82",00.00,
04-Apr-22,Reversal,51,00.00,51,
04-Apr-22,RTGS,00.00,08.50,42.5,
04-Apr-22,Bill,00.00,08.50,34,
04-Apr-22,IMPS,114,00.00,148,
04-Apr-22,Debit Card,"15,09,500.00",00.00,"15,09,648.00",
05-Apr-22,Bill,00.00,"1,67,738.67","13,41,909.33",
05-Apr-22,Commission,63.2,00.00,"13,41,972.53",
05-Apr-22,RTGS,09.00,00.00,"13,41,981.53",
05-Apr-22,Commission,00.00,"1,49,109.06","11,92,872.47",
05-Apr-22,RTGS,03.00,00.00,"11,92,875.47",
05-Apr-22,Debit Card,00.00,"5,96,437.74","5,96,437.74",
05-Apr-22,Cash,00.00,"66,270.86","5,30,166.88",
05-Apr-22,ATM,"2,53,932.00",00.00,"7,84,098.88",
05-Apr-22,NEFT,00.00,"2,61,366.29","5,22,732.59",
05-Apr-22,ATM,"23,824.00",00.00,"5,46,556.59",
05-Apr-22,Bill,00.00,"91,092.77","4,55,463.82",
05-Apr-22,Purchase,"16,14,021.20",00.00,"20,69,485.02",
05-Apr-22,Transfer,00.00,"5,17,371.26","15,52,113.76",
05-Apr-22,ATM,00.00,"2,21,730.54","13,30,383.22",
06-Apr-22,Transportellaneous,"6,337.00",00.00,"13,36,720.22",
06-Apr-22,ATM,00.00,"1,90,960.03","11,45,760.19",
06-Apr-22,Commission,00.00,"1,14,576.02","10,31,184.17",
06-Apr-22,NEFT,00.00,"10,31,184.17",00.00,
06-Apr-22,NEFT,"19,97,835.50",00.00,"19,97,835.50",
06-Apr-22,Purchase,00.00,"1,99,783.55","17,98,051.95",
06-Apr-22,Bill,02.97,00.00,"17,98,054.92",
06-Apr-22,ATM,00.00,"17,98,054.92",00.00,
06-Apr-22,Commission,"21,694.10",00.00,"21,694.10",
06-Apr-22,NEFT,434.8,00.00,"22,128.90",
06-Apr-22,Cash,00.00,"4,425.78","17,703.12",
06-Apr-22,Reversal,00.00,"17,703.12",00.00,
06-Apr-22,Reversal,"12,251.00",00.00,"12,251.00",
06-Apr-22,Interest,00.00,"4,083.67","8,167.33",
06-Apr-22,Debit Card,06.00,00.00,"8,173.33",
06-Apr-22,Interest,00.00,"8,173.33",00.00,
06-Apr-22,ATM,"3,454.70",00.00,"3,454.70",
06-Apr-22,Reversal,00.00,"3,454.70",00.00,
06-Apr-22,Bill,322,00.00,322,
06-Apr-22,IMPS,00.00,35.78,286.22,
06-Apr-22,Cash,"61,368.00",00.00,"61,654.22",
06-Apr-22,ATM,00.00,"7,706.78","53,947.44",
06-Apr-22,Tax,00.00,"53,947.44",00.00,
06-Apr-22,Interest,04.47,00.00,04.47,
06-Apr-22,Purchase,"1,55,446.31",00.00,"1,55,450.78",
06-Apr-22,Tax,"1,92,639.00",00.00,"3,48,089.78",
06-Apr-22,Debit Card,00.00,"43,511.22","3,04,578.56",
06-Apr-22,Debit Card,00.00,"30,457.86","2,74,120.70",
06-Apr-22,Interest,"1,04,682.00",00.00,"3,78,802.70",
06-Apr-22,Debit Card,"1,26,284.00",00.00,"5,05,086.70",
06-Apr-22,Bill,73,00.00,"5,05,159.70",
06-Apr-22,IMPS,268.21,00.00,"5,05,427.91",
06-Apr-22,RTGS,66.27,00.00,"5,05,494.18",
06-Apr-22,Interest,00.00,"50,549.42","4,54,944.76",
06-Apr-22,Reversal,116.1,00.00,"4,55,060.86",
06-Apr-22,Cheque,00.00,"4,55,060.86",00.00,
06-Apr-22,NEFT,01.72,00.00,01.72,
06-Apr-22,NEFT,00.00,00.86,00.86,
07-Apr-22,Purchase,"19,86,797.00",00.00,"19,86,797.86",
07-Apr-22,Reversal,"6,52,688.80",00.00,"26,39,486.66",
07-Apr-22,Transportellaneous,"9,82,494.50",00.00,"36,21,981.16",
08-Apr-22,Debit Card,00.00,"4,52,747.65","31,69,233.52",
08-Apr-22,ATM,"2,838.90",00.00,"31,72,072.42",
08-Apr-22,Debit Card,00.00,"15,86,036.21","15,86,036.21",
08-Apr-22,RTGS,00.00,"3,17,207.24","12,68,828.97",
08-Apr-22,IMPS,00.00,"2,53,765.79","10,15,063.18",
08-Apr-22,IMPS,412.3,00.00,"10,15,475.48",
08-Apr-22,Transfer,00.00,"2,03,095.10","8,12,380.38",
08-Apr-22,Debit Card,00.00,"1,35,396.73","6,76,983.65",
08-Apr-22,IMPS,31.8,00.00,"6,77,015.45",
08-Apr-22,RTGS,"2,560.72",00.00,"6,79,576.17",
08-Apr-22,Bill,00.00,"1,35,915.23","5,43,660.94",
08-Apr-22,ATM,"92,321.90",00.00,"6,35,982.84",
08-Apr-22,RTGS,00.00,"1,58,995.71","4,76,987.13",
08-Apr-22,Cheque,00.00,"1,58,995.71","3,17,991.42",
08-Apr-22,Tax,00.00,"31,799.14","2,86,192.28",
08-Apr-22,Cash,"2,77,514.50",00.00,"5,63,706.78",
09-Apr-22,Debit Card,00.00,"62,634.09","5,01,072.69",
09-Apr-22,RTGS,35.2,00.00,"5,01,107.89",
09-Apr-22,Transfer,00.00,"1,67,035.96","3,34,071.93",
09-Apr-22,RTGS,00.00,"83,517.98","2,50,553.95",
09-Apr-22,Reversal,11.72,00.00,"2,50,565.67",
09-Apr-22,Cheque,00.00,"1,25,282.84","1,25,282.84",
09-Apr-22,Transportellaneous,"19,693.50",00.00,"1,44,976.34",
09-Apr-22,RTGS,00.00,"36,244.09","1,08,732.26",
09-Apr-22,Cash,00.00,"12,081.36","96,650.90",
09-Apr-22,ATM,"2,156.00",00.00,"98,806.90",
09-Apr-22,Transfer,00.00,"24,701.73","74,105.17",
09-Apr-22,Bill,00.00,"24,701.72","49,403.45",
09-Apr-22,NEFT,03.56,00.00,"49,407.01",
09-Apr-22,Cheque,"99,481.00",00.00,"1,48,888.01",
09-Apr-22,NEFT,"2,41,397.10",00.00,"3,90,285.11",
09-Apr-22,NEFT,"1,754.10",00.00,"3,92,039.21",
09-Apr-22,Cash,"7,55,166.25",00.00,"11,47,205.46",
09-Apr-22,Reversal,"2,767.00",00.00,"11,49,972.46",
09-Apr-22,Interest,00.00,"1,43,746.56","10,06,225.90",
09-Apr-22,Cheque,00.00,"10,06,225.90",00.00,
09-Apr-22,Cash,"18,64,641.20",00.00,"18,64,641.20",
09-Apr-22,Commission,00.00,"4,66,160.30","13,98,480.90",
09-Apr-22,ATM,00.00,"2,79,696.18","11,18,784.72",
09-Apr-22,Reversal,00.00,"5,59,392.36","5,59,392.36",
09-Apr-22,RTGS,485,00.00,"5,59,877.36",
09-Apr-22,Transportellaneous,00.00,"55,987.74","5,03,889.62",
09-Apr-22,Cash,00.00,"71,984.23","4,31,905.39",
09-Apr-22,Tax,"28,169.62",00.00,"4,60,075.01",
09-Apr-22,Cash,04.23,00.00,"4,60,079.24",
09-Apr-22,Cash,00.00,"65,725.61","3,94,353.63",
09-Apr-22,Tax,00.00,"39,435.36","3,54,918.27",
09-Apr-22,Commission,12.8,00.00,"3,54,931.07",
09-Apr-22,Cash,"4,27,306.20",00.00,"7,82,237.27",
09-Apr-22,ATM,00.00,"1,56,447.45","6,25,789.82",
09-Apr-22,RTGS,"12,085.00",00.00,"6,37,874.82",
09-Apr-22,Purchase,00.00,"2,12,624.94","4,25,249.88",
10-Apr-22,RTGS,00.00,"60,749.98","3,64,499.90",
10-Apr-22,ATM,00.00,"36,449.99","3,28,049.91",
10-Apr-22,Reversal,00.00,"54,674.99","2,73,374.92",
10-Apr-22,Tax,00.00,"30,374.99","2,42,999.93",
10-Apr-22,Cheque,00.00,"2,42,999.93",00.00,
10-Apr-22,Purchase,"1,54,350.25",00.00,"1,54,350.25",
10-Apr-22,Commission,00.00,"19,293.78","1,35,056.47",
10-Apr-22,Transportellaneous,07.34,00.00,"1,35,063.81",
10-Apr-22,IMPS,00.00,"19,294.83","1,15,768.98",
10-Apr-22,Transportellaneous,00.00,"23,153.80","92,615.18",
10-Apr-22,Cheque,40.3,00.00,"92,655.48",
10-Apr-22,RTGS,02.00,00.00,"92,657.48",
11-Apr-22,Interest,00.00,"15,442.91","77,214.57",
11-Apr-22,NEFT,00.87,00.00,"77,215.44",
11-Apr-22,Cash,00.00,"12,869.24","64,346.20",
11-Apr-22,IMPS,"3,520.30",00.00,"67,866.50",
11-Apr-22,Interest,"1,25,995.00",00.00,"1,93,861.50",
11-Apr-22,NEFT,00.00,"64,620.50","1,29,241.00",
11-Apr-22,Transfer,00.00,"18,463.00","1,10,778.00",
11-Apr-22,ATM,00.00,"36,926.00","73,852.00",
11-Apr-22,Reversal,01.00,00.00,"73,853.00",
11-Apr-22,Commission,00.00,"8,205.89","65,647.11",
11-Apr-22,Cash,00.00,"21,882.37","43,764.74",
11-Apr-22,Bill,19,00.00,"43,783.74",
11-Apr-22,Interest,07.90,00.00,"43,791.64",
11-Apr-22,RTGS,"50,569.00",00.00,"94,360.64",
11-Apr-22,Purchase,00.00,"15,726.77","78,633.87",
11-Apr-22,RTGS,00.00,"13,105.65","65,528.22",
11-Apr-22,Debit Card,00.00,"13,105.64","52,422.58",
11-Apr-22,Transportellaneous,"26,970.50",00.00,"79,393.08",
11-Apr-22,RTGS,00.00,"79,393.08",00.00,
11-Apr-22,Interest,"1,89,866.69",00.00,"1,89,866.69",
11-Apr-22,Tax,"1,45,124.70",00.00,"3,34,991.39",
11-Apr-22,Commission,04.20,00.00,"3,34,995.59",
12-Apr-22,Commission,00.00,"1,11,665.20","2,23,330.39",
12-Apr-22,Reversal,00.00,"74,443.46","1,48,886.93",
12-Apr-22,Cash,"1,269.58",00.00,"1,50,156.51",
12-Apr-22,Bill,00.00,"75,078.26","75,078.26",
12-Apr-22,NEFT,06.18,00.00,"75,084.44",
12-Apr-22,Cheque,00.00,"8,342.72","66,741.72",
12-Apr-22,Debit Card,00.00,"9,534.53","57,207.19",
12-Apr-22,Reversal,00.00,"6,356.35","50,850.84",
12-Apr-22,Debit Card,"3,90,105.00",00.00,"4,40,955.84",
12-Apr-22,NEFT,00.00,"48,995.09","3,91,960.75",
12-Apr-22,Transfer,487.94,00.00,"3,92,448.69",
12-Apr-22,Cheque,00.00,"49,056.09","3,43,392.60",
12-Apr-22,Commission,02.70,00.00,"3,43,395.30",
12-Apr-22,Debit Card,"1,78,816.00",00.00,"5,22,211.30",
12-Apr-22,Transfer,00.00,"52,221.13","4,69,990.17",
12-Apr-22,Purchase,00.00,"2,34,995.09","2,34,995.08",
12-Apr-22,ATM,00.00,"23,499.51","2,11,495.57",
12-Apr-22,Reversal,00.00,"26,436.95","1,85,058.62",
12-Apr-22,IMPS,05.80,00.00,"1,85,064.42",
12-Apr-22,Commission,"1,97,399.00",00.00,"3,82,463.42",
12-Apr-22,Cash,00.00,"38,246.34","3,44,217.08",
12-Apr-22,Tax,00.00,"68,843.42","2,75,373.66",
12-Apr-22,ATM,284,00.00,"2,75,657.66",
12-Apr-22,Transfer,00.00,"1,37,828.83","1,37,828.83",
12-Apr-22,Transportellaneous,02.14,00.00,"1,37,830.97",
12-Apr-22,Debit Card,00.00,"13,783.10","1,24,047.87",
12-Apr-22,Cheque,"1,043.18",00.00,"1,25,091.05",
12-Apr-22,Purchase,"7,69,964.00",00.00,"8,95,055.05",
12-Apr-22,Purchase,00.00,"8,95,055.05",00.00,
12-Apr-22,Commission,295.3,00.00,295.3,
12-Apr-22,ATM,00.00,36.91,258.39,
12-Apr-22,RTGS,254.7,00.00,513.09,
12-Apr-22,RTGS,00.00,171.03,342.06,
12-Apr-22,Tax,00.00,68.41,273.65,
12-Apr-22,ATM,00.00,54.73,218.92,
12-Apr-22,ATM,52.5,00.00,271.42,
12-Apr-22,Transfer,22,00.00,293.42,
13-Apr-22,Interest,00.00,32.6,260.82,
13-Apr-22,Purchase,00.00,26.08,234.74,
13-Apr-22,Tax,00.00,58.69,176.06,
13-Apr-22,Debit Card,"7,16,272.75",00.00,"7,16,448.81",
13-Apr-22,RTGS,00.00,"89,556.10","6,26,892.71",
13-Apr-22,Transportellaneous,00.00,"1,25,378.54","5,01,514.17",
13-Apr-22,Cheque,"85,027.00",00.00,"5,86,541.17",
13-Apr-22,Commission,398.5,00.00,"5,86,939.67",
13-Apr-22,Debit Card,00.00,"1,95,646.56","3,91,293.11",
13-Apr-22,Transfer,00.00,"3,91,293.11",00.00,
13-Apr-22,Cash,"3,573.80",00.00,"3,573.80",
13-Apr-22,Bill,00.00,357.38,"3,216.42",
13-Apr-22,Bill,00.00,804.11,"2,412.32",
13-Apr-22,Tax,00.00,402.05,"2,010.27",
13-Apr-22,Tax,00.00,670.09,"1,340.18",
13-Apr-22,Debit Card,00.00,223.36,"1,116.82",
13-Apr-22,Tax,00.00,111.68,"1,005.14",
13-Apr-22,Tax,"29,336.70",00.00,"30,341.84",
13-Apr-22,Interest,00.00,"3,792.73","26,549.11",
13-Apr-22,Interest,00.00,"26,549.11",00.00,
13-Apr-22,Purchase,"19,117.00",00.00,"19,117.00",
13-Apr-22,Cheque,255.2,00.00,"19,372.20",
13-Apr-22,Tax,"20,06,148.00",00.00,"20,25,520.20",
13-Apr-22,Bill,"2,45,391.80",00.00,"22,70,912.00",
13-Apr-22,RTGS,00.00,"3,78,485.33","18,92,426.67",
13-Apr-22,Reversal,"2,30,986.70",00.00,"21,23,413.37",
13-Apr-22,Cheque,00.00,"3,03,344.77","18,20,068.60",
13-Apr-22,Tax,"10,92,546.75",00.00,"29,12,615.35",
13-Apr-22,Transfer,60.14,00.00,"29,12,675.49",
13-Apr-22,ATM,00.00,"14,56,337.75","14,56,337.74",
13-Apr-22,Transfer,"27,919.91",00.00,"14,84,257.65",
13-Apr-22,Transportellaneous,01.40,00.00,"14,84,259.05",
13-Apr-22,Interest,342,00.00,"14,84,601.05",
13-Apr-22,ATM,30,00.00,"14,84,631.05",
13-Apr-22,Cheque,00.00,"2,12,090.15","12,72,540.90",
13-Apr-22,Reversal,00.00,"1,41,393.43","11,31,147.47",
13-Apr-22,Commission,00.00,"1,25,683.05","10,05,464.42",
13-Apr-22,ATM,00.00,"1,43,637.77","8,61,826.65",
13-Apr-22,Transfer,311.12,00.00,"8,62,137.77",
13-Apr-22,Cheque,338,00.00,"8,62,475.77",
13-Apr-22,Debit Card,"1,305.00",00.00,"8,63,780.77",
13-Apr-22,RTGS,00.00,"1,72,756.15","6,91,024.62",
13-Apr-22,RTGS,00.00,"3,45,512.31","3,45,512.31",
13-Apr-22,Reversal,00.00,"57,585.39","2,87,926.92",
13-Apr-22,Debit Card,"2,979.70",00.00,"2,90,906.62",
13-Apr-22,RTGS,00.00,"72,726.66","2,18,179.96",
14-Apr-22,Debit Card,00.00,"1,09,089.98","1,09,089.98",
14-Apr-22,Cash,"3,225.60",00.00,"1,12,315.58",
14-Apr-22,IMPS,376.49,00.00,"1,12,692.07",
14-Apr-22,Interest,00.00,"14,086.51","98,605.56",
15-Apr-22,RTGS,"2,178.50",00.00,"1,00,784.06",
15-Apr-22,Bill,00.00,"20,156.81","80,627.25",
15-Apr-22,Purchase,48.25,00.00,"80,675.50",
15-Apr-22,Commission,"29,086.16",00.00,"1,09,761.66",
15-Apr-22,Cheque,00.00,"15,680.24","94,081.42",
15-Apr-22,IMPS,"2,471.80",00.00,"96,553.22",
15-Apr-22,RTGS,00.00,"24,138.31","72,414.92",
15-Apr-22,IMPS,"16,33,261.25",00.00,"17,05,676.17",
15-Apr-22,IMPS,"2,819.60",00.00,"17,08,495.77",
15-Apr-22,ATM,00.00,"2,44,070.82","14,64,424.95",
15-Apr-22,RTGS,00.00,"1,46,442.50","13,17,982.46",
15-Apr-22,Debit Card,00.00,"6,58,991.23","6,58,991.23",
15-Apr-22,Commission,00.00,"1,31,798.25","5,27,192.98",
15-Apr-22,Tax,00.00,"5,27,192.98",00.00,
15-Apr-22,Commission,00.30,00.00,00.30,
15-Apr-22,Reversal,00.00,00.03,00.27,
15-Apr-22,Commission,05.00,00.00,05.27,
15-Apr-22,Transfer,28.7,00.00,33.97,
15-Apr-22,Transfer,00.00,04.25,29.72,
15-Apr-22,Bill,00.00,07.43,22.29,
15-Apr-22,Tax,00.00,05.57,16.72,
15-Apr-22,RTGS,06.00,00.00,22.72,
15-Apr-22,Reversal,40.48,00.00,63.2,
15-Apr-22,Debit Card,00.00,06.32,56.88,
15-Apr-22,Bill,342.95,00.00,399.83,
15-Apr-22,Interest,"13,804.00",00.00,"14,203.83",
15-Apr-22,NEFT,00.00,"1,775.48","12,428.35",
15-Apr-22,Tax,52.5,00.00,"12,480.85",
15-Apr-22,Transfer,00.00,"6,240.43","6,240.42",
15-Apr-22,Reversal,00.00,"1,248.08","4,992.34",
15-Apr-22,Cash,00.00,998.47,"3,993.87",
15-Apr-22,ATM,"4,023.00",00.00,"8,016.87",
15-Apr-22,Reversal,"1,354.50",00.00,"9,371.37",
15-Apr-22,NEFT,00.00,"2,342.84","7,028.53",
15-Apr-22,Interest,"23,368.00",00.00,"30,396.53",
15-Apr-22,Cheque,88.3,00.00,"30,484.83",
15-Apr-22,Purchase,00.00,"15,242.42","15,242.42",
15-Apr-22,RTGS,29,00.00,"15,271.42",
15-Apr-22,Bill,444,00.00,"15,715.42",
15-Apr-22,Cash,00.00,"7,857.71","7,857.71",
15-Apr-22,Transfer,"1,08,068.00",00.00,"1,15,925.71",
15-Apr-22,Tax,"14,671.79",00.00,"1,30,597.50",
15-Apr-22,Transportellaneous,00.00,"14,510.83","1,16,086.67",
15-Apr-22,Interest,00.00,"29,021.67","87,065.00",
15-Apr-22,Cash,"19,366.66",00.00,"1,06,431.66",
15-Apr-22,Cheque,"12,28,741.75",00.00,"13,35,173.41",
16-Apr-22,Bill,00.00,"1,66,896.68","11,68,276.73",
17-Apr-22,IMPS,00.00,"11,68,276.73",00.00,
17-Apr-22,Bill,"20,08,021.00",00.00,"20,08,021.00",
17-Apr-22,Cash,"18,87,288.80",00.00,"38,95,309.80",
17-Apr-22,Reversal,"13,321.10",00.00,"39,08,630.90",
17-Apr-22,Reversal,00.00,"9,77,157.73","29,31,473.18",
17-Apr-22,Tax,00.00,"9,77,157.73","19,54,315.45",
17-Apr-22,Bill,00.00,"2,44,289.43","17,10,026.02",
17-Apr-22,Cheque,08.00,00.00,"17,10,034.02",
17-Apr-22,Commission,"1,05,386.16",00.00,"18,15,420.18",
17-Apr-22,RTGS,"5,44,011.00",00.00,"23,59,431.18",
17-Apr-22,Cheque,"1,339.50",00.00,"23,60,770.68",
17-Apr-22,Interest,"1,72,060.50",00.00,"25,32,831.18",
17-Apr-22,Transportellaneous,00.00,"3,16,603.90","22,16,227.28",
17-Apr-22,Transportellaneous,"2,640.34",00.00,"22,18,867.62",
17-Apr-22,IMPS,00.00,"11,09,433.81","11,09,433.81",
18-Apr-22,Tax,00.00,"1,38,679.23","9,70,754.58",
18-Apr-22,Reversal,"7,476.00",00.00,"9,78,230.58",
18-Apr-22,Interest,"2,25,688.12",00.00,"12,03,918.70",
18-Apr-22,Purchase,00.00,"2,00,653.12","10,03,265.58",
18-Apr-22,Transportellaneous,00.00,"1,25,408.20","8,77,857.38",
18-Apr-22,Bill,06.60,00.00,"8,77,863.98",
18-Apr-22,Reversal,00.00,"4,38,931.99","4,38,931.99",
18-Apr-22,Commission,00.00,"1,46,310.66","2,92,621.33",
18-Apr-22,Purchase,"14,83,277.50",00.00,"17,75,898.83",
18-Apr-22,Reversal,00.00,"2,21,987.35","15,53,911.48",
18-Apr-22,Commission,"11,64,023.00",00.00,"27,17,934.48",
18-Apr-22,Transportellaneous,00.00,"3,88,276.35","23,29,658.13",
18-Apr-22,Cheque,00.00,"5,82,414.53","17,47,243.60",
18-Apr-22,Commission,"1,122.10",00.00,"17,48,365.70",
18-Apr-22,RTGS,00.00,"1,74,836.57","15,73,529.13",
18-Apr-22,Commission,00.00,"2,24,789.88","13,48,739.25",
18-Apr-22,Transfer,00.00,"2,69,747.85","10,78,991.40",
18-Apr-22,IMPS,"19,823.10",00.00,"10,98,814.50",
18-Apr-22,NEFT,00.00,"2,74,703.63","8,24,110.88",
18-Apr-22,Interest,00.00,"82,411.09","7,41,699.79",
18-Apr-22,Debit Card,28,00.00,"7,41,727.79",
18-Apr-22,Commission,"1,717.00",00.00,"7,43,444.79",
18-Apr-22,Transportellaneous,00.00,"3,71,722.40","3,71,722.40",
18-Apr-22,NEFT,03.68,00.00,"3,71,726.08",
18-Apr-22,RTGS,50.9,00.00,"3,71,776.98",
18-Apr-22,ATM,00.00,"74,355.40","2,97,421.58",
18-Apr-22,Reversal,00.00,"42,488.80","2,54,932.78",
18-Apr-22,RTGS,09.70,00.00,"2,54,942.48",
18-Apr-22,NEFT,00.00,"42,490.41","2,12,452.07",
18-Apr-22,Transfer,473.7,00.00,"2,12,925.77",
19-Apr-22,Commission,"2,587.50",00.00,"2,15,513.27",
19-Apr-22,Purchase,"2,01,933.00",00.00,"4,17,446.27",
19-Apr-22,Reversal,00.00,"69,574.38","3,47,871.89",
19-Apr-22,Cash,00.00,"1,15,957.30","2,31,914.59",
19-Apr-22,Reversal,446.79,00.00,"2,32,361.38",
19-Apr-22,Debit Card,00.00,"33,194.48","1,99,166.90",
19-Apr-22,Transportellaneous,04.00,00.00,"1,99,170.90",
19-Apr-22,Cheque,"8,98,386.25",00.00,"10,97,557.15",
19-Apr-22,Interest,00.00,"1,82,926.19","9,14,630.96",
19-Apr-22,Cheque,30,00.00,"9,14,660.96",
19-Apr-22,Debit Card,"14,05,286.00",00.00,"23,19,946.96",
19-Apr-22,Cash,"1,06,774.66",00.00,"24,26,721.62",
19-Apr-22,Purchase,"2,27,226.00",00.00,"26,53,947.62",
20-Apr-22,Interest,01.00,00.00,"26,53,948.62",
20-Apr-22,Tax,00.00,"6,63,487.16","19,90,461.46",
20-Apr-22,Cheque,"17,10,776.25",00.00,"37,01,237.71",
20-Apr-22,Interest,00.00,"9,25,309.43","27,75,928.28",
20-Apr-22,Tax,00.00,"27,75,928.28",00.00,
20-Apr-22,Tax,09.00,00.00,09.00,
20-Apr-22,Tax,00.00,02.25,06.75,
20-Apr-22,RTGS,00.00,00.96,05.79,
20-Apr-22,Commission,00.00,01.45,04.34,
20-Apr-22,Purchase,00.00,00.62,03.72,
20-Apr-22,Cheque,00.00,01.24,02.48,
20-Apr-22,Cheque,00.00,00.31,02.17,
20-Apr-22,NEFT,04.90,00.00,07.07,
20-Apr-22,Reversal,"18,240.27",00.00,"18,247.34",
20-Apr-22,Cheque,00.00,"2,027.48","16,219.86",
20-Apr-22,Bill,04.56,00.00,"16,224.42",
20-Apr-22,Commission,00.00,"5,408.14","10,816.28",
20-Apr-22,Tax,00.00,"1,352.04","9,464.25",
20-Apr-22,Bill,00.00,00.00,"9,464.25",
20-Apr-22,NEFT,00.00,"1,577.38","7,886.88",
20-Apr-22,ATM,"51,073.80",00.00,"58,960.68",
20-Apr-22,Tax,00.00,"9,826.78","49,133.90",
20-Apr-22,Tax,00.00,"5,459.32","43,674.58",
20-Apr-22,Transportellaneous,00.00,"21,837.29","21,837.29",
20-Apr-22,Commission,"1,41,070.59",00.00,"1,62,907.88",
20-Apr-22,Cash,00.00,"20,363.49","1,42,544.40",
20-Apr-22,IMPS,460.62,00.00,"1,43,005.02",
20-Apr-22,Reversal,00.00,"1,43,005.02",00.00,
20-Apr-22,Transfer,"23,320.00",00.00,"23,320.00",
20-Apr-22,Cheque,259,00.00,"23,579.00",
20-Apr-22,Commission,00.00,"2,947.38","20,631.62",
20-Apr-22,Transportellaneous,"2,04,455.00",00.00,"2,25,086.62",
20-Apr-22,Commission,00.00,"75,028.87","1,50,057.75",
20-Apr-22,RTGS,00.00,"21,436.82","1,28,620.93",
20-Apr-22,NEFT,00.00,"18,374.42","1,10,246.51",
20-Apr-22,Cheque,00.00,"18,374.42","91,872.09",
20-Apr-22,IMPS,03.00,00.00,"91,875.09",
20-Apr-22,IMPS,"2,30,099.50",00.00,"3,21,974.59",
20-Apr-22,Transfer,"2,59,934.41",00.00,"5,81,909.00",
20-Apr-22,Cheque,"2,287.70",00.00,"5,84,196.70",
20-Apr-22,NEFT,00.00,"64,910.74","5,19,285.96",
20-Apr-22,Commission,00.00,"64,910.75","4,54,375.22",
20-Apr-22,Purchase,35,00.00,"4,54,410.22",
20-Apr-22,Transportellaneous,398,00.00,"4,54,808.22",
20-Apr-22,IMPS,"31,274.31",00.00,"4,86,082.53",
20-Apr-22,Cheque,"7,52,489.50",00.00,"12,38,572.03",
20-Apr-22,Debit Card,20.9,00.00,"12,38,592.93",
20-Apr-22,IMPS,00.00,"1,54,824.12","10,83,768.81",
20-Apr-22,Commission,48.7,00.00,"10,83,817.51",
20-Apr-22,Bill,43,00.00,"10,83,860.51",
20-Apr-22,Bill,00.00,"1,20,428.95","9,63,431.56",
20-Apr-22,Cheque,00.00,"1,37,633.08","8,25,798.48",
20-Apr-22,Debit Card,00.00,"1,17,971.21","7,07,827.27",
20-Apr-22,Transportellaneous,00.00,"1,41,565.45","5,66,261.82",
20-Apr-22,NEFT,00.00,"70,782.73","4,95,479.09",
20-Apr-22,Interest,"89,225.12",00.00,"5,84,704.21",
20-Apr-22,IMPS,"3,547.27",00.00,"5,88,251.48",
20-Apr-22,Debit Card,00.00,"1,47,062.87","4,41,188.61",
20-Apr-22,Debit Card,02.00,00.00,"4,41,190.61",
20-Apr-22,Debit Card,00.00,"1,10,297.65","3,30,892.96",
20-Apr-22,IMPS,"3,821.00",00.00,"3,34,713.96",
20-Apr-22,Debit Card,"20,17,302.00",00.00,"23,52,015.96",
20-Apr-22,Interest,00.00,"3,36,002.28","20,16,013.68",
20-Apr-22,Tax,510.53,00.00,"20,16,524.21",
20-Apr-22,Transportellaneous,00.00,"6,72,174.74","13,44,349.47",
20-Apr-22,NEFT,00.00,"1,49,372.16","11,94,977.31",
20-Apr-22,Debit Card,00.00,"1,70,711.04","10,24,266.27",
20-Apr-22,Debit Card,"7,252.16",00.00,"10,31,518.43",
20-Apr-22,Tax,00.00,"2,06,303.69","8,25,214.74",
20-Apr-22,Reversal,00.00,"1,37,535.79","6,87,678.95",
21-Apr-22,Debit Card,"10,650.00",00.00,"6,98,328.95",
21-Apr-22,Commission,00.00,"77,592.11","6,20,736.84",
21-Apr-22,Transfer,00.00,"3,10,368.42","3,10,368.42",
21-Apr-22,Interest,00.00,"62,073.68","2,48,294.74",
21-Apr-22,Commission,"3,04,078.20",00.00,"5,52,372.94",
21-Apr-22,NEFT,01.00,00.00,"5,52,373.94",
21-Apr-22,ATM,"7,879.00",00.00,"5,60,252.94",
21-Apr-22,Tax,00.00,"2,80,126.47","2,80,126.47",
21-Apr-22,ATM,00.00,"40,018.07","2,40,108.40",
21-Apr-22,Reversal,00.00,"2,40,108.40",00.00,
21-Apr-22,ATM,"10,205.48",00.00,"10,205.48",
21-Apr-22,Commission,"3,609.00",00.00,"13,814.48",
21-Apr-22,Bill,585,00.00,"14,399.48",
21-Apr-22,Transfer,"20,030.00",00.00,"34,429.48",
21-Apr-22,Cheque,00.00,"6,885.90","27,543.58",
21-Apr-22,Cash,352,00.00,"27,895.58",
22-Apr-22,Cheque,46.7,00.00,"27,942.28",
22-Apr-22,Transfer,00.00,"9,314.09","18,628.19",
22-Apr-22,Cash,00.00,"3,725.64","14,902.55",
22-Apr-22,Transportellaneous,00.00,"1,490.26","13,412.30",
22-Apr-22,Debit Card,00.00,"4,470.77","8,941.53",
22-Apr-22,Debit Card,01.51,00.00,"8,943.04",
22-Apr-22,Reversal,"1,930.10",00.00,"10,873.14",
22-Apr-22,Transfer,"3,239.70",00.00,"14,112.84",
22-Apr-22,Cheque,00.00,"2,016.12","12,096.72",
22-Apr-22,Bill,00.00,"3,024.18","9,072.54",
22-Apr-22,Commission,"1,53,229.00",00.00,"1,62,301.54",
22-Apr-22,Tax,"15,17,736.50",00.00,"16,80,038.04",
22-Apr-22,RTGS,00.00,"3,36,007.61","13,44,030.43",
22-Apr-22,Tax,"3,36,866.00",00.00,"16,80,896.43",
22-Apr-22,Cash,"22,823.72",00.00,"17,03,720.15",
22-Apr-22,Reversal,00.00,"17,03,720.15",00.00,
22-Apr-22,Commission,"1,78,723.20",00.00,"1,78,723.20",
22-Apr-22,NEFT,00.00,"89,361.60","89,361.60",
22-Apr-22,Tax,00.00,"44,680.80","44,680.80",
22-Apr-22,Cheque,00.00,"6,382.97","38,297.83",
22-Apr-22,Interest,00.00,"4,787.23","33,510.60",
22-Apr-22,Interest,12.56,00.00,"33,523.16",
22-Apr-22,Bill,"7,171.10",00.00,"40,694.26",
22-Apr-22,Purchase,00.00,"5,086.78","35,607.48",
22-Apr-22,Transfer,43.5,00.00,"35,650.98",
22-Apr-22,Reversal,00.00,"17,825.49","17,825.49",
22-Apr-22,Interest,00.00,"2,546.50","15,278.99",
22-Apr-22,Debit Card,"5,991.32",00.00,"21,270.31",
22-Apr-22,Cash,"1,65,529.50",00.00,"1,86,799.81",
22-Apr-22,Reversal,"4,47,054.00",00.00,"6,33,853.81",
22-Apr-22,Interest,04.21,00.00,"6,33,858.02",
22-Apr-22,Interest,00.00,"3,16,929.01","3,16,929.01",
22-Apr-22,Commission,"1,27,070.00",00.00,"4,43,999.01",
22-Apr-22,RTGS,05.90,00.00,"4,44,004.91",
22-Apr-22,Reversal,"3,861.40",00.00,"4,47,866.31",
22-Apr-22,RTGS,00.00,"1,11,966.58","3,35,899.73",
22-Apr-22,ATM,"22,494.79",00.00,"3,58,394.52",
22-Apr-22,Interest,00.00,"89,598.63","2,68,795.89",
22-Apr-22,IMPS,315.7,00.00,"2,69,111.59",
22-Apr-22,Purchase,00.00,"33,638.95","2,35,472.64",
22-Apr-22,Purchase,00.00,"29,434.08","2,06,038.56",
22-Apr-22,RTGS,00.00,"22,893.17","1,83,145.39",
22-Apr-22,Debit Card,00.00,"1,83,145.39",00.00,
22-Apr-22,Bill,52,00.00,52,
22-Apr-22,Transfer,00.00,05.78,46.22,
22-Apr-22,RTGS,00.00,23.11,23.11,
22-Apr-22,ATM,00.00,02.31,20.8,
22-Apr-22,ATM,00.00,06.93,13.87,
22-Apr-22,Interest,726.9,00.00,740.77,
22-Apr-22,Cash,00.00,185.19,555.58,
22-Apr-22,Cheque,"9,01,320.75",00.00,"9,01,876.33",
22-Apr-22,RTGS,00.00,"90,187.63","8,11,688.70",
22-Apr-22,Cheque,00.00,"4,05,844.35","4,05,844.35",
22-Apr-22,Debit Card,00.00,"4,05,844.35",00.00,
22-Apr-22,NEFT,"2,619.90",00.00,"2,619.90",
22-Apr-22,Cash,00.00,327.49,"2,292.41",
22-Apr-22,NEFT,00.23,00.00,"2,292.64",
22-Apr-22,ATM,"15,09,403.00",00.00,"15,11,695.64",
22-Apr-22,Debit Card,00.00,"2,51,949.27","12,59,746.37",
22-Apr-22,IMPS,00.00,"3,14,936.59","9,44,809.78",
22-Apr-22,Commission,"2,558.00",00.00,"9,47,367.78",
22-Apr-22,NEFT,103.8,00.00,"9,47,471.58",
22-Apr-22,Reversal,00.00,"2,36,867.90","7,10,603.68",
22-Apr-22,Interest,"11,338.00",00.00,"7,21,941.68",
22-Apr-22,Debit Card,"3,241.26",00.00,"7,25,182.94",
22-Apr-22,Transportellaneous,00.00,"1,45,036.59","5,80,146.35",
22-Apr-22,IMPS,00.00,"2,90,073.18","2,90,073.18",
22-Apr-22,RTGS,00.00,"96,691.06","1,93,382.12",
22-Apr-22,Transfer,00.00,"64,460.71","1,28,921.41",
22-Apr-22,Tax,00.00,"18,417.34","1,10,504.07",
22-Apr-22,RTGS,32,00.00,"1,10,536.07",
22-Apr-22,Cash,04.52,00.00,"1,10,540.59",
22-Apr-22,Commission,05.00,00.00,"1,10,545.59",
22-Apr-22,Transportellaneous,107.38,00.00,"1,10,652.97",
22-Apr-22,Commission,"16,946.00",00.00,"1,27,598.97",
22-Apr-22,Tax,44.57,00.00,"1,27,643.54",
22-Apr-22,RTGS,33.28,00.00,"1,27,676.82",
22-Apr-22,NEFT,423.6,00.00,"1,28,100.42",
22-Apr-22,Reversal,06.60,00.00,"1,28,107.02",
22-Apr-22,Bill,00.00,"64,053.51","64,053.51",
22-Apr-22,Interest,00.00,"7,117.06","56,936.45",
22-Apr-22,Reversal,00.00,"28,468.23","28,468.22",
22-Apr-22,Reversal,00.00,"3,163.14","25,305.08",
22-Apr-22,Commission,00.00,"12,652.54","12,652.54",
22-Apr-22,Purchase,00.00,"12,652.54",00.00,
22-Apr-22,ATM,27,00.00,27,
22-Apr-22,Cheque,"5,30,163.75",00.00,"5,30,190.75",
22-Apr-22,Transportellaneous,"1,251.15",00.00,"5,31,441.90",
22-Apr-22,Interest,"10,29,241.25",00.00,"15,60,683.15",
22-Apr-22,Purchase,00.00,"2,22,954.74","13,37,728.41",
22-Apr-22,ATM,"1,78,036.84",00.00,"15,15,765.25",
22-Apr-22,Cheque,00.00,"15,15,765.25",00.00,
22-Apr-22,Purchase,01.86,00.00,01.86,
22-Apr-22,Debit Card,"86,527.75",00.00,"86,529.61",
22-Apr-22,NEFT,00.00,"8,652.96","77,876.65",
22-Apr-22,ATM,00.00,"12,979.44","64,897.21",
22-Apr-22,Transportellaneous,00.00,"16,224.30","48,672.91",
22-Apr-22,Cheque,"1,11,529.00",00.00,"1,60,201.91",
22-Apr-22,Tax,468,00.00,"1,60,669.91",
22-Apr-22,Commission,26.04,00.00,"1,60,695.95",
22-Apr-22,NEFT,"2,820.40",00.00,"1,63,516.35",
22-Apr-22,Tax,47,00.00,"1,63,563.35",
22-Apr-22,Cheque,00.00,"32,712.67","1,30,850.68",
22-Apr-22,IMPS,342,00.00,"1,31,192.68",
22-Apr-22,Tax,00.00,"14,576.96","1,16,615.72",
22-Apr-22,Commission,00.00,"38,871.91","77,743.81",
22-Apr-22,RTGS,"1,57,334.00",00.00,"2,35,077.81",
22-Apr-22,Interest,00.00,"78,359.27","1,56,718.54",
22-Apr-22,Bill,00.00,"39,179.64","1,17,538.90",
22-Apr-22,Commission,00.00,"1,17,538.90",00.00,
22-Apr-22,Debit Card,228.5,00.00,228.5,
23-Apr-22,Commission,00.00,76.17,152.33,
23-Apr-22,RTGS,"1,11,773.41",00.00,"1,11,925.74",
23-Apr-22,Cash,00.00,"27,981.44","83,944.30",
23-Apr-22,Transportellaneous,00.00,"83,944.30",00.00,
23-Apr-22,Commission,"2,52,576.80",00.00,"2,52,576.80",
23-Apr-22,Commission,00.00,"84,192.27","1,68,384.53",
23-Apr-22,Interest,"2,49,420.00",00.00,"4,17,804.53",
23-Apr-22,Bill,00.00,"46,422.73","3,71,381.80",
23-Apr-22,Transfer,00.00,"92,845.45","2,78,536.35",
23-Apr-22,ATM,00.00,"30,948.48","2,47,587.87",
23-Apr-22,Tax,"11,70,379.00",00.00,"14,17,966.87",
23-Apr-22,Tax,06.99,00.00,"14,17,973.86",
23-Apr-22,Debit Card,00.00,"7,08,986.93","7,08,986.93",
23-Apr-22,IMPS,"27,698.32",00.00,"7,36,685.25",
23-Apr-22,Cheque,00.00,"1,84,171.31","5,52,513.94",
23-Apr-22,Tax,00.00,"69,064.24","4,83,449.70",
23-Apr-22,Commission,00.00,"1,20,862.43","3,62,587.28",
23-Apr-22,Reversal,00.00,"3,62,587.28",00.00,
23-Apr-22,Tax,"14,254.02",00.00,"14,254.02",
23-Apr-22,Bill,"18,03,524.75",00.00,"18,17,778.77",
23-Apr-22,Debit Card,"2,543.60",00.00,"18,20,322.37",
23-Apr-22,Commission,401,00.00,"18,20,723.37",
23-Apr-22,Cash,00.00,"3,64,144.67","14,56,578.70",
23-Apr-22,Commission,00.00,"1,82,072.34","12,74,506.36",
23-Apr-22,ATM,00.00,"1,41,611.82","11,32,894.54",
23-Apr-22,Reversal,26.53,00.00,"11,32,921.07",
24-Apr-22,Reversal,00.00,"1,41,615.13","9,91,305.94",
24-Apr-22,Transportellaneous,00.00,"9,91,305.94",00.00,
24-Apr-22,RTGS,"1,39,585.06",00.00,"1,39,585.06",
24-Apr-22,ATM,00.00,"13,958.51","1,25,626.55",
24-Apr-22,Commission,04.40,00.00,"1,25,630.95",
24-Apr-22,Commission,00.00,"20,938.49","1,04,692.46",
24-Apr-22,Purchase,00.00,"17,448.74","87,243.72",
24-Apr-22,Commission,00.00,"21,810.93","65,432.79",
24-Apr-22,Commission,"2,599.20",00.00,"68,031.99",
24-Apr-22,Transportellaneous,"3,692.00",00.00,"71,723.99",
24-Apr-22,Debit Card,914,00.00,"72,637.99",
24-Apr-22,Commission,00.00,"14,527.60","58,110.39",
24-Apr-22,RTGS,223.7,00.00,"58,334.09",
24-Apr-22,Interest,"14,756.50",00.00,"73,090.59",
24-Apr-22,NEFT,02.88,00.00,"73,093.47",
24-Apr-22,IMPS,00.00,"9,136.68","63,956.79",
24-Apr-22,IMPS,02.30,00.00,"63,959.09",
24-Apr-22,NEFT,"3,502.00",00.00,"67,461.09",
24-Apr-22,NEFT,02.40,00.00,"67,463.49",
24-Apr-22,Transportellaneous,00.00,"9,637.64","57,825.85",
24-Apr-22,Reversal,00.00,"5,782.59","52,043.26",
24-Apr-22,Interest,00.00,"10,408.65","41,634.61",
24-Apr-22,IMPS,00.00,"5,947.80","35,686.81",
24-Apr-22,Interest,"10,93,967.25",00.00,"11,29,654.06",
24-Apr-22,Purchase,00.00,"3,76,551.35","7,53,102.71",
24-Apr-22,Reversal,"3,193.56",00.00,"7,56,296.27",
24-Apr-22,ATM,39.26,00.00,"7,56,335.53",
24-Apr-22,IMPS,02.20,00.00,"7,56,337.73",
24-Apr-22,Interest,"12,954.56",00.00,"7,69,292.29",
24-Apr-22,RTGS,11,00.00,"7,69,303.29",
24-Apr-22,Bill,49.1,00.00,"7,69,352.39",
24-Apr-22,ATM,00.00,"76,935.24","6,92,417.15",
24-Apr-22,Commission,226.7,00.00,"6,92,643.85",
24-Apr-22,Reversal,00.00,"86,580.48","6,06,063.37",
24-Apr-22,Tax,00.00,"2,02,021.12","4,04,042.25",
24-Apr-22,Transfer,01.11,00.00,"4,04,043.36",
24-Apr-22,Cheque,195.05,00.00,"4,04,238.41",
24-Apr-22,Bill,"3,933.40",00.00,"4,08,171.81",
24-Apr-22,Purchase,00.00,"68,028.64","3,40,143.18",
24-Apr-22,IMPS,"11,27,451.00",00.00,"14,67,594.18",
24-Apr-22,Interest,00.00,"1,83,449.27","12,84,144.91",
24-Apr-22,Bill,45.57,00.00,"12,84,190.48",
24-Apr-22,Tax,00.00,"1,83,455.78","11,00,734.70",
24-Apr-22,Debit Card,"8,39,518.20",00.00,"19,40,252.90",
24-Apr-22,Debit Card,"20,400.00",00.00,"19,60,652.90",
24-Apr-22,Debit Card,00.00,"2,45,081.61","17,15,571.29",
24-Apr-22,Purchase,00.00,"1,90,619.03","15,24,952.26",
24-Apr-22,Transfer,00.00,"15,24,952.26",00.00,
24-Apr-22,ATM,"1,49,999.00",00.00,"1,49,999.00",
24-Apr-22,Commission,"97,533.80",00.00,"2,47,532.80",
24-Apr-22,ATM,155.72,00.00,"2,47,688.52",
24-Apr-22,Cheque,00.00,"49,537.70","1,98,150.82",
24-Apr-22,IMPS,00.00,"1,98,150.82",00.00,
24-Apr-22,Cash,"3,000.10",00.00,"3,000.10",
24-Apr-22,Purchase,00.00,"3,000.10",00.00,
24-Apr-22,NEFT,"1,40,316.91",00.00,"1,40,316.91",
24-Apr-22,IMPS,00.00,"35,079.23","1,05,237.68",
24-Apr-22,ATM,"13,861.00",00.00,"1,19,098.68",
24-Apr-22,Commission,00.00,"59,549.34","59,549.34",
24-Apr-22,Tax,00.00,"5,954.93","53,594.41",
24-Apr-22,Cash,00.00,"10,718.88","42,875.53",
24-Apr-22,Commission,00.00,"10,718.88","32,156.65",
24-Apr-22,Cash,00.00,"5,359.44","26,797.21",
24-Apr-22,Cash,"6,972.21",00.00,"33,769.42",
24-Apr-22,Cash,00.00,"33,769.42",00.00,
24-Apr-22,Debit Card,"1,294.49",00.00,"1,294.49",
24-Apr-22,Debit Card,"60,759.10",00.00,"62,053.59",
24-Apr-22,Interest,00.00,"8,864.80","53,188.79",
24-Apr-22,Cash,03.00,00.00,"53,191.79",
24-Apr-22,ATM,00.00,"13,297.95","39,893.84",
24-Apr-22,Bill,00.00,"19,946.92","19,946.92",
24-Apr-22,Transfer,00.00,"2,849.56","17,097.36",
24-Apr-22,Cheque,"2,095.10",00.00,"19,192.46",
24-Apr-22,Commission,"7,87,264.75",00.00,"8,06,457.21",
24-Apr-22,Transfer,"31,200.20",00.00,"8,37,657.41",
24-Apr-22,Bill,00.00,"93,073.05","7,44,584.36",
24-Apr-22,RTGS,"1,058.50",00.00,"7,45,642.86",
24-Apr-22,Bill,"13,19,763.80",00.00,"20,65,406.66",
24-Apr-22,Purchase,343,00.00,"20,65,749.66",
24-Apr-22,Reversal,00.00,"4,13,149.93","16,52,599.73",
25-Apr-22,ATM,00.00,"8,26,299.87","8,26,299.86",
25-Apr-22,Transportellaneous,718.01,00.00,"8,27,017.87",
25-Apr-22,Interest,00.00,"82,701.79","7,44,316.08",
25-Apr-22,Bill,"2,44,107.50",00.00,"9,88,423.58",
25-Apr-22,Debit Card,00.00,"3,29,474.53","6,58,949.05",
25-Apr-22,ATM,00.00,"1,31,789.81","5,27,159.24",
25-Apr-22,Debit Card,00.00,"1,05,431.85","4,21,727.39",
25-Apr-22,Debit Card,00.00,"46,858.60","3,74,868.79",
25-Apr-22,Reversal,00.00,"74,973.76","2,99,895.03",
26-Apr-22,Cash,"2,212.00",00.00,"3,02,107.03",
26-Apr-22,Tax,00.00,"30,210.70","2,71,896.33",
26-Apr-22,RTGS,00.00,"54,379.27","2,17,517.06",
26-Apr-22,Debit Card,"92,938.50",00.00,"3,10,455.56",
26-Apr-22,Bill,00.00,"1,55,227.78","1,55,227.78",
26-Apr-22,IMPS,00.00,"1,55,227.78",00.00,
26-Apr-22,Debit Card,497,00.00,497,
26-Apr-22,Cash,"9,053.00",00.00,"9,550.00",
26-Apr-22,IMPS,04.35,00.00,"9,554.35",
26-Apr-22,RTGS,00.00,"4,777.18","4,777.18",
26-Apr-22,ATM,19.2,00.00,"4,796.38",
27-Apr-22,Cash,46.7,00.00,"4,843.08",
27-Apr-22,RTGS,00.00,968.62,"3,874.46",
27-Apr-22,RTGS,04.00,00.00,"3,878.46",
27-Apr-22,Cash,23,00.00,"3,901.46",
27-Apr-22,RTGS,"2,497.00",00.00,"6,398.46",
27-Apr-22,ATM,"1,33,803.10",00.00,"1,40,201.56",
27-Apr-22,Cheque,"3,775.20",00.00,"1,43,976.76",
28-Apr-22,Transportellaneous,00.00,"20,568.11","1,23,408.65",
28-Apr-22,ATM,"3,095.00",00.00,"1,26,503.65",
28-Apr-22,Reversal,"14,889.68",00.00,"1,41,393.33",
28-Apr-22,Transfer,"1,17,040.00",00.00,"2,58,433.33",
28-Apr-22,Interest,00.00,"32,304.17","2,26,129.16",
28-Apr-22,Transportellaneous,"3,121.58",00.00,"2,29,250.74",
28-Apr-22,RTGS,00.00,"2,29,250.74",00.00,
28-Apr-22,Bill,06.71,00.00,06.71,
28-Apr-22,Debit Card,"28,699.80",00.00,"28,706.51",
28-Apr-22,Cheque,"1,155.10",00.00,"29,861.61",
28-Apr-22,Cheque,853.22,00.00,"30,714.83",
28-Apr-22,Reversal,00.00,"5,119.14","25,595.69",
28-Apr-22,NEFT,00.00,"8,531.90","17,063.79",
28-Apr-22,Commission,00.00,"5,687.93","11,375.86",
28-Apr-22,ATM,00.00,"1,263.98","10,111.88",
28-Apr-22,Purchase,389.5,00.00,"10,501.38",
29-Apr-22,Purchase,"1,61,275.28",00.00,"1,71,776.66",
29-Apr-22,Bill,52.6,00.00,"1,71,829.26",
29-Apr-22,Purchase,"53,662.97",00.00,"2,25,492.23",
29-Apr-22,Cheque,00.00,"25,054.69","2,00,437.54",
29-Apr-22,NEFT,"3,965.10",00.00,"2,04,402.64",
29-Apr-22,Purchase,00.00,"20,440.26","1,83,962.38",
29-Apr-22,Cash,"47,781.00",00.00,"2,31,743.38",
29-Apr-22,Purchase,50.84,00.00,"2,31,794.22",
29-Apr-22,Cheque,"15,81,888.20",00.00,"18,13,682.42",
29-Apr-22,Transportellaneous,00.00,"9,06,841.21","9,06,841.21",
29-Apr-22,Cheque,00.00,"4,53,420.61","4,53,420.60",
29-Apr-22,Commission,61.56,00.00,"4,53,482.16",
29-Apr-22,IMPS,00.00,"75,580.36","3,77,901.80",
29-Apr-22,Interest,"2,13,433.60",00.00,"5,91,335.40",
29-Apr-22,Purchase,00.00,"1,97,111.80","3,94,223.60",
29-Apr-22,RTGS,00.00,"1,31,407.87","2,62,815.73",
29-Apr-22,Reversal,00.00,"52,563.15","2,10,252.58",
29-Apr-22,ATM,00.00,"23,361.40","1,86,891.18",
29-Apr-22,Tax,00.00,"18,689.12","1,68,202.06",
29-Apr-22,Interest,"2,54,107.00",00.00,"4,22,309.06",
29-Apr-22,IMPS,00.00,"60,329.87","3,61,979.19",
29-Apr-22,ATM,11.07,00.00,"3,61,990.26",
29-Apr-22,ATM,"1,67,814.84",00.00,"5,29,805.10",
29-Apr-22,Purchase,00.00,"58,867.23","4,70,937.87",
30-Apr-22,Purchase,14.6,00.00,"4,70,952.47",
30-Apr-22,Reversal,504.6,00.00,"4,71,457.07",
30-Apr-22,Bill,00.00,"52,384.12","4,19,072.95",
30-Apr-22,Bill,00.56,00.00,"4,19,073.51",
01-May-22,NEFT,00.00,"1,04,768.38","3,14,305.13",
01-May-22,Transfer,"1,48,311.10",00.00,"4,62,616.23",
01-May-22,NEFT,797.74,00.00,"4,63,413.97",
01-May-22,Debit Card,00.00,"1,15,853.49","3,47,560.48",
01-May-22,Bill,00.00,"1,73,780.24","1,73,780.24",
01-May-22,Interest,00.00,"24,825.75","1,48,954.49",
01-May-22,Cash,"1,432.00",00.00,"1,50,386.49",
01-May-22,Cash,"1,95,376.70",00.00,"3,45,763.19",
01-May-22,RTGS,00.00,"34,576.32","3,11,186.87",
01-May-22,Bill,00.00,"38,898.36","2,72,288.51",
01-May-22,Transportellaneous,00.00,"27,228.85","2,45,059.66",
01-May-22,Transfer,58,00.00,"2,45,117.66",
01-May-22,Debit Card,"3,245.00",00.00,"2,48,362.66",
01-May-22,Tax,"6,085.91",00.00,"2,54,448.57",
01-May-22,Commission,00.00,"2,54,448.57",00.00,
01-May-22,Purchase,05.80,00.00,05.80,
01-May-22,Bill,"28,873.90",00.00,"28,879.70",
01-May-22,Bill,07.00,00.00,"28,886.70",
01-May-22,Purchase,00.00,"7,221.68","21,665.02",
01-May-22,Transfer,00.00,"2,407.22","19,257.80",
01-May-22,NEFT,00.00,"1,925.78","17,332.02",
01-May-22,Cheque,00.00,"4,333.01","12,999.02",
02-May-22,Commission,59.6,00.00,"13,058.62",
02-May-22,RTGS,00.00,"1,305.86","11,752.76",
02-May-22,IMPS,07.00,00.00,"11,759.76",
02-May-22,Interest,00.00,"5,879.88","5,879.88",
02-May-22,Interest,"2,10,186.00",00.00,"2,16,065.88",
02-May-22,NEFT,"24,115.70",00.00,"2,40,181.58",
02-May-22,RTGS,00.00,"1,20,090.79","1,20,090.79",
02-May-22,NEFT,314,00.00,"1,20,404.79",
02-May-22,Tax,00.00,"40,134.93","80,269.86",
02-May-22,Transportellaneous,06.00,00.00,"80,275.86",
03-May-22,Transportellaneous,00.00,"40,137.93","40,137.93",
03-May-22,ATM,00.00,"40,137.93",00.00,
03-May-22,RTGS,119.1,00.00,119.1,
03-May-22,IMPS,00.00,19.85,99.25,
03-May-22,Cash,00.00,09.93,89.32,
03-May-22,Cheque,246.93,00.00,336.25,
03-May-22,Transportellaneous,00.00,84.06,252.19,
03-May-22,Debit Card,34.9,00.00,287.09,
03-May-22,Purchase,00.00,41.01,246.08,
03-May-22,IMPS,00.00,41.01,205.07,
03-May-22,Interest,"22,709.00",00.00,"22,914.07",
03-May-22,Interest,00.00,"7,638.02","15,276.05",
03-May-22,Debit Card,00.00,"7,638.03","7,638.02",
03-May-22,RTGS,00.00,"7,638.02",00.00,
03-May-22,Cash,"2,50,501.70",00.00,"2,50,501.70",
03-May-22,NEFT,"12,382.40",00.00,"2,62,884.10",
03-May-22,Reversal,651,00.00,"2,63,535.10",
03-May-22,Interest,34.73,00.00,"2,63,569.83",
03-May-22,Cheque,"2,077.81",00.00,"2,65,647.64",
03-May-22,Cash,128,00.00,"2,65,775.64",
03-May-22,Interest,00.00,"2,65,775.64",00.00,
03-May-22,Tax,02.40,00.00,02.40,
03-May-22,Transfer,00.00,02.40,00.00,
03-May-22,Reversal,16,00.00,16,
03-May-22,Bill,"9,988.90",00.00,"10,004.90",
03-May-22,NEFT,00.00,"2,501.23","7,503.67",
03-May-22,Transfer,00.00,"2,501.22","5,002.45",
03-May-22,Bill,"51,368.60",00.00,"56,371.05",
03-May-22,Interest,"3,923.37",00.00,"60,294.42",
03-May-22,Cheque,"1,251.00",00.00,"61,545.42",
03-May-22,Transfer,00.00,"6,838.38","54,707.04",
03-May-22,Interest,"8,44,448.00",00.00,"8,99,155.04",
03-May-22,Transfer,08.30,00.00,"8,99,163.34",
03-May-22,Cheque,"2,409.00",00.00,"9,01,572.34",
03-May-22,RTGS,"24,382.70",00.00,"9,25,955.04",
03-May-22,Interest,00.00,"92,595.50","8,33,359.54",
03-May-22,Interest,33.1,00.00,"8,33,392.64",
04-May-22,Purchase,00.00,"4,16,696.32","4,16,696.32",
04-May-22,Transportellaneous,06.70,00.00,"4,16,703.02",
04-May-22,Transportellaneous,00.00,"41,670.30","3,75,032.72",
04-May-22,ATM,00.00,"41,670.30","3,33,362.42",
04-May-22,RTGS,00.00,"33,336.24","3,00,026.18",
04-May-22,Bill,00.00,"3,00,026.18",00.00,
04-May-22,Cash,"10,63,024.50",00.00,"10,63,024.50",
04-May-22,Commission,00.00,"1,51,860.64","9,11,163.86",
04-May-22,Transfer,00.00,"2,27,790.97","6,83,372.90",
04-May-22,Bill,00.00,"97,624.70","5,85,748.20",
04-May-22,Commission,00.00,"83,678.31","5,02,069.89",
04-May-22,Reversal,07.26,00.00,"5,02,077.15",
04-May-22,Transfer,00.00,"83,679.53","4,18,397.62",
04-May-22,Interest,00.00,"69,732.94","3,48,664.68",
05-May-22,Purchase,00.00,"87,166.17","2,61,498.51",
05-May-22,Cheque,00.00,"65,374.63","1,96,123.88",
05-May-22,Tax,"1,15,492.00",00.00,"3,11,615.88",
05-May-22,Transportellaneous,00.00,"1,55,807.94","1,55,807.94",
05-May-22,Commission,00.00,"25,967.99","1,29,839.95",
05-May-22,Reversal,"11,44,529.20",00.00,"12,74,369.15",
06-May-22,Tax,"14,03,531.00",00.00,"26,77,900.15",
06-May-22,Bill,00.00,"3,34,737.52","23,43,162.63",
06-May-22,NEFT,08.00,00.00,"23,43,170.63",
06-May-22,Transfer,00.00,"7,81,056.88","15,62,113.75",
07-May-22,Transfer,00.00,"3,12,422.75","12,49,691.00",
07-May-22,NEFT,05.75,00.00,"12,49,696.75",
07-May-22,Interest,05.77,00.00,"12,49,702.52",
07-May-22,ATM,00.00,"4,16,567.51","8,33,135.01",
07-May-22,Cash,"26,921.00",00.00,"8,60,056.01",
08-May-22,Cheque,31,00.00,"8,60,087.01",
08-May-22,Debit Card,00.00,"2,15,021.75","6,45,065.26",
08-May-22,IMPS,06.00,00.00,"6,45,071.26",
08-May-22,Commission,28.38,00.00,"6,45,099.64",
08-May-22,Cheque,352.6,00.00,"6,45,452.24",
08-May-22,Tax,00.00,"80,681.53","5,64,770.71",
08-May-22,ATM,00.00,"1,41,192.68","4,23,578.03",
08-May-22,Interest,418.03,00.00,"4,23,996.06",
08-May-22,ATM,434,00.00,"4,24,430.06",
09-May-22,Interest,00.00,"70,738.34","3,53,691.72",
09-May-22,Transportellaneous,"29,622.50",00.00,"3,83,314.22",
10-May-22,Transfer,00.00,"38,331.42","3,44,982.80",
10-May-22,Debit Card,00.00,"43,122.85","3,01,859.95",
10-May-22,Reversal,00.00,"75,464.99","2,26,394.96",
10-May-22,RTGS,253.3,00.00,"2,26,648.26",
10-May-22,Debit Card,00.00,"32,378.32","1,94,269.94",
10-May-22,Cash,00.00,"97,134.97","97,134.97",
10-May-22,Transportellaneous,"17,17,790.00",00.00,"18,14,924.97",
10-May-22,Cheque,00.00,"2,26,865.62","15,88,059.35",
10-May-22,Reversal,00.00,"2,64,676.56","13,23,382.79",
10-May-22,RTGS,"20,24,931.80",00.00,"33,48,314.59",
10-May-22,Transportellaneous,00.00,"5,58,052.43","27,90,262.16",
10-May-22,Reversal,"1,05,101.16",00.00,"28,95,363.32",
10-May-22,Purchase,"15,85,251.00",00.00,"44,80,614.32",
10-May-22,Cash,00.00,"44,80,614.32",00.00,
10-May-22,Transfer,"3,639.00",00.00,"3,639.00",
10-May-22,ATM,00.00,454.88,"3,184.12",
10-May-22,Commission,00.00,"1,592.06","1,592.06",
10-May-22,IMPS,"8,82,666.00",00.00,"8,84,258.06",
10-May-22,Bill,"1,938.66",00.00,"8,86,196.72",
10-May-22,IMPS,40.88,00.00,"8,86,237.60",
11-May-22,Transfer,"11,24,889.00",00.00,"20,11,126.60",
11-May-22,Transfer,"49,275.59",00.00,"20,60,402.19",
11-May-22,IMPS,"2,346.15",00.00,"20,62,748.34",
11-May-22,Transportellaneous,"14,075.00",00.00,"20,76,823.34",
11-May-22,Bill,00.00,"20,76,823.34",00.00,
11-May-22,ATM,"2,470.00",00.00,"2,470.00",
11-May-22,Transportellaneous,00.00,352.86,"2,117.14",
11-May-22,IMPS,00.00,264.64,"1,852.50",
11-May-22,Reversal,00.00,205.83,"1,646.67",
11-May-22,IMPS,00.00,205.83,"1,440.84",
11-May-22,Purchase,00.00,144.08,"1,296.76",
11-May-22,NEFT,00.00,162.1,"1,134.66",
11-May-22,NEFT,00.00,189.11,945.55,
11-May-22,Reversal,14,00.00,959.55,
11-May-22,ATM,00.00,106.62,852.93,
11-May-22,IMPS,00.00,852.93,00.00,
11-May-22,Commission,"14,33,861.00",00.00,"14,33,861.00",
11-May-22,Commission,00.00,"7,16,930.50","7,16,930.50",
11-May-22,Purchase,29.35,00.00,"7,16,959.85",
11-May-22,RTGS,00.00,"79,662.21","6,37,297.64",
11-May-22,Transportellaneous,00.00,"1,59,324.41","4,77,973.23",
11-May-22,NEFT,798.49,00.00,"4,78,771.72",
11-May-22,Transfer,00.00,"4,78,771.72",00.00,
11-May-22,NEFT,"20,328.02",00.00,"20,328.02",
11-May-22,Tax,00.00,"5,082.01","15,246.02",
11-May-22,Cheque,06.50,00.00,"15,252.52",
11-May-22,Bill,00.00,"2,178.93","13,073.59",
11-May-22,Reversal,00.00,"6,536.80","6,536.80",
11-May-22,ATM,00.00,"1,634.20","4,902.60",
11-May-22,Commission,00.00,612.83,"4,289.78",
11-May-22,Debit Card,"8,60,839.50",00.00,"8,65,129.28",
11-May-22,Debit Card,00.00,"1,44,188.21","7,20,941.07",
11-May-22,Purchase,00.00,"1,44,188.21","5,76,752.86",
11-May-22,Transfer,00.00,"82,393.27","4,94,359.59",
11-May-22,Transfer,00.00,"1,23,589.90","3,70,769.69",
11-May-22,NEFT,00.00,"1,23,589.90","2,47,179.79",
11-May-22,Interest,00.00,"30,897.47","2,16,282.32",
11-May-22,Transportellaneous,"1,371.80",00.00,"2,17,654.12",
11-May-22,Purchase,00.00,"43,530.82","1,74,123.30",
11-May-22,NEFT,07.80,00.00,"1,74,131.10",
11-May-22,Interest,00.00,"21,766.39","1,52,364.71",
11-May-22,Interest,"13,59,290.80",00.00,"15,11,655.51",
11-May-22,Purchase,"21,685.90",00.00,"15,33,341.41",
11-May-22,Purchase,00.00,"1,53,334.14","13,80,007.27",
11-May-22,Purchase,00.00,"1,53,334.14","12,26,673.13",
11-May-22,Cash,"20,962.00",00.00,"12,47,635.13",
11-May-22,Bill,00.00,"1,24,763.51","11,22,871.62",
11-May-22,NEFT,00.00,"1,87,145.27","9,35,726.35",
11-May-22,Reversal,00.00,"3,11,908.78","6,23,817.57",
11-May-22,Bill,00.00,"2,07,939.19","4,15,878.38",
11-May-22,Cheque,00.00,"4,15,878.38",00.00,
11-May-22,Transportellaneous,35,00.00,35,
11-May-22,Commission,"1,44,757.00",00.00,"1,44,792.00",
11-May-22,ATM,00.00,"20,684.57","1,24,107.43",
11-May-22,Reversal,00.00,"15,513.43","1,08,594.00",
11-May-22,Transportellaneous,"31,262.40",00.00,"1,39,856.40",
11-May-22,Reversal,00.00,"34,964.10","1,04,892.30",
11-May-22,IMPS,00.00,"10,489.23","94,403.07",
11-May-22,Interest,"19,80,068.00",00.00,"20,74,471.07",
11-May-22,Transportellaneous,02.50,00.00,"20,74,473.57",
11-May-22,Transfer,00.00,"3,45,745.60","17,28,727.98",
11-May-22,Bill,"1,21,923.22",00.00,"18,50,651.20",
11-May-22,Cheque,"5,91,872.00",00.00,"24,42,523.20",
11-May-22,IMPS,00.00,"8,14,174.40","16,28,348.80",
11-May-22,Interest,"8,60,617.00",00.00,"24,88,965.80",
11-May-22,Commission,"11,03,884.80",00.00,"35,92,850.60",
11-May-22,Transfer,"11,332.00",00.00,"36,04,182.60",
11-May-22,Debit Card,00.00,"3,60,418.26","32,43,764.34",
11-May-22,Transportellaneous,00.00,"16,21,882.17","16,21,882.17",
11-May-22,Debit Card,"13,29,823.75",00.00,"29,51,705.92",
11-May-22,IMPS,"3,582.80",00.00,"29,55,288.72",
12-May-22,Reversal,00.00,"4,22,184.10","25,33,104.62",
12-May-22,Transportellaneous,"7,71,583.00",00.00,"33,04,687.62",
12-May-22,Debit Card,01.00,00.00,"33,04,688.62",
12-May-22,RTGS,00.00,"8,26,172.16","24,78,516.46",
12-May-22,Purchase,00.00,"8,26,172.15","16,52,344.31",
12-May-22,Purchase,00.00,"2,06,543.04","14,45,801.27",
12-May-22,Purchase,00.00,"1,60,644.59","12,85,156.68",
12-May-22,Reversal,"79,413.44",00.00,"13,64,570.12",
12-May-22,Transfer,00.00,"1,94,938.59","11,69,631.53",
12-May-22,Transfer,00.00,"3,89,877.18","7,79,754.35",
12-May-22,Tax,00.00,"3,89,877.18","3,89,877.18",
13-May-22,Debit Card,"6,468.60",00.00,"3,96,345.78",
13-May-22,IMPS,"1,22,281.78",00.00,"5,18,627.56",
13-May-22,Transfer,00.00,"51,862.76","4,66,764.80",
13-May-22,Reversal,00.00,"46,676.48","4,20,088.32",
13-May-22,ATM,00.00,"70,014.72","3,50,073.60",
13-May-22,Bill,00.00,"1,75,036.80","1,75,036.80",
13-May-22,Commission,00.00,"58,345.60","1,16,691.20",
14-May-22,Cheque,00.20,00.00,"1,16,691.40",
14-May-22,ATM,00.00,"16,670.20","1,00,021.20",
14-May-22,Transfer,58.97,00.00,"1,00,080.17",
15-May-22,Transportellaneous,392,00.00,"1,00,472.17",
15-May-22,IMPS,19.65,00.00,"1,00,491.82",
16-May-22,ATM,429.3,00.00,"1,00,921.12",
16-May-22,Interest,00.00,"1,00,921.12",00.00,
16-May-22,RTGS,04.50,00.00,04.50,
16-May-22,NEFT,00.00,00.64,03.86,
16-May-22,Transportellaneous,205,00.00,208.86,
16-May-22,ATM,00.00,69.62,139.24,
16-May-22,Transportellaneous,"1,098.00",00.00,"1,237.24",
16-May-22,RTGS,00.00,412.41,824.83,
16-May-22,Transportellaneous,"13,77,517.50",00.00,"13,78,342.33",
17-May-22,Interest,286,00.00,"13,78,628.33",
17-May-22,IMPS,"8,17,111.00",00.00,"21,95,739.33",
17-May-22,IMPS,00.00,"21,95,739.33",00.00,
17-May-22,Debit Card,"2,775.10",00.00,"2,775.10",
17-May-22,Transportellaneous,03.05,00.00,"2,778.15",
17-May-22,Transfer,"19,21,378.00",00.00,"19,24,156.15",
17-May-22,Cheque,00.00,"3,20,692.69","16,03,463.46",
17-May-22,Bill,46.9,00.00,"16,03,510.36",
17-May-22,ATM,00.00,"5,34,503.45","10,69,006.91",
17-May-22,Transfer,"74,129.62",00.00,"11,43,136.53",
17-May-22,Tax,42.5,00.00,"11,43,179.03",
17-May-22,Tax,408,00.00,"11,43,587.03",
17-May-22,IMPS,"1,682.90",00.00,"11,45,269.93",
17-May-22,RTGS,00.00,"2,86,317.48","8,58,952.45",
17-May-22,Cheque,00.00,"8,58,952.45",00.00,
17-May-22,Commission,24,00.00,24,
17-May-22,Transportellaneous,00.00,02.40,21.6,
17-May-22,IMPS,00.00,21.6,00.00,
17-May-22,Transportellaneous,"19,81,687.00",00.00,"19,81,687.00",
17-May-22,Interest,186,00.00,"19,81,873.00",
17-May-22,Transportellaneous,00.00,"2,47,734.13","17,34,138.88",
17-May-22,Tax,"11,95,982.00",00.00,"29,30,120.88",
17-May-22,Commission,"7,561.20",00.00,"29,37,682.08",
17-May-22,NEFT,00.00,"3,26,409.12","26,11,272.96",
17-May-22,Transfer,00.00,"3,73,038.99","22,38,233.97",
17-May-22,Cash,"6,885.89",00.00,"22,45,119.86",
17-May-22,Transfer,48.6,00.00,"22,45,168.46",
17-May-22,Tax,00.00,"7,48,389.49","14,96,778.97",
17-May-22,IMPS,38.28,00.00,"14,96,817.25",
17-May-22,RTGS,"13,88,740.00",00.00,"28,85,557.25",
17-May-22,Commission,60,00.00,"28,85,617.25",
17-May-22,Debit Card,00.00,"4,80,936.21","24,04,681.04",
17-May-22,Interest,"1,884.00",00.00,"24,06,565.04",
17-May-22,Bill,00.00,"4,01,094.17","20,05,470.87",
17-May-22,Transfer,00.00,"10,02,735.44","10,02,735.44",
17-May-22,NEFT,00.00,"1,67,122.57","8,35,612.87",
17-May-22,Purchase,01.00,00.00,"8,35,613.87",
17-May-22,Interest,00.00,"8,35,613.87",00.00,
17-May-22,Interest,"1,859.92",00.00,"1,859.92",
17-May-22,Bill,"31,857.43",00.00,"33,717.35",
17-May-22,Interest,00.00,"33,717.35",00.00,
17-May-22,Purchase,100,00.00,100,
17-May-22,IMPS,34.3,00.00,134.3,
17-May-22,IMPS,35.17,00.00,169.47,
17-May-22,Interest,"2,63,806.25",00.00,"2,63,975.72",
17-May-22,Commission,00.00,"52,795.14","2,11,180.58",
17-May-22,Bill,"2,196.70",00.00,"2,13,377.28",
17-May-22,IMPS,"90,865.50",00.00,"3,04,242.78",
17-May-22,Commission,00.00,"1,52,121.39","1,52,121.39",
17-May-22,Cheque,"11,414.00",00.00,"1,63,535.39",
17-May-22,Tax,"1,620.53",00.00,"1,65,155.92",
17-May-22,Cheque,"2,51,381.60",00.00,"4,16,537.52",
17-May-22,Cash,00.00,"69,422.92","3,47,114.60",
17-May-22,Cheque,00.00,"43,389.33","3,03,725.27",
17-May-22,Commission,03.00,00.00,"3,03,728.27",
17-May-22,Transfer,160.1,00.00,"3,03,888.37",
17-May-22,Transportellaneous,00.00,"37,986.05","2,65,902.32",
17-May-22,NEFT,04.66,00.00,"2,65,906.98",
17-May-22,Reversal,04.69,00.00,"2,65,911.67",
17-May-22,Transportellaneous,"19,424.00",00.00,"2,85,335.67",
17-May-22,ATM,"18,48,778.00",00.00,"21,34,113.67",
17-May-22,IMPS,"2,75,868.00",00.00,"24,09,981.67",
17-May-22,Interest,00.00,"4,81,996.33","19,27,985.34",
17-May-22,Tax,00.00,"4,81,996.34","14,45,989.00",
17-May-22,Bill,"26,181.70",00.00,"14,72,170.70",
17-May-22,Purchase,353,00.00,"14,72,523.70",
17-May-22,Transfer,00.00,"7,36,261.85","7,36,261.85",
17-May-22,Purchase,"1,45,883.10",00.00,"8,82,144.95",
17-May-22,Cheque,00.00,"4,41,072.48","4,41,072.48",
17-May-22,Purchase,"2,59,298.25",00.00,"7,00,370.73",
17-May-22,ATM,03.20,00.00,"7,00,373.93",
17-May-22,Interest,"2,02,166.40",00.00,"9,02,540.33",
17-May-22,NEFT,381.18,00.00,"9,02,921.51",
17-May-22,RTGS,00.00,"1,12,865.19","7,90,056.32",
17-May-22,Purchase,"10,59,936.80",00.00,"18,49,993.12",
17-May-22,Reversal,13.16,00.00,"18,50,006.28",
17-May-22,NEFT,00.00,"4,62,501.57","13,87,504.71",
17-May-22,Reversal,00.00,"13,87,504.71",00.00,
17-May-22,ATM,"7,457.80",00.00,"7,457.80",
17-May-22,Bill,"75,209.20",00.00,"82,667.00",
17-May-22,Reversal,"9,04,697.25",00.00,"9,87,364.25",
17-May-22,Reversal,00.00,"98,736.43","8,88,627.82",
17-May-22,Cheque,00.00,"4,44,313.91","4,44,313.91",
17-May-22,Transfer,00.00,"2,22,156.96","2,22,156.96",
17-May-22,ATM,00.00,"22,215.70","1,99,941.26",
17-May-22,Reversal,00.00,"1,99,941.26",00.00,
17-May-22,Transfer,"2,35,129.80",00.00,"2,35,129.80",
17-May-22,Debit Card,00.00,"1,17,564.90","1,17,564.90",
17-May-22,IMPS,00.00,"58,782.45","58,782.45",
17-May-22,Reversal,00.00,"5,878.25","52,904.20",
17-May-22,Purchase,454,00.00,"53,358.20",
17-May-22,RTGS,00.00,"17,786.07","35,572.13",
17-May-22,Purchase,00.00,"5,081.73","30,490.40",
17-May-22,NEFT,218.2,00.00,"30,708.60",
17-May-22,Debit Card,00.00,"5,118.10","25,590.50",
17-May-22,IMPS,00.00,"3,198.81","22,391.69",
17-May-22,Cheque,00.00,"7,463.90","14,927.79",
17-May-22,Reversal,239.84,00.00,"15,167.63",
17-May-22,Transfer,00.00,"1,685.29","13,482.34",
17-May-22,Commission,"2,333.60",00.00,"15,815.94",
17-May-22,IMPS,00.00,"5,271.98","10,543.96",
17-May-22,Transfer,00.00,"2,108.79","8,435.17",
17-May-22,IMPS,00.00,"4,217.59","4,217.58",
17-May-22,Bill,00.00,468.62,"3,748.96",
17-May-22,Tax,00.00,"1,874.48","1,874.48",
17-May-22,RTGS,"12,37,013.00",00.00,"12,38,887.48",
17-May-22,Reversal,"6,79,545.00",00.00,"19,18,432.48",
17-May-22,Transfer,00.00,"3,19,738.75","15,98,693.73",
18-May-22,Tax,07.00,00.00,"15,98,700.73",
18-May-22,IMPS,"24,320.00",00.00,"16,23,020.73",
18-May-22,Bill,00.00,"1,80,335.64","14,42,685.09",
18-May-22,IMPS,"2,160.82",00.00,"14,44,845.91",
18-May-22,Reversal,00.00,"2,40,807.65","12,04,038.26",
19-May-22,RTGS,00.00,"2,00,673.04","10,03,365.22",
19-May-22,Reversal,00.00,"1,00,336.52","9,03,028.70",
19-May-22,NEFT,00.00,"1,29,004.10","7,74,024.60",
19-May-22,Cheque,"19,63,540.20",00.00,"27,37,564.80",
20-May-22,Interest,"81,675.00",00.00,"28,19,239.80",
20-May-22,ATM,07.80,00.00,"28,19,247.60",
20-May-22,RTGS,"29,802.90",00.00,"28,49,050.50",
20-May-22,Reversal,338,00.00,"28,49,388.50",
20-May-22,Transfer,676,00.00,"28,50,064.50",
20-May-22,Commission,03.00,00.00,"28,50,067.50",
20-May-22,Transportellaneous,00.00,"3,16,674.17","25,33,393.33",
20-May-22,ATM,05.00,00.00,"25,33,398.33",
20-May-22,Transfer,00.00,"8,44,466.11","16,88,932.22",
20-May-22,Interest,456.1,00.00,"16,89,388.32",
20-May-22,Reversal,"16,585.00",00.00,"17,05,973.32",
20-May-22,Reversal,00.00,"2,84,328.89","14,21,644.43",
20-May-22,Cash,42.62,00.00,"14,21,687.05",
20-May-22,Interest,58.55,00.00,"14,21,745.60",
20-May-22,Interest,00.00,"4,73,915.20","9,47,830.40",
20-May-22,Transfer,769.2,00.00,"9,48,599.60",
20-May-22,Transfer,00.00,"4,74,299.80","4,74,299.80",
20-May-22,Commission,00.00,"1,18,574.95","3,55,724.85",
20-May-22,Transfer,00.00,"3,55,724.85",00.00,
20-May-22,Purchase,"3,721.00",00.00,"3,721.00",
20-May-22,NEFT,293,00.00,"4,014.00",
20-May-22,ATM,00.00,501.75,"3,512.25",
20-May-22,Bill,00.00,"1,170.75","2,341.50",
20-May-22,Tax,25.19,00.00,"2,366.69",
20-May-22,Transfer,"1,764.40",00.00,"4,131.09",
20-May-22,Purchase,00.00,"2,065.55","2,065.54",
20-May-22,IMPS,00.00,344.26,"1,721.28",
20-May-22,Bill,182.1,00.00,"1,903.38",
20-May-22,Purchase,"65,315.00",00.00,"67,218.38",
20-May-22,Commission,00.00,"13,443.68","53,774.70",
20-May-22,Bill,00.00,"17,924.90","35,849.80",
20-May-22,Interest,00.00,"35,849.80",00.00,
20-May-22,Purchase,"5,484.72",00.00,"5,484.72",
20-May-22,Debit Card,00.00,685.59,"4,799.13",
20-May-22,Tax,568,00.00,"5,367.13",
20-May-22,NEFT,00.00,536.71,"4,830.42",
20-May-22,NEFT,38,00.00,"4,868.42",
20-May-22,IMPS,"29,778.45",00.00,"34,646.87",
20-May-22,NEFT,"90,337.00",00.00,"1,24,983.87",
20-May-22,Commission,00.00,"13,887.10","1,11,096.77",
20-May-22,NEFT,"2,010.10",00.00,"1,13,106.87",
20-May-22,ATM,"1,410.59",00.00,"1,14,517.46",
20-May-22,Transfer,00.00,"28,629.37","85,888.10",
20-May-22,Interest,"2,50,335.00",00.00,"3,36,223.10",
20-May-22,Commission,"1,060.00",00.00,"3,37,283.10",
20-May-22,Cheque,00.00,"1,68,641.55","1,68,641.55",
20-May-22,Debit Card,04.00,00.00,"1,68,645.55",
20-May-22,Reversal,00.00,"21,080.69","1,47,564.86",
20-May-22,ATM,00.00,"16,396.10","1,31,168.76",
20-May-22,Cash,00.00,"16,396.10","1,14,772.66",
20-May-22,Interest,00.00,"1,14,772.66",00.00,
20-May-22,Tax,56,00.00,56,
20-May-22,Interest,"1,07,513.00",00.00,"1,07,569.00",
20-May-22,NEFT,00.00,"17,928.17","89,640.83",
20-May-22,NEFT,"1,96,406.50",00.00,"2,86,047.33",
20-May-22,Debit Card,06.00,00.00,"2,86,053.33",
20-May-22,Bill,00.00,"31,783.70","2,54,269.63",
20-May-22,Commission,07.60,00.00,"2,54,277.23",
20-May-22,IMPS,00.00,00.00,"2,54,277.23",
20-May-22,Reversal,03.90,00.00,"2,54,281.13",
20-May-22,Transportellaneous,00.00,"2,54,281.13",00.00,
20-May-22,Bill,"11,73,871.00",00.00,"11,73,871.00",
20-May-22,Commission,"24,580.20",00.00,"11,98,451.20",
20-May-22,Transfer,98.2,00.00,"11,98,549.40",
20-May-22,Transportellaneous,"13,464.10",00.00,"12,12,013.50",
20-May-22,Bill,44.1,00.00,"12,12,057.60",
20-May-22,Purchase,282.8,00.00,"12,12,340.40",
20-May-22,IMPS,00.00,"1,51,542.55","10,60,797.85",
20-May-22,Purchase,00.00,"2,65,199.46","7,95,598.39",
20-May-22,Cheque,00.00,"3,97,799.20","3,97,799.20",
20-May-22,Cheque,00.00,"99,449.80","2,98,349.40",
20-May-22,ATM,"18,08,426.20",00.00,"21,06,775.60",
20-May-22,Reversal,"24,932.00",00.00,"21,31,707.60",
20-May-22,Cash,39.38,00.00,"21,31,746.98",
20-May-22,Purchase,10.45,00.00,"21,31,757.43",
20-May-22,Purchase,00.41,00.00,"21,31,757.84",
20-May-22,Reversal,"1,301.00",00.00,"21,33,058.84",
20-May-22,Bill,00.00,"7,11,019.61","14,22,039.23",
20-May-22,Commission,00.00,"1,42,203.92","12,79,835.31",
20-May-22,Tax,"2,411.78",00.00,"12,82,247.09",
20-May-22,RTGS,00.00,"4,27,415.70","8,54,831.39",
20-May-22,Reversal,16,00.00,"8,54,847.39",
20-May-22,RTGS,00.00,"1,42,474.57","7,12,372.82",
20-May-22,Reversal,"2,04,326.00",00.00,"9,16,698.82",
20-May-22,RTGS,00.00,"1,01,855.42","8,14,843.40",
20-May-22,Interest,"7,79,456.80",00.00,"15,94,300.20",
20-May-22,Reversal,"3,534.78",00.00,"15,97,834.98",
20-May-22,Tax,00.00,"2,66,305.83","13,31,529.15",
20-May-22,Reversal,00.00,"1,90,218.45","11,41,310.70",
20-May-22,Cheque,58.66,00.00,"11,41,369.36",
20-May-22,Transfer,"2,997.80",00.00,"11,44,367.16",
20-May-22,IMPS,00.00,"1,43,045.90","10,01,321.26",
20-May-22,IMPS,02.32,00.00,"10,01,323.58",
20-May-22,Debit Card,00.00,"1,00,132.36","9,01,191.22",
20-May-22,Purchase,"16,77,668.00",00.00,"25,78,859.22",
20-May-22,Purchase,00.00,"25,78,859.22",00.00,
20-May-22,Tax,"25,955.00",00.00,"25,955.00",
20-May-22,NEFT,00.00,"2,883.89","23,071.11",
20-May-22,Reversal,00.00,"2,307.11","20,764.00",
20-May-22,Reversal,00.00,"2,076.40","18,687.60",
20-May-22,RTGS,00.00,"9,343.80","9,343.80",
20-May-22,Purchase,07.00,00.00,"9,350.80",
20-May-22,Debit Card,"2,337.90",00.00,"11,688.70",
20-May-22,Cheque,"2,954.00",00.00,"14,642.70",
20-May-22,Purchase,00.00,"1,626.97","13,015.73",
20-May-22,Transfer,00.00,"2,603.15","10,412.58",
20-May-22,Debit Card,"1,44,138.69",00.00,"1,54,551.27",
20-May-22,Reversal,05.10,00.00,"1,54,556.37",
20-May-22,NEFT,139.3,00.00,"1,54,695.67",
20-May-22,ATM,403.3,00.00,"1,55,098.97",
20-May-22,IMPS,00.00,"51,699.66","1,03,399.31",
20-May-22,ATM,04.30,00.00,"1,03,403.61",
20-May-22,RTGS,00.00,"34,467.87","68,935.74",
20-May-22,Transportellaneous,"1,903.20",00.00,"70,838.94",
20-May-22,Cheque,209.8,00.00,"71,048.74",
20-May-22,Reversal,00.00,"17,762.19","53,286.56",
20-May-22,IMPS,"21,501.83",00.00,"74,788.39",
20-May-22,RTGS,00.00,"74,788.39",00.00,
20-May-22,Cheque,"5,99,014.00",00.00,"5,99,014.00",
20-May-22,Cheque,05.00,00.00,"5,99,019.00",
20-May-22,Bill,00.00,"85,574.14","5,13,444.86",
20-May-22,Debit Card,00.00,"57,049.43","4,56,395.43",
20-May-22,ATM,"9,66,401.50",00.00,"14,22,796.93",
20-May-22,Interest,06.79,00.00,"14,22,803.72",
20-May-22,Purchase,"1,59,765.00",00.00,"15,82,568.72",
20-May-22,Transfer,00.00,"3,95,642.18","11,86,926.54",
20-May-22,Bill,780.9,00.00,"11,87,707.44",
20-May-22,ATM,"1,144.23",00.00,"11,88,851.67",
21-May-22,Purchase,31.23,00.00,"11,88,882.90",
21-May-22,Transportellaneous,00.00,"1,48,610.36","10,40,272.54",
21-May-22,IMPS,"19,57,911.50",00.00,"29,98,184.04",
21-May-22,Purchase,00.00,"14,99,092.02","14,99,092.02",
21-May-22,Transportellaneous,"1,76,908.10",00.00,"16,76,000.12",
21-May-22,Bill,00.00,"2,09,500.02","14,66,500.10",
21-May-22,ATM,436,00.00,"14,66,936.10",
21-May-22,ATM,14.45,00.00,"14,66,950.55",
21-May-22,Transfer,"1,38,070.00",00.00,"16,05,020.55",
21-May-22,Interest,00.00,"2,29,288.65","13,75,731.90",
21-May-22,Bill,00.00,"3,43,932.98","10,31,798.92",
21-May-22,Purchase,"15,182.96",00.00,"10,46,981.88",
21-May-22,Reversal,41.3,00.00,"10,47,023.18",
21-May-22,Purchase,161.4,00.00,"10,47,184.58",
22-May-22,Bill,00.00,"2,61,796.15","7,85,388.44",
22-May-22,Debit Card,"84,376.00",00.00,"8,69,764.44",
22-May-22,Transportellaneous,262.51,00.00,"8,70,026.95",
22-May-22,Cash,00.00,"4,35,013.48","4,35,013.48",
22-May-22,Debit Card,20.2,00.00,"4,35,033.68",
22-May-22,Cash,00.00,"1,08,758.42","3,26,275.26",
22-May-22,Cheque,00.00,"54,379.21","2,71,896.05",
22-May-22,Debit Card,00.00,"67,974.01","2,03,922.04",
22-May-22,Interest,00.00,"1,01,961.02","1,01,961.02",
22-May-22,Debit Card,"1,84,661.00",00.00,"2,86,622.02",
22-May-22,Purchase,"14,40,792.00",00.00,"17,27,414.02",
22-May-22,Commission,00.00,"3,45,482.80","13,81,931.22",
22-May-22,Bill,"19,64,633.50",00.00,"33,46,564.72",
22-May-22,Reversal,"1,50,769.00",00.00,"34,97,333.72",
22-May-22,NEFT,00.00,"4,37,166.72","30,60,167.01",
22-May-22,Transfer,"2,303.00",00.00,"30,62,470.01",
22-May-22,Interest,00.00,"4,37,495.72","26,24,974.29",
22-May-22,Tax,06.08,00.00,"26,24,980.37",
22-May-22,IMPS,"3,963.30",00.00,"26,28,943.67",
22-May-22,IMPS,00.00,"5,25,788.73","21,03,154.94",
22-May-22,Interest,00.00,"4,20,630.99","16,82,523.95",
22-May-22,Cheque,525,00.00,"16,83,048.95",
22-May-22,Bill,"21,856.90",00.00,"17,04,905.85",
22-May-22,Cheque,325.81,00.00,"17,05,231.66",
22-May-22,Transfer,00.00,"1,70,523.17","15,34,708.49",
22-May-22,Cash,00.00,"7,67,354.25","7,67,354.24",
22-May-22,Transfer,00.00,"1,27,892.37","6,39,461.87",
22-May-22,RTGS,426.1,00.00,"6,39,887.97",
22-May-22,Tax,775.5,00.00,"6,40,663.47",
22-May-22,IMPS,"9,109.33",00.00,"6,49,772.80",
22-May-22,Cash,"6,146.00",00.00,"6,55,918.80",
22-May-22,Cash,06.00,00.00,"6,55,924.80",
22-May-22,NEFT,00.00,"65,592.48","5,90,332.32",
22-May-22,NEFT,00.00,"84,333.19","5,05,999.13",
22-May-22,Tax,00.00,"63,249.89","4,42,749.24",
22-May-22,Transportellaneous,00.00,"2,21,374.62","2,21,374.62",
22-May-22,Purchase,02.00,00.00,"2,21,376.62",
22-May-22,ATM,00.00,"36,896.10","1,84,480.52",
22-May-22,IMPS,"85,989.00",00.00,"2,70,469.52",
22-May-22,RTGS,04.00,00.00,"2,70,473.52",
22-May-22,RTGS,00.73,00.00,"2,70,474.25",
22-May-22,Purchase,04.70,00.00,"2,70,478.95",
22-May-22,IMPS,00.00,"67,619.74","2,02,859.21",
22-May-22,Interest,00.00,"40,571.84","1,62,287.37",
22-May-22,Transfer,00.00,"16,228.74","1,46,058.63",
22-May-22,Purchase,"1,74,500.20",00.00,"3,20,558.83",
22-May-22,NEFT,00.00,"80,139.71","2,40,419.12",
22-May-22,Transportellaneous,00.00,"60,104.78","1,80,314.34",
22-May-22,Tax,00.00,"18,031.43","1,62,282.91",
22-May-22,Tax,102,00.00,"1,62,384.91",
22-May-22,Tax,00.00,"54,128.30","1,08,256.61",
22-May-22,ATM,06.96,00.00,"1,08,263.57",
22-May-22,Commission,03.40,00.00,"1,08,266.97",
22-May-22,IMPS,"1,77,432.90",00.00,"2,85,699.87",
22-May-22,ATM,00.00,"31,744.43","2,53,955.44",
22-May-22,Purchase,129.19,00.00,"2,54,084.63",
22-May-22,IMPS,31.8,00.00,"2,54,116.43",
22-May-22,NEFT,"3,59,050.20",00.00,"6,13,166.63",
22-May-22,Cash,"2,430.00",00.00,"6,15,596.63",
22-May-22,Commission,"3,574.33",00.00,"6,19,170.96",
22-May-22,Cheque,"19,75,901.50",00.00,"25,95,072.46",
22-May-22,Transfer,"27,259.70",00.00,"26,22,332.16",
22-May-22,Bill,00.00,"3,74,618.88","22,47,713.28",
22-May-22,Purchase,"4,023.40",00.00,"22,51,736.68",
22-May-22,ATM,00.00,"2,81,467.09","19,70,269.60",
22-May-22,IMPS,25,00.00,"19,70,294.60",
22-May-22,IMPS,00.00,"2,46,286.83","17,24,007.78",
22-May-22,IMPS,01.00,00.00,"17,24,008.78",
22-May-22,Transfer,00.00,"4,31,002.20","12,93,006.58",
23-May-22,Cheque,00.00,"1,84,715.23","11,08,291.35",
23-May-22,Transfer,"22,891.95",00.00,"11,31,183.30",
23-May-22,IMPS,00.00,"1,25,687.03","10,05,496.27",
23-May-22,Cheque,62.3,00.00,"10,05,558.57",
23-May-22,Debit Card,00.00,"1,00,555.86","9,05,002.71",
23-May-22,Reversal,"1,35,353.00",00.00,"10,40,355.71",
23-May-22,Interest,00.00,"1,48,622.24","8,91,733.47",
23-May-22,Debit Card,00.00,"4,45,866.74","4,45,866.74",
23-May-22,IMPS,"2,28,183.16",00.00,"6,74,049.90",
23-May-22,NEFT,02.70,00.00,"6,74,052.60",
23-May-22,RTGS,00.00,"1,68,513.15","5,05,539.45",
23-May-22,ATM,"29,739.10",00.00,"5,35,278.55",
23-May-22,Transfer,00.00,"1,33,819.64","4,01,458.91",
23-May-22,RTGS,00.00,"57,351.27","3,44,107.64",
23-May-22,IMPS,00.00,"49,158.23","2,94,949.41",
23-May-22,IMPS,"13,41,472.00",00.00,"16,36,421.41",
23-May-22,Transfer,"11,06,015.25",00.00,"27,42,436.66",
23-May-22,Purchase,"25,085.00",00.00,"27,67,521.66",
23-May-22,Reversal,"89,638.00",00.00,"28,57,159.66",
23-May-22,Transfer,00.00,"7,14,289.92","21,42,869.74",
23-May-22,Tax,00.00,"10,71,434.87","10,71,434.87",
23-May-22,Commission,00.00,"2,14,286.97","8,57,147.90",
24-May-22,Tax,30.75,00.00,"8,57,178.65",
24-May-22,Bill,"1,298.85",00.00,"8,58,477.50",
24-May-22,ATM,00.00,"95,386.39","7,63,091.11",
24-May-22,Debit Card,50,00.00,"7,63,141.11",
24-May-22,Interest,00.00,"76,314.11","6,86,827.00",
25-May-22,Cheque,00.00,"1,37,365.40","5,49,461.60",
25-May-22,Debit Card,00.00,"2,74,730.80","2,74,730.80",
25-May-22,Commission,02.60,00.00,"2,74,733.40",
25-May-22,Cash,00.00,"27,473.34","2,47,260.06",
25-May-22,ATM,57,00.00,"2,47,317.06",
25-May-22,Tax,"13,933.00",00.00,"2,61,250.06",
25-May-22,Interest,03.40,00.00,"2,61,253.46",
25-May-22,IMPS,00.00,"52,250.69","2,09,002.77",
25-May-22,IMPS,00.00,"34,833.80","1,74,168.97",
25-May-22,Purchase,05.20,00.00,"1,74,174.17",
25-May-22,Reversal,"2,24,468.00",00.00,"3,98,642.17",
25-May-22,Purchase,"28,065.20",00.00,"4,26,707.37",
25-May-22,Interest,22.2,00.00,"4,26,729.57",
25-May-22,ATM,00.00,"42,672.96","3,84,056.61",
25-May-22,Cheque,00.00,"96,014.15","2,88,042.46",
25-May-22,Cash,199.62,00.00,"2,88,242.08",
25-May-22,Cheque,00.00,"1,44,121.04","1,44,121.04",
25-May-22,Cash,00.00,"14,412.10","1,29,708.94",
25-May-22,IMPS,01.00,00.00,"1,29,709.94",
25-May-22,RTGS,00.00,"21,618.32","1,08,091.62",
25-May-22,Transfer,58,00.00,"1,08,149.62",
25-May-22,Commission,00.00,"21,629.92","86,519.70",
25-May-22,IMPS,"1,055.00",00.00,"87,574.70",
25-May-22,Commission,"2,683.63",00.00,"90,258.33",
25-May-22,Bill,"67,310.31",00.00,"1,57,568.64",
25-May-22,IMPS,06.00,00.00,"1,57,574.64",
25-May-22,Transfer,00.00,"15,757.46","1,41,817.18",
25-May-22,Bill,00.00,"28,363.44","1,13,453.74",
25-May-22,Transportellaneous,00.51,00.00,"1,13,454.25",
25-May-22,Commission,"3,30,269.20",00.00,"4,43,723.45",
25-May-22,Reversal,03.00,00.00,"4,43,726.45",
25-May-22,Tax,00.00,"1,47,908.82","2,95,817.63",
25-May-22,Bill,00.00,"29,581.76","2,66,235.87",
25-May-22,IMPS,"16,44,320.00",00.00,"19,10,555.87",
25-May-22,Commission,01.00,00.00,"19,10,556.87",
25-May-22,Interest,"3,13,310.00",00.00,"22,23,866.87",
25-May-22,Transfer,"1,40,900.44",00.00,"23,64,767.31",
25-May-22,Reversal,40.62,00.00,"23,64,807.93",
25-May-22,NEFT,"67,925.62",00.00,"24,32,733.55",
25-May-22,IMPS,323,00.00,"24,33,056.55",
25-May-22,Transfer,00.00,"4,86,611.31","19,46,445.24",
25-May-22,Bill,21.98,00.00,"19,46,467.22",
25-May-22,Transfer,"4,797.90",00.00,"19,51,265.12",
25-May-22,Transportellaneous,00.00,"2,43,908.14","17,07,356.98",
25-May-22,Bill,"81,655.20",00.00,"17,89,012.18",
25-May-22,Interest,00.00,"2,55,573.17","15,33,439.01",
25-May-22,Cash,00.95,00.00,"15,33,439.96",
25-May-22,Purchase,00.00,"5,11,146.65","10,22,293.31",
25-May-22,Transfer,259,00.00,"10,22,552.31",
25-May-22,Bill,00.00,"1,27,819.04","8,94,733.27",
25-May-22,Cheque,"2,54,525.75",00.00,"11,49,259.02",
25-May-22,IMPS,21,00.00,"11,49,280.02",
25-May-22,Purchase,00.00,"1,64,182.86","9,85,097.16",
25-May-22,Purchase,00.00,"4,92,548.58","4,92,548.58",
26-May-22,IMPS,00.00,"98,509.72","3,94,038.86",
26-May-22,Cheque,60.3,00.00,"3,94,099.16",
26-May-22,Transfer,59.45,00.00,"3,94,158.61",
26-May-22,Transfer,00.00,"56,308.37","3,37,850.24",
26-May-22,Interest,00.00,"42,231.28","2,95,618.96",
26-May-22,Purchase,"8,35,056.00",00.00,"11,30,674.96",
26-May-22,Transportellaneous,60,00.00,"11,30,734.96",
26-May-22,Purchase,"14,062.80",00.00,"11,44,797.76",
26-May-22,RTGS,00.00,"11,44,797.76",00.00,
26-May-22,Debit Card,"26,749.00",00.00,"26,749.00",
26-May-22,Bill,53,00.00,"26,802.00",
26-May-22,Interest,00.00,"2,680.20","24,121.80",
26-May-22,Transfer,"3,781.18",00.00,"27,902.98",
26-May-22,NEFT,333,00.00,"28,235.98",
26-May-22,Cheque,"4,062.20",00.00,"32,298.18",
26-May-22,IMPS,00.00,00.00,"32,298.18",
26-May-22,Cash,"31,098.00",00.00,"63,396.18",
26-May-22,Cheque,757.7,00.00,"64,153.88",
26-May-22,Commission,"17,736.00",00.00,"81,889.88",
26-May-22,Cheque,00.00,"9,098.88","72,791.00",
26-May-22,Cheque,70,00.00,"72,861.00",
26-May-22,Bill,00.00,"72,861.00",00.00,
26-May-22,Cash,"16,20,753.50",00.00,"16,20,753.50",
26-May-22,Interest,05.36,00.00,"16,20,758.86",
26-May-22,Transfer,232,00.00,"16,20,990.86",
26-May-22,Purchase,"2,549.10",00.00,"16,23,539.96",
26-May-22,Commission,00.00,"2,31,934.28","13,91,605.68",
26-May-22,Cash,34.19,00.00,"13,91,639.87",
26-May-22,RTGS,00.00,"3,47,909.97","10,43,729.90",
26-May-22,Tax,"23,978.00",00.00,"10,67,707.90",
26-May-22,Commission,00.00,"1,77,951.32","8,89,756.58",
26-May-22,Reversal,00.00,"2,22,439.15","6,67,317.43",
26-May-22,IMPS,"3,261.77",00.00,"6,70,579.20",
26-May-22,Cash,00.00,"67,057.92","6,03,521.28",
26-May-22,Reversal,00.00,"3,01,760.64","3,01,760.64",
26-May-22,Cash,"26,484.00",00.00,"3,28,244.64",
26-May-22,Commission,"1,64,855.50",00.00,"4,93,100.14",
26-May-22,Debit Card,853,00.00,"4,93,953.14",
26-May-22,NEFT,"22,094.96",00.00,"5,16,048.10",
26-May-22,Cheque,"1,803.00",00.00,"5,17,851.10",
26-May-22,Interest,05.50,00.00,"5,17,856.60",
26-May-22,Reversal,127.95,00.00,"5,17,984.55",
26-May-22,Commission,491.19,00.00,"5,18,475.74",
26-May-22,Debit Card,"1,34,538.00",00.00,"6,53,013.74",
26-May-22,ATM,"10,34,546.00",00.00,"16,87,559.74",
26-May-22,Tax,00.00,"8,43,779.87","8,43,779.87",
26-May-22,Debit Card,"11,731.50",00.00,"8,55,511.37",
26-May-22,Commission,"6,99,891.25",00.00,"15,55,402.62",
26-May-22,Transportellaneous,15.71,00.00,"15,55,418.33",
26-May-22,ATM,53.67,00.00,"15,55,472.00",
26-May-22,Purchase,00.00,"2,59,245.33","12,96,226.67",
26-May-22,Tax,402,00.00,"12,96,628.67",
26-May-22,Reversal,00.00,"2,16,104.78","10,80,523.89",
26-May-22,NEFT,00.00,"1,80,087.32","9,00,436.58",
26-May-22,Transportellaneous,00.00,"1,80,087.32","7,20,349.26",
26-May-22,Transfer,426.07,00.00,"7,20,775.33",
26-May-22,Tax,"1,68,339.00",00.00,"8,89,114.33",
26-May-22,Debit Card,00.00,"2,96,371.44","5,92,742.89",
26-May-22,Debit Card,00.00,"1,18,548.58","4,74,194.31",
26-May-22,Purchase,00.00,"4,74,194.31",00.00,
26-May-22,ATM,06.40,00.00,06.40,
26-May-22,NEFT,00.00,01.07,05.33,
26-May-22,RTGS,00.00,01.33,04.00,
26-May-22,Tax,"31,035.00",00.00,"31,039.00",
26-May-22,Transfer,00.00,"3,879.88","27,159.12",
26-May-22,Bill,"14,310.00",00.00,"41,469.12",
26-May-22,Cheque,00.00,"5,924.16","35,544.96",
26-May-22,IMPS,53.2,00.00,"35,598.16",
26-May-22,Transportellaneous,167,00.00,"35,765.16",
26-May-22,Debit Card,"2,398.06",00.00,"38,163.22",
26-May-22,Interest,00.00,"38,163.22",00.00,
26-May-22,ATM,60,00.00,60,
26-May-22,RTGS,"20,73,471.00",00.00,"20,73,531.00",
26-May-22,Bill,"11,293.00",00.00,"20,84,824.00",
26-May-22,Transfer,"2,045.00",00.00,"20,86,869.00",
26-May-22,Debit Card,"2,66,984.20",00.00,"23,53,853.20",
26-May-22,ATM,37,00.00,"23,53,890.20",
26-May-22,Tax,"8,78,373.80",00.00,"32,32,264.00",
26-May-22,Cheque,"6,89,963.50",00.00,"39,22,227.50",
26-May-22,Cheque,00.00,"9,80,556.88","29,41,670.62",
26-May-22,Purchase,00.00,"3,26,852.29","26,14,818.33",
26-May-22,Bill,174.5,00.00,"26,14,992.83",
26-May-22,Commission,00.00,"13,07,496.42","13,07,496.42",
26-May-22,Debit Card,00.00,"13,07,496.42",00.00,
26-May-22,Cheque,13.95,00.00,13.95,
26-May-22,Commission,00.00,01.40,12.56,
26-May-22,Transfer,764.9,00.00,777.46,
26-May-22,ATM,439.4,00.00,"1,216.86",
26-May-22,Cheque,00.00,152.11,"1,064.75",
26-May-22,ATM,"2,61,963.80",00.00,"2,63,028.55",
26-May-22,Commission,00.00,"43,838.09","2,19,190.46",
26-May-22,Tax,60.8,00.00,"2,19,251.26",
26-May-22,Cheque,00.00,"1,09,625.63","1,09,625.63",
26-May-22,Reversal,"1,810.30",00.00,"1,11,435.93",
26-May-22,IMPS,00.00,"12,381.77","99,054.16",
26-May-22,Bill,"18,233.00",00.00,"1,17,287.16",
26-May-22,ATM,47.45,00.00,"1,17,334.61",
26-May-22,IMPS,00.00,"58,667.31","58,667.30",
26-May-22,ATM,472.4,00.00,"59,139.70",
26-May-22,Purchase,"1,31,011.00",00.00,"1,90,150.70",
26-May-22,Transportellaneous,38,00.00,"1,90,188.70",
26-May-22,IMPS,"73,447.00",00.00,"2,63,635.70",
26-May-22,Cheque,00.00,"32,954.46","2,30,681.24",
26-May-22,Tax,00.00,"32,954.46","1,97,726.78",
26-May-22,NEFT,"23,381.40",00.00,"2,21,108.18",
26-May-22,Debit Card,"17,83,658.75",00.00,"20,04,766.93",
27-May-22,Reversal,56.4,00.00,"20,04,823.33",
27-May-22,Tax,"12,04,608.00",00.00,"32,09,431.33",
27-May-22,Bill,00.00,"3,20,943.13","28,88,488.20",
27-May-22,Transfer,"6,065.00",00.00,"28,94,553.20",
27-May-22,Purchase,364.53,00.00,"28,94,917.73",
27-May-22,Transportellaneous,00.00,"3,61,864.72","25,33,053.01",
27-May-22,Transportellaneous,"1,72,354.00",00.00,"27,05,407.01",
27-May-22,Transportellaneous,00.00,"5,41,081.40","21,64,325.61",
27-May-22,Purchase,122.3,00.00,"21,64,447.91",
27-May-22,ATM,00.00,"5,41,111.98","16,23,335.93",
28-May-22,Cash,"26,507.38",00.00,"16,49,843.31",
28-May-22,Reversal,00.00,"8,24,921.66","8,24,921.66",
28-May-22,NEFT,00.00,"1,17,845.95","7,07,075.71",
28-May-22,Debit Card,"1,30,697.16",00.00,"8,37,772.87",
28-May-22,Transfer,00.00,"2,79,257.62","5,58,515.25",
28-May-22,Cash,"16,122.00",00.00,"5,74,637.25",
28-May-22,Purchase,00.00,"71,829.66","5,02,807.59",
28-May-22,Tax,00.00,"5,02,807.59",00.00,
28-May-22,Commission,11.4,00.00,11.4,
28-May-22,Debit Card,"63,417.20",00.00,"63,428.60",
28-May-22,Cheque,50.25,00.00,"63,478.85",
28-May-22,RTGS,00.00,"6,347.89","57,130.96",
28-May-22,Bill,"30,684.00",00.00,"87,814.96",
28-May-22,Cash,06.60,00.00,"87,821.56",
28-May-22,Debit Card,00.00,"17,564.31","70,257.25",
28-May-22,Interest,36.1,00.00,"70,293.35",
28-May-22,Cash,"4,09,156.00",00.00,"4,79,449.35",
28-May-22,RTGS,00.00,00.00,"4,79,449.35",
28-May-22,Transfer,00.00,"68,492.76","4,10,956.59",
28-May-22,NEFT,26.1,00.00,"4,10,982.69",
29-May-22,Transfer,"12,73,647.00",00.00,"16,84,629.69",
29-May-22,Debit Card,265,00.00,"16,84,894.69",
29-May-22,Debit Card,00.00,"8,42,447.35","8,42,447.34",
29-May-22,IMPS,"12,67,736.00",00.00,"21,10,183.34",
29-May-22,IMPS,00.00,"7,03,394.45","14,06,788.89",
29-May-22,RTGS,13.2,00.00,"14,06,802.09",
29-May-22,NEFT,"2,37,115.40",00.00,"16,43,917.49",
29-May-22,Transfer,00.00,"4,10,979.37","12,32,938.12",
29-May-22,Transportellaneous,17.5,00.00,"12,32,955.62",
29-May-22,Transportellaneous,00.00,"1,36,995.07","10,95,960.55",
29-May-22,Cash,00.00,"2,19,192.11","8,76,768.44",
29-May-22,Tax,"92,671.78",00.00,"9,69,440.22",
29-May-22,Interest,"2,09,840.00",00.00,"11,79,280.22",
29-May-22,ATM,"1,79,035.50",00.00,"13,58,315.72",
29-May-22,Purchase,00.00,"2,26,385.95","11,31,929.77",
29-May-22,Purchase,00.00,"1,88,654.96","9,43,274.81",
29-May-22,ATM,00.00,"3,14,424.94","6,28,849.87",
29-May-22,RTGS,266.66,00.00,"6,29,116.53",
29-May-22,Cheque,431.3,00.00,"6,29,547.83",
29-May-22,ATM,"4,14,308.20",00.00,"10,43,856.03",
29-May-22,Debit Card,36.7,00.00,"10,43,892.73",
29-May-22,Transportellaneous,00.00,"1,49,127.53","8,94,765.20",
29-May-22,RTGS,00.00,"89,476.52","8,05,288.68",
29-May-22,Transfer,00.00,"80,528.87","7,24,759.81",
29-May-22,Transportellaneous,"3,034.10",00.00,"7,27,793.91",
29-May-22,Bill,01.80,00.00,"7,27,795.71",
29-May-22,Bill,00.00,"2,42,598.57","4,85,197.14",
29-May-22,Tax,00.00,"60,649.64","4,24,547.50",
30-May-22,ATM,55.52,00.00,"4,24,603.02",
30-May-22,NEFT,04.97,00.00,"4,24,607.99",
30-May-22,NEFT,00.00,"1,06,152.00","3,18,455.99",
30-May-22,Tax,00.00,"35,384.00","2,83,071.99",
30-May-22,Cash,"1,720.51",00.00,"2,84,792.50",
30-May-22,RTGS,48.98,00.00,"2,84,841.48",
30-May-22,Tax,00.00,"40,691.64","2,44,149.84",
30-May-22,Transportellaneous,495.42,00.00,"2,44,645.26",
30-May-22,Transfer,"1,642.30",00.00,"2,46,287.56",
30-May-22,Commission,00.00,"82,095.85","1,64,191.71",
30-May-22,Cheque,05.30,00.00,"1,64,197.01",
30-May-22,Debit Card,00.00,"18,244.11","1,45,952.90",
30-May-22,IMPS,00.00,"29,190.58","1,16,762.32",
30-May-22,Cash,00.00,"23,352.46","93,409.86",
30-May-22,Debit Card,284,00.00,"93,693.86",
30-May-22,NEFT,00.00,"9,369.39","84,324.47",
30-May-22,Interest,00.00,"9,369.39","74,955.08",
30-May-22,Bill,"1,852.98",00.00,"76,808.06",
30-May-22,RTGS,06.30,00.00,"76,814.36",
30-May-22,ATM,39.81,00.00,"76,854.17",
30-May-22,RTGS,00.00,"12,809.03","64,045.14",
30-May-22,ATM,00.00,"7,116.13","56,929.01",
30-May-22,ATM,00.00,"11,385.80","45,543.21",
30-May-22,Cheque,00.10,00.00,"45,543.31",
30-May-22,Reversal,07.00,00.00,"45,550.31",
31-May-22,Transfer,00.00,"9,110.06","36,440.25",
31-May-22,IMPS,00.00,"3,644.03","32,796.22",
01-Jun-22,Transportellaneous,"51,107.91",00.00,"83,904.13",
01-Jun-22,Transfer,00.00,"83,904.13",00.00,
01-Jun-22,Bill,"3,591.70",00.00,"3,591.70",
01-Jun-22,IMPS,00.00,897.93,"2,693.77",
01-Jun-22,Debit Card,"2,30,268.28",00.00,"2,32,962.05",
01-Jun-22,Debit Card,"7,65,940.00",00.00,"9,98,902.05",
01-Jun-22,RTGS,00.00,"1,24,862.76","8,74,039.29",
01-Jun-22,Bill,00.00,"1,09,254.91","7,64,784.38",
01-Jun-22,Interest,"3,415.00",00.00,"7,68,199.38",
02-Jun-22,ATM,461.7,00.00,"7,68,661.08",
02-Jun-22,Commission,00.00,"1,92,165.27","5,76,495.81",
02-Jun-22,Debit Card,00.00,"2,88,247.91","2,88,247.91",
02-Jun-22,NEFT,03.31,00.00,"2,88,251.22",
03-Jun-22,RTGS,00.00,"2,88,251.22",00.00,
04-Jun-22,Interest,01.00,00.00,01.00,
04-Jun-22,Tax,"1,88,305.44",00.00,"1,88,306.44",
04-Jun-22,Cheque,00.00,"1,88,306.44",00.00,
04-Jun-22,Interest,37.85,00.00,37.85,
04-Jun-22,Debit Card,00.00,04.21,33.64,
04-Jun-22,Purchase,00.00,08.41,25.23,
04-Jun-22,Interest,"1,96,901.78",00.00,"1,96,927.01",
04-Jun-22,ATM,"2,05,228.00",00.00,"4,02,155.01",
04-Jun-22,Reversal,"5,380.20",00.00,"4,07,535.21",
04-Jun-22,Transportellaneous,"20,53,922.00",00.00,"24,61,457.21",
04-Jun-22,Commission,"19,828.00",00.00,"24,81,285.21",
04-Jun-22,RTGS,449,00.00,"24,81,734.21",
04-Jun-22,IMPS,00.00,"12,40,867.11","12,40,867.10",
04-Jun-22,Tax,236.9,00.00,"12,41,104.00",
04-Jun-22,Cheque,00.00,"4,13,701.33","8,27,402.67",
04-Jun-22,Interest,"1,38,426.80",00.00,"9,65,829.47",
04-Jun-22,Cheque,00.00,"1,93,165.89","7,72,663.58",
04-Jun-22,IMPS,"1,89,958.90",00.00,"9,62,622.48",
04-Jun-22,Cheque,00.00,"1,60,437.08","8,02,185.40",
04-Jun-22,Purchase,"2,24,464.12",00.00,"10,26,649.52",
04-Jun-22,ATM,868,00.00,"10,27,517.52",
04-Jun-22,Cheque,"8,95,538.50",00.00,"19,23,056.02",
04-Jun-22,Commission,00.00,"2,74,722.29","16,48,333.73",
04-Jun-22,Commission,00.00,"3,29,666.75","13,18,666.98",
04-Jun-22,Reversal,14.9,00.00,"13,18,681.88",
04-Jun-22,Reversal,00.00,"2,63,736.38","10,54,945.50",
04-Jun-22,Cheque,987.5,00.00,"10,55,933.00",
04-Jun-22,Debit Card,"16,82,615.00",00.00,"27,38,548.00",
04-Jun-22,Reversal,"4,035.90",00.00,"27,42,583.90",
04-Jun-22,NEFT,00.00,"6,85,645.98","20,56,937.92",
04-Jun-22,Transfer,00.00,"2,93,848.27","17,63,089.65",
04-Jun-22,Cash,59.6,00.00,"17,63,149.25",
04-Jun-22,Cheque,02.00,00.00,"17,63,151.25",
04-Jun-22,Commission,"17,60,739.50",00.00,"35,23,890.75",
04-Jun-22,Purchase,00.00,"5,03,412.96","30,20,477.79",
04-Jun-22,Cheque,00.00,"3,77,559.72","26,42,918.07",
04-Jun-22,Commission,06.70,00.00,"26,42,924.77",
04-Jun-22,NEFT,246.9,00.00,"26,43,171.67",
05-Jun-22,Reversal,"1,58,776.80",00.00,"28,01,948.47",
05-Jun-22,Commission,00.00,"4,00,278.35","24,01,670.12",
05-Jun-22,Bill,00.00,"4,00,278.35","20,01,391.77",
05-Jun-22,Tax,"3,769.24",00.00,"20,05,161.01",
05-Jun-22,Debit Card,00.00,"6,68,387.00","13,36,774.01",
05-Jun-22,Cheque,00.15,00.00,"13,36,774.16",
05-Jun-22,Purchase,00.00,"3,34,193.54","10,02,580.62",
05-Jun-22,ATM,00.00,"1,67,096.77","8,35,483.85",
05-Jun-22,Commission,00.00,"1,04,435.48","7,31,048.37",
06-Jun-22,Cash,"12,31,022.00",00.00,"19,62,070.37",
06-Jun-22,Commission,00.00,"6,54,023.46","13,08,046.91",
06-Jun-22,NEFT,"2,37,745.94",00.00,"15,45,792.85",
06-Jun-22,Cheque,00.00,"2,20,827.55","13,24,965.30",
06-Jun-22,NEFT,08.05,00.00,"13,24,973.35",
06-Jun-22,Cheque,18,00.00,"13,24,991.35",
06-Jun-22,Purchase,00.00,"3,31,247.84","9,93,743.51",
06-Jun-22,Purchase,"2,03,170.28",00.00,"11,96,913.79",
06-Jun-22,Transfer,00.00,"1,32,990.42","10,63,923.37",
06-Jun-22,ATM,00.00,"1,32,990.42","9,30,932.95",
06-Jun-22,Tax,"9,180.59",00.00,"9,40,113.54",
06-Jun-22,Bill,00.00,"3,13,371.18","6,26,742.36",
06-Jun-22,Transfer,55.8,00.00,"6,26,798.16",
06-Jun-22,RTGS,06.00,00.00,"6,26,804.16",
06-Jun-22,Reversal,00.00,"62,680.42","5,64,123.74",
06-Jun-22,Transfer,00.00,"94,020.62","4,70,103.12",
06-Jun-22,Bill,54,00.00,"4,70,157.12",
06-Jun-22,RTGS,00.00,"52,239.68","4,17,917.44",
06-Jun-22,ATM,06.16,00.00,"4,17,923.60",
06-Jun-22,NEFT,00.00,"83,584.72","3,34,338.88",
06-Jun-22,Transportellaneous,"1,230.63",00.00,"3,35,569.51",
06-Jun-22,Debit Card,90,00.00,"3,35,659.51",
06-Jun-22,ATM,"3,282.00",00.00,"3,38,941.51",
06-Jun-22,IMPS,00.00,"1,12,980.50","2,25,961.01",
06-Jun-22,IMPS,"69,858.00",00.00,"2,95,819.01",
06-Jun-22,Tax,00.00,"59,163.80","2,36,655.21",
06-Jun-22,IMPS,00.00,"59,163.80","1,77,491.41",
06-Jun-22,Transportellaneous,672,00.00,"1,78,163.41",
06-Jun-22,Reversal,00.00,"22,270.43","1,55,892.98",
06-Jun-22,Interest,00.00,"15,589.30","1,40,303.68",
06-Jun-22,Bill,00.00,"28,060.74","1,12,242.94",
06-Jun-22,Debit Card,00.00,"56,121.47","56,121.47",
06-Jun-22,Commission,00.00,"56,121.47",00.00,
06-Jun-22,Cheque,353.2,00.00,353.2,
06-Jun-22,Reversal,"8,972.00",00.00,"9,325.20",
06-Jun-22,Interest,00.00,"3,108.40","6,216.80",
06-Jun-22,Transportellaneous,"20,537.00",00.00,"26,753.80",
06-Jun-22,Cheque,00.00,"26,753.80",00.00,
06-Jun-22,Purchase,"3,083.44",00.00,"3,083.44",
06-Jun-22,Transfer,"1,39,690.20",00.00,"1,42,773.64",
06-Jun-22,Bill,00.00,"35,693.41","1,07,080.23",
07-Jun-22,ATM,00.00,"53,540.12","53,540.12",
07-Jun-22,Reversal,00.00,"5,354.01","48,186.11",
07-Jun-22,Reversal,"4,616.00",00.00,"52,802.11",
07-Jun-22,Purchase,00.00,"5,866.90","46,935.21",
07-Jun-22,Cash,00.00,"7,822.54","39,112.68",
07-Jun-22,Tax,00.00,"4,345.85","34,766.83",
07-Jun-22,Reversal,00.00,"4,345.85","30,420.98",
07-Jun-22,Commission,00.00,"5,070.16","25,350.82",
07-Jun-22,Interest,00.00,"6,337.71","19,013.11",
07-Jun-22,Tax,00.00,"6,337.70","12,675.41",
07-Jun-22,Cheque,"6,570.80",00.00,"19,246.21",
07-Jun-22,Debit Card,"1,836.56",00.00,"21,082.77",
07-Jun-22,Transfer,00.00,"3,011.82","18,070.95",
07-Jun-22,Transportellaneous,00.00,"18,070.95",00.00,
07-Jun-22,Transfer,"98,654.80",00.00,"98,654.80",
07-Jun-22,Bill,02.50,00.00,"98,657.30",
07-Jun-22,Commission,"14,873.00",00.00,"1,13,530.30",
08-Jun-22,Interest,"90,409.50",00.00,"2,03,939.80",
08-Jun-22,Transfer,00.00,"67,979.93","1,35,959.87",
08-Jun-22,Interest,00.00,"19,422.84","1,16,537.03",
08-Jun-22,Purchase,00.00,"11,653.70","1,04,883.33",
08-Jun-22,Purchase,00.00,"10,488.33","94,395.00",
08-Jun-22,Commission,"6,96,156.25",00.00,"7,90,551.25",
08-Jun-22,RTGS,00.00,"1,12,935.89","6,77,615.36",
08-Jun-22,Bill,00.00,"1,12,935.89","5,64,679.47",
08-Jun-22,Reversal,00.00,"94,113.25","4,70,566.22",
08-Jun-22,Commission,17.34,00.00,"4,70,583.56",
08-Jun-22,Cash,00.00,"2,35,291.78","2,35,291.78",
08-Jun-22,Transportellaneous,"94,537.60",00.00,"3,29,829.38",
08-Jun-22,Commission,00.00,"65,965.88","2,63,863.50",
08-Jun-22,Transportellaneous,00.00,"87,954.50","1,75,909.00",
08-Jun-22,ATM,00.00,"25,129.86","1,50,779.14",
08-Jun-22,Bill,01.90,00.00,"1,50,781.04",
08-Jun-22,ATM,00.00,"37,695.26","1,13,085.78",
08-Jun-22,Commission,00.00,"18,847.63","94,238.15",
08-Jun-22,Cash,"2,121.12",00.00,"96,359.27",
08-Jun-22,NEFT,58,00.00,"96,417.27",
08-Jun-22,RTGS,336,00.00,"96,753.27",
08-Jun-22,RTGS,00.00,"96,753.27",00.00,
08-Jun-22,Interest,44.55,00.00,44.55,
08-Jun-22,Tax,00.00,06.36,38.19,
08-Jun-22,Transportellaneous,"1,992.00",00.00,"2,030.19",
08-Jun-22,Bill,00.00,290.03,"1,740.16",
08-Jun-22,RTGS,00.00,174.02,"1,566.14",
08-Jun-22,Transfer,465.52,00.00,"2,031.66",
08-Jun-22,Cash,"3,684.70",00.00,"5,716.36",
08-Jun-22,RTGS,405.7,00.00,"6,122.06",
08-Jun-22,NEFT,00.00,"1,020.34","5,101.72",
08-Jun-22,Interest,"14,262.00",00.00,"19,363.72",
08-Jun-22,Bill,00.00,"2,420.47","16,943.26",
08-Jun-22,Transfer,00.00,"8,471.63","8,471.63",
08-Jun-22,Cash,45.24,00.00,"8,516.87",
08-Jun-22,Interest,00.00,851.69,"7,665.18",
08-Jun-22,Commission,06.30,00.00,"7,671.48",
08-Jun-22,RTGS,"3,821.00",00.00,"11,492.48",
08-Jun-22,IMPS,00.00,"11,492.48",00.00,
08-Jun-22,Cheque,03.83,00.00,03.83,
08-Jun-22,Cheque,00.00,00.64,03.19,
08-Jun-22,Cheque,00.00,01.06,02.13,
08-Jun-22,NEFT,02.60,00.00,04.73,
08-Jun-22,IMPS,00.00,00.53,04.20,
08-Jun-22,Cheque,"50,290.00",00.00,"50,294.20",
08-Jun-22,Debit Card,00.00,"50,294.20",00.00,
08-Jun-22,Bill,"15,776.70",00.00,"15,776.70",
08-Jun-22,ATM,00.00,"5,258.90","10,517.80",
08-Jun-22,IMPS,03.00,00.00,"10,520.80",
08-Jun-22,Cheque,00.00,"3,506.93","7,013.87",
08-Jun-22,RTGS,05.00,00.00,"7,018.87",
08-Jun-22,Transportellaneous,00.00,"1,002.70","6,016.17",
08-Jun-22,Transportellaneous,"6,618.00",00.00,"12,634.17",
09-Jun-22,RTGS,00.00,"6,317.09","6,317.08",
09-Jun-22,Debit Card,"4,694.53",00.00,"11,011.61",
09-Jun-22,Transportellaneous,03.93,00.00,"11,015.54",
09-Jun-22,Interest,"3,769.60",00.00,"14,785.14",
09-Jun-22,Interest,00.00,"2,957.03","11,828.11",
09-Jun-22,Bill,00.00,"1,971.35","9,856.76",
09-Jun-22,Transfer,"26,186.00",00.00,"36,042.76",
10-Jun-22,ATM,00.00,"18,021.38","18,021.38",
10-Jun-22,Bill,"4,80,294.00",00.00,"4,98,315.38",
10-Jun-22,Debit Card,"3,044.80",00.00,"5,01,360.18",
10-Jun-22,ATM,00.00,"2,50,680.09","2,50,680.09",
10-Jun-22,Interest,00.00,"1,25,340.05","1,25,340.04",
10-Jun-22,Interest,376.1,00.00,"1,25,716.14",
10-Jun-22,Purchase,00.00,"20,952.69","1,04,763.45",
10-Jun-22,Cheque,375.95,00.00,"1,05,139.40",
10-Jun-22,Debit Card,06.00,00.00,"1,05,145.40",
10-Jun-22,Transfer,06.00,00.00,"1,05,151.40",
10-Jun-22,Transfer,00.00,"52,575.70","52,575.70",
10-Jun-22,NEFT,00.00,"13,143.93","39,431.77",
10-Jun-22,ATM,502.68,00.00,"39,934.45",
10-Jun-22,ATM,"2,50,543.25",00.00,"2,90,477.70",
10-Jun-22,Cash,00.00,"2,90,477.70",00.00,
10-Jun-22,Cheque,"1,343.24",00.00,"1,343.24",
10-Jun-22,Debit Card,"23,063.66",00.00,"24,406.90",
10-Jun-22,Cash,00.00,"6,101.73","18,305.18",
10-Jun-22,Bill,00.00,"2,615.03","15,690.15",
10-Jun-22,Interest,"2,314.00",00.00,"18,004.15",
10-Jun-22,Debit Card,00.00,"2,000.46","16,003.69",
10-Jun-22,RTGS,435.93,00.00,"16,439.62",
10-Jun-22,RTGS,00.00,"1,826.62","14,613.00",
10-Jun-22,Debit Card,05.23,00.00,"14,618.23",
10-Jun-22,Commission,"55,896.06",00.00,"70,514.29",
10-Jun-22,Tax,00.00,"7,834.92","62,679.37",
10-Jun-22,Commission,"2,470.20",00.00,"65,149.57",
10-Jun-22,IMPS,00.00,"10,858.26","54,291.31",
10-Jun-22,Commission,00.00,"9,048.55","45,242.76",
10-Jun-22,Debit Card,"1,810.74",00.00,"47,053.50",
10-Jun-22,Cash,"1,011.00",00.00,"48,064.50",
10-Jun-22,Tax,00.00,"48,064.50",00.00,
10-Jun-22,Debit Card,"20,024.00",00.00,"20,024.00",
10-Jun-22,Debit Card,00.00,"4,004.80","16,019.20",
10-Jun-22,Transportellaneous,00.00,"2,288.46","13,730.74",
10-Jun-22,Transfer,"58,995.47",00.00,"72,726.21",
10-Jun-22,Commission,00.00,"72,726.21",00.00,
10-Jun-22,Transportellaneous,"1,71,220.00",00.00,"1,71,220.00",
10-Jun-22,Transfer,"18,55,963.00",00.00,"20,27,183.00",
10-Jun-22,IMPS,00.00,"20,27,183.00",00.00,
10-Jun-22,NEFT,"16,479.70",00.00,"16,479.70",
10-Jun-22,Debit Card,32.56,00.00,"16,512.26",
10-Jun-22,IMPS,"2,855.45",00.00,"19,367.71",
10-Jun-22,Transfer,00.00,"2,420.96","16,946.75",
10-Jun-22,Transportellaneous,"2,404.14",00.00,"19,350.89",
10-Jun-22,Transfer,00.00,"3,870.18","15,480.71",
10-Jun-22,RTGS,60,00.00,"15,540.71",
10-Jun-22,Transportellaneous,"2,138.29",00.00,"17,679.00",
11-Jun-22,Tax,00.00,"2,209.88","15,469.12",
11-Jun-22,IMPS,352,00.00,"15,821.12",
11-Jun-22,Reversal,"20,01,372.00",00.00,"20,17,193.12",
11-Jun-22,Transportellaneous,43.74,00.00,"20,17,236.86",
11-Jun-22,ATM,"12,35,934.00",00.00,"32,53,170.86",
11-Jun-22,Tax,00.00,"10,84,390.29","21,68,780.57",
11-Jun-22,Cheque,"1,016.90",00.00,"21,69,797.47",
11-Jun-22,Tax,"17,089.42",00.00,"21,86,886.89",
11-Jun-22,Transportellaneous,"1,803.55",00.00,"21,88,690.44",
11-Jun-22,Reversal,06.90,00.00,"21,88,697.34",
12-Jun-22,RTGS,00.00,"2,43,188.59","19,45,508.75",
12-Jun-22,Purchase,00.00,"2,77,929.82","16,67,578.93",
12-Jun-22,Transportellaneous,00.00,"1,85,286.55","14,82,292.38",
12-Jun-22,Purchase,03.00,00.00,"14,82,295.38",
12-Jun-22,RTGS,54,00.00,"14,82,349.38",
12-Jun-22,Reversal,"98,260.09",00.00,"15,80,609.47",
12-Jun-22,Transfer,00.00,"1,58,060.95","14,22,548.52",
13-Jun-22,Interest,00.00,"7,11,274.26","7,11,274.26",
13-Jun-22,Cash,"2,56,617.00",00.00,"9,67,891.26",
13-Jun-22,Commission,00.00,"1,61,315.21","8,06,576.05",
13-Jun-22,Tax,00.00,"2,68,858.68","5,37,717.37",
13-Jun-22,IMPS,00.00,"76,816.77","4,60,900.60",
13-Jun-22,RTGS,"1,41,558.40",00.00,"6,02,459.00",
13-Jun-22,ATM,00.00,"86,065.57","5,16,393.43",
13-Jun-22,Cheque,00.00,"57,377.05","4,59,016.38",
13-Jun-22,Purchase,"2,57,847.53",00.00,"7,16,863.91",
13-Jun-22,Cheque,21.26,00.00,"7,16,885.17",
13-Jun-22,Transfer,"20,802.90",00.00,"7,37,688.07",
14-Jun-22,Debit Card,00.00,"3,68,844.04","3,68,844.04",
14-Jun-22,NEFT,00.00,"1,84,422.02","1,84,422.02",
14-Jun-22,NEFT,436.8,00.00,"1,84,858.82",
14-Jun-22,Bill,02.00,00.00,"1,84,860.82",
14-Jun-22,RTGS,00.00,"1,84,860.82",00.00,
14-Jun-22,Reversal,"2,50,900.00",00.00,"2,50,900.00",
14-Jun-22,NEFT,00.00,"2,50,900.00",00.00,
15-Jun-22,Bill,"1,513.00",00.00,"1,513.00",
15-Jun-22,RTGS,00.00,151.3,"1,361.70",
15-Jun-22,Purchase,00.84,00.00,"1,362.54",
15-Jun-22,Cheque,428.6,00.00,"1,791.14",
15-Jun-22,Debit Card,00.00,"1,791.14",00.00,
15-Jun-22,Transfer,"2,593.72",00.00,"2,593.72",
15-Jun-22,Interest,62,00.00,"2,655.72",
15-Jun-22,Transportellaneous,04.00,00.00,"2,659.72",
15-Jun-22,Cash,00.00,531.94,"2,127.78",
16-Jun-22,Reversal,"1,459.65",00.00,"3,587.43",
16-Jun-22,Interest,"4,042.00",00.00,"7,629.43",
16-Jun-22,Bill,"2,190.17",00.00,"9,819.60",
16-Jun-22,ATM,00.00,"1,636.60","8,183.00",
16-Jun-22,RTGS,"19,62,694.50",00.00,"19,70,877.50",
16-Jun-22,NEFT,"3,39,438.25",00.00,"23,10,315.75",
16-Jun-22,IMPS,00.00,"3,85,052.63","19,25,263.12",
17-Jun-22,Cash,00.00,"2,40,657.89","16,84,605.23",
17-Jun-22,Transfer,"13,896.00",00.00,"16,98,501.23",
17-Jun-22,Interest,37,00.00,"16,98,538.23",
17-Jun-22,Interest,"7,830.00",00.00,"17,06,368.23",
17-Jun-22,RTGS,"77,680.00",00.00,"17,84,048.23",
17-Jun-22,Debit Card,37,00.00,"17,84,085.23",
17-Jun-22,Transfer,"3,754.00",00.00,"17,87,839.23",
17-Jun-22,Reversal,"3,502.00",00.00,"17,91,341.23",
17-Jun-22,Transportellaneous,"1,60,826.00",00.00,"19,52,167.23",
17-Jun-22,Purchase,"1,437.48",00.00,"19,53,604.71",
17-Jun-22,Bill,00.00,"1,95,360.47","17,58,244.24",
18-Jun-22,RTGS,03.94,00.00,"17,58,248.18",
18-Jun-22,Reversal,"1,70,180.75",00.00,"19,28,428.93",
18-Jun-22,IMPS,00.00,"3,85,685.79","15,42,743.14",
18-Jun-22,Bill,00.00,"1,71,415.90","13,71,327.24",
18-Jun-22,Cash,00.00,"1,71,415.91","11,99,911.34",
19-Jun-22,Cash,00.00,"2,99,977.84","8,99,933.51",
19-Jun-22,Purchase,"12,94,989.50",00.00,"21,94,923.01",
19-Jun-22,Tax,00.00,"7,31,641.00","14,63,282.01",
19-Jun-22,NEFT,00.00,"14,63,282.01",00.00,
19-Jun-22,Cash,07.90,00.00,07.90,
19-Jun-22,Interest,00.00,01.32,06.58,
19-Jun-22,Transfer,"3,744.31",00.00,"3,750.89",
19-Jun-22,Reversal,00.00,625.15,"3,125.74",
19-Jun-22,Bill,00.00,390.72,"2,735.02",
19-Jun-22,IMPS,00.00,273.5,"2,461.52",
19-Jun-22,RTGS,100.1,00.00,"2,561.62",
19-Jun-22,Tax,00.00,"2,561.62",00.00,
19-Jun-22,Purchase,176.68,00.00,176.68,
19-Jun-22,IMPS,00.00,44.17,132.51,
19-Jun-22,Cash,"3,78,502.25",00.00,"3,78,634.76",
19-Jun-22,Cash,00.00,"3,78,634.76",00.00,
19-Jun-22,Bill,372.6,00.00,372.6,
19-Jun-22,Purchase,21.85,00.00,394.45,
19-Jun-22,Reversal,"24,813.00",00.00,"25,207.45",
19-Jun-22,Purchase,00.00,"3,150.93","22,056.52",
19-Jun-22,Transportellaneous,00.00,"2,757.07","19,299.46",
19-Jun-22,NEFT,"12,260.00",00.00,"31,559.46",
19-Jun-22,NEFT,00.00,"31,559.46",00.00,
19-Jun-22,Bill,01.00,00.00,01.00,
19-Jun-22,Bill,00.00,00.20,00.80,
19-Jun-22,Commission,00.00,00.80,00.00,
19-Jun-22,Transportellaneous,"9,17,775.25",00.00,"9,17,775.25",
19-Jun-22,Transportellaneous,00.00,"1,31,110.75","7,86,664.50",
19-Jun-22,Cash,"2,48,027.60",00.00,"10,34,692.10",
19-Jun-22,Reversal,34.24,00.00,"10,34,726.34",
19-Jun-22,IMPS,"5,959.30",00.00,"10,40,685.64",
19-Jun-22,Debit Card,"23,841.56",00.00,"10,64,527.20",
19-Jun-22,Debit Card,00.00,"2,12,905.44","8,51,621.76",
19-Jun-22,ATM,03.50,00.00,"8,51,625.26",
19-Jun-22,Transportellaneous,03.00,00.00,"8,51,628.26",
19-Jun-22,IMPS,00.00,"1,41,938.04","7,09,690.22",
19-Jun-22,ATM,05.80,00.00,"7,09,696.02",
19-Jun-22,Transportellaneous,00.00,"70,969.60","6,38,726.42",
19-Jun-22,RTGS,00.00,"1,27,745.28","5,10,981.14",
19-Jun-22,Transfer,00.00,"85,163.52","4,25,817.62",
19-Jun-22,Transportellaneous,"89,295.00",00.00,"5,15,112.62",
19-Jun-22,Debit Card,00.00,"1,28,778.16","3,86,334.46",
19-Jun-22,Purchase,00.00,"1,28,778.15","2,57,556.31",
19-Jun-22,NEFT,"15,216.10",00.00,"2,72,772.41",
19-Jun-22,Bill,"15,667.60",00.00,"2,88,440.01",
19-Jun-22,IMPS,447.5,00.00,"2,88,887.51",
19-Jun-22,Transportellaneous,"31,772.00",00.00,"3,20,659.51",
19-Jun-22,RTGS,00.00,"1,06,886.50","2,13,773.01",
20-Jun-22,Cheque,07.20,00.00,"2,13,780.21",
20-Jun-22,Cheque,00.00,"26,722.53","1,87,057.68",
20-Jun-22,RTGS,"3,975.00",00.00,"1,91,032.68",
20-Jun-22,Bill,394,00.00,"1,91,426.68",
20-Jun-22,NEFT,05.48,00.00,"1,91,432.16",
20-Jun-22,ATM,421.2,00.00,"1,91,853.36",
20-Jun-22,Debit Card,"5,126.07",00.00,"1,96,979.43",
20-Jun-22,Transportellaneous,05.00,00.00,"1,96,984.43",
20-Jun-22,Commission,"2,51,776.20",00.00,"4,48,760.63",
20-Jun-22,Interest,00.00,"49,862.29","3,98,898.34",
20-Jun-22,Reversal,00.00,"66,483.06","3,32,415.28",
20-Jun-22,Cash,00.00,"33,241.53","2,99,173.75",
20-Jun-22,Cheque,00.00,"49,862.29","2,49,311.46",
20-Jun-22,Transfer,96.6,00.00,"2,49,408.06",
20-Jun-22,Reversal,"20,889.70",00.00,"2,70,297.76",
20-Jun-22,Debit Card,00.00,"30,033.08","2,40,264.68",
20-Jun-22,Purchase,00.00,"60,066.17","1,80,198.51",
20-Jun-22,NEFT,00.00,"90,099.26","90,099.26",
20-Jun-22,Cheque,79,00.00,"90,178.26",
20-Jun-22,Cheque,"3,484.00",00.00,"93,662.26",
20-Jun-22,ATM,01.00,00.00,"93,663.26",
20-Jun-22,IMPS,32.4,00.00,"93,695.66",
20-Jun-22,Transportellaneous,19,00.00,"93,714.66",
20-Jun-22,Debit Card,"89,814.00",00.00,"1,83,528.66",
20-Jun-22,ATM,"3,790.00",00.00,"1,87,318.66",
20-Jun-22,Transportellaneous,168.2,00.00,"1,87,486.86",
20-Jun-22,Bill,00.00,"46,871.72","1,40,615.14",
20-Jun-22,ATM,00.00,"28,123.03","1,12,492.11",
20-Jun-22,Cheque,00.00,"14,061.51","98,430.60",
20-Jun-22,ATM,"84,665.81",00.00,"1,83,096.41",
20-Jun-22,Bill,00.00,"61,032.14","1,22,064.27",
20-Jun-22,Debit Card,00.00,"13,562.70","1,08,501.57",
20-Jun-22,Bill,00.00,"15,500.22","93,001.35",
20-Jun-22,NEFT,00.00,"18,600.27","74,401.08",
20-Jun-22,NEFT,61.5,00.00,"74,462.58",
20-Jun-22,Tax,00.00,"74,462.58",00.00,
20-Jun-22,ATM,"30,591.10",00.00,"30,591.10",
20-Jun-22,Interest,00.00,"10,197.03","20,394.07",
20-Jun-22,IMPS,"3,946.10",00.00,"24,340.17",
20-Jun-22,Bill,02.00,00.00,"24,342.17",
20-Jun-22,ATM,424,00.00,"24,766.17",
20-Jun-22,Debit Card,323,00.00,"25,089.17",
20-Jun-22,NEFT,00.00,"2,508.92","22,580.25",
20-Jun-22,Purchase,"6,29,961.00",00.00,"6,52,541.25",
20-Jun-22,Bill,"2,445.52",00.00,"6,54,986.77",
20-Jun-22,IMPS,61.7,00.00,"6,55,048.47",
20-Jun-22,Reversal,00.00,"65,504.85","5,89,543.62",
21-Jun-22,NEFT,05.62,00.00,"5,89,549.24",
21-Jun-22,Cash,00.00,"73,693.66","5,15,855.58",
21-Jun-22,RTGS,28.8,00.00,"5,15,884.38",
21-Jun-22,Commission,247,00.00,"5,16,131.38",
21-Jun-22,ATM,00.00,"57,347.93","4,58,783.45",
21-Jun-22,NEFT,396.6,00.00,"4,59,180.05",
21-Jun-22,Interest,00.00,"4,59,180.05",00.00,
21-Jun-22,Cheque,15.5,00.00,15.5,
21-Jun-22,Cheque,40,00.00,55.5,
21-Jun-22,Transfer,00.00,18.5,37,
21-Jun-22,Purchase,00.00,05.29,31.71,
21-Jun-22,RTGS,00.00,15.86,15.86,
21-Jun-22,NEFT,"2,14,902.62",00.00,"2,14,918.48",
21-Jun-22,Interest,"16,57,112.75",00.00,"18,72,031.23",
21-Jun-22,Interest,00.00,"3,74,406.25","14,97,624.98",
21-Jun-22,Debit Card,440.02,00.00,"14,98,065.00",
21-Jun-22,IMPS,"2,852.00",00.00,"15,00,917.00",
21-Jun-22,Transportellaneous,00.00,"5,00,305.67","10,00,611.33",
21-Jun-22,Cheque,00.00,"10,00,611.33",00.00,
21-Jun-22,Cheque,"26,688.80",00.00,"26,688.80",
21-Jun-22,Purchase,00.00,"5,337.76","21,351.04",
21-Jun-22,Bill,"7,151.48",00.00,"28,502.52",
21-Jun-22,Bill,"17,04,444.50",00.00,"17,32,947.02",
21-Jun-22,Bill,00.00,"5,77,649.01","11,55,298.01",
21-Jun-22,Cash,"26,975.80",00.00,"11,82,273.81",
21-Jun-22,Bill,00.00,"1,31,363.76","10,50,910.05",
21-Jun-22,Tax,"1,96,696.00",00.00,"12,47,606.05",
21-Jun-22,Commission,00.00,"3,11,901.51","9,35,704.54",
21-Jun-22,Debit Card,"95,892.00",00.00,"10,31,596.54",
21-Jun-22,Tax,00.00,"1,14,621.84","9,16,974.70",
21-Jun-22,Interest,01.00,00.00,"9,16,975.70",
21-Jun-22,Cheque,00.00,"91,697.57","8,25,278.13",
21-Jun-22,Debit Card,01.00,00.00,"8,25,279.13",
21-Jun-22,Cash,287,00.00,"8,25,566.13",
21-Jun-22,RTGS,"36,350.00",00.00,"8,61,916.13",
21-Jun-22,Reversal,00.40,00.00,"8,61,916.53",
21-Jun-22,RTGS,"1,177.00",00.00,"8,63,093.53",
21-Jun-22,Debit Card,00.00,"95,899.28","7,67,194.25",
21-Jun-22,Commission,00.00,"1,91,798.56","5,75,395.69",
21-Jun-22,Bill,00.00,"5,75,395.69",00.00,
21-Jun-22,RTGS,90.8,00.00,90.8,
21-Jun-22,Debit Card,00.00,45.4,45.4,
21-Jun-22,Interest,"2,46,720.40",00.00,"2,46,765.80",
21-Jun-22,Reversal,"1,811.32",00.00,"2,48,577.12",
21-Jun-22,Debit Card,02.26,00.00,"2,48,579.38",
21-Jun-22,Cash,30,00.00,"2,48,609.38",
21-Jun-22,Tax,00.00,"24,860.94","2,23,748.44",
21-Jun-22,IMPS,00.00,"44,749.69","1,78,998.75",
21-Jun-22,Tax,31.4,00.00,"1,79,030.15",
21-Jun-22,Reversal,00.00,"35,806.03","1,43,224.12",
21-Jun-22,Transfer,31,00.00,"1,43,255.12",
21-Jun-22,Bill,00.00,"47,751.71","95,503.41",
21-Jun-22,Transportellaneous,05.00,00.00,"95,508.41",
21-Jun-22,Cheque,"75,774.80",00.00,"1,71,283.21",
21-Jun-22,Purchase,"15,529.00",00.00,"1,86,812.21",
21-Jun-22,Tax,00.00,"23,351.53","1,63,460.68",
21-Jun-22,Debit Card,00.00,"1,63,460.68",00.00,
21-Jun-22,Interest,"14,78,473.80",00.00,"14,78,473.80",
21-Jun-22,Debit Card,00.00,"1,47,847.38","13,30,626.42",
21-Jun-22,ATM,00.00,"2,21,771.07","11,08,855.35",
21-Jun-22,Transfer,00.00,"1,10,885.54","9,97,969.82",
21-Jun-22,Cheque,73,00.00,"9,98,042.82",
21-Jun-22,Reversal,52.4,00.00,"9,98,095.22",
21-Jun-22,IMPS,"7,91,602.00",00.00,"17,89,697.22",
21-Jun-22,Bill,07.82,00.00,"17,89,705.04",
21-Jun-22,IMPS,00.00,"4,47,426.26","13,42,278.78",
21-Jun-22,Cheque,"19,90,470.00",00.00,"33,32,748.78",
21-Jun-22,Transfer,04.86,00.00,"33,32,753.64",
21-Jun-22,Tax,00.00,"3,70,305.96","29,62,447.68",
21-Jun-22,Purchase,425,00.00,"29,62,872.68",
21-Jun-22,NEFT,00.00,"29,62,872.68",00.00,
21-Jun-22,IMPS,"7,86,840.20",00.00,"7,86,840.20",
21-Jun-22,Debit Card,00.00,"98,355.03","6,88,485.18",
22-Jun-22,RTGS,13,00.00,"6,88,498.18",
22-Jun-22,Debit Card,05.60,00.00,"6,88,503.78",
22-Jun-22,Purchase,00.00,"76,500.42","6,12,003.36",
22-Jun-22,Bill,38,00.00,"6,12,041.36",
22-Jun-22,Interest,"16,277.14",00.00,"6,28,318.50",
22-Jun-22,Interest,"2,416.00",00.00,"6,30,734.50",
22-Jun-22,Reversal,06.60,00.00,"6,30,741.10",
22-Jun-22,Transportellaneous,00.00,"63,074.11","5,67,666.99",
22-Jun-22,Cheque,40.77,00.00,"5,67,707.76",
22-Jun-22,Transportellaneous,00.00,"1,41,926.94","4,25,780.82",
22-Jun-22,Bill,00.00,"2,12,890.41","2,12,890.41",
22-Jun-22,Bill,"1,456.30",00.00,"2,14,346.71",
22-Jun-22,RTGS,"29,360.23",00.00,"2,43,706.94",
22-Jun-22,IMPS,07.80,00.00,"2,43,714.74",
22-Jun-22,NEFT,"2,77,476.00",00.00,"5,21,190.74",
22-Jun-22,Cash,00.00,"74,455.82","4,46,734.92",
22-Jun-22,Cash,00.00,"1,48,911.64","2,97,823.28",
22-Jun-22,ATM,00.00,"2,97,823.28",00.00,
22-Jun-22,IMPS,23.99,00.00,23.99,
22-Jun-22,Commission,"22,641.00",00.00,"22,664.99",
22-Jun-22,Bill,00.00,"11,332.50","11,332.50",
22-Jun-22,Purchase,00.00,"11,332.50",00.00,
22-Jun-22,Cash,"19,19,178.25",00.00,"19,19,178.25",
22-Jun-22,Cash,00.00,"2,13,242.03","17,05,936.22",
22-Jun-22,Transfer,"1,20,551.80",00.00,"18,26,488.02",
22-Jun-22,Cheque,323,00.00,"18,26,811.02",
22-Jun-22,Transfer,57.79,00.00,"18,26,868.81",
22-Jun-22,Purchase,00.00,"3,65,373.76","14,61,495.05",
22-Jun-22,Debit Card,00.00,"4,87,165.02","9,74,330.03",
22-Jun-22,Transfer,108.9,00.00,"9,74,438.93",
22-Jun-22,Cheque,34.01,00.00,"9,74,472.94",
22-Jun-22,Commission,00.00,"9,74,472.94",00.00,
22-Jun-22,Bill,02.50,00.00,02.50,
22-Jun-22,Tax,00.00,00.31,02.19,
22-Jun-22,ATM,00.00,00.73,01.46,
22-Jun-22,Cash,33.7,00.00,35.16,
22-Jun-22,Bill,"2,551.69",00.00,"2,586.85",
22-Jun-22,Tax,623.59,00.00,"3,210.44",
22-Jun-22,Purchase,"23,688.00",00.00,"26,898.44",
22-Jun-22,Reversal,00.00,"2,689.84","24,208.60",
22-Jun-22,NEFT,"30,381.81",00.00,"54,590.41",
22-Jun-22,Tax,"17,509.15",00.00,"72,099.56",
22-Jun-22,Commission,00.00,"72,099.56",00.00,
22-Jun-22,IMPS,185.4,00.00,185.4,
22-Jun-22,Purchase,00.00,23.18,162.22,
22-Jun-22,Tax,00.50,00.00,162.72,
22-Jun-22,NEFT,00.00,54.24,108.48,
22-Jun-22,Cheque,24,00.00,132.48,
22-Jun-22,NEFT,"3,301.90",00.00,"3,434.38",
22-Jun-22,Commission,00.00,"3,434.38",00.00,
22-Jun-22,Reversal,"9,80,639.25",00.00,"9,80,639.25",
22-Jun-22,IMPS,00.00,"1,96,127.85","7,84,511.40",
22-Jun-22,Transportellaneous,37.3,00.00,"7,84,548.70",
22-Jun-22,RTGS,"20,693.00",00.00,"8,05,241.70",
22-Jun-22,Transportellaneous,00.00,"2,01,310.43","6,03,931.27",
22-Jun-22,ATM,00.00,"1,00,655.21","5,03,276.06",
22-Jun-22,Cheque,02.30,00.00,"5,03,278.36",
22-Jun-22,Debit Card,00.00,"50,327.84","4,52,950.52",
22-Jun-22,Bill,00.00,"64,707.22","3,88,243.30",
22-Jun-22,Commission,"2,396.20",00.00,"3,90,639.50",
22-Jun-22,Commission,00.00,"3,90,639.50",00.00,
22-Jun-22,Tax,484,00.00,484,
22-Jun-22,RTGS,00.00,53.78,430.22,
22-Jun-22,ATM,00.00,47.8,382.42,
22-Jun-22,Cash,00.00,191.21,191.21,
22-Jun-22,Transportellaneous,51.6,00.00,242.81,
22-Jun-22,Interest,00.00,80.94,161.87,
22-Jun-22,IMPS,"16,94,485.00",00.00,"16,94,646.87",
22-Jun-22,Bill,"1,56,719.10",00.00,"18,51,365.97",
22-Jun-22,NEFT,188,00.00,"18,51,553.97",
22-Jun-22,Cheque,"29,002.72",00.00,"18,80,556.69",
22-Jun-22,NEFT,00.00,"18,80,556.69",00.00,
22-Jun-22,IMPS,"2,937.27",00.00,"2,937.27",
22-Jun-22,Commission,"2,790.32",00.00,"5,727.59",
22-Jun-22,Transfer,00.00,636.4,"5,091.19",
22-Jun-22,Commission,03.30,00.00,"5,094.49",
22-Jun-22,Transfer,00.00,636.81,"4,457.68",
22-Jun-22,IMPS,32,00.00,"4,489.68",
22-Jun-22,NEFT,56,00.00,"4,545.68",
22-Jun-22,Reversal,08.00,00.00,"4,553.68",
22-Jun-22,Debit Card,00.00,"2,276.84","2,276.84",
22-Jun-22,RTGS,00.00,284.61,"1,992.24",
22-Jun-22,Purchase,00.00,284.61,"1,707.63",
22-Jun-22,NEFT,00.00,170.76,"1,536.87",
22-Jun-22,Commission,02.00,00.00,"1,538.87",
22-Jun-22,Cash,00.00,512.96,"1,025.91",
22-Jun-22,Tax,"1,11,935.30",00.00,"1,12,961.21",
22-Jun-22,Reversal,"2,17,673.50",00.00,"3,30,634.71",
22-Jun-22,NEFT,422.3,00.00,"3,31,057.01",
22-Jun-22,Cheque,"20,085.20",00.00,"3,51,142.21",
22-Jun-22,Bill,00.00,"43,892.78","3,07,249.43",
22-Jun-22,ATM,"3,95,831.00",00.00,"7,03,080.43",
22-Jun-22,ATM,02.40,00.00,"7,03,082.83",
22-Jun-22,Transfer,37,00.00,"7,03,119.83",
22-Jun-22,NEFT,00.00,"1,40,623.97","5,62,495.86",
22-Jun-22,Cheque,00.00,"56,249.59","5,06,246.27",
22-Jun-22,Purchase,"11,22,845.80",00.00,"16,29,092.07",
22-Jun-22,Commission,00.00,"1,81,010.23","14,48,081.84",
23-Jun-22,Commission,"14,43,075.00",00.00,"28,91,156.84",
23-Jun-22,Cheque,"51,421.62",00.00,"29,42,578.46",
23-Jun-22,Bill,00.00,"14,71,289.23","14,71,289.23",
23-Jun-22,ATM,"32,335.00",00.00,"15,03,624.23",
23-Jun-22,NEFT,"2,221.10",00.00,"15,05,845.33",
23-Jun-22,Commission,689.86,00.00,"15,06,535.19",
23-Jun-22,Transportellaneous,102.1,00.00,"15,06,637.29",
23-Jun-22,ATM,04.60,00.00,"15,06,641.89",
23-Jun-22,Transportellaneous,00.00,"5,02,213.96","10,04,427.93",
23-Jun-22,Commission,00.00,"3,34,809.31","6,69,618.62",
23-Jun-22,Bill,00.00,"1,33,923.72","5,35,694.90",
23-Jun-22,Cheque,00.00,"5,35,694.90",00.00,
23-Jun-22,Debit Card,344.7,00.00,344.7,
23-Jun-22,Bill,00.00,114.9,229.8,
23-Jun-22,Interest,66,00.00,295.8,
23-Jun-22,Debit Card,59,00.00,354.8,
23-Jun-22,Cheque,00.00,59.13,295.67,
23-Jun-22,RTGS,"3,745.92",00.00,"4,041.59",
23-Jun-22,Cheque,"19,22,972.75",00.00,"19,27,014.34",
23-Jun-22,Cheque,00.00,"3,21,169.06","16,05,845.28",
23-Jun-22,RTGS,07.00,00.00,"16,05,852.28",
23-Jun-22,Cheque,"1,13,124.00",00.00,"17,18,976.28",
23-Jun-22,Cash,"14,240.70",00.00,"17,33,216.98",
23-Jun-22,Bill,"13,490.59",00.00,"17,46,707.57",
23-Jun-22,Bill,00.00,"2,18,338.45","15,28,369.12",
23-Jun-22,RTGS,"20,16,271.00",00.00,"35,44,640.12",
23-Jun-22,ATM,00.00,"5,06,377.16","30,38,262.96",
23-Jun-22,Reversal,"14,31,264.00",00.00,"44,69,526.96",
23-Jun-22,IMPS,00.00,"6,38,503.85","38,31,023.11",
23-Jun-22,ATM,"2,33,114.00",00.00,"40,64,137.11",
23-Jun-22,Commission,78.95,00.00,"40,64,216.06",
23-Jun-22,Reversal,00.00,"5,08,027.01","35,56,189.05",
23-Jun-22,Cheque,00.00,"8,89,047.26","26,67,141.79",
23-Jun-22,Cash,00.00,"5,33,428.36","21,33,713.43",
23-Jun-22,NEFT,00.00,"21,33,713.43",00.00,
23-Jun-22,IMPS,388.6,00.00,388.6,
23-Jun-22,Reversal,01.30,00.00,389.9,
23-Jun-22,IMPS,00.00,38.99,350.91,
23-Jun-22,Commission,01.00,00.00,351.91,
23-Jun-22,Bill,00.00,35.19,316.72,
23-Jun-22,IMPS,06.00,00.00,322.72,
23-Jun-22,Cheque,00.00,46.1,276.62,
23-Jun-22,Cheque,00.00,39.52,237.1,
23-Jun-22,Tax,03.10,00.00,240.2,
23-Jun-22,Purchase,00.00,48.04,192.16,
23-Jun-22,Reversal,00.00,19.22,172.94,
23-Jun-22,Commission,"1,42,488.22",00.00,"1,42,661.16",
23-Jun-22,Cash,02.00,00.00,"1,42,663.16",
23-Jun-22,IMPS,00.00,"1,42,663.16",00.00,
23-Jun-22,Tax,485.8,00.00,485.8,
23-Jun-22,Cash,"9,655.00",00.00,"10,140.80",
23-Jun-22,NEFT,00.00,"2,028.16","8,112.64",
23-Jun-22,Transfer,04.20,00.00,"8,116.84",
24-Jun-22,Purchase,00.00,"4,058.42","4,058.42",
24-Jun-22,NEFT,00.00,450.94,"3,607.48",
24-Jun-22,RTGS,00.00,"3,607.48",00.00,
24-Jun-22,Purchase,"1,965.78",00.00,"1,965.78",
24-Jun-22,RTGS,00.00,280.83,"1,684.95",
24-Jun-22,Cash,00.00,168.5,"1,516.46",
24-Jun-22,Reversal,511.7,00.00,"2,028.16",
24-Jun-22,NEFT,00.00,"1,014.08","1,014.08",
24-Jun-22,IMPS,00.00,101.41,912.67,
24-Jun-22,Reversal,398,00.00,"1,310.67",
24-Jun-22,Cheque,"6,840.30",00.00,"8,150.97",
24-Jun-22,RTGS,00.00,905.66,"7,245.31",
24-Jun-22,Cheque,149,00.00,"7,394.31",
24-Jun-22,RTGS,00.00,"3,697.16","3,697.16",
24-Jun-22,NEFT,00.00,739.43,"2,957.73",
24-Jun-22,Purchase,"2,026.20",00.00,"4,983.93",
24-Jun-22,Purchase,106.84,00.00,"5,090.77",
24-Jun-22,Commission,123.49,00.00,"5,214.26",
24-Jun-22,Tax,00.00,744.89,"4,469.37",
24-Jun-22,Transportellaneous,"4,067.70",00.00,"8,537.07",
24-Jun-22,Cash,"10,743.00",00.00,"19,280.07",
24-Jun-22,ATM,00.00,"6,426.69","12,853.38",
24-Jun-22,Commission,00.00,"3,213.35","9,640.04",
24-Jun-22,NEFT,"3,716.43",00.00,"13,356.47",
24-Jun-22,Purchase,"22,735.50",00.00,"36,091.97",
24-Jun-22,Debit Card,"14,775.00",00.00,"50,866.97",
24-Jun-22,Debit Card,00.00,"10,173.39","40,693.58",
24-Jun-22,Transfer,00.00,"4,521.51","36,172.07",
24-Jun-22,Purchase,00.00,"9,043.02","27,129.05",
24-Jun-22,Purchase,"3,06,125.00",00.00,"3,33,254.05",
24-Jun-22,Interest,00.00,"55,542.34","2,77,711.71",
24-Jun-22,Cheque,00.00,"2,77,711.71",00.00,
24-Jun-22,Debit Card,"2,496.40",00.00,"2,496.40",
24-Jun-22,Purchase,00.00,277.38,"2,219.02",
24-Jun-22,RTGS,"7,87,285.50",00.00,"7,89,504.52",
24-Jun-22,Cheque,370,00.00,"7,89,874.52",
24-Jun-22,Commission,00.00,"7,89,874.52",00.00,
24-Jun-22,Bill,61.32,00.00,61.32,
24-Jun-22,Commission,00.00,20.44,40.88,
24-Jun-22,Transportellaneous,"25,157.00",00.00,"25,197.88",
24-Jun-22,NEFT,00.00,"6,299.47","18,898.41",
24-Jun-22,Bill,00.00,"9,449.21","9,449.20",
24-Jun-22,Transfer,00.00,944.92,"8,504.28",
24-Jun-22,Bill,00.00,"4,252.14","4,252.14",
25-Jun-22,Reversal,"16,362.00",00.00,"20,614.14",
25-Jun-22,Commission,00.00,"2,061.41","18,552.73",
25-Jun-22,Transportellaneous,390.9,00.00,"18,943.63",
25-Jun-22,Debit Card,00.00,"6,314.54","12,629.09",
25-Jun-22,Debit Card,00.00,"1,804.16","10,824.93",
25-Jun-22,Purchase,02.00,00.00,"10,826.93",
25-Jun-22,NEFT,"5,02,273.50",00.00,"5,13,100.43",
25-Jun-22,RTGS,"24,947.80",00.00,"5,38,048.23",
25-Jun-22,RTGS,00.00,"5,38,048.23",00.00,
25-Jun-22,Interest,"16,70,302.75",00.00,"16,70,302.75",
25-Jun-22,NEFT,"13,52,892.50",00.00,"30,23,195.25",
25-Jun-22,Transfer,"17,53,972.00",00.00,"47,77,167.25",
25-Jun-22,IMPS,"7,73,814.00",00.00,"55,50,981.25",
25-Jun-22,RTGS,"15,996.00",00.00,"55,66,977.25",
25-Jun-22,Cheque,00.00,"11,13,395.45","44,53,581.80",
25-Jun-22,Commission,"2,898.00",00.00,"44,56,479.80",
25-Jun-22,Reversal,00.00,"14,85,493.27","29,70,986.53",
25-Jun-22,NEFT,00.00,"9,90,328.84","19,80,657.69",
25-Jun-22,ATM,400.6,00.00,"19,81,058.29",
26-Jun-22,IMPS,"51,595.28",00.00,"20,32,653.57",
27-Jun-22,RTGS,00.00,"2,90,379.08","17,42,274.49",
27-Jun-22,Transportellaneous,00.00,"8,71,137.25","8,71,137.24",
27-Jun-22,IMPS,00.00,"8,71,137.24",00.00,
27-Jun-22,Reversal,"6,683.00",00.00,"6,683.00",
27-Jun-22,IMPS,00.00,835.38,"5,847.62",
27-Jun-22,Bill,169.6,00.00,"6,017.22",
27-Jun-22,RTGS,"73,597.00",00.00,"79,614.22",
27-Jun-22,Cheque,00.00,"26,538.07","53,076.15",
27-Jun-22,Bill,01.52,00.00,"53,077.67",
27-Jun-22,Interest,163.25,00.00,"53,240.92",
27-Jun-22,Purchase,06.20,00.00,"53,247.12",
27-Jun-22,NEFT,"24,974.00",00.00,"78,221.12",
27-Jun-22,RTGS,52,00.00,"78,273.12",
27-Jun-22,Debit Card,"1,850.00",00.00,"80,123.12",
27-Jun-22,Transportellaneous,253.83,00.00,"80,376.95",
27-Jun-22,IMPS,00.20,00.00,"80,377.15",
27-Jun-22,Transfer,00.40,00.00,"80,377.55",
27-Jun-22,Commission,"13,760.47",00.00,"94,138.02",
27-Jun-22,Cheque,04.97,00.00,"94,142.99",
27-Jun-22,Commission,00.00,"47,071.50","47,071.50",
27-Jun-22,Debit Card,00.00,"7,845.25","39,226.25",
28-Jun-22,Cash,"5,122.86",00.00,"44,349.11",
28-Jun-22,Commission,00.00,"44,349.11",00.00,
28-Jun-22,Bill,62.3,00.00,62.3,
28-Jun-22,Transfer,00.00,08.90,53.4,
28-Jun-22,Purchase,"1,06,241.22",00.00,"1,06,294.62",
28-Jun-22,Reversal,00.00,"11,810.51","94,484.11",
28-Jun-22,Purchase,185,00.00,"94,669.11",
28-Jun-22,Cash,"12,99,257.00",00.00,"13,93,926.11",
28-Jun-22,Cash,"70,655.60",00.00,"14,64,581.71",
28-Jun-22,RTGS,00.00,"1,83,072.71","12,81,509.00",
28-Jun-22,Tax,48,00.00,"12,81,557.00",
28-Jun-22,Cash,00.00,"12,81,557.00",00.00,
28-Jun-22,NEFT,"1,43,506.00",00.00,"1,43,506.00",
28-Jun-22,Commission,"3,389.01",00.00,"1,46,895.01",
28-Jun-22,Reversal,345.52,00.00,"1,47,240.53",
28-Jun-22,Interest,00.00,"18,405.07","1,28,835.46",
28-Jun-22,Debit Card,00.00,"14,315.05","1,14,520.41",
28-Jun-22,Bill,381.52,00.00,"1,14,901.93",
28-Jun-22,IMPS,00.00,"38,300.64","76,601.29",
28-Jun-22,NEFT,44,00.00,"76,645.29",
28-Jun-22,Transportellaneous,01.43,00.00,"76,646.72",
28-Jun-22,IMPS,"8,32,027.50",00.00,"9,08,674.22",
28-Jun-22,NEFT,00.00,"1,51,445.70","7,57,228.52",
28-Jun-22,Tax,00.00,"75,722.85","6,81,505.67",
28-Jun-22,Debit Card,"70,337.09",00.00,"7,51,842.76",
29-Jun-22,Debit Card,00.00,"1,87,960.69","5,63,882.07",
29-Jun-22,Transportellaneous,275.9,00.00,"5,64,157.97",
29-Jun-22,Interest,"38,142.00",00.00,"6,02,299.97",
29-Jun-22,Cash,126.32,00.00,"6,02,426.29",
29-Jun-22,Reversal,"16,418.80",00.00,"6,18,845.09",
29-Jun-22,Bill,07.13,00.00,"6,18,852.22",
29-Jun-22,Transfer,00.00,"88,407.46","5,30,444.76",
29-Jun-22,Transfer,00.42,00.00,"5,30,445.18",
29-Jun-22,ATM,00.00,"1,76,815.06","3,53,630.12",
29-Jun-22,Commission,35,00.00,"3,53,665.12",
29-Jun-22,NEFT,"1,566.20",00.00,"3,55,231.32",
29-Jun-22,Cheque,00.00,"35,523.13","3,19,708.19",
29-Jun-22,IMPS,03.00,00.00,"3,19,711.19",
29-Jun-22,Transportellaneous,00.00,"53,285.20","2,66,425.99",
29-Jun-22,Transportellaneous,00.00,"88,808.66","1,77,617.33",
29-Jun-22,Purchase,00.00,"1,77,617.33",00.00,
29-Jun-22,ATM,123.36,00.00,123.36,
29-Jun-22,Interest,04.00,00.00,127.36,
29-Jun-22,Tax,00.00,21.23,106.13,
29-Jun-22,IMPS,48,00.00,154.13,
29-Jun-22,Tax,00.00,30.83,123.3,
29-Jun-22,Tax,00.00,13.7,109.6,
30-Jun-22,Commission,00.00,15.66,93.94,
30-Jun-22,Transportellaneous,02.49,00.00,96.43,
30-Jun-22,Reversal,"13,938.40",00.00,"14,034.83",
30-Jun-22,Bill,05.00,00.00,"14,039.83",
01-Jul-22,Reversal,57.55,00.00,"14,097.38",
01-Jul-22,Transfer,00.00,"3,524.35","10,573.04",
01-Jul-22,ATM,00.00,"1,762.17","8,810.87",
01-Jul-22,NEFT,"94,290.40",00.00,"1,03,101.27",
01-Jul-22,ATM,00.00,"12,887.66","90,213.61",
01-Jul-22,Bill,"48,132.10",00.00,"1,38,345.71",
01-Jul-22,Debit Card,"44,606.00",00.00,"1,82,951.71",
02-Jul-22,Tax,04.80,00.00,"1,82,956.51",
02-Jul-22,Debit Card,00.00,"26,136.64","1,56,819.87",
02-Jul-22,Cheque,"20,752.80",00.00,"1,77,572.67",
02-Jul-22,Cash,"2,570.02",00.00,"1,80,142.69",
02-Jul-22,Bill,00.00,"22,517.84","1,57,624.85",
02-Jul-22,Transportellaneous,00.00,"15,762.49","1,41,862.36",
02-Jul-22,ATM,00.00,"47,287.45","94,574.91",
02-Jul-22,Debit Card,05.20,00.00,"94,580.11",
02-Jul-22,NEFT,"2,28,455.50",00.00,"3,23,035.61",
02-Jul-22,Transportellaneous,00.00,"1,07,678.54","2,15,357.07",
02-Jul-22,Reversal,00.00,"23,928.56","1,91,428.51",
02-Jul-22,ATM,"18,11,232.00",00.00,"20,02,660.51",
02-Jul-22,Interest,297.7,00.00,"20,02,958.21",
02-Jul-22,ATM,00.00,"2,22,550.91","17,80,407.30",
02-Jul-22,Purchase,00.00,"5,93,469.10","11,86,938.20",
02-Jul-22,ATM,"3,331.00",00.00,"11,90,269.20",
02-Jul-22,NEFT,26.63,00.00,"11,90,295.83",
02-Jul-22,Transfer,"28,432.81",00.00,"12,18,728.64",
02-Jul-22,Commission,04.07,00.00,"12,18,732.71",
02-Jul-22,Bill,00.00,"1,52,341.59","10,66,391.12",
02-Jul-22,Cheque,00.00,"1,77,731.85","8,88,659.27",
03-Jul-22,NEFT,"38,115.88",00.00,"9,26,775.15",
03-Jul-22,Commission,00.00,"1,85,355.03","7,41,420.12",
03-Jul-22,Debit Card,00.00,"7,41,420.12",00.00,
04-Jul-22,Purchase,01.50,00.00,01.50,
04-Jul-22,NEFT,26,00.00,27.5,
05-Jul-22,Tax,"4,60,230.00",00.00,"4,60,257.50",
05-Jul-22,Commission,00.00,"4,60,257.50",00.00,
05-Jul-22,Cheque,"3,271.08",00.00,"3,271.08",
05-Jul-22,Commission,57,00.00,"3,328.08",
05-Jul-22,IMPS,61,00.00,"3,389.08",
05-Jul-22,Commission,00.00,484.15,"2,904.93",
05-Jul-22,ATM,00.00,290.49,"2,614.44",
05-Jul-22,Transfer,"1,792.81",00.00,"4,407.25",
05-Jul-22,Purchase,00.00,440.73,"3,966.52",
05-Jul-22,RTGS,00.00,495.82,"3,470.70",
05-Jul-22,Bill,00.00,694.14,"2,776.56",
05-Jul-22,Tax,"1,633.50",00.00,"4,410.06",
05-Jul-22,Commission,00.00,882.01,"3,528.05",
05-Jul-22,Cash,15.4,00.00,"3,543.45",
05-Jul-22,Reversal,00.00,"1,771.73","1,771.72",
05-Jul-22,Interest,00.00,177.17,"1,594.55",
05-Jul-22,Bill,00.00,159.46,"1,435.10",
05-Jul-22,NEFT,00.33,00.00,"1,435.43",
05-Jul-22,Interest,00.00,205.06,"1,230.37",
06-Jul-22,Reversal,00.00,410.12,820.25,
06-Jul-22,Debit Card,00.00,102.53,717.72,
06-Jul-22,NEFT,"2,13,070.31",00.00,"2,13,788.03",
06-Jul-22,Cheque,"77,271.28",00.00,"2,91,059.31",
06-Jul-22,Cheque,00.00,"36,382.41","2,54,676.90",
06-Jul-22,RTGS,00.00,"42,446.15","2,12,230.75",
06-Jul-22,Cash,27,00.00,"2,12,257.75",
06-Jul-22,Commission,00.00,"35,376.29","1,76,881.46",
06-Jul-22,Transportellaneous,00.00,"88,440.73","88,440.73",
06-Jul-22,IMPS,"30,632.00",00.00,"1,19,072.73",
06-Jul-22,Debit Card,"9,08,616.50",00.00,"10,27,689.23",
06-Jul-22,Reversal,00.00,"3,42,563.08","6,85,126.15",
06-Jul-22,Debit Card,"5,28,002.00",00.00,"12,13,128.15",
06-Jul-22,Interest,00.00,"1,73,304.02","10,39,824.13",
06-Jul-22,Transfer,00.00,"1,48,546.30","8,91,277.83",
06-Jul-22,IMPS,00.00,"1,27,325.40","7,63,952.43",
06-Jul-22,NEFT,546.8,00.00,"7,64,499.23",
06-Jul-22,Transfer,00.00,"1,91,124.81","5,73,374.42",
06-Jul-22,Reversal,00.00,"1,14,674.88","4,58,699.54",
06-Jul-22,RTGS,"70,145.00",00.00,"5,28,844.54",
06-Jul-22,Cheque,"2,81,208.00",00.00,"8,10,052.54",
06-Jul-22,Purchase,"20,62,947.75",00.00,"28,73,000.29",
06-Jul-22,Tax,"13,03,226.00",00.00,"41,76,226.29",
06-Jul-22,NEFT,52.3,00.00,"41,76,278.59",
06-Jul-22,Reversal,"1,55,932.00",00.00,"43,32,210.59",
06-Jul-22,Purchase,00.00,"8,66,442.12","34,65,768.47",
06-Jul-22,Interest,03.90,00.00,"34,65,772.37",
06-Jul-22,ATM,05.00,00.00,"34,65,777.37",
06-Jul-22,IMPS,00.00,"8,66,444.34","25,99,333.03",
07-Jul-22,Debit Card,"2,28,749.00",00.00,"28,28,082.03",
07-Jul-22,NEFT,"2,674.90",00.00,"28,30,756.93",
07-Jul-22,Bill,00.00,"2,83,075.69","25,47,681.24",
07-Jul-22,Commission,00.00,"25,47,681.24",00.00,
07-Jul-22,Transfer,"52,491.59",00.00,"52,491.59",
07-Jul-22,Cheque,200,00.00,"52,691.59",
07-Jul-22,Transportellaneous,00.00,"5,269.16","47,422.43",
07-Jul-22,Interest,07.60,00.00,"47,430.03",
07-Jul-22,Transfer,"3,024.00",00.00,"50,454.03",
07-Jul-22,Interest,100,00.00,"50,554.03",
07-Jul-22,Bill,00.00,"10,110.81","40,443.22",
07-Jul-22,RTGS,"4,71,759.00",00.00,"5,12,202.22",
07-Jul-22,RTGS,00.00,"73,171.75","4,39,030.47",
07-Jul-22,Purchase,00.00,"1,46,343.49","2,92,686.98",
07-Jul-22,RTGS,00.00,"1,46,343.49","1,46,343.49",
07-Jul-22,NEFT,00.00,"29,268.70","1,17,074.79",
07-Jul-22,Transportellaneous,00.00,"39,024.93","78,049.86",
07-Jul-22,RTGS,502,00.00,"78,551.86",
07-Jul-22,Transfer,00.00,"9,818.98","68,732.88",
07-Jul-22,IMPS,00.00,"22,910.96","45,821.92",
07-Jul-22,IMPS,00.00,"45,821.92",00.00,
07-Jul-22,Cheque,233.8,00.00,233.8,
07-Jul-22,Cheque,"1,576.00",00.00,"1,809.80",
07-Jul-22,Cheque,34,00.00,"1,843.80",
07-Jul-22,Reversal,229.1,00.00,"2,072.90",
08-Jul-22,Transportellaneous,07.91,00.00,"2,080.81",
08-Jul-22,RTGS,00.00,346.8,"1,734.01",
08-Jul-22,Cash,"10,970.90",00.00,"12,704.91",
08-Jul-22,ATM,"20,92,334.80",00.00,"21,05,039.71",
08-Jul-22,Reversal,00.00,"3,50,839.95","17,54,199.76",
08-Jul-22,ATM,00.00,"17,54,199.76",00.00,
08-Jul-22,Tax,00.50,00.00,00.50,
08-Jul-22,Debit Card,224.8,00.00,225.3,
09-Jul-22,Transportellaneous,00.00,45.06,180.24,
09-Jul-22,Debit Card,57.8,00.00,238.04,
09-Jul-22,Interest,"2,729.77",00.00,"2,967.81",
09-Jul-22,Transfer,"1,503.00",00.00,"4,470.81",
09-Jul-22,IMPS,00.00,894.16,"3,576.65",
09-Jul-22,RTGS,"15,03,210.20",00.00,"15,06,786.85",
09-Jul-22,Interest,00.00,"5,02,262.28","10,04,524.57",
09-Jul-22,NEFT,360.75,00.00,"10,04,885.32",
09-Jul-22,Purchase,00.00,"1,11,653.92","8,93,231.40",
09-Jul-22,IMPS,00.00,"4,46,615.70","4,46,615.70",
09-Jul-22,Bill,17.16,00.00,"4,46,632.86",
09-Jul-22,Reversal,00.00,"1,48,877.62","2,97,755.24",
09-Jul-22,Debit Card,"1,247.00",00.00,"2,99,002.24",
09-Jul-22,Transfer,"7,04,336.20",00.00,"10,03,338.44",
09-Jul-22,IMPS,"1,15,846.25",00.00,"11,19,184.69",
09-Jul-22,Transportellaneous,"2,47,201.72",00.00,"13,66,386.41",
09-Jul-22,Transfer,00.00,"1,36,638.64","12,29,747.77",
10-Jul-22,Bill,05.00,00.00,"12,29,752.77",
10-Jul-22,Interest,"19,55,165.00",00.00,"31,84,917.77",
10-Jul-22,Debit Card,00.00,"3,53,879.75","28,31,038.02",
10-Jul-22,ATM,23,00.00,"28,31,061.02",
10-Jul-22,Commission,741,00.00,"28,31,802.02",
10-Jul-22,Interest,00.00,"7,07,950.51","21,23,851.52",
10-Jul-22,ATM,424.3,00.00,"21,24,275.82",
10-Jul-22,Reversal,00.00,"3,03,467.97","18,20,807.85",
10-Jul-22,Reversal,"1,386.00",00.00,"18,22,193.85",
10-Jul-22,Transportellaneous,00.00,"4,55,548.46","13,66,645.39",
10-Jul-22,Purchase,"2,16,105.00",00.00,"15,82,750.39",
10-Jul-22,Tax,00.00,"5,27,583.46","10,55,166.93",
10-Jul-22,RTGS,01.00,00.00,"10,55,167.93",
10-Jul-22,NEFT,00.00,"1,05,516.79","9,49,651.14",
10-Jul-22,Cash,00.00,"2,37,412.79","7,12,238.36",
10-Jul-22,Transfer,01.00,00.00,"7,12,239.36",
10-Jul-22,Cheque,07.50,00.00,"7,12,246.86",
10-Jul-22,IMPS,"31,561.10",00.00,"7,43,807.96",
10-Jul-22,Reversal,00.00,"7,43,807.96",00.00,
10-Jul-22,Transportellaneous,"28,933.90",00.00,"28,933.90",
10-Jul-22,Bill,00.00,"7,233.48","21,700.43",
10-Jul-22,Commission,02.60,00.00,"21,703.03",
10-Jul-22,Transportellaneous,"7,804.50",00.00,"29,507.53",
10-Jul-22,Cash,463.04,00.00,"29,970.57",
10-Jul-22,Bill,00.00,"9,990.19","19,980.38",
10-Jul-22,ATM,00.00,"1,998.04","17,982.34",
10-Jul-22,NEFT,"1,861.00",00.00,"19,843.34",
10-Jul-22,Interest,"6,58,000.50",00.00,"6,77,843.84",
10-Jul-22,ATM,"19,863.60",00.00,"6,97,707.44",
10-Jul-22,ATM,00.00,"69,770.74","6,27,936.70",
10-Jul-22,Bill,"11,816.59",00.00,"6,39,753.29",
10-Jul-22,NEFT,01.00,00.00,"6,39,754.29",
10-Jul-22,Cheque,"1,318.00",00.00,"6,41,072.29",
10-Jul-22,NEFT,"32,484.80",00.00,"6,73,557.09",
10-Jul-22,ATM,00.00,"1,34,711.42","5,38,845.67",
10-Jul-22,Transportellaneous,00.00,"53,884.57","4,84,961.10",
10-Jul-22,Cash,"19,52,206.00",00.00,"24,37,167.10",
10-Jul-22,Commission,03.40,00.00,"24,37,170.50",
10-Jul-22,Cash,00.00,"3,04,646.31","21,32,524.19",
10-Jul-22,IMPS,00.00,"7,10,841.40","14,21,682.79",
10-Jul-22,ATM,00.00,"14,21,682.79",00.00,
10-Jul-22,NEFT,"1,17,069.40",00.00,"1,17,069.40",
10-Jul-22,ATM,"1,80,140.00",00.00,"2,97,209.40",
10-Jul-22,Interest,"6,08,124.50",00.00,"9,05,333.90",
10-Jul-22,Interest,"15,87,252.00",00.00,"24,92,585.90",
10-Jul-22,Cheque,00.00,"3,11,573.24","21,81,012.66",
10-Jul-22,Bill,"1,21,078.00",00.00,"23,02,090.66",
10-Jul-22,NEFT,"2,443.00",00.00,"23,04,533.66",
10-Jul-22,ATM,00.00,"5,76,133.42","17,28,400.24",
10-Jul-22,Cash,455,00.00,"17,28,855.24",
10-Jul-22,NEFT,56,00.00,"17,28,911.24",
10-Jul-22,Purchase,00.00,"5,76,303.75","11,52,607.49",
10-Jul-22,Transportellaneous,"23,620.00",00.00,"11,76,227.49",
10-Jul-22,Tax,03.80,00.00,"11,76,231.29",
10-Jul-22,Interest,05.70,00.00,"11,76,236.99",
11-Jul-22,Cheque,00.00,"1,47,029.62","10,29,207.37",
11-Jul-22,NEFT,"1,75,727.70",00.00,"12,04,935.07",
11-Jul-22,Transportellaneous,00.00,"6,02,467.54","6,02,467.54",
12-Jul-22,Cash,00.00,"3,01,233.77","3,01,233.77",
12-Jul-22,Transfer,159.3,00.00,"3,01,393.07",
13-Jul-22,Commission,"23,250.00",00.00,"3,24,643.07",
13-Jul-22,Bill,05.50,00.00,"3,24,648.57",
13-Jul-22,Bill,00.00,"1,08,216.19","2,16,432.38",
13-Jul-22,Debit Card,00.00,"43,286.48","1,73,145.90",
13-Jul-22,Transfer,00.00,"43,286.48","1,29,859.42",
13-Jul-22,Bill,00.00,"64,929.71","64,929.71",
13-Jul-22,Debit Card,47.79,00.00,"64,977.50",
13-Jul-22,Cheque,07.00,00.00,"64,984.50",
13-Jul-22,Tax,00.00,"7,220.50","57,764.00",
13-Jul-22,Debit Card,00.00,"11,552.80","46,211.20",
13-Jul-22,Debit Card,"32,539.06",00.00,"78,750.26",
13-Jul-22,Transfer,"12,04,249.50",00.00,"12,82,999.76",
13-Jul-22,IMPS,"1,300.00",00.00,"12,84,299.76",
13-Jul-22,Debit Card,00.00,"3,21,074.94","9,63,224.82",
13-Jul-22,Cheque,02.69,00.00,"9,63,227.51",
13-Jul-22,Reversal,25.9,00.00,"9,63,253.41",
13-Jul-22,Transportellaneous,"18,283.20",00.00,"9,81,536.61",
13-Jul-22,Tax,580.2,00.00,"9,82,116.81",
13-Jul-22,Bill,214,00.00,"9,82,330.81",
13-Jul-22,Cash,28.59,00.00,"9,82,359.40",
13-Jul-22,ATM,00.00,"1,96,471.88","7,85,887.52",
14-Jul-22,Tax,08.89,00.00,"7,85,896.41",
14-Jul-22,Transfer,00.00,"98,237.05","6,87,659.36",
14-Jul-22,Reversal,"1,999.00",00.00,"6,89,658.36",
14-Jul-22,NEFT,00.00,"1,37,931.67","5,51,726.69",
14-Jul-22,Cheque,00.00,"5,51,726.69",00.00,
14-Jul-22,Purchase,"1,962.00",00.00,"1,962.00",
14-Jul-22,Cash,00.00,327,"1,635.00",
14-Jul-22,Transfer,03.54,00.00,"1,638.54",
14-Jul-22,Bill,00.00,327.71,"1,310.83",
14-Jul-22,Debit Card,00.00,131.08,"1,179.75",
14-Jul-22,Tax,"60,256.06",00.00,"61,435.81",
14-Jul-22,Tax,00.00,"15,358.95","46,076.86",
14-Jul-22,ATM,"1,17,271.25",00.00,"1,63,348.11",
14-Jul-22,Interest,00.00,"32,669.62","1,30,678.49",
14-Jul-22,IMPS,"1,36,091.40",00.00,"2,66,769.89",
14-Jul-22,NEFT,"21,102.93",00.00,"2,87,872.82",
14-Jul-22,RTGS,732,00.00,"2,88,604.82",
14-Jul-22,Reversal,"11,547.10",00.00,"3,00,151.92",
14-Jul-22,NEFT,"32,281.00",00.00,"3,32,432.92",
14-Jul-22,NEFT,00.00,"55,405.49","2,77,027.43",
14-Jul-22,IMPS,"2,49,520.00",00.00,"5,26,547.43",
14-Jul-22,Debit Card,05.80,00.00,"5,26,553.23",
14-Jul-22,Tax,00.00,"1,05,310.65","4,21,242.58",
14-Jul-22,Reversal,07.83,00.00,"4,21,250.41",
14-Jul-22,NEFT,00.00,"52,656.30","3,68,594.11",
14-Jul-22,Commission,00.00,"61,432.35","3,07,161.76",
14-Jul-22,Commission,03.00,00.00,"3,07,164.76",
14-Jul-22,Bill,20.29,00.00,"3,07,185.05",
14-Jul-22,Transportellaneous,07.55,00.00,"3,07,192.60",
14-Jul-22,Cheque,16.9,00.00,"3,07,209.50",
14-Jul-22,ATM,00.00,"61,441.90","2,45,767.60",
14-Jul-22,Reversal,00.00,"2,45,767.60",00.00,
15-Jul-22,Transportellaneous,"1,62,618.00",00.00,"1,62,618.00",
15-Jul-22,Commission,02.00,00.00,"1,62,620.00",
15-Jul-22,Interest,00.00,"54,206.67","1,08,413.33",
16-Jul-22,IMPS,"80,457.30",00.00,"1,88,870.63",
16-Jul-22,Commission,45.9,00.00,"1,88,916.53",
16-Jul-22,Transfer,05.90,00.00,"1,88,922.43",
16-Jul-22,Cheque,00.00,"94,461.22","94,461.22",
16-Jul-22,Bill,00.00,"47,230.61","47,230.61",
16-Jul-22,Reversal,"1,65,248.88",00.00,"2,12,479.49",
16-Jul-22,Cheque,00.00,"30,354.21","1,82,125.28",
16-Jul-22,Bill,"1,66,891.06",00.00,"3,49,016.34",
16-Jul-22,Cash,"1,700.84",00.00,"3,50,717.18",
16-Jul-22,Commission,00.00,"35,071.72","3,15,645.46",
16-Jul-22,Tax,00.00,"45,092.21","2,70,553.25",
16-Jul-22,Purchase,01.40,00.00,"2,70,554.65",
16-Jul-22,Bill,00.00,"30,061.63","2,40,493.02",
16-Jul-22,Interest,00.00,"26,721.45","2,13,771.57",
16-Jul-22,Transfer,"1,860.00",00.00,"2,15,631.57",
16-Jul-22,RTGS,00.00,"2,15,631.57",00.00,
16-Jul-22,Cheque,"16,33,174.20",00.00,"16,33,174.20",
17-Jul-22,NEFT,17.1,00.00,"16,33,191.30",
17-Jul-22,ATM,00.00,"2,33,313.04","13,99,878.26",
17-Jul-22,Cheque,00.00,"2,33,313.04","11,66,565.22",
17-Jul-22,Tax,"3,085.24",00.00,"11,69,650.46",
17-Jul-22,Cash,227.2,00.00,"11,69,877.66",
17-Jul-22,Debit Card,"32,518.61",00.00,"12,02,396.27",
17-Jul-22,Cash,00.00,"1,20,239.63","10,82,156.64",
17-Jul-22,Tax,00.00,"1,35,269.58","9,46,887.06",
17-Jul-22,Bill,"3,619.00",00.00,"9,50,506.06",
17-Jul-22,Interest,496.69,00.00,"9,51,002.75",
17-Jul-22,RTGS,00.00,"1,90,200.55","7,60,802.20",
17-Jul-22,Transfer,"4,056.06",00.00,"7,64,858.26",
17-Jul-22,Reversal,00.00,"7,64,858.26",00.00,
17-Jul-22,RTGS,"6,40,236.80",00.00,"6,40,236.80",
17-Jul-22,Commission,00.00,"2,13,412.27","4,26,824.53",
17-Jul-22,Transportellaneous,00.00,"4,26,824.53",00.00,
18-Jul-22,Purchase,"32,555.81",00.00,"32,555.81",
18-Jul-22,Reversal,"12,143.97",00.00,"44,699.78",
18-Jul-22,Reversal,211,00.00,"44,910.78",
18-Jul-22,Commission,06.30,00.00,"44,917.08",
18-Jul-22,Bill,04.15,00.00,"44,921.23",
18-Jul-22,Cheque,00.00,"44,921.23",00.00,
18-Jul-22,RTGS,00.00,00.00,00.00,
18-Jul-22,Reversal,04.00,00.00,04.00,
18-Jul-22,Debit Card,01.00,00.00,05.00,
18-Jul-22,IMPS,"12,16,134.00",00.00,"12,16,139.00",
18-Jul-22,RTGS,"3,05,036.00",00.00,"15,21,175.00",
18-Jul-22,Tax,"14,11,819.25",00.00,"29,32,994.25",
18-Jul-22,Debit Card,"25,954.33",00.00,"29,58,948.58",
18-Jul-22,IMPS,39.02,00.00,"29,58,987.60",
18-Jul-22,ATM,342.69,00.00,"29,59,330.29",
18-Jul-22,Tax,00.00,"9,86,443.43","19,72,886.86",
18-Jul-22,Bill,00.00,"2,81,840.98","16,91,045.88",
18-Jul-22,Cheque,"2,130.00",00.00,"16,93,175.88",
18-Jul-22,Transportellaneous,00.00,"2,41,882.27","14,51,293.61",
18-Jul-22,RTGS,00.00,"3,62,823.40","10,88,470.21",
18-Jul-22,IMPS,"4,14,155.00",00.00,"15,02,625.21",
18-Jul-22,Transportellaneous,"2,046.90",00.00,"15,04,672.11",
18-Jul-22,NEFT,51,00.00,"15,04,723.11",
18-Jul-22,Interest,00.00,"1,88,090.39","13,16,632.72",
18-Jul-22,IMPS,00.00,"1,64,579.09","11,52,053.63",
18-Jul-22,RTGS,34,00.00,"11,52,087.63",
18-Jul-22,Reversal,01.00,00.00,"11,52,088.63",
18-Jul-22,ATM,00.00,"1,15,208.86","10,36,879.77",
18-Jul-22,IMPS,"5,82,017.00",00.00,"16,18,896.77",
18-Jul-22,Interest,00.00,"2,69,816.13","13,49,080.64",
18-Jul-22,Transportellaneous,00.00,"4,49,693.55","8,99,387.09",
18-Jul-22,Commission,00.00,"1,79,877.42","7,19,509.67",
18-Jul-22,Debit Card,03.80,00.00,"7,19,513.47",
18-Jul-22,Transportellaneous,"1,74,803.00",00.00,"8,94,316.47",
18-Jul-22,Purchase,"86,733.50",00.00,"9,81,049.97",
18-Jul-22,IMPS,00.00,"1,40,150.00","8,40,899.97",
18-Jul-22,RTGS,00.00,"93,433.33","7,47,466.64",
18-Jul-22,Commission,00.00,"83,051.85","6,64,414.79",
18-Jul-22,Cheque,400,00.00,"6,64,814.79",
18-Jul-22,Commission,00.00,"1,32,962.96","5,31,851.83",
19-Jul-22,Transfer,00.00,"1,32,962.96","3,98,888.87",
19-Jul-22,NEFT,00.18,00.00,"3,98,889.05",
19-Jul-22,Transfer,00.00,"1,99,444.53","1,99,444.52",
19-Jul-22,NEFT,00.00,"19,944.45","1,79,500.07",
19-Jul-22,IMPS,452.28,00.00,"1,79,952.35",
19-Jul-22,Tax,00.00,"22,494.04","1,57,458.31",
19-Jul-22,Cash,47.45,00.00,"1,57,505.76",
19-Jul-22,Transportellaneous,"25,555.10",00.00,"1,83,060.86",
20-Jul-22,Debit Card,"3,737.00",00.00,"1,86,797.86",
20-Jul-22,RTGS,00.00,"1,86,797.86",00.00,
20-Jul-22,Transfer,"10,06,969.50",00.00,"10,06,969.50",
20-Jul-22,Transportellaneous,00.00,"1,43,852.79","8,63,116.71",
21-Jul-22,Commission,48,00.00,"8,63,164.71",
21-Jul-22,Reversal,"3,248.92",00.00,"8,66,413.63",
21-Jul-22,ATM,"2,01,766.60",00.00,"10,68,180.23",
21-Jul-22,Tax,53.9,00.00,"10,68,234.13",
21-Jul-22,Transfer,90.2,00.00,"10,68,324.33",
21-Jul-22,Reversal,171,00.00,"10,68,495.33",
21-Jul-22,ATM,00.00,"5,34,247.67","5,34,247.66",
21-Jul-22,Cash,"3,020.00",00.00,"5,37,267.66",
21-Jul-22,Transportellaneous,"19,99,193.00",00.00,"25,36,460.66",
21-Jul-22,NEFT,00.00,"3,17,057.58","22,19,403.08",
21-Jul-22,Reversal,00.00,00.00,"22,19,403.08",
21-Jul-22,Tax,00.00,"7,39,801.03","14,79,602.05",
21-Jul-22,IMPS,141.8,00.00,"14,79,743.85",
21-Jul-22,Reversal,00.00,"3,69,935.96","11,09,807.89",
21-Jul-22,Interest,00.00,"1,38,725.99","9,71,081.90",
21-Jul-22,Transportellaneous,31.2,00.00,"9,71,113.10",
21-Jul-22,ATM,00.00,"2,42,778.28","7,28,334.82",
21-Jul-22,Cheque,00.00,"80,926.09","6,47,408.73",
21-Jul-22,Cheque,00.00,"92,486.96","5,54,921.77",
21-Jul-22,Transportellaneous,07.80,00.00,"5,54,929.57",
21-Jul-22,Cheque,"13,26,106.00",00.00,"18,81,035.57",
21-Jul-22,IMPS,00.00,"2,35,129.45","16,45,906.12",
21-Jul-22,Reversal,00.00,"16,45,906.12",00.00,
21-Jul-22,ATM,26,00.00,26,
21-Jul-22,Debit Card,07.00,00.00,33,
21-Jul-22,Tax,00.00,11,22,
21-Jul-22,Tax,494.98,00.00,516.98,
21-Jul-22,Bill,04.00,00.00,520.98,
21-Jul-22,Bill,00.00,52.1,468.88,
21-Jul-22,ATM,43,00.00,511.88,
21-Jul-22,Cheque,00.00,56.88,455,
21-Jul-22,Transportellaneous,00.00,151.67,303.33,
21-Jul-22,Purchase,00.00,33.7,269.63,
21-Jul-22,Tax,40,00.00,309.63,
21-Jul-22,Transportellaneous,00.00,51.61,258.02,
21-Jul-22,Debit Card,"19,57,828.25",00.00,"19,58,086.27",
21-Jul-22,ATM,00.00,"19,58,086.27",00.00,
22-Jul-22,Commission,331.39,00.00,331.39,
22-Jul-22,NEFT,"9,78,408.00",00.00,"9,78,739.39",
22-Jul-22,ATM,00.00,"9,78,739.39",00.00,
22-Jul-22,Bill,"2,25,574.12",00.00,"2,25,574.12",
22-Jul-22,Transportellaneous,00.00,"28,196.77","1,97,377.36",
22-Jul-22,NEFT,"7,78,722.00",00.00,"9,76,099.36",
22-Jul-22,NEFT,00.00,"3,25,366.45","6,50,732.91",
22-Jul-22,Interest,00.00,"3,25,366.46","3,25,366.46",
22-Jul-22,Purchase,440,00.00,"3,25,806.46",
22-Jul-22,IMPS,00.00,"65,161.29","2,60,645.17",
22-Jul-22,Cash,00.00,"2,60,645.17",00.00,
22-Jul-22,Bill,05.57,00.00,05.57,
22-Jul-22,Tax,370,00.00,375.57,
22-Jul-22,NEFT,"13,826.90",00.00,"14,202.47",
22-Jul-22,Transportellaneous,00.00,"1,578.05","12,624.42",
22-Jul-22,ATM,00.00,"1,578.05","11,046.37",
22-Jul-22,NEFT,"1,10,265.70",00.00,"1,21,312.07",
22-Jul-22,Interest,208,00.00,"1,21,520.07",
22-Jul-22,Debit Card,06.34,00.00,"1,21,526.41",
22-Jul-22,NEFT,"1,578.10",00.00,"1,23,104.51",
22-Jul-22,Debit Card,00.00,"13,678.28","1,09,426.23",
22-Jul-22,Reversal,391.03,00.00,"1,09,817.26",
23-Jul-22,Cash,441.87,00.00,"1,10,259.13",
23-Jul-22,Interest,"94,045.00",00.00,"2,04,304.13",
23-Jul-22,Transfer,00.00,"68,101.38","1,36,202.75",
23-Jul-22,Reversal,00.00,"27,240.55","1,08,962.20",
23-Jul-22,Cheque,00.00,"10,896.22","98,065.98",
23-Jul-22,NEFT,"4,65,747.00",00.00,"5,63,812.98",
23-Jul-22,Debit Card,"24,200.00",00.00,"5,88,012.98",
23-Jul-22,IMPS,00.00,"58,801.30","5,29,211.68",
23-Jul-22,Transportellaneous,47,00.00,"5,29,258.68",
23-Jul-22,Reversal,00.00,00.00,"5,29,258.68",
23-Jul-22,Transportellaneous,"1,65,867.00",00.00,"6,95,125.68",
23-Jul-22,Tax,00.00,"99,303.67","5,95,822.01",
23-Jul-22,RTGS,00.00,"85,117.43","5,10,704.58",
23-Jul-22,Transportellaneous,383.56,00.00,"5,11,088.14",
23-Jul-22,Cash,00.00,"2,55,544.07","2,55,544.07",
23-Jul-22,Transportellaneous,00.00,"25,554.41","2,29,989.66",
23-Jul-22,Cash,00.00,"2,29,989.66",00.00,
23-Jul-22,NEFT,"3,527.16",00.00,"3,527.16",
23-Jul-22,Tax,"3,819.90",00.00,"7,347.06",
23-Jul-22,Cheque,42.44,00.00,"7,389.50",
23-Jul-22,Purchase,00.00,"3,694.75","3,694.75",
24-Jul-22,Cash,00.00,461.84,"3,232.91",
24-Jul-22,ATM,00.00,"1,077.64","2,155.27",
24-Jul-22,Cash,"3,31,024.50",00.00,"3,33,179.77",
24-Jul-22,Interest,387.67,00.00,"3,33,567.44",
24-Jul-22,Transfer,"6,31,242.00",00.00,"9,64,809.44",
24-Jul-22,Reversal,"18,39,845.75",00.00,"28,04,655.19",
24-Jul-22,Cash,"2,36,780.00",00.00,"30,41,435.19",
24-Jul-22,Commission,"27,941.18",00.00,"30,69,376.37",
24-Jul-22,RTGS,"1,212.00",00.00,"30,70,588.37",
24-Jul-22,Reversal,00.00,"7,67,647.09","23,02,941.28",
24-Jul-22,Interest,00.00,"2,55,882.36","20,47,058.92",
24-Jul-22,Transfer,"30,650.00",00.00,"20,77,708.92",
24-Jul-22,NEFT,00.00,"20,77,708.92",00.00,
24-Jul-22,Bill,"13,633.68",00.00,"13,633.68",
24-Jul-22,ATM,"1,008.00",00.00,"14,641.68",
24-Jul-22,NEFT,303,00.00,"14,944.68",
24-Jul-22,Reversal,"1,70,789.40",00.00,"1,85,734.08",
24-Jul-22,Transfer,56.99,00.00,"1,85,791.07",
24-Jul-22,Transfer,00.00,"23,223.88","1,62,567.19",
24-Jul-22,Commission,00.00,"16,256.72","1,46,310.47",
24-Jul-22,Bill,"3,678.11",00.00,"1,49,988.58",
24-Jul-22,Cheque,00.00,"18,748.57","1,31,240.01",
24-Jul-22,NEFT,00.00,"21,873.34","1,09,366.68",
24-Jul-22,Reversal,00.00,"27,341.67","82,025.01",
24-Jul-22,Interest,189,00.00,"82,214.01",
24-Jul-22,Purchase,00.00,"9,134.89","73,079.12",
24-Jul-22,Bill,00.00,"10,439.87","62,639.25",
24-Jul-22,Commission,04.50,00.00,"62,643.75",
24-Jul-22,Bill,01.00,00.00,"62,644.75",
24-Jul-22,Transportellaneous,00.00,"15,661.19","46,983.56",
24-Jul-22,Bill,00.00,"15,661.19","31,322.37",
24-Jul-22,Transportellaneous,00.00,"6,264.47","25,057.90",
24-Jul-22,Cash,992,00.00,"26,049.90",
24-Jul-22,Purchase,00.00,"8,683.30","17,366.60",
24-Jul-22,NEFT,39,00.00,"17,405.60",
24-Jul-22,Reversal,00.00,"2,900.93","14,504.67",
24-Jul-22,IMPS,00.00,"7,252.34","7,252.34",
24-Jul-22,Commission,54,00.00,"7,306.34",
24-Jul-22,Bill,00.00,811.82,"6,494.52",
24-Jul-22,Cheque,"88,988.00",00.00,"95,482.52",
24-Jul-22,Purchase,00.00,"23,870.63","71,611.89",
24-Jul-22,RTGS,"1,450.70",00.00,"73,062.59",
24-Jul-22,Transportellaneous,00.00,"73,062.59",00.00,
24-Jul-22,IMPS,"59,174.00",00.00,"59,174.00",
24-Jul-22,Cheque,00.00,"8,453.43","50,720.57",
24-Jul-22,Interest,00.00,"16,906.86","33,813.71",
24-Jul-22,Interest,"7,11,386.00",00.00,"7,45,199.71",
24-Jul-22,Debit Card,411.25,00.00,"7,45,610.96",
24-Jul-22,Transportellaneous,00.00,"82,845.66","6,62,765.30",
24-Jul-22,Transfer,00.00,"73,640.59","5,89,124.71",
24-Jul-22,Interest,00.00,"98,187.45","4,90,937.26",
24-Jul-22,Purchase,"1,19,282.00",00.00,"6,10,219.26",
24-Jul-22,ATM,00.00,"1,22,043.85","4,88,175.41",
24-Jul-22,Transfer,380.6,00.00,"4,88,556.01",
24-Jul-22,Interest,00.00,"54,284.00","4,34,272.01",
24-Jul-22,Debit Card,00.00,"48,252.45","3,86,019.56",
24-Jul-22,Interest,"1,928.00",00.00,"3,87,947.56",
24-Jul-22,Transportellaneous,236,00.00,"3,88,183.56",
24-Jul-22,Cheque,00.00,"3,88,183.56",00.00,
24-Jul-22,ATM,28.3,00.00,28.3,
24-Jul-22,Purchase,382,00.00,410.3,
24-Jul-22,Cheque,00.00,51.29,359.01,
24-Jul-22,Commission,"44,933.50",00.00,"45,292.51",
24-Jul-22,RTGS,"24,519.30",00.00,"69,811.81",
24-Jul-22,NEFT,00.00,"7,756.87","62,054.94",
24-Jul-22,Cash,"85,608.34",00.00,"1,47,663.28",
24-Jul-22,Bill,269.86,00.00,"1,47,933.14",
24-Jul-22,NEFT,"2,29,371.03",00.00,"3,77,304.17",
24-Jul-22,Transportellaneous,10.5,00.00,"3,77,314.67",
24-Jul-22,Commission,00.00,"3,77,314.67",00.00,
24-Jul-22,Cheque,"1,19,027.40",00.00,"1,19,027.40",
25-Jul-22,Tax,00.00,"1,19,027.40",00.00,
25-Jul-22,Debit Card,12,00.00,12,
26-Jul-22,Reversal,00.00,01.50,10.5,
26-Jul-22,IMPS,00.00,02.10,08.40,
26-Jul-22,Transfer,"18,69,758.25",00.00,"18,69,766.65",
26-Jul-22,Interest,00.00,"1,86,976.67","16,82,789.98",
26-Jul-22,Debit Card,265,00.00,"16,83,054.98",
26-Jul-22,ATM,703,00.00,"16,83,757.98",
26-Jul-22,RTGS,00.00,"4,20,939.50","12,62,818.48",
27-Jul-22,NEFT,00.00,"1,80,402.64","10,82,415.84",
27-Jul-22,Reversal,00.00,"2,70,603.96","8,11,811.88",
27-Jul-22,NEFT,"70,750.00",00.00,"8,82,561.88",
28-Jul-22,Interest,00.00,"98,062.43","7,84,499.45",
28-Jul-22,RTGS,"10,408.00",00.00,"7,94,907.45",
28-Jul-22,IMPS,"7,72,769.80",00.00,"15,67,677.25",
28-Jul-22,Transportellaneous,00.00,"3,13,535.45","12,54,141.80",
28-Jul-22,Debit Card,00.00,"1,39,349.09","11,14,792.71",
28-Jul-22,Tax,"3,292.00",00.00,"11,18,084.71",
29-Jul-22,Cash,"2,12,722.59",00.00,"13,30,807.30",
29-Jul-22,Transfer,63.21,00.00,"13,30,870.51",
29-Jul-22,IMPS,00.00,"2,66,174.10","10,64,696.41",
29-Jul-22,Tax,218.3,00.00,"10,64,914.71",
29-Jul-22,Transportellaneous,00.00,"10,64,914.71",00.00,
29-Jul-22,IMPS,"2,595.43",00.00,"2,595.43",
29-Jul-22,Reversal,"16,49,517.20",00.00,"16,52,112.63",
29-Jul-22,Commission,29.71,00.00,"16,52,142.34",
29-Jul-22,Purchase,00.00,"4,13,035.59","12,39,106.76",
29-Jul-22,Debit Card,05.00,00.00,"12,39,111.76",
29-Jul-22,Bill,"2,287.22",00.00,"12,41,398.98",
29-Jul-22,Purchase,"1,70,186.20",00.00,"14,11,585.18",
29-Jul-22,Interest,00.00,"4,70,528.39","9,41,056.79",
29-Jul-22,Tax,00.00,"1,56,842.80","7,84,213.99",
29-Jul-22,ATM,00.00,"1,30,702.33","6,53,511.66",
29-Jul-22,Debit Card,00.00,"93,358.81","5,60,152.85",
29-Jul-22,Tax,01.94,00.00,"5,60,154.79",
29-Jul-22,Purchase,00.00,"80,022.11","4,80,132.68",
29-Jul-22,Commission,"1,128.20",00.00,"4,81,260.88",
29-Jul-22,Debit Card,00.00,"68,751.55","4,12,509.33",
29-Jul-22,Bill,00.00,"41,250.93","3,71,258.40",
29-Jul-22,RTGS,00.00,"1,23,752.80","2,47,505.60",
29-Jul-22,Cheque,00.00,"2,47,505.60",00.00,
29-Jul-22,Tax,05.63,00.00,05.63,
29-Jul-22,Cash,"16,460.80",00.00,"16,466.43",
29-Jul-22,RTGS,00.00,"2,744.41","13,722.02",
29-Jul-22,IMPS,00.07,00.00,"13,722.09",
29-Jul-22,Cheque,00.00,"3,430.52","10,291.57",
29-Jul-22,Transfer,00.00,"2,572.89","7,718.68",
29-Jul-22,Purchase,00.00,857.63,"6,861.05",
29-Jul-22,Purchase,02.00,00.00,"6,863.05",
29-Jul-22,Cash,00.00,"3,431.53","3,431.52",
29-Jul-22,Interest,"20,823.00",00.00,"24,254.52",
29-Jul-22,NEFT,00.00,"8,084.84","16,169.68",
29-Jul-22,Transportellaneous,00.00,"4,042.42","12,127.26",
29-Jul-22,Transportellaneous,"2,44,278.50",00.00,"2,56,405.76",
29-Jul-22,NEFT,"18,81,151.75",00.00,"21,37,557.51",
29-Jul-22,Transportellaneous,06.94,00.00,"21,37,564.45",
29-Jul-22,Commission,00.00,"5,34,391.11","16,03,173.34",
30-Jul-22,Interest,00.00,"2,00,396.67","14,02,776.67",
30-Jul-22,Tax,00.00,00.00,"14,02,776.67",
30-Jul-22,Bill,06.00,00.00,"14,02,782.67",
30-Jul-22,Bill,"1,330.52",00.00,"14,04,113.19",
30-Jul-22,Reversal,"16,58,154.00",00.00,"30,62,267.19",
30-Jul-22,ATM,00.00,"10,20,755.73","20,41,511.46",
30-Jul-22,Transfer,"70,219.50",00.00,"21,11,730.96",
30-Jul-22,Bill,"2,25,525.41",00.00,"23,37,256.37",
30-Jul-22,NEFT,00.00,"3,89,542.73","19,47,713.64",
30-Jul-22,Tax,00.00,"3,24,618.94","16,23,094.70",
30-Jul-22,Cash,00.00,"2,70,515.78","13,52,578.92",
30-Jul-22,RTGS,60,00.00,"13,52,638.92",
30-Jul-22,Transfer,38.6,00.00,"13,52,677.52",
30-Jul-22,Transportellaneous,00.00,"3,38,169.38","10,14,508.14",
30-Jul-22,ATM,167.81,00.00,"10,14,675.95",
30-Jul-22,Tax,00.00,"1,44,953.71","8,69,722.24",
30-Jul-22,Commission,"3,312.27",00.00,"8,73,034.51",
30-Jul-22,Cash,54.99,00.00,"8,73,089.50",
30-Jul-22,Transportellaneous,80,00.00,"8,73,169.50",
30-Jul-22,Transportellaneous,00.00,"1,45,528.25","7,27,641.25",
30-Jul-22,Commission,"9,438.34",00.00,"7,37,079.59",
30-Jul-22,Bill,00.00,"1,22,846.60","6,14,232.99",
30-Jul-22,IMPS,"20,57,719.50",00.00,"26,71,952.49",
30-Jul-22,Cheque,00.00,"3,81,707.50","22,90,244.99",
30-Jul-22,Purchase,84,00.00,"22,90,328.99",
30-Jul-22,Bill,"1,79,064.59",00.00,"24,69,393.58",
30-Jul-22,RTGS,"1,22,110.30",00.00,"25,91,503.88",
30-Jul-22,Reversal,"3,964.10",00.00,"25,95,467.98",
30-Jul-22,Transfer,00.80,00.00,"25,95,468.78",
30-Jul-22,Interest,"14,826.97",00.00,"26,10,295.75",
31-Jul-22,RTGS,00.00,"5,22,059.15","20,88,236.60",
31-Jul-22,Debit Card,00.00,"20,88,236.60",00.00,
31-Jul-22,Commission,"1,483.00",00.00,"1,483.00",
31-Jul-22,Bill,00.00,741.5,741.5,
31-Jul-22,Interest,294.2,00.00,"1,035.70",
31-Jul-22,Cheque,00.00,103.57,932.13,
31-Jul-22,Tax,"51,072.25",00.00,"52,004.38",
31-Jul-22,Debit Card,00.00,"6,500.55","45,503.83",
31-Jul-22,Reversal,00.00,"7,583.97","37,919.86",
31-Jul-22,RTGS,00.00,"6,319.98","31,599.88",
31-Jul-22,Debit Card,28.5,00.00,"31,628.38",
31-Jul-22,Tax,00.00,"5,271.40","26,356.98",
01-Aug-22,Interest,00.00,"2,928.55","23,428.43",
01-Aug-22,Interest,04.80,00.00,"23,433.23",
01-Aug-22,Transfer,04.02,00.00,"23,437.25",
01-Aug-22,Interest,00.00,"4,687.45","18,749.80",
01-Aug-22,Debit Card,00.00,"9,374.90","9,374.90",
01-Aug-22,Transportellaneous,00.00,"1,171.86","8,203.04",
01-Aug-22,Purchase,"23,193.50",00.00,"31,396.54",
01-Aug-22,RTGS,"14,474.40",00.00,"45,870.94",
01-Aug-22,RTGS,00.00,"5,096.77","40,774.17",
01-Aug-22,Cash,00.00,"10,193.54","30,580.63",
01-Aug-22,Cash,00.00,"3,397.85","27,182.78",
01-Aug-22,Transportellaneous,00.00,"4,530.46","22,652.32",
01-Aug-22,Transfer,00.00,"3,775.39","18,876.93",
01-Aug-22,Purchase,407.3,00.00,"19,284.23",
01-Aug-22,Transportellaneous,"1,81,251.10",00.00,"2,00,535.33",
01-Aug-22,Reversal,"14,77,084.80",00.00,"16,77,620.13",
01-Aug-22,RTGS,00.00,"3,35,524.03","13,42,096.10",
01-Aug-22,Interest,"2,44,890.00",00.00,"15,86,986.10",
01-Aug-22,Tax,"13,709.60",00.00,"16,00,695.70",
01-Aug-22,Debit Card,"1,161.22",00.00,"16,01,856.92",
01-Aug-22,Purchase,00.00,"5,33,952.31","10,67,904.61",
01-Aug-22,Purchase,00.00,"1,18,656.07","9,49,248.54",
01-Aug-22,Commission,01.52,00.00,"9,49,250.06",
01-Aug-22,Transfer,03.00,00.00,"9,49,253.06",
01-Aug-22,Cash,00.00,"1,05,472.56","8,43,780.50",
01-Aug-22,Tax,54.64,00.00,"8,43,835.14",
01-Aug-22,Interest,"12,82,778.00",00.00,"21,26,613.14",
01-Aug-22,Cheque,241,00.00,"21,26,854.14",
01-Aug-22,Cheque,54,00.00,"21,26,908.14",
01-Aug-22,Tax,00.00,"4,25,381.63","17,01,526.51",
01-Aug-22,Tax,16,00.00,"17,01,542.51",
01-Aug-22,IMPS,"2,13,501.00",00.00,"19,15,043.51",
01-Aug-22,Debit Card,"1,185.20",00.00,"19,16,228.71",
01-Aug-22,Cash,205,00.00,"19,16,433.71",
01-Aug-22,Transportellaneous,00.00,"9,58,216.86","9,58,216.86",
01-Aug-22,Reversal,"66,299.80",00.00,"10,24,516.66",
01-Aug-22,Cheque,03.78,00.00,"10,24,520.44",
01-Aug-22,Tax,164,00.00,"10,24,684.44",
01-Aug-22,RTGS,00.00,"5,12,342.22","5,12,342.22",
01-Aug-22,Cash,00.00,"85,390.37","4,26,951.85",
01-Aug-22,Reversal,00.00,"85,390.37","3,41,561.48",
01-Aug-22,RTGS,00.00,"1,70,780.74","1,70,780.74",
01-Aug-22,Bill,414,00.00,"1,71,194.74",
02-Aug-22,Interest,00.00,"85,597.37","85,597.37",
03-Aug-22,IMPS,"77,589.00",00.00,"1,63,186.37",
03-Aug-22,Bill,00.00,"27,197.73","1,35,988.64",
03-Aug-22,NEFT,03.60,00.00,"1,35,992.24",
03-Aug-22,ATM,"1,17,758.59",00.00,"2,53,750.83",
03-Aug-22,Transfer,00.00,"2,53,750.83",00.00,
03-Aug-22,Cash,188.7,00.00,188.7,
03-Aug-22,Bill,00.00,20.97,167.73,
03-Aug-22,ATM,03.00,00.00,170.73,
03-Aug-22,Transfer,411.27,00.00,582,
03-Aug-22,Reversal,"1,360.90",00.00,"1,942.90",
03-Aug-22,Cash,07.00,00.00,"1,949.90",
03-Aug-22,Interest,35.5,00.00,"1,985.40",
03-Aug-22,ATM,"7,38,168.50",00.00,"7,40,153.90",
03-Aug-22,NEFT,"1,63,098.00",00.00,"9,03,251.90",
03-Aug-22,Commission,00.00,"1,12,906.49","7,90,345.41",
03-Aug-22,Transportellaneous,107.91,00.00,"7,90,453.32",
03-Aug-22,NEFT,00.00,"98,806.67","6,91,646.65",
03-Aug-22,Transportellaneous,"7,273.80",00.00,"6,98,920.45",
03-Aug-22,Purchase,42,00.00,"6,98,962.45",
03-Aug-22,RTGS,00.00,"2,32,987.48","4,65,974.97",
03-Aug-22,Cash,"13,51,886.00",00.00,"18,17,860.97",
03-Aug-22,NEFT,65,00.00,"18,17,925.97",
03-Aug-22,Purchase,00.00,"9,08,962.99","9,08,962.98",
03-Aug-22,Cheque,00.00,"1,13,620.37","7,95,342.61",
03-Aug-22,Interest,00.00,"7,95,342.61",00.00,
03-Aug-22,Tax,"20,26,905.00",00.00,"20,26,905.00",
03-Aug-22,RTGS,00.00,"2,25,211.67","18,01,693.33",
03-Aug-22,Cheque,00.00,"1,80,169.33","16,21,524.00",
03-Aug-22,Commission,00.00,"2,70,254.00","13,51,270.00",
03-Aug-22,Commission,"1,60,996.00",00.00,"15,12,266.00",
03-Aug-22,ATM,00.00,"1,51,226.60","13,61,039.40",
03-Aug-22,Commission,00.00,"6,80,519.70","6,80,519.70",
04-Aug-22,Debit Card,00.00,"68,051.97","6,12,467.73",
04-Aug-22,Debit Card,295.7,00.00,"6,12,763.43",
04-Aug-22,IMPS,"3,99,305.00",00.00,"10,12,068.43",
04-Aug-22,IMPS,42.7,00.00,"10,12,111.13",
04-Aug-22,Interest,00.00,"1,12,456.79","8,99,654.34",
04-Aug-22,Purchase,00.00,"8,99,654.34",00.00,
04-Aug-22,Bill,13.2,00.00,13.2,
04-Aug-22,Tax,07.50,00.00,20.7,
04-Aug-22,Purchase,00.00,00.00,20.7,
04-Aug-22,Interest,00.00,05.18,15.52,
04-Aug-22,RTGS,22,00.00,37.52,
04-Aug-22,RTGS,00.00,09.38,28.14,
05-Aug-22,Transportellaneous,"17,07,984.50",00.00,"17,08,012.64",
05-Aug-22,Purchase,903.7,00.00,"17,08,916.34",
05-Aug-22,Tax,247.53,00.00,"17,09,163.87",
05-Aug-22,Cash,00.00,"2,13,645.48","14,95,518.39",
05-Aug-22,NEFT,00.00,"1,49,551.84","13,45,966.55",
05-Aug-22,Transportellaneous,00.00,"1,92,280.94","11,53,685.61",
05-Aug-22,RTGS,00.00,"2,30,737.12","9,22,948.49",
05-Aug-22,Reversal,"14,384.40",00.00,"9,37,332.89",
05-Aug-22,IMPS,05.23,00.00,"9,37,338.12",
05-Aug-22,Transportellaneous,"66,153.78",00.00,"10,03,491.90",
05-Aug-22,Bill,00.00,"2,00,698.38","8,02,793.52",
05-Aug-22,Cheque,00.00,"1,60,558.70","6,42,234.82",
05-Aug-22,Reversal,00.00,"91,747.83","5,50,486.99",
05-Aug-22,Bill,00.00,"1,10,097.40","4,40,389.59",
05-Aug-22,NEFT,"14,02,859.00",00.00,"18,43,248.59",
05-Aug-22,Cheque,00.00,"3,68,649.72","14,74,598.87",
05-Aug-22,Cheque,01.10,00.00,"14,74,599.97",
05-Aug-22,ATM,"17,542.82",00.00,"14,92,142.79",
05-Aug-22,Transportellaneous,"18,48,054.00",00.00,"33,40,196.79",
05-Aug-22,Reversal,00.00,"8,35,049.20","25,05,147.59",
05-Aug-22,Cheque,"1,429.67",00.00,"25,06,577.26",
05-Aug-22,Commission,"2,749.40",00.00,"25,09,326.66",
05-Aug-22,Reversal,339,00.00,"25,09,665.66",
05-Aug-22,Cheque,00.00,"12,54,832.83","12,54,832.83",
05-Aug-22,Purchase,"1,99,722.00",00.00,"14,54,554.83",
05-Aug-22,Transfer,"14,81,370.25",00.00,"29,35,925.08",
05-Aug-22,Cash,00.00,"29,35,925.08",00.00,
05-Aug-22,IMPS,56,00.00,56,
05-Aug-22,Transfer,00.00,08.00,48,
05-Aug-22,Transportellaneous,"11,33,821.00",00.00,"11,33,869.00",
05-Aug-22,Tax,11.9,00.00,"11,33,880.90",
05-Aug-22,Transfer,"20,463.70",00.00,"11,54,344.60",
05-Aug-22,Cash,"20,81,832.50",00.00,"32,36,177.10",
05-Aug-22,NEFT,41.7,00.00,"32,36,218.80",
05-Aug-22,Transportellaneous,"9,19,394.00",00.00,"41,55,612.80",
05-Aug-22,NEFT,00.00,"5,19,451.60","36,36,161.20",
05-Aug-22,Reversal,76.6,00.00,"36,36,237.80",
05-Aug-22,RTGS,00.00,"6,06,039.63","30,30,198.17",
05-Aug-22,NEFT,144.16,00.00,"30,30,342.33",
05-Aug-22,Debit Card,140.39,00.00,"30,30,482.72",
05-Aug-22,Tax,"17,072.00",00.00,"30,47,554.72",
05-Aug-22,NEFT,04.10,00.00,"30,47,558.82",
05-Aug-22,Commission,39,00.00,"30,47,597.82",
05-Aug-22,Bill,00.00,"3,38,621.98","27,08,975.84",
05-Aug-22,NEFT,"19,22,457.50",00.00,"46,31,433.34",
05-Aug-22,NEFT,"1,57,721.20",00.00,"47,89,154.54",
05-Aug-22,Purchase,00.00,"15,96,384.85","31,92,769.69",
06-Aug-22,NEFT,"2,593.50",00.00,"31,95,363.19",
06-Aug-22,Cash,"12,26,068.50",00.00,"44,21,431.69",
06-Aug-22,Cash,00.00,"6,31,633.10","37,89,798.59",
06-Aug-22,Purchase,00.00,"7,57,959.72","30,31,838.87",
06-Aug-22,Tax,"7,99,305.75",00.00,"38,31,144.62",
06-Aug-22,Transportellaneous,00.00,"19,15,572.31","19,15,572.31",
06-Aug-22,Cash,"11,88,463.00",00.00,"31,04,035.31",
06-Aug-22,Bill,"1,61,263.00",00.00,"32,65,298.31",
06-Aug-22,Debit Card,"2,153.12",00.00,"32,67,451.43",
06-Aug-22,Cheque,"8,52,906.00",00.00,"41,20,357.43",
06-Aug-22,Cash,00.00,"5,15,044.68","36,05,312.75",
06-Aug-22,Interest,18.8,00.00,"36,05,331.55",
06-Aug-22,Transportellaneous,"3,543.00",00.00,"36,08,874.55",
06-Aug-22,Transfer,00.00,"9,02,218.64","27,06,655.91",
06-Aug-22,NEFT,00.00,"3,38,331.99","23,68,323.92",
06-Aug-22,Interest,"49,397.88",00.00,"24,17,721.80",
06-Aug-22,Transfer,13.3,00.00,"24,17,735.10",
06-Aug-22,IMPS,"1,66,928.10",00.00,"25,84,663.20",
06-Aug-22,ATM,"1,74,739.00",00.00,"27,59,402.20",
06-Aug-22,Purchase,"8,51,514.00",00.00,"36,10,916.20",
06-Aug-22,ATM,00.00,"3,61,091.62","32,49,824.58",
06-Aug-22,Interest,00.00,"10,83,274.86","21,66,549.72",
06-Aug-22,NEFT,00.00,"3,09,507.10","18,57,042.62",
06-Aug-22,Tax,00.10,00.00,"18,57,042.72",
06-Aug-22,Debit Card,00.00,"3,71,408.54","14,85,634.18",
06-Aug-22,Debit Card,00.00,"2,12,233.45","12,73,400.73",
06-Aug-22,Transfer,04.00,00.00,"12,73,404.73",
06-Aug-22,Transfer,00.00,"2,12,234.12","10,61,170.61",
06-Aug-22,RTGS,05.00,00.00,"10,61,175.61",
06-Aug-22,Bill,"23,779.80",00.00,"10,84,955.41",
06-Aug-22,Cash,00.00,"10,84,955.41",00.00,
06-Aug-22,Debit Card,"1,486.00",00.00,"1,486.00",
06-Aug-22,IMPS,"12,988.00",00.00,"14,474.00",
06-Aug-22,Bill,00.00,"1,447.40","13,026.60",
06-Aug-22,ATM,00.00,"1,628.33","11,398.28",
06-Aug-22,Interest,258.04,00.00,"11,656.32",
06-Aug-22,Transfer,00.00,"11,656.32",00.00,
06-Aug-22,RTGS,"36,801.00",00.00,"36,801.00",
06-Aug-22,Tax,00.00,"36,801.00",00.00,
06-Aug-22,NEFT,51.2,00.00,51.2,
06-Aug-22,IMPS,00.00,07.31,43.89,
06-Aug-22,Debit Card,37.11,00.00,81,
06-Aug-22,Bill,00.00,08.10,72.9,
06-Aug-22,Cash,00.00,12.15,60.75,
06-Aug-22,NEFT,00.00,08.68,52.07,
06-Aug-22,Cash,00.00,05.21,46.86,
06-Aug-22,Cash,"2,892.00",00.00,"2,938.86",
06-Aug-22,Purchase,"28,977.00",00.00,"31,915.86",
06-Aug-22,NEFT,00.00,"7,978.97","23,936.90",
07-Aug-22,RTGS,254,00.00,"24,190.90",
07-Aug-22,Cheque,"29,488.20",00.00,"53,679.10",
08-Aug-22,Cheque,"2,85,970.00",00.00,"3,39,649.10",
08-Aug-22,Transfer,00.00,"1,13,216.37","2,26,432.73",
08-Aug-22,Bill,07.00,00.00,"2,26,439.73",
08-Aug-22,ATM,"14,23,571.00",00.00,"16,50,010.73",
08-Aug-22,IMPS,00.00,"4,12,502.68","12,37,508.05",
08-Aug-22,Tax,06.00,00.00,"12,37,514.05",
08-Aug-22,RTGS,"2,07,406.50",00.00,"14,44,920.55",
08-Aug-22,Commission,00.00,"14,44,920.55",00.00,
08-Aug-22,Reversal,"17,91,240.00",00.00,"17,91,240.00",
08-Aug-22,IMPS,"1,64,302.00",00.00,"19,55,542.00",
08-Aug-22,Tax,00.00,"2,44,442.75","17,11,099.25",
08-Aug-22,Commission,"2,841.99",00.00,"17,13,941.24",
08-Aug-22,Interest,00.00,"2,14,242.66","14,99,698.58",
08-Aug-22,Transfer,00.00,"2,99,939.72","11,99,758.86",
08-Aug-22,IMPS,508,00.00,"12,00,266.86",
08-Aug-22,IMPS,00.00,"2,00,044.48","10,00,222.38",
08-Aug-22,IMPS,00.00,"1,42,888.91","8,57,333.47",
08-Aug-22,RTGS,05.70,00.00,"8,57,339.17",
08-Aug-22,Cash,04.03,00.00,"8,57,343.20",
08-Aug-22,IMPS,49,00.00,"8,57,392.20",
09-Aug-22,Interest,00.00,"85,739.22","7,71,652.98",
09-Aug-22,NEFT,00.00,"2,57,217.66","5,14,435.32",
09-Aug-22,RTGS,00.00,"5,14,435.32",00.00,
09-Aug-22,NEFT,00.31,00.00,00.31,
09-Aug-22,Debit Card,"14,31,668.00",00.00,"14,31,668.31",
09-Aug-22,Transportellaneous,"15,776.00",00.00,"14,47,444.31",
09-Aug-22,Reversal,"2,86,966.00",00.00,"17,34,410.31",
09-Aug-22,ATM,75.61,00.00,"17,34,485.92",
09-Aug-22,Tax,00.00,"2,16,810.74","15,17,675.18",
09-Aug-22,Bill,00.00,"3,79,418.80","11,38,256.38",
10-Aug-22,Purchase,00.00,"2,84,564.10","8,53,692.28",
10-Aug-22,Bill,00.00,"1,70,738.46","6,82,953.82",
10-Aug-22,Cash,"7,95,626.00",00.00,"14,78,579.82",
10-Aug-22,RTGS,"7,808.10",00.00,"14,86,387.92",
10-Aug-22,NEFT,00.00,"1,85,798.49","13,00,589.43",
10-Aug-22,Commission,00.00,"3,25,147.36","9,75,442.07",
10-Aug-22,ATM,00.00,"9,75,442.07",00.00,
10-Aug-22,IMPS,"28,561.90",00.00,"28,561.90",
10-Aug-22,RTGS,"7,234.10",00.00,"35,796.00",
10-Aug-22,Purchase,00.00,"3,579.60","32,216.40",
10-Aug-22,Debit Card,"1,06,172.00",00.00,"1,38,388.40",
10-Aug-22,Cheque,"1,50,193.00",00.00,"2,88,581.40",
10-Aug-22,NEFT,427.5,00.00,"2,89,008.90",
10-Aug-22,Debit Card,00.00,"1,44,504.45","1,44,504.45",
11-Aug-22,Debit Card,01.90,00.00,"1,44,506.35",
11-Aug-22,Debit Card,00.00,"24,084.39","1,20,421.96",
11-Aug-22,Cash,"1,359.20",00.00,"1,21,781.16",
11-Aug-22,RTGS,00.00,"13,531.24","1,08,249.92",
11-Aug-22,Cheque,"2,775.00",00.00,"1,11,024.92",
11-Aug-22,Transfer,00.00,"37,008.31","74,016.61",
11-Aug-22,Purchase,00.00,"10,573.80","63,442.81",
11-Aug-22,ATM,00.00,"10,573.80","52,869.01",
11-Aug-22,Bill,"18,10,177.00",00.00,"18,63,046.01",
12-Aug-22,Reversal,00.00,"9,31,523.01","9,31,523.00",
12-Aug-22,Commission,00.00,"1,55,253.83","7,76,269.17",
12-Aug-22,ATM,00.00,"97,033.65","6,79,235.52",
12-Aug-22,Interest,"1,494.60",00.00,"6,80,730.12",
12-Aug-22,Commission,00.00,"85,091.27","5,95,638.86",
12-Aug-22,ATM,00.00,"74,454.86","5,21,184.00",
13-Aug-22,NEFT,"27,149.46",00.00,"5,48,333.46",
13-Aug-22,Transportellaneous,"1,86,534.90",00.00,"7,34,868.36",
13-Aug-22,Tax,"14,61,322.80",00.00,"21,96,191.16",
13-Aug-22,NEFT,00.00,"2,44,021.24","19,52,169.92",
13-Aug-22,Bill,"14,84,896.20",00.00,"34,37,066.12",
13-Aug-22,ATM,00.00,"3,81,896.24","30,55,169.88",
13-Aug-22,NEFT,"3,106.56",00.00,"30,58,276.44",
13-Aug-22,Purchase,00.00,"3,82,284.56","26,75,991.88",
13-Aug-22,Transfer,00.00,"5,35,198.38","21,40,793.50",
13-Aug-22,Commission,52.5,00.00,"21,40,846.00",
13-Aug-22,Transfer,"2,463.28",00.00,"21,43,309.28",
13-Aug-22,Commission,00.00,"2,67,913.66","18,75,395.62",
13-Aug-22,Reversal,00.00,"2,34,424.45","16,40,971.17",
13-Aug-22,Tax,"29,690.88",00.00,"16,70,662.05",
13-Aug-22,IMPS,"4,43,556.00",00.00,"21,14,218.05",
13-Aug-22,Cheque,05.00,00.00,"21,14,223.05",
13-Aug-22,ATM,02.00,00.00,"21,14,225.05",
13-Aug-22,Cheque,04.00,00.00,"21,14,229.05",
13-Aug-22,IMPS,00.00,"4,22,845.81","16,91,383.24",
13-Aug-22,Purchase,00.00,"2,11,422.91","14,79,960.34",
13-Aug-22,RTGS,"1,071.34",00.00,"14,81,031.68",
13-Aug-22,Bill,00.00,"3,70,257.92","11,10,773.76",
13-Aug-22,NEFT,"10,394.65",00.00,"11,21,168.41",
13-Aug-22,Bill,"14,92,496.00",00.00,"26,13,664.41",
13-Aug-22,Transportellaneous,00.00,"13,06,832.21","13,06,832.20",
13-Aug-22,Interest,00.00,"4,35,610.73","8,71,221.47",
13-Aug-22,Interest,00.00,"87,122.15","7,84,099.32",
13-Aug-22,Reversal,00.00,"98,012.42","6,86,086.90",
13-Aug-22,Debit Card,00.00,"68,608.69","6,17,478.21",
13-Aug-22,Commission,00.00,"1,54,369.55","4,63,108.66",
13-Aug-22,Bill,00.00,"77,184.78","3,85,923.88",
13-Aug-22,Debit Card,"13,918.60",00.00,"3,99,842.48",
13-Aug-22,RTGS,00.00,"79,968.50","3,19,873.98",
13-Aug-22,ATM,00.00,"35,541.55","2,84,332.43",
13-Aug-22,NEFT,00.00,"94,777.48","1,89,554.95",
13-Aug-22,Purchase,00.00,"21,061.66","1,68,493.29",
13-Aug-22,Interest,00.00,"28,082.22","1,40,411.08",
13-Aug-22,ATM,00.00,"28,082.22","1,12,328.86",
13-Aug-22,Debit Card,34,00.00,"1,12,362.86",
13-Aug-22,Cheque,00.00,"18,727.14","93,635.72",
13-Aug-22,RTGS,00.00,"11,704.47","81,931.26",
13-Aug-22,Cheque,"15,447.10",00.00,"97,378.36",
13-Aug-22,IMPS,05.40,00.00,"97,383.76",
13-Aug-22,IMPS,"13,909.00",00.00,"1,11,292.76",
13-Aug-22,Bill,00.00,"27,823.19","83,469.57",
13-Aug-22,Cheque,00.00,"41,734.79","41,734.79",
13-Aug-22,Reversal,00.00,"13,911.60","27,823.19",
13-Aug-22,Reversal,59.67,00.00,"27,882.86",
13-Aug-22,Interest,44.1,00.00,"27,926.96",
13-Aug-22,ATM,00.00,"9,308.99","18,617.97",
13-Aug-22,Purchase,00.00,"2,068.66","16,549.31",
13-Aug-22,Purchase,00.00,"16,549.31",00.00,
13-Aug-22,Cheque,05.45,00.00,05.45,
13-Aug-22,Commission,00.00,01.09,04.36,
13-Aug-22,Transfer,00.00,04.36,00.00,
13-Aug-22,NEFT,"2,45,868.90",00.00,"2,45,868.90",
13-Aug-22,IMPS,"10,497.61",00.00,"2,56,366.51",
14-Aug-22,Commission,00.00,"28,485.17","2,27,881.34",
14-Aug-22,Interest,29,00.00,"2,27,910.34",
14-Aug-22,Purchase,04.00,00.00,"2,27,914.34",
14-Aug-22,Commission,01.44,00.00,"2,27,915.78",
14-Aug-22,ATM,00.00,"45,583.16","1,82,332.62",
14-Aug-22,Debit Card,00.00,"91,166.31","91,166.31",
14-Aug-22,RTGS,00.12,00.00,"91,166.43",
14-Aug-22,Purchase,00.00,"9,116.64","82,049.79",
14-Aug-22,Cheque,63.3,00.00,"82,113.09",
14-Aug-22,Debit Card,00.00,"11,730.44","70,382.65",
14-Aug-22,Transportellaneous,06.00,00.00,"70,388.65",
14-Aug-22,Reversal,06.00,00.00,"70,394.65",
14-Aug-22,NEFT,"14,35,762.00",00.00,"15,06,156.65",
15-Aug-22,Transportellaneous,00.00,"3,76,539.16","11,29,617.49",
15-Aug-22,Bill,437.6,00.00,"11,30,055.09",
15-Aug-22,Transfer,00.00,"1,13,005.51","10,17,049.58",
15-Aug-22,Tax,00.00,"1,27,131.20","8,89,918.38",
15-Aug-22,Debit Card,439,00.00,"8,90,357.38",
16-Aug-22,Interest,00.00,"8,90,357.38",00.00,
16-Aug-22,RTGS,246,00.00,246,
16-Aug-22,Debit Card,00.00,30.75,215.25,
16-Aug-22,RTGS,00.00,35.88,179.38,
16-Aug-22,IMPS,"1,952.83",00.00,"2,132.21",
17-Aug-22,Purchase,00.00,710.74,"1,421.47",
17-Aug-22,RTGS,00.00,355.37,"1,066.10",
17-Aug-22,NEFT,00.00,177.68,888.42,
17-Aug-22,Cheque,"2,34,988.56",00.00,"2,35,876.98",
17-Aug-22,Transportellaneous,06.46,00.00,"2,35,883.44",
17-Aug-22,Cash,"19,515.47",00.00,"2,55,398.91",
17-Aug-22,Transfer,33.05,00.00,"2,55,431.96",
18-Aug-22,Cash,404.37,00.00,"2,55,836.33",
18-Aug-22,Debit Card,00.00,"31,979.54","2,23,856.79",
18-Aug-22,Purchase,"14,554.10",00.00,"2,38,410.89",
18-Aug-22,Purchase,00.00,"47,682.18","1,90,728.71",
18-Aug-22,Cash,00.00,"27,246.96","1,63,481.75",
18-Aug-22,Transfer,22,00.00,"1,63,503.75",
18-Aug-22,Tax,"7,60,788.00",00.00,"9,24,291.75",
18-Aug-22,Transfer,02.00,00.00,"9,24,293.75",
18-Aug-22,Reversal,00.00,"3,08,097.92","6,16,195.83",
18-Aug-22,ATM,00.00,"68,466.20","5,47,729.63",
18-Aug-22,IMPS,00.00,"68,466.20","4,79,263.43",
18-Aug-22,Cheque,"2,14,418.30",00.00,"6,93,681.73",
18-Aug-22,NEFT,00.00,"2,31,227.24","4,62,454.49",
18-Aug-22,Interest,00.00,"46,245.45","4,16,209.04",
18-Aug-22,Cheque,00.00,"83,241.81","3,32,967.23",
18-Aug-22,IMPS,54.28,00.00,"3,33,021.51",
18-Aug-22,Transfer,"10,77,867.50",00.00,"14,10,889.01",
18-Aug-22,IMPS,"27,915.18",00.00,"14,38,804.19",
18-Aug-22,IMPS,"11,222.00",00.00,"14,50,026.19",
18-Aug-22,Debit Card,"18,50,584.75",00.00,"33,00,610.94",
18-Aug-22,Commission,"63,292.81",00.00,"33,63,903.75",
18-Aug-22,ATM,00.00,"3,73,767.08","29,90,136.67",
18-Aug-22,Tax,"12,80,320.00",00.00,"42,70,456.67",
18-Aug-22,Reversal,"3,201.00",00.00,"42,73,657.67",
18-Aug-22,IMPS,00.00,"42,73,657.67",00.00,
18-Aug-22,NEFT,345,00.00,345,
18-Aug-22,RTGS,03.99,00.00,348.99,
18-Aug-22,RTGS,00.00,116.33,232.66,
18-Aug-22,Transportellaneous,00.00,232.66,00.00,
18-Aug-22,Reversal,201.4,00.00,201.4,
18-Aug-22,Cheque,347,00.00,548.4,
18-Aug-22,Transfer,"8,455.80",00.00,"9,004.20",
18-Aug-22,Interest,00.00,900.42,"8,103.78",
18-Aug-22,Debit Card,00.00,"2,701.26","5,402.52",
18-Aug-22,Commission,392.9,00.00,"5,795.42",
18-Aug-22,Transportellaneous,"2,858.00",00.00,"8,653.42",
18-Aug-22,NEFT,00.00,"1,081.68","7,571.74",
18-Aug-22,RTGS,687.68,00.00,"8,259.42",
18-Aug-22,Transfer,00.00,917.71,"7,341.71",
18-Aug-22,Debit Card,05.80,00.00,"7,347.51",
18-Aug-22,Debit Card,00.00,918.44,"6,429.07",
18-Aug-22,ATM,"2,47,607.70",00.00,"2,54,036.77",
18-Aug-22,Interest,00.00,"25,403.68","2,28,633.09",
18-Aug-22,Interest,22.2,00.00,"2,28,655.29",
18-Aug-22,Cash,00.00,"1,14,327.65","1,14,327.64",
18-Aug-22,Transfer,00.00,"1,14,327.64",00.00,
18-Aug-22,IMPS,"11,21,826.00",00.00,"11,21,826.00",
18-Aug-22,Cheque,56.82,00.00,"11,21,882.82",
18-Aug-22,Transportellaneous,00.00,"3,73,960.94","7,47,921.88",
18-Aug-22,Debit Card,10.67,00.00,"7,47,932.55",
18-Aug-22,Reversal,"16,425.62",00.00,"7,64,358.17",
18-Aug-22,Debit Card,00.00,"1,27,393.03","6,36,965.14",
18-Aug-22,ATM,00.00,"70,773.90","5,66,191.24",
18-Aug-22,Purchase,00.00,"1,41,547.81","4,24,643.43",
18-Aug-22,Cash,211,00.00,"4,24,854.43",
18-Aug-22,Reversal,"2,824.50",00.00,"4,27,678.93",
18-Aug-22,Bill,02.45,00.00,"4,27,681.38",
18-Aug-22,Interest,00.00,"53,460.17","3,74,221.21",
18-Aug-22,Transfer,"1,742.00",00.00,"3,75,963.21",
18-Aug-22,Commission,"24,591.00",00.00,"4,00,554.21",
18-Aug-22,Reversal,00.00,"1,00,138.55","3,00,415.66",
18-Aug-22,Bill,00.00,"1,50,207.83","1,50,207.83",
18-Aug-22,Tax,"12,978.00",00.00,"1,63,185.83",
18-Aug-22,Tax,03.00,00.00,"1,63,188.83",
18-Aug-22,Transportellaneous,00.00,"54,396.28","1,08,792.55",
18-Aug-22,Transfer,303.95,00.00,"1,09,096.50",
18-Aug-22,NEFT,37,00.00,"1,09,133.50",
18-Aug-22,Tax,00.00,"10,913.35","98,220.15",
18-Aug-22,Transportellaneous,00.00,"16,370.03","81,850.12",
18-Aug-22,Transportellaneous,00.00,"20,462.53","61,387.59",
18-Aug-22,Commission,00.00,"8,769.66","52,617.93",
18-Aug-22,Debit Card,00.00,"17,539.31","35,078.62",
18-Aug-22,Transfer,"15,252.00",00.00,"50,330.62",
18-Aug-22,IMPS,00.00,"50,330.62",00.00,
18-Aug-22,Cheque,"1,211.20",00.00,"1,211.20",
18-Aug-22,Reversal,00.00,"1,211.20",00.00,
18-Aug-22,Reversal,"2,290.00",00.00,"2,290.00",
18-Aug-22,Cash,"3,157.00",00.00,"5,447.00",
18-Aug-22,Reversal,00.00,778.14,"4,668.86",
18-Aug-22,Transportellaneous,00.00,"2,334.43","2,334.43",
18-Aug-22,Debit Card,"1,99,587.44",00.00,"2,01,921.87",
18-Aug-22,NEFT,"13,80,859.00",00.00,"15,82,780.87",
18-Aug-22,Transportellaneous,"13,40,709.00",00.00,"29,23,489.87",
18-Aug-22,Commission,00.00,"5,84,697.97","23,38,791.90",
18-Aug-22,Interest,00.00,"3,34,113.13","20,04,678.77",
18-Aug-22,NEFT,00.00,"4,00,935.75","16,03,743.02",
18-Aug-22,Cheque,"3,745.50",00.00,"16,07,488.52",
18-Aug-22,Debit Card,164.1,00.00,"16,07,652.62",
18-Aug-22,Commission,"24,182.00",00.00,"16,31,834.62",
18-Aug-22,Tax,07.00,00.00,"16,31,841.62",
18-Aug-22,Commission,00.00,"1,81,315.74","14,50,525.88",
18-Aug-22,Cheque,411,00.00,"14,50,936.88",
18-Aug-22,Tax,00.00,"2,41,822.81","12,09,114.07",
18-Aug-22,Transportellaneous,480,00.00,"12,09,594.07",
18-Aug-22,Reversal,00.00,"2,01,599.01","10,07,995.06",
18-Aug-22,Reversal,00.00,"10,07,995.06",00.00,
18-Aug-22,Commission,"14,44,040.00",00.00,"14,44,040.00",
18-Aug-22,Purchase,04.00,00.00,"14,44,044.00",
18-Aug-22,Tax,00.00,"2,06,292.00","12,37,752.00",
18-Aug-22,Purchase,"27,236.32",00.00,"12,64,988.32",
18-Aug-22,Cheque,00.00,"1,26,498.83","11,38,489.49",
18-Aug-22,Debit Card,00.00,"1,42,311.19","9,96,178.30",
18-Aug-22,Transfer,"2,201.00",00.00,"9,98,379.30",
18-Aug-22,Commission,"12,90,920.00",00.00,"22,89,299.30",
18-Aug-22,NEFT,01.97,00.00,"22,89,301.27",
18-Aug-22,NEFT,"2,45,917.70",00.00,"25,35,218.97",
18-Aug-22,Transfer,291.52,00.00,"25,35,510.49",
19-Aug-22,IMPS,"20,947.00",00.00,"25,56,457.49",
19-Aug-22,Bill,"4,766.40",00.00,"25,61,223.89",
19-Aug-22,Commission,00.00,"3,20,152.99","22,41,070.90",
19-Aug-22,Cash,27.9,00.00,"22,41,098.80",
19-Aug-22,Tax,00.00,"4,48,219.76","17,92,879.04",
19-Aug-22,Cash,"27,833.80",00.00,"18,20,712.84",
19-Aug-22,RTGS,"20,146.41",00.00,"18,40,859.25",
19-Aug-22,Cash,00.00,"2,04,539.92","16,36,319.33",
19-Aug-22,Transportellaneous,00.00,"2,72,719.89","13,63,599.44",
19-Aug-22,ATM,187.8,00.00,"13,63,787.24",
19-Aug-22,Debit Card,13.2,00.00,"13,63,800.44",
20-Aug-22,Cash,55.47,00.00,"13,63,855.91",
20-Aug-22,Cash,"12,22,452.00",00.00,"25,86,307.91",
20-Aug-22,Interest,00.00,"12,93,153.96","12,93,153.96",
20-Aug-22,Commission,00.00,"1,84,736.28","11,08,417.68",
20-Aug-22,Bill,00.00,"1,58,345.38","9,50,072.30",
20-Aug-22,Transportellaneous,"4,623.61",00.00,"9,54,695.91",
21-Aug-22,Transfer,00.00,"3,18,231.97","6,36,463.94",
21-Aug-22,Bill,00.00,"1,59,115.99","4,77,347.95",
21-Aug-22,Cash,00.00,"59,668.49","4,17,679.46",
21-Aug-22,IMPS,00.00,"2,08,839.73","2,08,839.73",
21-Aug-22,Debit Card,00.00,"2,08,839.73",00.00,
21-Aug-22,Purchase,"12,95,967.00",00.00,"12,95,967.00",
21-Aug-22,Reversal,"20,503.60",00.00,"13,16,470.60",
21-Aug-22,Debit Card,"7,645.00",00.00,"13,24,115.60",
21-Aug-22,RTGS,00.00,"1,89,159.37","11,34,956.23",
21-Aug-22,Reversal,00.00,"1,13,495.62","10,21,460.61",
21-Aug-22,ATM,02.00,00.00,"10,21,462.61",
21-Aug-22,Transportellaneous,04.00,00.00,"10,21,466.61",
21-Aug-22,Bill,"57,206.70",00.00,"10,78,673.31",
22-Aug-22,Reversal,00.00,"3,59,557.77","7,19,115.54",
22-Aug-22,Cash,262.13,00.00,"7,19,377.67",
22-Aug-22,Commission,07.00,00.00,"7,19,384.67",
22-Aug-22,NEFT,00.00,"1,02,769.24","6,16,615.43",
22-Aug-22,Transportellaneous,"18,38,728.25",00.00,"24,55,343.68",
22-Aug-22,Tax,"2,04,629.25",00.00,"26,59,972.93",
22-Aug-22,Transfer,00.00,"4,43,328.82","22,16,644.11",
22-Aug-22,Cash,00.00,"7,38,881.37","14,77,762.74",
22-Aug-22,Cash,00.00,"7,38,881.37","7,38,881.37",
22-Aug-22,Transportellaneous,185,00.00,"7,39,066.37",
23-Aug-22,NEFT,00.00,"1,47,813.27","5,91,253.10",
23-Aug-22,NEFT,00.00,"73,906.64","5,17,346.46",
24-Aug-22,Transportellaneous,"49,486.00",00.00,"5,66,832.46",
24-Aug-22,ATM,01.00,00.00,"5,66,833.46",
24-Aug-22,Purchase,00.00,"5,66,833.46",00.00,
24-Aug-22,Debit Card,633.2,00.00,633.2,
24-Aug-22,Transportellaneous,00.00,633.2,00.00,
24-Aug-22,NEFT,"1,22,817.40",00.00,"1,22,817.40",
24-Aug-22,ATM,00.00,"20,469.57","1,02,347.83",
24-Aug-22,Tax,00.00,"25,586.96","76,760.87",
24-Aug-22,IMPS,00.00,"19,190.22","57,570.65",
24-Aug-22,Cheque,00.00,"6,396.74","51,173.91",
24-Aug-22,Commission,02.60,00.00,"51,176.51",
24-Aug-22,Bill,00.00,"25,588.26","25,588.26",
24-Aug-22,Bill,53.3,00.00,"25,641.56",
24-Aug-22,RTGS,"1,535.00",00.00,"27,176.56",
24-Aug-22,Cash,"18,01,540.80",00.00,"18,28,717.36",
24-Aug-22,Transportellaneous,00.00,"4,57,179.34","13,71,538.02",
24-Aug-22,Reversal,00.00,"1,52,393.11","12,19,144.91",
24-Aug-22,ATM,00.00,"2,03,190.82","10,15,954.09",
24-Aug-22,NEFT,00.00,"1,26,994.26","8,88,959.83",
24-Aug-22,Commission,00.00,"1,11,119.98","7,77,839.85",
24-Aug-22,Interest,57,00.00,"7,77,896.85",
24-Aug-22,Transportellaneous,07.00,00.00,"7,77,903.85",
24-Aug-22,Cheque,"1,50,945.30",00.00,"9,28,849.15",
24-Aug-22,Tax,"20,25,544.00",00.00,"29,54,393.15",
24-Aug-22,RTGS,00.00,"3,28,265.91","26,26,127.24",
24-Aug-22,RTGS,00.00,"6,56,531.81","19,69,595.43",
24-Aug-22,Interest,391,00.00,"19,69,986.43",
24-Aug-22,Transfer,00.00,"2,46,248.30","17,23,738.13",
24-Aug-22,Reversal,00.00,"2,46,248.30","14,77,489.83",
24-Aug-22,NEFT,00.00,"14,77,489.83",00.00,
24-Aug-22,Bill,07.92,00.00,07.92,
24-Aug-22,Interest,03.74,00.00,11.66,
24-Aug-22,NEFT,00.00,05.83,05.83,
24-Aug-22,Debit Card,00.00,02.92,02.92,
24-Aug-22,ATM,00.00,00.97,01.95,
24-Aug-22,Commission,59.61,00.00,61.56,
24-Aug-22,Commission,"2,685.00",00.00,"2,746.56",
24-Aug-22,Cash,"2,319.50",00.00,"5,066.06",
24-Aug-22,Bill,"14,18,262.75",00.00,"14,23,328.81",
24-Aug-22,RTGS,"15,653.82",00.00,"14,38,982.63",
24-Aug-22,Reversal,00.00,"2,87,796.53","11,51,186.10",
24-Aug-22,Tax,05.20,00.00,"11,51,191.30",
24-Aug-22,Transportellaneous,27,00.00,"11,51,218.30",
24-Aug-22,Transfer,"2,824.41",00.00,"11,54,042.71",
25-Aug-22,Tax,06.79,00.00,"11,54,049.50",
25-Aug-22,NEFT,00.00,"1,64,864.21","9,89,185.29",
25-Aug-22,Transportellaneous,29,00.00,"9,89,214.29",
25-Aug-22,Debit Card,"3,495.90",00.00,"9,92,710.19",
25-Aug-22,Commission,"6,073.30",00.00,"9,98,783.49",
25-Aug-22,Commission,"4,547.60",00.00,"10,03,331.09",
25-Aug-22,RTGS,"1,64,848.00",00.00,"11,68,179.09",
25-Aug-22,Bill,"1,881.20",00.00,"11,70,060.29",
26-Aug-22,Interest,00.00,"2,34,012.06","9,36,048.23",
27-Aug-22,Cash,00.00,"1,87,209.65","7,48,838.58",
27-Aug-22,Reversal,00.00,"1,49,767.72","5,99,070.86",
27-Aug-22,RTGS,"2,866.30",00.00,"6,01,937.16",
27-Aug-22,Debit Card,"10,319.00",00.00,"6,12,256.16",
27-Aug-22,RTGS,00.00,"6,12,256.16",00.00,
27-Aug-22,Purchase,"3,725.48",00.00,"3,725.48",
27-Aug-22,Reversal,497.2,00.00,"4,222.68",
27-Aug-22,Bill,00.00,"1,055.67","3,167.01",
27-Aug-22,NEFT,04.10,00.00,"3,171.11",
27-Aug-22,Bill,"2,24,813.10",00.00,"2,27,984.21",
27-Aug-22,Cash,"7,80,278.50",00.00,"10,08,262.71",
27-Aug-22,Cheque,00.00,"1,00,826.27","9,07,436.44",
27-Aug-22,Transfer,00.00,"90,743.64","8,16,692.80",
27-Aug-22,Debit Card,00.00,"90,743.64","7,25,949.16",
27-Aug-22,RTGS,00.00,"2,41,983.05","4,83,966.11",
27-Aug-22,Debit Card,00.00,"1,20,991.53","3,62,974.58",
27-Aug-22,Commission,00.00,"1,20,991.53","2,41,983.05",
27-Aug-22,Transportellaneous,00.00,"60,495.76","1,81,487.29",
27-Aug-22,Transfer,00.00,"36,297.46","1,45,189.83",
28-Aug-22,Transportellaneous,00.00,"24,198.31","1,20,991.52",
28-Aug-22,Reversal,"2,11,545.00",00.00,"3,32,536.52",
28-Aug-22,Bill,01.00,00.00,"3,32,537.52",
28-Aug-22,Cheque,00.00,"83,134.38","2,49,403.14",
29-Aug-22,IMPS,00.00,"49,880.63","1,99,522.51",
29-Aug-22,Cheque,00.00,"1,99,522.51",00.00,
29-Aug-22,Bill,400.1,00.00,400.1,
29-Aug-22,Reversal,00.00,44.46,355.64,
29-Aug-22,Purchase,00.00,50.81,304.83,
29-Aug-22,Tax,"17,25,884.00",00.00,"17,26,188.83",
29-Aug-22,Cash,01.61,00.00,"17,26,190.44",
29-Aug-22,Interest,00.00,"17,26,190.44",00.00,
29-Aug-22,Bill,06.40,00.00,06.40,
29-Aug-22,RTGS,00.00,00.71,05.69,
29-Aug-22,Reversal,00.00,02.85,02.84,
29-Aug-22,RTGS,00.00,00.41,02.43,
29-Aug-22,Commission,00.00,01.22,01.22,
29-Aug-22,Purchase,"1,02,374.25",00.00,"1,02,375.47",
29-Aug-22,ATM,00.00,"12,796.93","89,578.54",
29-Aug-22,Commission,00.00,"11,197.32","78,381.22",
29-Aug-22,RTGS,00.00,"78,381.22",00.00,
29-Aug-22,Bill,"20,289.00",00.00,"20,289.00",
29-Aug-22,Cheque,07.00,00.00,"20,296.00",
29-Aug-22,Reversal,00.00,"10,148.00","10,148.00",
29-Aug-22,Transportellaneous,"67,975.00",00.00,"78,123.00",
29-Aug-22,Bill,91,00.00,"78,214.00",
29-Aug-22,ATM,00.00,"11,173.43","67,040.57",
29-Aug-22,Commission,"23,793.65",00.00,"90,834.22",
29-Aug-22,Tax,00.00,"10,092.69","80,741.53",
29-Aug-22,NEFT,"21,534.30",00.00,"1,02,275.83",
29-Aug-22,Reversal,"1,458.00",00.00,"1,03,733.83",
29-Aug-22,ATM,33.13,00.00,"1,03,766.96",
29-Aug-22,Cash,00.00,"25,941.74","77,825.22",
29-Aug-22,Cash,418.81,00.00,"78,244.03",
29-Aug-22,Purchase,00.00,"26,081.34","52,162.69",
29-Aug-22,Purchase,00.20,00.00,"52,162.89",
29-Aug-22,RTGS,00.00,"17,387.63","34,775.26",
29-Aug-22,Bill,00.00,"5,795.88","28,979.38",
29-Aug-22,Cheque,"1,51,538.00",00.00,"1,80,517.38",
29-Aug-22,Commission,"41,359.00",00.00,"2,21,876.38",
29-Aug-22,Commission,492,00.00,"2,22,368.38",
29-Aug-22,Bill,"10,890.31",00.00,"2,33,258.69",
29-Aug-22,Tax,"29,192.50",00.00,"2,62,451.19",
29-Aug-22,Transfer,00.00,"1,31,225.60","1,31,225.60",
29-Aug-22,Cheque,311.8,00.00,"1,31,537.40",
29-Aug-22,Transportellaneous,00.00,"13,153.74","1,18,383.66",
29-Aug-22,Transportellaneous,00.00,"19,730.61","98,653.05",
29-Aug-22,RTGS,04.52,00.00,"98,657.57",
29-Aug-22,ATM,00.00,"98,657.57",00.00,
29-Aug-22,NEFT,18.3,00.00,18.3,
29-Aug-22,Purchase,00.00,04.58,13.73,
29-Aug-22,Purchase,00.00,01.37,12.36,
29-Aug-22,Transfer,00.00,03.09,09.27,
29-Aug-22,Transfer,"22,150.62",00.00,"22,159.89",
29-Aug-22,Interest,00.00,"3,165.70","18,994.19",
29-Aug-22,Transfer,00.00,"2,713.46","16,280.73",
29-Aug-22,Interest,00.00,"1,808.97","14,471.76",
29-Aug-22,Bill,"13,23,008.00",00.00,"13,37,479.76",
29-Aug-22,Transfer,"1,13,493.47",00.00,"14,50,973.23",
29-Aug-22,Tax,02.00,00.00,"14,50,975.23",
29-Aug-22,ATM,00.00,"7,25,487.62","7,25,487.62",
29-Aug-22,RTGS,09.00,00.00,"7,25,496.62",
29-Aug-22,ATM,00.00,"1,81,374.16","5,44,122.46",
29-Aug-22,Tax,"32,585.95",00.00,"5,76,708.41",
29-Aug-22,Reversal,00.00,"96,118.07","4,80,590.34",
30-Aug-22,Cheque,"5,98,134.00",00.00,"10,78,724.34",
30-Aug-22,Cash,03.85,00.00,"10,78,728.19",
30-Aug-22,ATM,00.00,"2,69,682.05","8,09,046.14",
30-Aug-22,Interest,00.00,"2,69,682.05","5,39,364.09",
30-Aug-22,Bill,"2,806.60",00.00,"5,42,170.69",
30-Aug-22,Debit Card,00.00,"90,361.78","4,51,808.91",
30-Aug-22,Commission,04.00,00.00,"4,51,812.91",
30-Aug-22,NEFT,00.00,"45,181.29","4,06,631.62",
30-Aug-22,Cash,"1,708.00",00.00,"4,08,339.62",
30-Aug-22,ATM,"3,678.60",00.00,"4,12,018.22",
30-Aug-22,Debit Card,377.03,00.00,"4,12,395.25",
30-Aug-22,Reversal,00.00,"58,913.61","3,53,481.64",
30-Aug-22,Bill,00.00,"58,913.61","2,94,568.03",
30-Aug-22,Interest,196,00.00,"2,94,764.03",
30-Aug-22,Debit Card,00.00,"1,47,382.02","1,47,382.02",
30-Aug-22,Transfer,54.1,00.00,"1,47,436.12",
30-Aug-22,Purchase,00.00,"29,487.22","1,17,948.90",
30-Aug-22,ATM,"1,561.00",00.00,"1,19,509.90",
30-Aug-22,Commission,527.26,00.00,"1,20,037.16",
30-Aug-22,Debit Card,00.00,"1,20,037.16",00.00,
31-Aug-22,ATM,336,00.00,336,
31-Aug-22,Cash,00.00,336,00.00,
31-Aug-22,Purchase,"1,32,959.81",00.00,"1,32,959.81",
31-Aug-22,Debit Card,00.00,"26,591.96","1,06,367.85",
31-Aug-22,Commission,00.00,"1,06,367.85",00.00,
31-Aug-22,Cash,"28,839.06",00.00,"28,839.06",
31-Aug-22,Interest,33,00.00,"28,872.06",
31-Aug-22,RTGS,00.00,"14,436.03","14,436.03",
31-Aug-22,ATM,00.00,"2,887.21","11,548.82",
31-Aug-22,Tax,00.00,"5,774.41","5,774.41",
31-Aug-22,ATM,"31,444.50",00.00,"37,218.91",
31-Aug-22,Debit Card,00.00,"37,218.91",00.00,
31-Aug-22,Bill,"27,753.80",00.00,"27,753.80",
31-Aug-22,Transfer,"1,55,769.20",00.00,"1,83,523.00",
31-Aug-22,Interest,00.00,"91,761.50","91,761.50",
31-Aug-22,Transportellaneous,60,00.00,"91,821.50",
31-Aug-22,Interest,"89,503.10",00.00,"1,81,324.60",
01-Sep-22,Purchase,"2,426.00",00.00,"1,83,750.60",
01-Sep-22,Purchase,"18,853.00",00.00,"2,02,603.60",
01-Sep-22,Commission,00.00,"50,650.90","1,51,952.70",
01-Sep-22,Interest,53,00.00,"1,52,005.70",
02-Sep-22,Bill,498,00.00,"1,52,503.70",
02-Sep-22,Reversal,00.00,"30,500.74","1,22,002.96",
02-Sep-22,Interest,360,00.00,"1,22,362.96",
02-Sep-22,Debit Card,13.8,00.00,"1,22,376.76",
02-Sep-22,Debit Card,185.3,00.00,"1,22,562.06",
02-Sep-22,NEFT,02.30,00.00,"1,22,564.36",
02-Sep-22,Transfer,"6,136.40",00.00,"1,28,700.76",
02-Sep-22,Cheque,314.7,00.00,"1,29,015.46",
02-Sep-22,Transfer,00.00,"16,126.93","1,12,888.53",
02-Sep-22,IMPS,00.00,"56,444.27","56,444.26",
02-Sep-22,Purchase,00.00,"5,644.43","50,799.83",
02-Sep-22,Cheque,00.00,"50,799.83",00.00,
02-Sep-22,Interest,416.6,00.00,416.6,
02-Sep-22,ATM,00.00,69.43,347.17,
02-Sep-22,Transportellaneous,"16,03,070.20",00.00,"16,03,417.37",
02-Sep-22,Transportellaneous,00.00,"8,01,708.69","8,01,708.68",
02-Sep-22,Cheque,00.00,"1,00,213.59","7,01,495.10",
02-Sep-22,Commission,"5,68,946.00",00.00,"12,70,441.10",
02-Sep-22,ATM,"1,855.90",00.00,"12,72,297.00",
02-Sep-22,NEFT,123.6,00.00,"12,72,420.60",
02-Sep-22,Cheque,"17,090.23",00.00,"12,89,510.83",
02-Sep-22,Bill,"18,37,868.50",00.00,"31,27,379.33",
02-Sep-22,Transfer,00.00,"6,25,475.87","25,01,903.46",
02-Sep-22,Commission,00.00,"6,25,475.87","18,76,427.60",
02-Sep-22,Debit Card,172.31,00.00,"18,76,599.91",
03-Sep-22,Transfer,00.00,"18,76,599.91",00.00,
03-Sep-22,Interest,13,00.00,13,
03-Sep-22,Transportellaneous,00.00,04.33,08.67,
03-Sep-22,Cheque,00.00,02.17,06.50,
03-Sep-22,Commission,00.00,02.17,04.33,
03-Sep-22,Cheque,53.8,00.00,58.13,
03-Sep-22,IMPS,00.00,14.53,43.6,
03-Sep-22,Interest,"18,13,351.75",00.00,"18,13,395.35",
03-Sep-22,Transportellaneous,00.00,"1,81,339.54","16,32,055.82",
03-Sep-22,RTGS,"15,814.71",00.00,"16,47,870.53",
03-Sep-22,Cash,"17,63,079.00",00.00,"34,10,949.53",
03-Sep-22,Interest,"5,29,818.75",00.00,"39,40,768.28",
03-Sep-22,Purchase,00.00,"5,62,966.90","33,77,801.38",
03-Sep-22,Transportellaneous,"28,275.00",00.00,"34,06,076.38",
03-Sep-22,Bill,00.00,"5,67,679.40","28,38,396.98",
03-Sep-22,Bill,218.2,00.00,"28,38,615.18",
03-Sep-22,Transportellaneous,45,00.00,"28,38,660.18",
03-Sep-22,Transfer,50.4,00.00,"28,38,710.58",
03-Sep-22,ATM,00.00,"14,19,355.29","14,19,355.29",
03-Sep-22,Purchase,00.00,"2,02,765.04","12,16,590.25",
03-Sep-22,Interest,"9,37,902.00",00.00,"21,54,492.25",
03-Sep-22,Commission,00.00,"3,07,784.61","18,46,707.64",
03-Sep-22,Interest,"1,81,329.00",00.00,"20,28,036.64",
03-Sep-22,Commission,"27,903.81",00.00,"20,55,940.45",
03-Sep-22,Bill,00.00,"6,85,313.48","13,70,626.97",
03-Sep-22,Debit Card,"2,31,855.16",00.00,"16,02,482.13",
03-Sep-22,IMPS,00.00,"4,00,620.53","12,01,861.60",
03-Sep-22,Debit Card,00.00,"6,00,930.80","6,00,930.80",
03-Sep-22,Purchase,168.22,00.00,"6,01,099.02",
03-Sep-22,ATM,36,00.00,"6,01,135.02",
03-Sep-22,IMPS,00.00,"85,876.43","5,15,258.59",
03-Sep-22,RTGS,"1,879.00",00.00,"5,17,137.59",
03-Sep-22,Bill,00.00,"51,713.76","4,65,423.83",
03-Sep-22,Transfer,00.00,"58,177.98","4,07,245.85",
03-Sep-22,Commission,"25,749.12",00.00,"4,32,994.97",
03-Sep-22,IMPS,00.00,"72,165.83","3,60,829.14",
03-Sep-22,IMPS,00.00,"1,80,414.57","1,80,414.57",
03-Sep-22,Commission,00.00,"60,138.19","1,20,276.38",
03-Sep-22,Transfer,318.37,00.00,"1,20,594.75",
03-Sep-22,NEFT,"6,79,552.00",00.00,"8,00,146.75",
03-Sep-22,Debit Card,00.00,"4,00,073.38","4,00,073.38",
03-Sep-22,Commission,"1,97,224.70",00.00,"5,97,298.08",
04-Sep-22,Transfer,00.00,"2,98,649.04","2,98,649.04",
04-Sep-22,Cash,"16,86,962.80",00.00,"19,85,611.84",
04-Sep-22,Commission,"3,627.00",00.00,"19,89,238.84",
04-Sep-22,Purchase,00.00,"2,84,176.98","17,05,061.86",
04-Sep-22,Reversal,00.00,"1,70,506.19","15,34,555.67",
04-Sep-22,Reversal,"38,448.72",00.00,"15,73,004.39",
04-Sep-22,IMPS,04.60,00.00,"15,73,008.99",
04-Sep-22,NEFT,00.00,"5,24,336.33","10,48,672.66",
04-Sep-22,RTGS,00.00,"1,74,778.78","8,73,893.88",
04-Sep-22,Purchase,"1,571.00",00.00,"8,75,464.88",
05-Sep-22,Transportellaneous,01.00,00.00,"8,75,465.88",
05-Sep-22,Bill,00.00,"1,09,433.24","7,66,032.64",
05-Sep-22,Transfer,00.00,"1,53,206.53","6,12,826.11",
05-Sep-22,IMPS,00.00,"68,091.79","5,44,734.32",
05-Sep-22,Reversal,"9,396.52",00.00,"5,54,130.84",
05-Sep-22,Cheque,"5,900.00",00.00,"5,60,030.84",
05-Sep-22,Debit Card,00.00,"93,338.47","4,66,692.37",
05-Sep-22,Purchase,00.00,"51,854.71","4,14,837.66",
05-Sep-22,Commission,00.00,"2,07,418.83","2,07,418.83",
05-Sep-22,RTGS,00.00,"1,03,709.42","1,03,709.42",
05-Sep-22,Transfer,"29,295.30",00.00,"1,33,004.72",
05-Sep-22,Reversal,"1,86,338.20",00.00,"3,19,342.92",
06-Sep-22,RTGS,00.00,"63,868.58","2,55,474.34",
06-Sep-22,Cash,"1,08,630.91",00.00,"3,64,105.25",
06-Sep-22,Debit Card,06.00,00.00,"3,64,111.25",
06-Sep-22,NEFT,00.00,"36,411.13","3,27,700.12",
06-Sep-22,Reversal,"1,280.79",00.00,"3,28,980.91",
06-Sep-22,Commission,164.4,00.00,"3,29,145.31",
06-Sep-22,Purchase,00.00,"54,857.55","2,74,287.76",
06-Sep-22,Transfer,00.00,"1,37,143.88","1,37,143.88",
06-Sep-22,Debit Card,00.00,"19,591.98","1,17,551.90",
06-Sep-22,Purchase,00.00,"39,183.97","78,367.93",
06-Sep-22,Interest,"3,473.40",00.00,"81,841.33",
06-Sep-22,Commission,49,00.00,"81,890.33",
06-Sep-22,Commission,"18,46,024.50",00.00,"19,27,914.83",
06-Sep-22,Bill,00.00,"6,42,638.28","12,85,276.55",
06-Sep-22,Bill,"2,880.13",00.00,"12,88,156.68",
06-Sep-22,RTGS,00.00,"1,61,019.59","11,27,137.10",
06-Sep-22,NEFT,32,00.00,"11,27,169.10",
06-Sep-22,Transfer,00.00,"3,75,723.03","7,51,446.07",
07-Sep-22,Bill,00.00,"7,51,446.07",00.00,
07-Sep-22,Purchase,354,00.00,354,
07-Sep-22,Purchase,00.00,00.00,354,
07-Sep-22,Transfer,"3,907.90",00.00,"4,261.90",
07-Sep-22,Cash,01.20,00.00,"4,263.10",
07-Sep-22,Cash,04.70,00.00,"4,267.80",
07-Sep-22,IMPS,20.53,00.00,"4,288.33",
07-Sep-22,Interest,00.00,"4,288.33",00.00,
07-Sep-22,Purchase,30.15,00.00,30.15,
07-Sep-22,Debit Card,00.00,10.05,20.1,
07-Sep-22,Debit Card,00.00,20.1,00.00,
07-Sep-22,Purchase,"19,51,788.00",00.00,"19,51,788.00",
07-Sep-22,Purchase,00.00,"2,43,973.50","17,07,814.50",
07-Sep-22,Transportellaneous,53.9,00.00,"17,07,868.40",
07-Sep-22,ATM,30.7,00.00,"17,07,899.10",
07-Sep-22,Interest,"27,689.24",00.00,"17,35,588.34",
07-Sep-22,Tax,00.00,"2,16,948.54","15,18,639.80",
07-Sep-22,RTGS,00.00,"3,79,659.95","11,38,979.85",
07-Sep-22,ATM,00.00,"1,42,372.48","9,96,607.37",
07-Sep-22,Reversal,00.00,"1,24,575.92","8,72,031.45",
07-Sep-22,Bill,00.00,"1,09,003.93","7,63,027.52",
07-Sep-22,Bill,00.00,"76,302.75","6,86,724.77",
07-Sep-22,Commission,00.00,"1,71,681.19","5,15,043.58",
07-Sep-22,IMPS,"3,111.20",00.00,"5,18,154.78",
07-Sep-22,Cash,00.00,"64,769.35","4,53,385.43",
07-Sep-22,Interest,456.4,00.00,"4,53,841.83",
07-Sep-22,ATM,22,00.00,"4,53,863.83",
07-Sep-22,Reversal,00.00,"1,13,465.96","3,40,397.87",
07-Sep-22,Bill,"13,916.40",00.00,"3,54,314.27",
07-Sep-22,ATM,"2,449.90",00.00,"3,56,764.17",
07-Sep-22,Purchase,00.00,"1,18,921.39","2,37,842.78",
07-Sep-22,Cheque,"7,24,251.00",00.00,"9,62,093.78",
07-Sep-22,NEFT,"1,481.60",00.00,"9,63,575.38",
07-Sep-22,ATM,00.00,"2,40,893.85","7,22,681.54",
07-Sep-22,ATM,08.00,00.00,"7,22,689.54",
07-Sep-22,Commission,00.00,"80,298.84","6,42,390.70",
07-Sep-22,Commission,"11,62,512.00",00.00,"18,04,902.70",
07-Sep-22,Interest,"1,97,031.47",00.00,"20,01,934.17",
07-Sep-22,Reversal,00.00,"6,67,311.39","13,34,622.78",
07-Sep-22,Reversal,"11,929.00",00.00,"13,46,551.78",
07-Sep-22,ATM,"3,968.00",00.00,"13,50,519.78",
07-Sep-22,Bill,00.00,"4,50,173.26","9,00,346.52",
07-Sep-22,IMPS,05.80,00.00,"9,00,352.32",
07-Sep-22,ATM,347.17,00.00,"9,00,699.49",
07-Sep-22,Tax,00.00,"9,00,699.49",00.00,
07-Sep-22,RTGS,309.58,00.00,309.58,
07-Sep-22,Bill,00.00,44.23,265.35,
07-Sep-22,Tax,"2,16,893.00",00.00,"2,17,158.35",
07-Sep-22,ATM,00.00,"2,17,158.35",00.00,
07-Sep-22,Commission,"8,73,012.80",00.00,"8,73,012.80",
07-Sep-22,Transfer,00.00,"87,301.28","7,85,711.52",
07-Sep-22,Bill,03.10,00.00,"7,85,714.62",
07-Sep-22,Transportellaneous,114,00.00,"7,85,828.62",
07-Sep-22,Transportellaneous,"2,484.00",00.00,"7,88,312.62",
07-Sep-22,Commission,00.00,"87,590.29","7,00,722.33",
07-Sep-22,Transportellaneous,00.00,"70,072.23","6,30,650.10",
07-Sep-22,Interest,00.00,"1,05,108.35","5,25,541.75",
07-Sep-22,Transportellaneous,00.00,"52,554.18","4,72,987.58",
07-Sep-22,Reversal,00.10,00.00,"4,72,987.68",
07-Sep-22,Cheque,00.00,"52,554.19","4,20,433.49",
07-Sep-22,Bill,00.00,"42,043.35","3,78,390.14",
08-Sep-22,Commission,234,00.00,"3,78,624.14",
08-Sep-22,Commission,"18,106.30",00.00,"3,96,730.44",
08-Sep-22,ATM,"1,576.00",00.00,"3,98,306.44",
08-Sep-22,IMPS,00.00,"99,576.61","2,98,729.83",
08-Sep-22,IMPS,00.00,"1,49,364.92","1,49,364.92",
08-Sep-22,Commission,684.53,00.00,"1,50,049.45",
08-Sep-22,Interest,"91,679.00",00.00,"2,41,728.45",
08-Sep-22,Reversal,209,00.00,"2,41,937.45",
08-Sep-22,ATM,00.00,"1,20,968.73","1,20,968.72",
08-Sep-22,Cheque,00.00,"15,121.09","1,05,847.63",
08-Sep-22,ATM,00.00,"13,230.95","92,616.68",
08-Sep-22,Reversal,"15,94,963.00",00.00,"16,87,579.68",
08-Sep-22,Interest,00.00,"2,81,263.28","14,06,316.40",
08-Sep-22,Cheque,00.00,"14,06,316.40",00.00,
08-Sep-22,Debit Card,68.3,00.00,68.3,
08-Sep-22,ATM,"1,726.00",00.00,"1,794.30",
09-Sep-22,IMPS,06.00,00.00,"1,800.30",
09-Sep-22,Cash,00.00,225.04,"1,575.26",
09-Sep-22,Cheque,"2,33,855.25",00.00,"2,35,430.51",
09-Sep-22,RTGS,03.00,00.00,"2,35,433.51",
09-Sep-22,Transportellaneous,00.00,"2,35,433.51",00.00,
09-Sep-22,Cheque,32.5,00.00,32.5,
09-Sep-22,Reversal,00.00,03.61,28.89,
09-Sep-22,IMPS,00.00,14.45,14.44,
09-Sep-22,Tax,00.00,01.60,12.84,
09-Sep-22,Transportellaneous,"2,59,194.70",00.00,"2,59,207.54",
09-Sep-22,ATM,"23,719.00",00.00,"2,82,926.54",
09-Sep-22,RTGS,00.10,00.00,"2,82,926.64",
09-Sep-22,Debit Card,"2,551.00",00.00,"2,85,477.64",
09-Sep-22,Cash,00.00,"40,782.52","2,44,695.12",
09-Sep-22,Transportellaneous,00.00,"48,939.02","1,95,756.10",
09-Sep-22,IMPS,00.00,"19,575.61","1,76,180.49",
09-Sep-22,Cheque,"18,109.00",00.00,"1,94,289.49",
09-Sep-22,Reversal,11,00.00,"1,94,300.49",
09-Sep-22,Cheque,"2,12,043.20",00.00,"4,06,343.69",
09-Sep-22,RTGS,00.00,"58,049.10","3,48,294.59",
09-Sep-22,Tax,00.00,"43,536.82","3,04,757.77",
09-Sep-22,Cheque,438,00.00,"3,05,195.77",
09-Sep-22,Bill,00.00,"3,05,195.77",00.00,
09-Sep-22,IMPS,04.00,00.00,04.00,
09-Sep-22,RTGS,00.00,01.00,03.00,
09-Sep-22,Interest,144.66,00.00,147.66,
09-Sep-22,Purchase,00.00,147.66,00.00,
09-Sep-22,IMPS,"2,442.10",00.00,"2,442.10",
09-Sep-22,NEFT,00.00,271.34,"2,170.76",
09-Sep-22,ATM,00.00,271.35,"1,899.42",
09-Sep-22,Debit Card,24,00.00,"1,923.42",
09-Sep-22,Reversal,00.00,240.43,"1,682.99",
09-Sep-22,Debit Card,00.14,00.00,"1,683.13",
09-Sep-22,Cash,"1,49,874.90",00.00,"1,51,558.03",
09-Sep-22,Tax,00.00,"30,311.61","1,21,246.42",
09-Sep-22,Debit Card,"13,615.52",00.00,"1,34,861.94",
09-Sep-22,Tax,415,00.00,"1,35,276.94",
09-Sep-22,Debit Card,00.00,"1,35,276.94",00.00,
09-Sep-22,Cash,02.00,00.00,02.00,
09-Sep-22,Bill,00.00,00.22,01.78,
09-Sep-22,Bill,"1,563.00",00.00,"1,564.78",
09-Sep-22,Transportellaneous,262.7,00.00,"1,827.48",
09-Sep-22,Commission,00.00,261.07,"1,566.41",
09-Sep-22,IMPS,00.00,174.05,"1,392.36",
09-Sep-22,Debit Card,06.00,00.00,"1,398.36",
09-Sep-22,Tax,00.00,"1,398.36",00.00,
09-Sep-22,IMPS,"3,726.13",00.00,"3,726.13",
09-Sep-22,Bill,00.00,"1,863.07","1,863.06",
09-Sep-22,Bill,95.7,00.00,"1,958.76",
09-Sep-22,RTGS,00.00,217.64,"1,741.12",
09-Sep-22,RTGS,"63,996.40",00.00,"65,737.52",
09-Sep-22,Cash,"1,30,765.00",00.00,"1,96,502.52",
09-Sep-22,Transfer,58.2,00.00,"1,96,560.72",
09-Sep-22,Tax,"19,85,982.00",00.00,"21,82,542.72",
09-Sep-22,Transfer,00.00,"2,42,504.75","19,40,037.97",
09-Sep-22,Transfer,"1,22,867.00",00.00,"20,62,904.97",
09-Sep-22,ATM,24.52,00.00,"20,62,929.49",
09-Sep-22,Tax,00.00,"3,43,821.58","17,19,107.91",
09-Sep-22,Purchase,446.4,00.00,"17,19,554.31",
09-Sep-22,NEFT,"7,400.05",00.00,"17,26,954.36",
09-Sep-22,Reversal,"30,228.86",00.00,"17,57,183.22",
09-Sep-22,IMPS,03.60,00.00,"17,57,186.82",
09-Sep-22,Transfer,689.3,00.00,"17,57,876.12",
09-Sep-22,Cash,00.00,"2,51,125.16","15,06,750.96",
09-Sep-22,Tax,00.00,"7,53,375.48","7,53,375.48",
10-Sep-22,IMPS,06.44,00.00,"7,53,381.92",
10-Sep-22,Debit Card,"19,170.70",00.00,"7,72,552.62",
10-Sep-22,Cheque,59,00.00,"7,72,611.62",
10-Sep-22,Interest,00.00,"1,28,768.60","6,43,843.02",
10-Sep-22,Transfer,"12,399.70",00.00,"6,56,242.72",
11-Sep-22,Transportellaneous,00.00,"1,09,373.79","5,46,868.93",
11-Sep-22,Cash,00.00,"60,763.21","4,86,105.72",
11-Sep-22,Cash,63.7,00.00,"4,86,169.42",
11-Sep-22,RTGS,653.3,00.00,"4,86,822.72",
11-Sep-22,RTGS,00.00,"69,546.10","4,17,276.62",
11-Sep-22,Cheque,00.00,"41,727.66","3,75,548.96",
11-Sep-22,Tax,00.00,"37,554.90","3,37,994.06",
11-Sep-22,Cash,"2,20,440.06",00.00,"5,58,434.12",
11-Sep-22,Reversal,469.18,00.00,"5,58,903.30",
11-Sep-22,Cheque,03.50,00.00,"5,58,906.80",
11-Sep-22,IMPS,00.00,"93,151.13","4,65,755.67",
11-Sep-22,Cash,00.00,"1,16,438.92","3,49,316.75",
11-Sep-22,Debit Card,00.00,"58,219.46","2,91,097.29",
11-Sep-22,Transportellaneous,"89,685.00",00.00,"3,80,782.29",
11-Sep-22,Transfer,04.00,00.00,"3,80,786.29",
11-Sep-22,RTGS,00.00,"1,90,393.15","1,90,393.14",
11-Sep-22,Reversal,"90,967.80",00.00,"2,81,360.94",
11-Sep-22,Bill,11,00.00,"2,81,371.94",
11-Sep-22,IMPS,"2,12,787.50",00.00,"4,94,159.44",
11-Sep-22,Bill,16.8,00.00,"4,94,176.24",
11-Sep-22,Cheque,06.60,00.00,"4,94,182.84",
11-Sep-22,Purchase,204.49,00.00,"4,94,387.33",
11-Sep-22,RTGS,"2,264.70",00.00,"4,96,652.03",
11-Sep-22,IMPS,"9,661.56",00.00,"5,06,313.59",
11-Sep-22,Cash,16,00.00,"5,06,329.59",
11-Sep-22,Purchase,00.00,"50,632.96","4,55,696.63",
11-Sep-22,Tax,00.00,"45,569.66","4,10,126.97",
11-Sep-22,Transportellaneous,14,00.00,"4,10,140.97",
11-Sep-22,NEFT,00.00,"1,36,713.66","2,73,427.31",
11-Sep-22,Transportellaneous,00.00,"39,061.04","2,34,366.27",
11-Sep-22,Reversal,"2,11,605.00",00.00,"4,45,971.27",
11-Sep-22,Cash,00.00,"1,48,657.09","2,97,314.18",
11-Sep-22,NEFT,"66,881.30",00.00,"3,64,195.48",
11-Sep-22,Purchase,"2,35,515.50",00.00,"5,99,710.98",
11-Sep-22,Transportellaneous,00.00,"1,19,942.20","4,79,768.78",
11-Sep-22,Cash,00.00,"68,538.40","4,11,230.38",
11-Sep-22,Transfer,"7,12,301.25",00.00,"11,23,531.63",
11-Sep-22,Purchase,00.00,"1,12,353.16","10,11,178.47",
11-Sep-22,Cash,"46,795.30",00.00,"10,57,973.77",
11-Sep-22,IMPS,00.00,"1,17,552.64","9,40,421.13",
11-Sep-22,IMPS,"67,118.00",00.00,"10,07,539.13",
11-Sep-22,Purchase,03.80,00.00,"10,07,542.93",
11-Sep-22,Reversal,00.00,"1,00,754.29","9,06,788.64",
11-Sep-22,IMPS,"7,54,675.50",00.00,"16,61,464.14",
11-Sep-22,Transportellaneous,00.00,"1,84,607.13","14,76,857.01",
11-Sep-22,Reversal,00.00,"4,92,285.67","9,84,571.34",
11-Sep-22,RTGS,450.31,00.00,"9,85,021.65",
11-Sep-22,Debit Card,"1,393.20",00.00,"9,86,414.85",
11-Sep-22,Commission,03.10,00.00,"9,86,417.95",
11-Sep-22,Transportellaneous,00.00,"2,46,604.49","7,39,813.46",
11-Sep-22,RTGS,"9,07,444.00",00.00,"16,47,257.46",
11-Sep-22,NEFT,00.00,"5,49,085.82","10,98,171.64",
11-Sep-22,Commission,00.00,"2,19,634.33","8,78,537.31",
11-Sep-22,Reversal,444,00.00,"8,78,981.31",
11-Sep-22,Tax,"9,84,423.00",00.00,"18,63,404.31",
11-Sep-22,Reversal,00.00,"6,21,134.77","12,42,269.54",
11-Sep-22,Debit Card,17.98,00.00,"12,42,287.52",
11-Sep-22,Transfer,197,00.00,"12,42,484.52",
11-Sep-22,Transportellaneous,00.00,"6,21,242.26","6,21,242.26",
11-Sep-22,Transportellaneous,00.00,"1,03,540.38","5,17,701.88",
11-Sep-22,Commission,00.00,"1,72,567.29","3,45,134.59",
11-Sep-22,Purchase,00.00,"86,283.65","2,58,850.94",
11-Sep-22,Reversal,01.00,00.00,"2,58,851.94",
11-Sep-22,Transfer,00.00,"64,712.99","1,94,138.96",
11-Sep-22,Cheque,00.00,"21,571.00","1,72,567.96",
11-Sep-22,Tax,"2,12,374.50",00.00,"3,84,942.46",
11-Sep-22,Transportellaneous,"1,739.60",00.00,"3,86,682.06",
11-Sep-22,RTGS,"2,14,567.00",00.00,"6,01,249.06",
11-Sep-22,Debit Card,"1,37,216.66",00.00,"7,38,465.72",
11-Sep-22,IMPS,292,00.00,"7,38,757.72",
11-Sep-22,ATM,09.90,00.00,"7,38,767.62",
11-Sep-22,ATM,00.00,"82,085.29","6,56,682.33",
11-Sep-22,RTGS,00.00,"93,811.76","5,62,870.57",
11-Sep-22,Commission,00.00,"5,62,870.57",00.00,
11-Sep-22,Cheque,285.14,00.00,285.14,
11-Sep-22,Cheque,364,00.00,649.14,
11-Sep-22,Cash,00.00,81.14,568,
11-Sep-22,Reversal,"1,23,467.00",00.00,"1,24,035.00",
11-Sep-22,Debit Card,00.00,"17,719.29","1,06,315.71",
11-Sep-22,Cash,01.00,00.00,"1,06,316.71",
11-Sep-22,Bill,"22,863.70",00.00,"1,29,180.41",
11-Sep-22,Bill,00.00,"18,454.34","1,10,726.07",
11-Sep-22,Cash,00.00,"11,072.61","99,653.46",
11-Sep-22,Cash,00.00,"33,217.82","66,435.64",
11-Sep-22,Purchase,"1,72,538.20",00.00,"2,38,973.84",
11-Sep-22,Transportellaneous,00.00,"59,743.46","1,79,230.38",
11-Sep-22,NEFT,00.00,"35,846.08","1,43,384.30",
11-Sep-22,Interest,"3,011.30",00.00,"1,46,395.60",
11-Sep-22,Transportellaneous,"9,193.00",00.00,"1,55,588.60",
12-Sep-22,Tax,00.00,"19,448.58","1,36,140.02",
12-Sep-22,ATM,03.20,00.00,"1,36,143.22",
12-Sep-22,Debit Card,313.06,00.00,"1,36,456.28",
12-Sep-22,RTGS,00.00,"34,114.07","1,02,342.21",
12-Sep-22,Bill,00.00,"11,371.36","90,970.85",
12-Sep-22,Cash,"1,167.38",00.00,"92,138.23",
12-Sep-22,Tax,267.18,00.00,"92,405.41",
12-Sep-22,Cheque,"16,743.30",00.00,"1,09,148.71",
13-Sep-22,Tax,00.00,"36,382.90","72,765.81",
13-Sep-22,Transfer,"3,033.00",00.00,"75,798.81",
13-Sep-22,IMPS,00.00,"18,949.70","56,849.11",
13-Sep-22,Bill,00.00,"5,684.91","51,164.20",
13-Sep-22,IMPS,00.00,"7,309.17","43,855.03",
13-Sep-22,Commission,17.36,00.00,"43,872.39",
13-Sep-22,Commission,00.00,"6,267.48","37,604.91",
13-Sep-22,Cheque,00.00,"3,760.49","33,844.42",
13-Sep-22,Purchase,53,00.00,"33,897.42",
14-Sep-22,Bill,00.00,"4,237.18","29,660.24",
14-Sep-22,Cash,"2,53,603.50",00.00,"2,83,263.74",
14-Sep-22,RTGS,"2,745.05",00.00,"2,86,008.79",
14-Sep-22,Tax,419.89,00.00,"2,86,428.68",
14-Sep-22,Commission,00.00,"35,803.59","2,50,625.10",
14-Sep-22,Cheque,22.2,00.00,"2,50,647.30",
15-Sep-22,Cheque,00.00,"2,50,647.30",00.00,
15-Sep-22,Purchase,"2,59,679.00",00.00,"2,59,679.00",
15-Sep-22,Reversal,00.00,"86,559.67","1,73,119.33",
15-Sep-22,Interest,"31,501.00",00.00,"2,04,620.33",
15-Sep-22,Transportellaneous,00.00,"40,924.07","1,63,696.26",
15-Sep-22,RTGS,00.00,"23,385.18","1,40,311.08",
15-Sep-22,Transfer,659,00.00,"1,40,970.08",
15-Sep-22,Tax,"90,590.56",00.00,"2,31,560.64",
15-Sep-22,Purchase,00.00,"28,945.08","2,02,615.56",
15-Sep-22,ATM,00.00,"28,945.08","1,73,670.48",
15-Sep-22,ATM,"1,50,557.20",00.00,"3,24,227.68",
15-Sep-22,ATM,"1,73,647.50",00.00,"4,97,875.18",
15-Sep-22,Cheque,00.00,"2,48,937.59","2,48,937.59",
15-Sep-22,Reversal,00.00,"31,117.20","2,17,820.39",
15-Sep-22,IMPS,"9,69,949.00",00.00,"11,87,769.39",
15-Sep-22,Cheque,235.3,00.00,"11,88,004.69",
15-Sep-22,Debit Card,"1,79,962.30",00.00,"13,67,966.99",
15-Sep-22,ATM,00.00,"6,83,983.50","6,83,983.50",
15-Sep-22,Cheque,00.00,"3,41,991.75","3,41,991.75",
15-Sep-22,Reversal,00.00,"34,199.18","3,07,792.58",
15-Sep-22,ATM,"7,52,437.25",00.00,"10,60,229.83",
15-Sep-22,ATM,55.6,00.00,"10,60,285.43",
15-Sep-22,Reversal,"14,35,298.80",00.00,"24,95,584.23",
15-Sep-22,Commission,"16,65,568.50",00.00,"41,61,152.73",
15-Sep-22,Reversal,06.20,00.00,"41,61,158.93",
15-Sep-22,RTGS,"13,71,610.00",00.00,"55,32,768.93",
15-Sep-22,ATM,"12,56,566.00",00.00,"67,89,334.93",
15-Sep-22,Transportellaneous,00.00,"16,97,333.73","50,92,001.20",
15-Sep-22,Reversal,00.00,"7,27,428.74","43,64,572.46",
15-Sep-22,Debit Card,00.00,"43,64,572.46",00.00,
15-Sep-22,Debit Card,01.21,00.00,01.21,
15-Sep-22,Reversal,"23,094.00",00.00,"23,095.21",
15-Sep-22,Transportellaneous,534.6,00.00,"23,629.81",
15-Sep-22,Cash,00.00,"2,362.98","21,266.83",
15-Sep-22,Tax,"3,891.00",00.00,"25,157.83",
15-Sep-22,Cheque,00.00,"12,578.92","12,578.92",
15-Sep-22,Reversal,00.00,"1,796.99","10,781.93",
15-Sep-22,Cash,00.00,"1,796.99","8,984.94",
16-Sep-22,Bill,00.00,"1,796.99","7,187.95",
16-Sep-22,RTGS,"16,70,988.50",00.00,"16,78,176.45",
16-Sep-22,Interest,"3,05,028.00",00.00,"19,83,204.45",
16-Sep-22,IMPS,00.00,"19,83,204.45",00.00,
16-Sep-22,Interest,24,00.00,24,
16-Sep-22,Transfer,00.00,03.00,21,
16-Sep-22,IMPS,35,00.00,56,
16-Sep-22,Debit Card,"3,825.50",00.00,"3,881.50",
16-Sep-22,NEFT,02.90,00.00,"3,884.40",
16-Sep-22,Transportellaneous,00.00,388.44,"3,495.96",
17-Sep-22,Transfer,00.00,699.19,"2,796.77",
17-Sep-22,Transfer,510.2,00.00,"3,306.97",
17-Sep-22,Commission,00.00,826.74,"2,480.23",
17-Sep-22,Interest,03.78,00.00,"2,484.01",
18-Sep-22,Bill,"1,33,785.70",00.00,"1,36,269.71",
18-Sep-22,Commission,00.00,"1,36,269.71",00.00,
19-Sep-22,NEFT,04.42,00.00,04.42,
19-Sep-22,Transfer,00.00,02.21,02.21,
19-Sep-22,Bill,00.00,00.22,01.99,
19-Sep-22,RTGS,"7,859.00",00.00,"7,860.99",
19-Sep-22,Interest,31.76,00.00,"7,892.75",
19-Sep-22,Bill,61.58,00.00,"7,954.33",
19-Sep-22,ATM,00.00,"7,954.33",00.00,
19-Sep-22,Reversal,428.87,00.00,428.87,
20-Sep-22,Transportellaneous,00.00,61.27,367.6,
20-Sep-22,Bill,07.73,00.00,375.33,
20-Sep-22,Reversal,48.2,00.00,423.53,
20-Sep-22,Transportellaneous,231.79,00.00,655.32,
20-Sep-22,Purchase,00.00,72.81,582.51,
20-Sep-22,Debit Card,00.00,83.22,499.29,
20-Sep-22,Transfer,"3,984.00",00.00,"4,483.29",
20-Sep-22,NEFT,00.00,640.47,"3,842.82",
20-Sep-22,Transportellaneous,63.8,00.00,"3,906.62",
20-Sep-22,Commission,"27,486.60",00.00,"31,393.22",
20-Sep-22,ATM,16.95,00.00,"31,410.17",
20-Sep-22,Commission,"2,265.60",00.00,"33,675.77",
20-Sep-22,Cash,284.69,00.00,"33,960.46",
20-Sep-22,Debit Card,00.00,"8,490.12","25,470.34",
20-Sep-22,Transfer,00.00,"8,490.11","16,980.23",
20-Sep-22,Debit Card,"1,68,649.00",00.00,"1,85,629.23",
20-Sep-22,Cheque,"1,93,570.00",00.00,"3,79,199.23",
20-Sep-22,Debit Card,00.00,"54,171.32","3,25,027.91",
20-Sep-22,NEFT,60.56,00.00,"3,25,088.47",
20-Sep-22,Transportellaneous,00.00,"40,636.06","2,84,452.41",
20-Sep-22,Transportellaneous,00.00,"2,84,452.41",00.00,
20-Sep-22,Tax,"1,57,651.00",00.00,"1,57,651.00",
20-Sep-22,Tax,77.4,00.00,"1,57,728.40",
20-Sep-22,Interest,431,00.00,"1,58,159.40",
20-Sep-22,Tax,00.00,"15,815.94","1,42,343.46",
20-Sep-22,ATM,00.00,"23,723.91","1,18,619.55",
20-Sep-22,Cheque,"52,301.00",00.00,"1,70,920.55",
20-Sep-22,ATM,00.00,"42,730.14","1,28,190.41",
20-Sep-22,Reversal,00.00,"64,095.21","64,095.20",
20-Sep-22,Transfer,107.2,00.00,"64,202.40",
20-Sep-22,Cash,00.00,"32,101.20","32,101.20",
20-Sep-22,Interest,00.00,"32,101.20",00.00,
20-Sep-22,Transportellaneous,45,00.00,45,
20-Sep-22,Transportellaneous,00.00,05.00,40,
20-Sep-22,Interest,00.00,05.71,34.29,
20-Sep-22,Reversal,06.98,00.00,41.27,
20-Sep-22,ATM,00.00,05.90,35.37,
20-Sep-22,Tax,00.00,17.69,17.68,
20-Sep-22,Debit Card,00.00,08.84,08.84,
20-Sep-22,Transportellaneous,"2,26,397.00",00.00,"2,26,405.84",
20-Sep-22,Bill,00.00,"37,734.31","1,88,671.53",
20-Sep-22,RTGS,113,00.00,"1,88,784.53",
20-Sep-22,Commission,00.00,"20,976.06","1,67,808.47",
20-Sep-22,RTGS,00.00,"16,780.85","1,51,027.62",
20-Sep-22,Debit Card,"28,400.80",00.00,"1,79,428.42",
20-Sep-22,Purchase,00.00,"25,632.63","1,53,795.79",
20-Sep-22,Reversal,510.9,00.00,"1,54,306.69",
20-Sep-22,Purchase,00.00,"15,430.67","1,38,876.02",
20-Sep-22,RTGS,"11,037.00",00.00,"1,49,913.02",
20-Sep-22,IMPS,"1,814.16",00.00,"1,51,727.18",
20-Sep-22,Reversal,218.9,00.00,"1,51,946.08",
20-Sep-22,Bill,"4,082.00",00.00,"1,56,028.08",
20-Sep-22,NEFT,01.40,00.00,"1,56,029.48",
20-Sep-22,Purchase,00.00,"78,014.74","78,014.74",
20-Sep-22,Transfer,00.00,"78,014.74",00.00,
20-Sep-22,Commission,"1,74,295.00",00.00,"1,74,295.00",
20-Sep-22,Commission,199.9,00.00,"1,74,494.90",
20-Sep-22,Cheque,00.00,"24,927.84","1,49,567.06",
20-Sep-22,Transportellaneous,147,00.00,"1,49,714.06",
20-Sep-22,Cash,"2,865.20",00.00,"1,52,579.26",
20-Sep-22,IMPS,00.00,"38,144.82","1,14,434.44",
20-Sep-22,Transfer,"7,50,596.00",00.00,"8,65,030.44",
20-Sep-22,Cheque,"15,76,099.20",00.00,"24,41,129.64",
20-Sep-22,Cash,"9,206.20",00.00,"24,50,335.84",
20-Sep-22,Reversal,00.00,"24,50,335.84",00.00,
20-Sep-22,Tax,01.59,00.00,01.59,
20-Sep-22,ATM,00.00,00.27,01.33,
20-Sep-22,Transfer,00.00,00.17,01.16,
20-Sep-22,Cash,813.63,00.00,814.79,
20-Sep-22,RTGS,00.00,203.7,611.09,
20-Sep-22,Transportellaneous,00.00,61.11,549.98,
20-Sep-22,Debit Card,"17,71,715.00",00.00,"17,72,264.98",
20-Sep-22,Cash,00.00,"1,77,226.50","15,95,038.48",
20-Sep-22,NEFT,00.00,"2,27,862.64","13,67,175.84",
20-Sep-22,Debit Card,321.5,00.00,"13,67,497.34",
20-Sep-22,Transportellaneous,00.00,"1,36,749.73","12,30,747.61",
20-Sep-22,Bill,00.00,"12,30,747.61",00.00,
20-Sep-22,Commission,"82,293.94",00.00,"82,293.94",
20-Sep-22,Bill,"18,005.74",00.00,"1,00,299.68",
20-Sep-22,ATM,00.00,"25,074.92","75,224.76",
20-Sep-22,ATM,00.00,"7,522.48","67,702.28",
20-Sep-22,NEFT,00.00,"6,770.23","60,932.05",
21-Sep-22,RTGS,00.00,"30,466.03","30,466.02",
21-Sep-22,Transportellaneous,"2,496.88",00.00,"32,962.90",
21-Sep-22,Purchase,00.00,"8,240.73","24,722.18",
21-Sep-22,Transportellaneous,"2,970.60",00.00,"27,692.78",
21-Sep-22,RTGS,57.64,00.00,"27,750.42",
21-Sep-22,Commission,"10,32,879.00",00.00,"10,60,629.42",
21-Sep-22,RTGS,485.4,00.00,"10,61,114.82",
21-Sep-22,Cash,"6,574.00",00.00,"10,67,688.82",
21-Sep-22,Transfer,"31,390.38",00.00,"10,99,079.20",
21-Sep-22,Reversal,"1,53,914.00",00.00,"12,52,993.20",
21-Sep-22,Transfer,00.00,"1,56,624.15","10,96,369.05",
21-Sep-22,NEFT,00.00,"2,74,092.26","8,22,276.79",
21-Sep-22,Cheque,00.00,"1,64,455.36","6,57,821.43",
21-Sep-22,Tax,00.00,"1,31,564.29","5,26,257.14",
21-Sep-22,Bill,00.00,"1,05,251.43","4,21,005.71",
21-Sep-22,Purchase,00.00,"60,143.67","3,60,862.04",
21-Sep-22,Cheque,02.00,00.00,"3,60,864.04",
21-Sep-22,Debit Card,00.00,"3,60,864.04",00.00,
21-Sep-22,Reversal,"43,595.47",00.00,"43,595.47",
21-Sep-22,NEFT,00.00,"43,595.47",00.00,
21-Sep-22,NEFT,"2,149.52",00.00,"2,149.52",
21-Sep-22,Tax,00.00,537.38,"1,612.14",
21-Sep-22,Debit Card,"2,35,074.00",00.00,"2,36,686.14",
21-Sep-22,Commission,322.7,00.00,"2,37,008.84",
22-Sep-22,Debit Card,00.00,"59,252.21","1,77,756.63",
22-Sep-22,Cheque,00.00,"44,439.16","1,33,317.47",
22-Sep-22,Purchase,56.2,00.00,"1,33,373.67",
22-Sep-22,Interest,853,00.00,"1,34,226.67",
22-Sep-22,Cheque,00.00,"19,175.24","1,15,051.43",
22-Sep-22,Commission,"2,38,154.12",00.00,"3,53,205.55",
22-Sep-22,Transfer,00.00,"1,17,735.18","2,35,470.37",
22-Sep-22,Interest,00.00,"2,35,470.37",00.00,
22-Sep-22,Interest,"2,57,497.28",00.00,"2,57,497.28",
22-Sep-22,RTGS,02.40,00.00,"2,57,499.68",
22-Sep-22,RTGS,"78,749.00",00.00,"3,36,248.68",
22-Sep-22,Interest,00.00,"1,12,082.89","2,24,165.79",
22-Sep-22,Commission,00.00,"37,360.97","1,86,804.82",
22-Sep-22,RTGS,"3,362.26",00.00,"1,90,167.08",
22-Sep-22,Cash,03.00,00.00,"1,90,170.08",
22-Sep-22,Transportellaneous,08.00,00.00,"1,90,178.08",
22-Sep-22,Transfer,00.00,"19,017.81","1,71,160.27",
22-Sep-22,IMPS,00.00,"57,053.42","1,14,106.85",
22-Sep-22,RTGS,00.00,"57,053.43","57,053.42",
22-Sep-22,Purchase,00.00,"6,339.27","50,714.15",
22-Sep-22,Debit Card,00.00,"25,357.08","25,357.08",
22-Sep-22,IMPS,"3,14,685.00",00.00,"3,40,042.08",
22-Sep-22,Tax,00.00,"37,782.45","3,02,259.63",
22-Sep-22,NEFT,02.92,00.00,"3,02,262.55",
22-Sep-22,Cheque,228.5,00.00,"3,02,491.05",
22-Sep-22,Reversal,00.00,"37,811.38","2,64,679.67",
22-Sep-22,RTGS,00.00,"66,169.92","1,98,509.75",
22-Sep-22,Interest,00.00,"1,98,509.75",00.00,
22-Sep-22,Commission,20.8,00.00,20.8,
22-Sep-22,Debit Card,00.00,10.4,10.4,
22-Sep-22,RTGS,00.00,05.20,05.20,
22-Sep-22,Transfer,00.00,00.52,04.68,
22-Sep-22,Cash,06.60,00.00,11.28,
22-Sep-22,Purchase,00.00,01.13,10.15,
23-Sep-22,Interest,00.00,10.15,00.00,
23-Sep-22,Cheque,"9,675.90",00.00,"9,675.90",
23-Sep-22,Reversal,29.8,00.00,"9,705.70",
23-Sep-22,Debit Card,"1,969.08",00.00,"11,674.78",
23-Sep-22,Tax,00.00,"1,167.48","10,507.30",
23-Sep-22,RTGS,00.00,"2,101.46","8,405.84",
23-Sep-22,Bill,00.00,"1,050.73","7,355.11",
23-Sep-22,Debit Card,00.00,817.23,"6,537.88",
23-Sep-22,Reversal,00.00,726.43,"5,811.45",
23-Sep-22,Bill,"88,446.70",00.00,"94,258.15",
23-Sep-22,Interest,00.00,"13,465.45","80,792.70",
23-Sep-22,Purchase,00.00,"8,976.97","71,815.73",
23-Sep-22,Cash,00.00,"11,969.29","59,846.44",
23-Sep-22,Cash,00.00,"8,549.49","51,296.95",
23-Sep-22,Interest,00.00,"51,296.95",00.00,
23-Sep-22,Purchase,"18,01,962.00",00.00,"18,01,962.00",
23-Sep-22,Purchase,"6,39,749.75",00.00,"24,41,711.75",
23-Sep-22,Tax,00.00,"3,48,815.96","20,92,895.79",
23-Sep-22,Transportellaneous,00.00,"4,18,579.16","16,74,316.63",
23-Sep-22,Cheque,00.00,"5,58,105.54","11,16,211.09",
23-Sep-22,Cheque,00.00,"5,58,105.55","5,58,105.55",
23-Sep-22,Tax,00.00,"5,58,105.55",00.00,
23-Sep-22,Transportellaneous,"19,31,438.25",00.00,"19,31,438.25",
23-Sep-22,Cheque,47,00.00,"19,31,485.25",
23-Sep-22,Commission,03.40,00.00,"19,31,488.65",
23-Sep-22,Interest,506.2,00.00,"19,31,994.85",
23-Sep-22,NEFT,00.00,"3,86,398.97","15,45,595.88",
23-Sep-22,RTGS,00.00,"15,45,595.88",00.00,
23-Sep-22,NEFT,03.00,00.00,03.00,
23-Sep-22,RTGS,"3,38,268.50",00.00,"3,38,271.50",
23-Sep-22,Interest,"1,91,970.50",00.00,"5,30,242.00",
23-Sep-22,ATM,"7,56,054.00",00.00,"12,86,296.00",
23-Sep-22,Transportellaneous,"8,56,210.00",00.00,"21,42,506.00",
23-Sep-22,Bill,00.00,"3,57,084.33","17,85,421.67",
23-Sep-22,Reversal,263.76,00.00,"17,85,685.43",
24-Sep-22,Transportellaneous,00.00,"2,23,210.68","15,62,474.75",
24-Sep-22,Reversal,00.00,"1,56,247.48","14,06,227.28",
24-Sep-22,ATM,00.00,"1,56,247.48","12,49,979.80",
24-Sep-22,Tax,00.00,"6,24,989.90","6,24,989.90",
24-Sep-22,Bill,461,00.00,"6,25,450.90",
24-Sep-22,Cash,354.69,00.00,"6,25,805.59",
24-Sep-22,IMPS,00.00,"69,533.95","5,56,271.64",
24-Sep-22,Transfer,"3,867.18",00.00,"5,60,138.82",
24-Sep-22,Interest,960.1,00.00,"5,61,098.92",
24-Sep-22,Debit Card,"2,877.00",00.00,"5,63,975.92",
25-Sep-22,Purchase,00.00,"2,81,987.96","2,81,987.96",
25-Sep-22,Reversal,00.00,"28,198.80","2,53,789.16",
25-Sep-22,NEFT,00.00,"31,723.65","2,22,065.52",
25-Sep-22,Transfer,00.00,"22,206.55","1,99,858.97",
25-Sep-22,NEFT,"1,43,660.00",00.00,"3,43,518.97",
25-Sep-22,NEFT,"8,108.10",00.00,"3,51,627.07",
25-Sep-22,Bill,"14,579.70",00.00,"3,66,206.77",
25-Sep-22,IMPS,"1,030.26",00.00,"3,67,237.03",
25-Sep-22,RTGS,"2,068.93",00.00,"3,69,305.96",
25-Sep-22,RTGS,213.08,00.00,"3,69,519.04",
25-Sep-22,RTGS,"21,094.88",00.00,"3,90,613.92",
25-Sep-22,Interest,00.00,"1,30,204.64","2,60,409.28",
26-Sep-22,Transportellaneous,"14,57,657.50",00.00,"17,18,066.78",
27-Sep-22,RTGS,00.00,"8,59,033.39","8,59,033.39",
27-Sep-22,NEFT,"23,233.00",00.00,"8,82,266.39",
27-Sep-22,Debit Card,00.00,"2,20,566.60","6,61,699.79",
28-Sep-22,Transfer,00.00,"1,32,339.96","5,29,359.83",
29-Sep-22,Reversal,"3,480.84",00.00,"5,32,840.67",
29-Sep-22,Tax,222.8,00.00,"5,33,063.47",
29-Sep-22,Commission,00.00,"76,151.92","4,56,911.55",
29-Sep-22,Cheque,"16,324.00",00.00,"4,73,235.55",
29-Sep-22,Interest,00.00,"59,154.44","4,14,081.11",
29-Sep-22,Transportellaneous,00.00,"69,013.52","3,45,067.59",
29-Sep-22,RTGS,00.00,"34,506.76","3,10,560.83",
29-Sep-22,Interest,00.00,"31,056.08","2,79,504.75",
29-Sep-22,Commission,"29,682.30",00.00,"3,09,187.05",
29-Sep-22,Bill,00.00,"77,296.76","2,31,890.29",
29-Sep-22,Reversal,39.36,00.00,"2,31,929.65",
29-Sep-22,Interest,00.00,"46,385.93","1,85,543.72",
29-Sep-22,IMPS,"5,67,285.25",00.00,"7,52,828.97",
29-Sep-22,Reversal,00.00,"83,647.66","6,69,181.31",
29-Sep-22,Cash,00.00,"83,647.66","5,85,533.65",
29-Sep-22,ATM,"15,772.06",00.00,"6,01,305.71",
29-Sep-22,ATM,00.00,"1,20,261.14","4,81,044.57",
29-Sep-22,ATM,00.00,"68,720.65","4,12,323.92",
29-Sep-22,Purchase,00.00,"41,232.39","3,71,091.53",
29-Sep-22,ATM,02.00,00.00,"3,71,093.53",
29-Sep-22,Transportellaneous,00.00,"1,85,546.77","1,85,546.76",
29-Sep-22,Interest,"2,056.40",00.00,"1,87,603.16",
29-Sep-22,IMPS,00.00,"62,534.39","1,25,068.77",
29-Sep-22,IMPS,01.00,00.00,"1,25,069.77",
29-Sep-22,IMPS,00.00,"17,867.11","1,07,202.66",
29-Sep-22,Commission,"65,874.00",00.00,"1,73,076.66",
29-Sep-22,Transportellaneous,00.00,"34,615.33","1,38,461.33",
29-Sep-22,Debit Card,00.00,"15,384.59","1,23,076.74",
29-Sep-22,ATM,148,00.00,"1,23,224.74",
29-Sep-22,Cash,"29,815.92",00.00,"1,53,040.66",
29-Sep-22,Transportellaneous,00.00,"15,304.07","1,37,736.59",
29-Sep-22,Cash,00.00,"19,676.66","1,18,059.93",
29-Sep-22,Bill,00.00,"11,805.99","1,06,253.94",
29-Sep-22,Commission,07.00,00.00,"1,06,260.94",
29-Sep-22,ATM,00.00,"21,252.19","85,008.75",
29-Sep-22,Debit Card,00.00,"12,144.11","72,864.64",
29-Sep-22,IMPS,00.00,"12,144.11","60,720.53",
29-Sep-22,Reversal,00.00,"10,120.09","50,600.44",
29-Sep-22,Cheque,00.00,"7,228.63","43,371.81",
29-Sep-22,Interest,"14,13,730.00",00.00,"14,57,101.81",
29-Sep-22,Tax,53.63,00.00,"14,57,155.44",
29-Sep-22,Transportellaneous,06.42,00.00,"14,57,161.86",
29-Sep-22,Transfer,"92,968.97",00.00,"15,50,130.83",
29-Sep-22,Cash,59,00.00,"15,50,189.83",
29-Sep-22,Bill,"1,376.78",00.00,"15,51,566.61",
29-Sep-22,Tax,00.00,"3,87,891.65","11,63,674.96",
29-Sep-22,Transportellaneous,03.00,00.00,"11,63,677.96",
29-Sep-22,Transfer,12.13,00.00,"11,63,690.09",
29-Sep-22,RTGS,00.00,"2,90,922.52","8,72,767.57",
29-Sep-22,Debit Card,00.00,"2,18,191.89","6,54,575.68",
29-Sep-22,Transfer,00.00,"72,730.63","5,81,845.05",
29-Sep-22,ATM,00.00,"96,974.18","4,84,870.88",
29-Sep-22,Bill,"1,832.80",00.00,"4,86,703.68",
29-Sep-22,ATM,84.79,00.00,"4,86,788.47",
29-Sep-22,Commission,04.79,00.00,"4,86,793.26",
29-Sep-22,Debit Card,00.00,"81,132.21","4,05,661.05",
29-Sep-22,IMPS,00.00,"81,132.21","3,24,528.84",
29-Sep-22,Commission,"1,265.70",00.00,"3,25,794.54",
29-Sep-22,ATM,00.00,"36,199.39","2,89,595.15",
29-Sep-22,Transfer,00.00,"72,398.79","2,17,196.36",
29-Sep-22,Debit Card,258.83,00.00,"2,17,455.19",
29-Sep-22,Purchase,00.00,"43,491.04","1,73,964.15",
29-Sep-22,Cash,00.00,"21,745.52","1,52,218.63",
29-Sep-22,IMPS,00.00,"30,443.73","1,21,774.90",
29-Sep-22,Bill,00.00,"15,221.86","1,06,553.04",
29-Sep-22,NEFT,00.00,"21,310.61","85,242.43",
29-Sep-22,Reversal,00.00,"12,177.49","73,064.94",
29-Sep-22,Tax,00.00,"10,437.85","62,627.09",
29-Sep-22,NEFT,00.00,"8,946.73","53,680.36",
29-Sep-22,Bill,00.00,"8,946.73","44,733.63",
29-Sep-22,Bill,"3,224.90",00.00,"47,958.53",
29-Sep-22,Transfer,330.3,00.00,"48,288.83",
29-Sep-22,Transfer,00.00,"6,898.40","41,390.43",
29-Sep-22,NEFT,00.00,"20,695.22","20,695.22",
29-Sep-22,Purchase,"13,87,615.80",00.00,"14,08,311.02",
29-Sep-22,NEFT,00.00,"14,08,311.02",00.00,
29-Sep-22,Cash,"2,33,572.66",00.00,"2,33,572.66",
29-Sep-22,Commission,00.00,"46,714.53","1,86,858.13",
29-Sep-22,RTGS,"2,776.00",00.00,"1,89,634.13",
29-Sep-22,Commission,"5,97,392.50",00.00,"7,87,026.63",
29-Sep-22,RTGS,00.00,"2,62,342.21","5,24,684.42",
29-Sep-22,Reversal,00.00,"87,447.40","4,37,237.02",
29-Sep-22,Transfer,"17,693.59",00.00,"4,54,930.61",
29-Sep-22,Transfer,00.00,"4,54,930.61",00.00,
29-Sep-22,Cheque,307,00.00,307,
29-Sep-22,Commission,"6,082.00",00.00,"6,389.00",
29-Sep-22,RTGS,00.00,798.63,"5,590.38",
29-Sep-22,Bill,46,00.00,"5,636.38",
29-Sep-22,ATM,268.7,00.00,"5,905.08",
29-Sep-22,ATM,"2,322.12",00.00,"8,227.20",
29-Sep-22,NEFT,00.00,"2,742.40","5,484.80",
29-Sep-22,Cash,00.00,685.6,"4,799.20",
29-Sep-22,Transfer,"12,29,553.20",00.00,"12,34,352.40",
29-Sep-22,Cash,00.00,"1,23,435.24","11,10,917.16",
29-Sep-22,NEFT,00.00,"1,58,702.45","9,52,214.71",
29-Sep-22,Tax,"1,45,239.60",00.00,"10,97,454.31",
29-Sep-22,Interest,00.00,"1,09,745.43","9,87,708.88",
29-Sep-22,Reversal,"20,65,590.00",00.00,"30,53,298.88",
29-Sep-22,RTGS,"7,326.00",00.00,"30,60,624.88",
29-Sep-22,Cash,29,00.00,"30,60,653.88",
29-Sep-22,Cash,"2,25,618.91",00.00,"32,86,272.79",
29-Sep-22,Interest,02.51,00.00,"32,86,275.30",
29-Sep-22,Bill,00.00,"16,43,137.65","16,43,137.65",
29-Sep-22,IMPS,00.00,"2,34,733.95","14,08,403.70",
29-Sep-22,Bill,01.10,00.00,"14,08,404.80",
29-Sep-22,RTGS,00.00,"14,08,404.80",00.00,
29-Sep-22,IMPS,18.31,00.00,18.31,
29-Sep-22,Transportellaneous,00.00,03.05,15.26,
29-Sep-22,Purchase,"1,79,608.00",00.00,"1,79,623.26",
29-Sep-22,Debit Card,00.00,"1,79,623.26",00.00,
29-Sep-22,Commission,23.25,00.00,23.25,
29-Sep-22,NEFT,00.00,23.25,00.00,
29-Sep-22,Reversal,"2,56,184.00",00.00,"2,56,184.00",
29-Sep-22,Cheque,00.00,"2,56,184.00",00.00,
29-Sep-22,Cash,"1,92,911.72",00.00,"1,92,911.72",
29-Sep-22,NEFT,00.00,"27,558.82","1,65,352.90",
29-Sep-22,Transfer,00.00,"27,558.82","1,37,794.08",
29-Sep-22,ATM,160,00.00,"1,37,954.08",
29-Sep-22,Debit Card,"11,78,096.80",00.00,"13,16,050.88",
29-Sep-22,RTGS,135.2,00.00,"13,16,186.08",
29-Sep-22,Interest,00.00,"1,88,026.58","11,28,159.50",
29-Sep-22,Reversal,"3,174.55",00.00,"11,31,334.05",
29-Sep-22,Reversal,00.00,"2,82,833.51","8,48,500.54",
30-Sep-22,Cheque,63,00.00,"8,48,563.54",
30-Sep-22,Tax,02.25,00.00,"8,48,565.79",
30-Sep-22,Reversal,02.21,00.00,"8,48,568.00",
30-Sep-22,ATM,00.00,"2,12,142.00","6,36,426.00",
30-Sep-22,Transfer,386.2,00.00,"6,36,812.20",
30-Sep-22,Bill,"13,104.19",00.00,"6,49,916.39",
30-Sep-22,IMPS,"3,614.22",00.00,"6,53,530.61",
30-Sep-22,Reversal,"1,055.00",00.00,"6,54,585.61",
30-Sep-22,Transfer,"2,603.22",00.00,"6,57,188.83",
30-Sep-22,RTGS,52.89,00.00,"6,57,241.72",
30-Sep-22,Debit Card,00.00,"1,09,540.29","5,47,701.43",
30-Sep-22,Transfer,"17,559.95",00.00,"5,65,261.38",
30-Sep-22,IMPS,"1,10,637.30",00.00,"6,75,898.68",
30-Sep-22,ATM,"16,114.25",00.00,"6,92,012.93",
30-Sep-22,ATM,"7,202.06",00.00,"6,99,214.99",
30-Sep-22,Transfer,00.00,"69,921.50","6,29,293.49",
30-Sep-22,ATM,00.00,"3,14,646.75","3,14,646.74",
01-Oct-22,Commission,00.00,"62,929.35","2,51,717.39",
01-Oct-22,Cash,"17,82,127.00",00.00,"20,33,844.39",
01-Oct-22,Bill,00.00,"6,77,948.13","13,55,896.26",
01-Oct-22,ATM,"1,527.13",00.00,"13,57,423.39",
01-Oct-22,RTGS,"1,278.20",00.00,"13,58,701.59",
01-Oct-22,Purchase,"10,93,626.00",00.00,"24,52,327.59",
01-Oct-22,Transportellaneous,00.00,"12,26,163.80","12,26,163.80",
01-Oct-22,Transportellaneous,"4,128.40",00.00,"12,30,292.20",
01-Oct-22,IMPS,00.00,"1,53,786.53","10,76,505.68",
01-Oct-22,NEFT,00.00,"3,58,835.23","7,17,670.45",
01-Oct-22,RTGS,"14,48,969.00",00.00,"21,66,639.45",
01-Oct-22,Cash,"31,526.35",00.00,"21,98,165.80",
01-Oct-22,Tax,03.60,00.00,"21,98,169.40",
01-Oct-22,Cash,00.00,"3,14,024.20","18,84,145.20",
01-Oct-22,Commission,00.00,"2,09,349.47","16,74,795.73",
01-Oct-22,Tax,00.00,"2,39,256.53","14,35,539.20",
01-Oct-22,Interest,00.00,"3,58,884.80","10,76,654.40",
01-Oct-22,Purchase,00.00,"5,38,327.20","5,38,327.20",
01-Oct-22,Debit Card,"1,44,985.80",00.00,"6,83,313.00",
01-Oct-22,ATM,00.00,"85,414.13","5,97,898.88",
01-Oct-22,Debit Card,413.4,00.00,"5,98,312.28",
01-Oct-22,Cash,"20,425.60",00.00,"6,18,737.88",
01-Oct-22,Interest,00.00,"3,09,368.94","3,09,368.94",
01-Oct-22,IMPS,00.00,"3,09,368.94",00.00,
01-Oct-22,Debit Card,"90,169.00",00.00,"90,169.00",
01-Oct-22,RTGS,00.00,"9,016.90","81,152.10",
01-Oct-22,RTGS,00.00,"11,593.16","69,558.94",
01-Oct-22,Transportellaneous,00.00,"8,694.87","60,864.07",
01-Oct-22,Bill,00.00,"60,864.07",00.00,
01-Oct-22,NEFT,"2,086.70",00.00,"2,086.70",
02-Oct-22,IMPS,00.00,417.34,"1,669.36",
02-Oct-22,Reversal,00.00,278.23,"1,391.13",
02-Oct-22,Transportellaneous,00.00,139.11,"1,252.02",
02-Oct-22,NEFT,00.00,208.67,"1,043.35",
02-Oct-22,Interest,00.00,104.34,939.01,
02-Oct-22,IMPS,00.00,104.33,834.68,
02-Oct-22,Cheque,"20,54,896.20",00.00,"20,55,730.88",
02-Oct-22,Transportellaneous,00.00,"2,56,966.36","17,98,764.52",
02-Oct-22,IMPS,"1,68,406.00",00.00,"19,67,170.52",
02-Oct-22,Purchase,492.7,00.00,"19,67,663.22",
02-Oct-22,Bill,"2,08,146.40",00.00,"21,75,809.62",
02-Oct-22,Bill,"3,621.99",00.00,"21,79,431.61",
02-Oct-22,NEFT,"3,763.10",00.00,"21,83,194.71",
02-Oct-22,NEFT,00.00,"3,63,865.79","18,19,328.92",
02-Oct-22,Tax,52.4,00.00,"18,19,381.32",
02-Oct-22,Tax,171.39,00.00,"18,19,552.71",
02-Oct-22,Interest,00.00,"3,03,258.79","15,16,293.92",
03-Oct-22,Transfer,"1,63,137.20",00.00,"16,79,431.12",
03-Oct-22,Cheque,"1,34,775.00",00.00,"18,14,206.12",
03-Oct-22,IMPS,166,00.00,"18,14,372.12",
03-Oct-22,Tax,24,00.00,"18,14,396.12",
03-Oct-22,Transportellaneous,219,00.00,"18,14,615.12",
03-Oct-22,Transportellaneous,472.58,00.00,"18,15,087.70",
04-Oct-22,Reversal,"1,122.62",00.00,"18,16,210.32",
04-Oct-22,Commission,00.00,"4,54,052.58","13,62,157.74",
04-Oct-22,Transfer,"10,212.49",00.00,"13,72,370.23",
04-Oct-22,NEFT,00.00,"6,86,185.12","6,86,185.12",
04-Oct-22,Purchase,00.00,"1,71,546.28","5,14,638.84",
04-Oct-22,Commission,"5,864.70",00.00,"5,20,503.54",
04-Oct-22,Interest,"6,54,874.50",00.00,"11,75,378.04",
04-Oct-22,RTGS,00.00,"1,17,537.80","10,57,840.24",
04-Oct-22,Cash,00.00,"1,51,120.03","9,06,720.21",
04-Oct-22,Debit Card,05.00,00.00,"9,06,725.21",
04-Oct-22,Bill,00.00,"1,29,532.17","7,77,193.04",
05-Oct-22,Tax,00.00,"7,77,193.04",00.00,
05-Oct-22,Purchase,"2,30,307.88",00.00,"2,30,307.88",
05-Oct-22,Reversal,"8,10,994.80",00.00,"10,41,302.68",
05-Oct-22,Cash,00.00,"2,60,325.67","7,80,977.01",
06-Oct-22,NEFT,"23,942.13",00.00,"8,04,919.14",
06-Oct-22,Debit Card,32.7,00.00,"8,04,951.84",
06-Oct-22,IMPS,00.00,"89,439.09","7,15,512.75",
06-Oct-22,Transfer,"8,89,547.50",00.00,"16,05,060.25",
06-Oct-22,Interest,34.9,00.00,"16,05,095.15",
06-Oct-22,Transfer,"3,399.92",00.00,"16,08,495.07",
06-Oct-22,NEFT,"4,076.00",00.00,"16,12,571.07",
06-Oct-22,Interest,00.00,"1,79,174.56","14,33,396.51",
06-Oct-22,Bill,"14,966.00",00.00,"14,48,362.51",
06-Oct-22,IMPS,04.80,00.00,"14,48,367.31",
06-Oct-22,Purchase,89.1,00.00,"14,48,456.41",
06-Oct-22,Reversal,"18,293.50",00.00,"14,66,749.91",
06-Oct-22,IMPS,"1,44,682.16",00.00,"16,11,432.07",
06-Oct-22,Commission,00.00,"2,68,572.01","13,42,860.06",
06-Oct-22,Purchase,37,00.00,"13,42,897.06",
06-Oct-22,Transfer,204.76,00.00,"13,43,101.82",
06-Oct-22,Commission,00.00,"2,68,620.36","10,74,481.46",
06-Oct-22,RTGS,52,00.00,"10,74,533.46",
06-Oct-22,Transportellaneous,46.4,00.00,"10,74,579.86",
06-Oct-22,Reversal,"6,32,439.50",00.00,"17,07,019.36",
06-Oct-22,Purchase,00.00,"17,07,019.36",00.00,
06-Oct-22,Transfer,279.55,00.00,279.55,
06-Oct-22,Tax,00.00,27.96,251.6,
06-Oct-22,Bill,07.00,00.00,258.6,
06-Oct-22,Bill,00.00,51.72,206.88,
06-Oct-22,IMPS,00.00,51.72,155.16,
06-Oct-22,Cheque,00.00,15.52,139.64,
06-Oct-22,ATM,00.00,69.82,69.82,
06-Oct-22,Interest,00.00,23.27,46.55,
06-Oct-22,Transfer,05.20,00.00,51.75,
06-Oct-22,Commission,00.00,17.25,34.5,
06-Oct-22,Debit Card,03.99,00.00,38.49,
06-Oct-22,Transfer,161,00.00,199.49,
06-Oct-22,Commission,"1,37,360.20",00.00,"1,37,559.69",
06-Oct-22,Tax,00.00,"22,926.62","1,14,633.08",
06-Oct-22,Transfer,"25,808.60",00.00,"1,40,441.68",
06-Oct-22,IMPS,00.00,"17,555.21","1,22,886.47",
06-Oct-22,IMPS,"2,31,285.60",00.00,"3,54,172.07",
06-Oct-22,ATM,00.00,"50,596.01","3,03,576.06",
06-Oct-22,Bill,"15,602.50",00.00,"3,19,178.56",
06-Oct-22,Debit Card,00.00,"1,59,589.28","1,59,589.28",
06-Oct-22,ATM,00.00,"79,794.64","79,794.64",
06-Oct-22,Commission,"16,641.56",00.00,"96,436.20",
06-Oct-22,Transportellaneous,123.5,00.00,"96,559.70",
06-Oct-22,IMPS,00.00,"32,186.57","64,373.13",
07-Oct-22,Reversal,279.9,00.00,"64,653.03",
07-Oct-22,Bill,57.31,00.00,"64,710.34",
07-Oct-22,ATM,00.00,"12,942.07","51,768.27",
07-Oct-22,RTGS,"72,909.53",00.00,"1,24,677.80",
07-Oct-22,Transportellaneous,00.00,"12,467.78","1,12,210.02",
07-Oct-22,Interest,"31,946.00",00.00,"1,44,156.02",
07-Oct-22,Tax,00.00,"18,019.50","1,26,136.52",
07-Oct-22,Interest,05.70,00.00,"1,26,142.22",
07-Oct-22,Interest,00.00,"63,071.11","63,071.11",
07-Oct-22,Transportellaneous,00.00,"7,883.89","55,187.22",
07-Oct-22,ATM,00.00,"13,796.81","41,390.42",
07-Oct-22,Interest,00.00,"8,278.08","33,112.34",
07-Oct-22,Commission,00.00,"8,278.09","24,834.25",
07-Oct-22,Transportellaneous,"1,715.00",00.00,"26,549.25",
07-Oct-22,Cash,"1,89,356.70",00.00,"2,15,905.95",
07-Oct-22,Reversal,00.00,"43,181.19","1,72,724.76",
07-Oct-22,IMPS,05.00,00.00,"1,72,729.76",
07-Oct-22,ATM,"54,532.00",00.00,"2,27,261.76",
07-Oct-22,Cash,00.00,"1,13,630.88","1,13,630.88",
07-Oct-22,Reversal,"1,26,167.00",00.00,"2,39,797.88",
07-Oct-22,Interest,"1,44,235.25",00.00,"3,84,033.13",
07-Oct-22,ATM,00.00,"64,005.52","3,20,027.61",
07-Oct-22,NEFT,00.00,"32,002.76","2,88,024.85",
07-Oct-22,NEFT,05.00,00.00,"2,88,029.85",
07-Oct-22,ATM,00.00,"36,003.73","2,52,026.12",
07-Oct-22,Reversal,"2,842.20",00.00,"2,54,868.32",
07-Oct-22,Tax,00.00,"84,956.11","1,69,912.21",
07-Oct-22,Cheque,279,00.00,"1,70,191.21",
07-Oct-22,Transfer,"6,67,984.00",00.00,"8,38,175.21",
07-Oct-22,RTGS,"74,479.00",00.00,"9,12,654.21",
07-Oct-22,Transportellaneous,00.00,"1,82,530.84","7,30,123.37",
07-Oct-22,Reversal,01.76,00.00,"7,30,125.13",
07-Oct-22,ATM,00.00,"7,30,125.13",00.00,
08-Oct-22,Bill,"15,69,582.80",00.00,"15,69,582.80",
08-Oct-22,Debit Card,00.00,"3,92,395.70","11,77,187.10",
08-Oct-22,Interest,00.00,"11,77,187.10",00.00,
08-Oct-22,Cheque,"2,262.90",00.00,"2,262.90",
08-Oct-22,Cheque,"2,23,856.00",00.00,"2,26,118.90",
08-Oct-22,Debit Card,00.00,"56,529.73","1,69,589.18",
08-Oct-22,Bill,00.00,"16,958.92","1,52,630.26",
08-Oct-22,RTGS,00.00,"1,52,630.26",00.00,
08-Oct-22,ATM,01.60,00.00,01.60,
08-Oct-22,IMPS,00.00,00.53,01.07,
08-Oct-22,Bill,00.00,00.18,00.89,
08-Oct-22,Bill,00.00,00.18,00.71,
08-Oct-22,RTGS,"14,62,791.75",00.00,"14,62,792.46",
08-Oct-22,Transportellaneous,93.3,00.00,"14,62,885.76",
08-Oct-22,Reversal,00.00,"2,92,577.15","11,70,308.61",
08-Oct-22,IMPS,00.00,"2,34,061.72","9,36,246.89",
08-Oct-22,Reversal,56.5,00.00,"9,36,303.39",
08-Oct-22,Commission,"2,60,735.00",00.00,"11,97,038.39",
08-Oct-22,Tax,00.00,"1,19,703.84","10,77,334.55",
08-Oct-22,Tax,"88,902.00",00.00,"11,66,236.55",
08-Oct-22,Purchase,"2,105.50",00.00,"11,68,342.05",
08-Oct-22,Bill,00.00,"1,66,906.01","10,01,436.04",
08-Oct-22,NEFT,00.00,"2,50,359.01","7,51,077.03",
08-Oct-22,Cash,00.00,"1,87,769.26","5,63,307.77",
08-Oct-22,Transfer,00.00,"62,589.75","5,00,718.02",
08-Oct-22,Purchase,00.00,"5,00,718.02",00.00,
08-Oct-22,Cheque,04.00,00.00,04.00,
08-Oct-22,RTGS,"2,56,325.00",00.00,"2,56,329.00",
08-Oct-22,Debit Card,129,00.00,"2,56,458.00",
08-Oct-22,Interest,00.00,"28,495.33","2,27,962.67",
08-Oct-22,Purchase,00.00,"56,990.67","1,70,972.00",
08-Oct-22,Purchase,00.00,"17,097.20","1,53,874.80",
08-Oct-22,ATM,00.00,"17,097.20","1,36,777.60",
08-Oct-22,Interest,07.00,00.00,"1,36,784.60",
08-Oct-22,IMPS,"1,21,971.50",00.00,"2,58,756.10",
08-Oct-22,RTGS,"66,579.80",00.00,"3,25,335.90",
08-Oct-22,Bill,00.00,"1,62,667.95","1,62,667.95",
08-Oct-22,Cheque,00.00,"18,074.22","1,44,593.73",
09-Oct-22,Reversal,00.00,"28,918.75","1,15,674.98",
09-Oct-22,Reversal,00.00,"11,567.50","1,04,107.48",
09-Oct-22,IMPS,00.00,"52,053.74","52,053.74",
09-Oct-22,Tax,00.00,"10,410.75","41,642.99",
09-Oct-22,Transfer,"2,153.00",00.00,"43,795.99",
09-Oct-22,RTGS,21,00.00,"43,816.99",
09-Oct-22,RTGS,"1,42,500.00",00.00,"1,86,316.99",
09-Oct-22,Bill,02.10,00.00,"1,86,319.09",
09-Oct-22,RTGS,"2,47,293.00",00.00,"4,33,612.09",
09-Oct-22,Interest,00.00,"43,361.21","3,90,250.88",
09-Oct-22,Bill,345.02,00.00,"3,90,595.90",
09-Oct-22,ATM,00.00,"43,399.54","3,47,196.36",
09-Oct-22,ATM,289,00.00,"3,47,485.36",
09-Oct-22,IMPS,"20,996.16",00.00,"3,68,481.52",
09-Oct-22,RTGS,"5,12,037.80",00.00,"8,80,519.32",
09-Oct-22,Interest,00.00,"1,10,064.92","7,70,454.40",
09-Oct-22,Transfer,"1,305.00",00.00,"7,71,759.40",
09-Oct-22,Interest,01.40,00.00,"7,71,760.80",
09-Oct-22,IMPS,06.30,00.00,"7,71,767.10",
09-Oct-22,Cheque,189.5,00.00,"7,71,956.60",
09-Oct-22,Transfer,"15,03,182.00",00.00,"22,75,138.60",
09-Oct-22,Cash,"2,19,488.00",00.00,"24,94,626.60",
09-Oct-22,Bill,00.00,"12,47,313.30","12,47,313.30",
09-Oct-22,Transfer,139.67,00.00,"12,47,452.97",
09-Oct-22,NEFT,03.00,00.00,"12,47,455.97",
09-Oct-22,Tax,00.00,"1,38,606.22","11,08,849.75",
09-Oct-22,ATM,"1,31,934.75",00.00,"12,40,784.50",
09-Oct-22,Bill,00.00,"1,77,254.93","10,63,529.57",
09-Oct-22,Transportellaneous,00.00,"2,65,882.39","7,97,647.18",
09-Oct-22,Cheque,00.00,"88,627.46","7,09,019.72",
09-Oct-22,Debit Card,256.9,00.00,"7,09,276.62",
09-Oct-22,Cheque,"3,503.40",00.00,"7,12,780.02",
09-Oct-22,NEFT,"1,181.00",00.00,"7,13,961.02",
09-Oct-22,Interest,00.00,"1,42,792.20","5,71,168.82",
09-Oct-22,Cheque,03.00,00.00,"5,71,171.82",
09-Oct-22,Cheque,00.00,"81,595.97","4,89,575.85",
09-Oct-22,Tax,00.00,"2,44,787.93","2,44,787.92",
09-Oct-22,Debit Card,00.00,"27,198.66","2,17,589.26",
09-Oct-22,Tax,"14,82,808.00",00.00,"17,00,397.26",
09-Oct-22,Debit Card,00.00,"2,12,549.66","14,87,847.60",
09-Oct-22,Cash,"2,668.70",00.00,"14,90,516.30",
09-Oct-22,NEFT,07.30,00.00,"14,90,523.60",
09-Oct-22,Cheque,00.00,"2,12,931.94","12,77,591.66",
09-Oct-22,NEFT,00.00,"3,19,397.92","9,58,193.74",
09-Oct-22,Debit Card,"2,56,848.03",00.00,"12,15,041.77",
09-Oct-22,Purchase,01.60,00.00,"12,15,043.37",
09-Oct-22,Commission,00.00,"2,43,008.67","9,72,034.70",
09-Oct-22,Cash,00.00,"1,08,003.86","8,64,030.84",
09-Oct-22,NEFT,00.00,"1,08,003.86","7,56,026.98",
09-Oct-22,Reversal,01.25,00.00,"7,56,028.23",
09-Oct-22,Tax,00.00,"1,89,007.06","5,67,021.17",
09-Oct-22,Transfer,"4,631.98",00.00,"5,71,653.15",
09-Oct-22,Bill,00.00,"57,165.32","5,14,487.84",
09-Oct-22,RTGS,"13,56,760.00",00.00,"18,71,247.84",
09-Oct-22,Tax,"25,139.06",00.00,"18,96,386.90",
09-Oct-22,RTGS,"1,819.00",00.00,"18,98,205.90",
09-Oct-22,Tax,00.00,"1,89,820.59","17,08,385.31",
09-Oct-22,IMPS,00.00,"2,84,730.89","14,23,654.42",
09-Oct-22,IMPS,798,00.00,"14,24,452.42",
09-Oct-22,Purchase,00.00,"2,03,493.20","12,20,959.22",
09-Oct-22,Cash,00.00,"2,44,191.84","9,76,767.38",
09-Oct-22,Purchase,00.00,"9,76,767.38",00.00,
09-Oct-22,RTGS,394,00.00,394,
10-Oct-22,Cheque,394,00.00,788,
10-Oct-22,Bill,212.9,00.00,"1,000.90",
10-Oct-22,Reversal,00.00,166.82,834.08,
10-Oct-22,Debit Card,04.00,00.00,838.08,
10-Oct-22,NEFT,00.00,119.73,718.35,
10-Oct-22,IMPS,13,00.00,731.35,
10-Oct-22,IMPS,00.00,104.48,626.87,
10-Oct-22,Interest,07.50,00.00,634.37,
10-Oct-22,NEFT,"6,17,157.50",00.00,"6,17,791.87",
10-Oct-22,RTGS,00.00,"1,54,447.97","4,63,343.90",
10-Oct-22,Interest,"41,007.00",00.00,"5,04,350.90",
10-Oct-22,Cheque,00.00,"63,043.86","4,41,307.04",
10-Oct-22,Commission,00.00,"1,10,326.76","3,30,980.28",
10-Oct-22,NEFT,"20,52,376.00",00.00,"23,83,356.28",
10-Oct-22,Transportellaneous,00.00,"2,97,919.54","20,85,436.74",
10-Oct-22,ATM,"20,32,213.80",00.00,"41,17,650.54",
10-Oct-22,Cash,00.00,"5,14,706.32","36,02,944.22",
10-Oct-22,Reversal,"69,687.40",00.00,"36,72,631.62",
10-Oct-22,Bill,00.00,"3,67,263.16","33,05,368.46",
11-Oct-22,Tax,00.00,"11,01,789.49","22,03,578.97",
11-Oct-22,Cheque,00.00,"22,03,578.97",00.00,
11-Oct-22,Purchase,"3,972.50",00.00,"3,972.50",
11-Oct-22,Purchase,"41,110.00",00.00,"45,082.50",
11-Oct-22,Transfer,"26,639.40",00.00,"71,721.90",
11-Oct-22,Transportellaneous,07.00,00.00,"71,728.90",
11-Oct-22,Purchase,00.00,"7,172.89","64,556.01",
12-Oct-22,NEFT,"1,96,227.40",00.00,"2,60,783.41",
12-Oct-22,Cash,00.00,"43,463.90","2,17,319.51",
12-Oct-22,IMPS,"12,889.00",00.00,"2,30,208.51",
12-Oct-22,Cash,00.00,"38,368.09","1,91,840.42",
12-Oct-22,Bill,00.00,"27,405.77","1,64,434.65",
12-Oct-22,ATM,42.8,00.00,"1,64,477.45",
12-Oct-22,Interest,00.00,"23,496.78","1,40,980.67",
12-Oct-22,Bill,02.80,00.00,"1,40,983.47",
12-Oct-22,Transportellaneous,06.70,00.00,"1,40,990.17",
12-Oct-22,NEFT,"7,32,372.75",00.00,"8,73,362.92",
12-Oct-22,Transportellaneous,00.00,"4,36,681.46","4,36,681.46",
12-Oct-22,Interest,00.00,"1,09,170.37","3,27,511.10",
12-Oct-22,Reversal,00.00,"54,585.18","2,72,925.92",
12-Oct-22,RTGS,00.00,"27,292.59","2,45,633.33",
12-Oct-22,Interest,"3,041.00",00.00,"2,48,674.33",
12-Oct-22,Cash,"3,218.30",00.00,"2,51,892.63",
12-Oct-22,Reversal,03.27,00.00,"2,51,895.90",
12-Oct-22,Cash,00.00,"27,988.43","2,23,907.47",
12-Oct-22,Purchase,295.3,00.00,"2,24,202.77",
12-Oct-22,Cash,00.00,"56,050.69","1,68,152.08",
12-Oct-22,IMPS,00.00,"84,076.04","84,076.04",
12-Oct-22,Purchase,00.00,"16,815.21","67,260.83",
12-Oct-22,Cash,112.26,00.00,"67,373.09",
12-Oct-22,RTGS,"3,091.00",00.00,"70,464.09",
12-Oct-22,Tax,00.00,"14,092.82","56,371.27",
12-Oct-22,Debit Card,00.00,"18,790.42","37,580.85",
12-Oct-22,Cheque,00.00,"4,175.65","33,405.20",
12-Oct-22,Bill,00.00,"5,567.53","27,837.67",
12-Oct-22,NEFT,07.00,00.00,"27,844.67",
12-Oct-22,IMPS,03.27,00.00,"27,847.94",
12-Oct-22,Debit Card,01.80,00.00,"27,849.74",
13-Oct-22,Tax,"32,889.00",00.00,"60,738.74",
13-Oct-22,NEFT,138.62,00.00,"60,877.36",
13-Oct-22,Cheque,156.48,00.00,"61,033.84",
13-Oct-22,Tax,48,00.00,"61,081.84",
13-Oct-22,Commission,21.48,00.00,"61,103.32",
13-Oct-22,Cheque,00.00,"12,220.66","48,882.66",
13-Oct-22,ATM,"3,880.50",00.00,"52,763.16",
13-Oct-22,Commission,"1,633.90",00.00,"54,397.06",
13-Oct-22,Transfer,"1,52,259.90",00.00,"2,06,656.96",
13-Oct-22,Tax,00.00,"1,03,328.48","1,03,328.48",
13-Oct-22,NEFT,356.68,00.00,"1,03,685.16",
13-Oct-22,Reversal,195,00.00,"1,03,880.16",
13-Oct-22,Tax,00.00,"20,776.03","83,104.13",
13-Oct-22,RTGS,16.01,00.00,"83,120.14",
13-Oct-22,Tax,38.51,00.00,"83,158.65",
13-Oct-22,IMPS,00.00,"9,239.85","73,918.80",
13-Oct-22,Reversal,00.00,"9,239.85","64,678.95",
13-Oct-22,IMPS,00.00,"8,084.87","56,594.08",
13-Oct-22,Tax,00.00,"9,432.35","47,161.73",
13-Oct-22,ATM,00.00,"5,895.22","41,266.51",
13-Oct-22,ATM,"15,21,224.00",00.00,"15,62,490.51",
13-Oct-22,Purchase,00.00,"1,56,249.05","14,06,241.46",
13-Oct-22,RTGS,00.00,"1,75,780.18","12,30,461.28",
13-Oct-22,ATM,00.00,"1,23,046.13","11,07,415.15",
13-Oct-22,Reversal,07.00,00.00,"11,07,422.15",
13-Oct-22,Reversal,00.00,"3,69,140.72","7,38,281.43",
13-Oct-22,Commission,00.00,"3,69,140.72","3,69,140.72",
13-Oct-22,Tax,00.00,"92,285.18","2,76,855.54",
13-Oct-22,Purchase,02.00,00.00,"2,76,857.54",
13-Oct-22,Cash,00.00,"92,285.85","1,84,571.69",
13-Oct-22,Purchase,15,00.00,"1,84,586.69",
13-Oct-22,Commission,00.00,"18,458.67","1,66,128.02",
13-Oct-22,Interest,00.00,"16,612.80","1,49,515.22",
13-Oct-22,Transfer,00.00,"16,612.80","1,32,902.42",
13-Oct-22,ATM,"32,887.80",00.00,"1,65,790.22",
13-Oct-22,Cash,"9,45,884.50",00.00,"11,11,674.72",
13-Oct-22,ATM,"12,02,324.20",00.00,"23,13,998.92",
13-Oct-22,Bill,315,00.00,"23,14,313.92",
14-Oct-22,NEFT,00.00,"5,78,578.48","17,35,735.44",
14-Oct-22,Transfer,443.1,00.00,"17,36,178.54",
14-Oct-22,Bill,55.42,00.00,"17,36,233.96",
14-Oct-22,Transportellaneous,08.00,00.00,"17,36,241.96",
14-Oct-22,Commission,"5,61,412.80",00.00,"22,97,654.76",
14-Oct-22,Commission,00.00,"2,55,294.97","20,42,359.79",
14-Oct-22,Commission,00.00,"10,21,179.90","10,21,179.90",
14-Oct-22,Reversal,00.00,"1,70,196.65","8,50,983.25",
14-Oct-22,Cheque,00.00,"1,41,830.54","7,09,152.71",
14-Oct-22,Commission,"66,841.69",00.00,"7,75,994.40",
14-Oct-22,Interest,"18,39,069.00",00.00,"26,15,063.40",
14-Oct-22,Transfer,00.00,"2,90,562.60","23,24,500.80",
14-Oct-22,Interest,00.00,"3,32,071.54","19,92,429.26",
14-Oct-22,Bill,42.4,00.00,"19,92,471.66",
14-Oct-22,Cash,00.00,"1,99,247.17","17,93,224.49",
14-Oct-22,ATM,00.00,"17,93,224.49",00.00,
14-Oct-22,Interest,30,00.00,30,
14-Oct-22,Purchase,"3,439.00",00.00,"3,469.00",
14-Oct-22,Commission,32.79,00.00,"3,501.79",
14-Oct-22,Reversal,08.00,00.00,"3,509.79",
14-Oct-22,Cash,05.00,00.00,"3,514.79",
14-Oct-22,Bill,"5,44,606.50",00.00,"5,48,121.29",
14-Oct-22,Debit Card,525.39,00.00,"5,48,646.68",
14-Oct-22,Interest,00.00,"1,37,161.67","4,11,485.01",
14-Oct-22,NEFT,06.70,00.00,"4,11,491.71",
14-Oct-22,Interest,"1,57,295.19",00.00,"5,68,786.90",
14-Oct-22,Purchase,00.00,"94,797.82","4,73,989.08",
14-Oct-22,NEFT,00.00,"2,36,994.54","2,36,994.54",
14-Oct-22,Cash,374.5,00.00,"2,37,369.04",
14-Oct-22,Debit Card,"7,900.80",00.00,"2,45,269.84",
14-Oct-22,Cash,00.00,"2,45,269.84",00.00,
14-Oct-22,Cheque,22.7,00.00,22.7,
14-Oct-22,Transfer,"13,50,441.75",00.00,"13,50,464.45",
14-Oct-22,Debit Card,00.00,"1,68,808.06","11,81,656.39",
14-Oct-22,Cheque,00.00,"1,18,165.64","10,63,490.75",
14-Oct-22,Cash,00.00,"1,51,927.25","9,11,563.50",
14-Oct-22,Tax,"26,620.45",00.00,"9,38,183.95",
14-Oct-22,Purchase,"1,21,265.30",00.00,"10,59,449.25",
14-Oct-22,Transfer,00.00,"3,53,149.75","7,06,299.50",
14-Oct-22,Reversal,00.00,"3,53,149.75","3,53,149.75",
14-Oct-22,IMPS,34,00.00,"3,53,183.75",
14-Oct-22,Reversal,00.00,"39,242.64","3,13,941.11",
14-Oct-22,Tax,00.00,"3,13,941.11",00.00,
14-Oct-22,Bill,"5,214.20",00.00,"5,214.20",
14-Oct-22,IMPS,"19,68,354.75",00.00,"19,73,568.95",
14-Oct-22,Cash,969.5,00.00,"19,74,538.45",
14-Oct-22,Commission,06.00,00.00,"19,74,544.45",
14-Oct-22,Cheque,00.00,"6,58,181.48","13,16,362.97",
14-Oct-22,Debit Card,"1,25,143.00",00.00,"14,41,505.97",
14-Oct-22,ATM,"1,28,263.44",00.00,"15,69,769.41",
14-Oct-22,Transfer,00.00,"5,23,256.47","10,46,512.94",
14-Oct-22,RTGS,"18,71,429.00",00.00,"29,17,941.94",
14-Oct-22,Interest,00.00,"5,83,588.39","23,34,353.55",
14-Oct-22,Interest,00.00,"7,78,117.85","15,56,235.70",
14-Oct-22,Cheque,00.00,"1,94,529.46","13,61,706.24",
14-Oct-22,Transfer,02.00,00.00,"13,61,708.24",
14-Oct-22,IMPS,00.00,"2,72,341.65","10,89,366.59",
14-Oct-22,Bill,"15,86,897.50",00.00,"26,76,264.09",
14-Oct-22,Commission,00.00,"5,35,252.82","21,41,011.27",
14-Oct-22,Commission,00.00,"10,70,505.64","10,70,505.64",
14-Oct-22,Purchase,"2,28,989.80",00.00,"12,99,495.44",
14-Oct-22,Interest,07.00,00.00,"12,99,502.44",
14-Oct-22,ATM,00.00,"2,59,900.49","10,39,601.95",
14-Oct-22,Debit Card,00.00,"10,39,601.95",00.00,
14-Oct-22,ATM,287.77,00.00,287.77,
14-Oct-22,Transfer,00.00,31.97,255.8,
14-Oct-22,ATM,"12,40,295.00",00.00,"12,40,550.80",
14-Oct-22,Commission,21,00.00,"12,40,571.80",
14-Oct-22,Tax,"1,69,268.75",00.00,"14,09,840.55",
14-Oct-22,Interest,00.00,"2,01,405.79","12,08,434.76",
14-Oct-22,Transportellaneous,"17,771.00",00.00,"12,26,205.76",
14-Oct-22,Debit Card,"17,83,676.00",00.00,"30,09,881.76",
14-Oct-22,IMPS,00.00,"7,52,470.44","22,57,411.32",
14-Oct-22,NEFT,00.00,"7,52,470.44","15,04,940.88",
14-Oct-22,RTGS,00.00,"1,50,494.09","13,54,446.79",
14-Oct-22,Commission,"96,045.00",00.00,"14,50,491.79",
15-Oct-22,ATM,01.00,00.00,"14,50,492.79",
15-Oct-22,Cash,00.00,"2,07,213.26","12,43,279.53",
15-Oct-22,ATM,00.00,"1,24,327.95","11,18,951.58",
15-Oct-22,Transfer,"2,25,522.00",00.00,"13,44,473.58",
15-Oct-22,IMPS,00.00,"2,68,894.72","10,75,578.86",
15-Oct-22,Reversal,"1,83,090.00",00.00,"12,58,668.86",
15-Oct-22,ATM,00.00,"1,25,866.89","11,32,801.97",
15-Oct-22,Cash,00.00,"3,77,600.66","7,55,201.31",
15-Oct-22,Purchase,"90,600.00",00.00,"8,45,801.31",
15-Oct-22,Interest,00.00,"2,81,933.77","5,63,867.54",
15-Oct-22,Debit Card,53.5,00.00,"5,63,921.04",
15-Oct-22,Transfer,"9,62,792.00",00.00,"15,26,713.04",
15-Oct-22,Cash,"30,397.31",00.00,"15,57,110.35",
15-Oct-22,NEFT,00.00,"7,78,555.18","7,78,555.18",
16-Oct-22,NEFT,"16,667.00",00.00,"7,95,222.18",
16-Oct-22,Cash,00.00,"2,65,074.06","5,30,148.12",
16-Oct-22,IMPS,"9,888.10",00.00,"5,40,036.22",
16-Oct-22,Reversal,"1,96,580.50",00.00,"7,36,616.72",
16-Oct-22,IMPS,00.00,"1,22,769.45","6,13,847.27",
16-Oct-22,Purchase,00.00,"68,205.25","5,45,642.02",
16-Oct-22,Tax,00.00,"60,626.89","4,85,015.13",
16-Oct-22,ATM,00.00,"53,890.57","4,31,124.56",
16-Oct-22,Interest,00.00,"71,854.09","3,59,270.47",
16-Oct-22,Transfer,"7,649.12",00.00,"3,66,919.59",
16-Oct-22,RTGS,00.00,"40,768.84","3,26,150.75",
16-Oct-22,ATM,00.00,"3,26,150.75",00.00,
16-Oct-22,IMPS,357.45,00.00,357.45,
16-Oct-22,RTGS,00.00,89.36,268.09,
17-Oct-22,Interest,00.00,33.51,234.58,
17-Oct-22,Commission,00.00,58.65,175.94,
17-Oct-22,Reversal,00.00,43.99,131.95,
17-Oct-22,RTGS,01.90,00.00,133.85,
17-Oct-22,Cheque,00.00,13.39,120.46,
17-Oct-22,Cash,"42,082.00",00.00,"42,202.46",
17-Oct-22,ATM,00.00,"14,067.49","28,134.97",
17-Oct-22,Tax,"2,091.90",00.00,"30,226.87",
17-Oct-22,NEFT,00.00,"10,075.62","20,151.25",
17-Oct-22,IMPS,889.5,00.00,"21,040.75",
17-Oct-22,NEFT,00.00,"5,260.19","15,780.56",
17-Oct-22,Cash,"4,022.98",00.00,"19,803.54",
17-Oct-22,Purchase,00.00,"9,901.77","9,901.77",
18-Oct-22,Cash,427,00.00,"10,328.77",
18-Oct-22,Debit Card,00.00,"3,442.92","6,885.85",
18-Oct-22,Cash,59,00.00,"6,944.85",
18-Oct-22,NEFT,00.00,"1,736.21","5,208.64",
18-Oct-22,IMPS,00.00,868.11,"4,340.53",
18-Oct-22,Commission,"13,682.00",00.00,"18,022.53",
18-Oct-22,Commission,04.30,00.00,"18,026.83",
18-Oct-22,RTGS,"16,06,686.75",00.00,"16,24,713.58",
18-Oct-22,IMPS,00.00,"2,32,101.94","13,92,611.64",
18-Oct-22,RTGS,00.00,"6,96,305.82","6,96,305.82",
18-Oct-22,Debit Card,"2,105.11",00.00,"6,98,410.93",
18-Oct-22,Debit Card,"9,433.78",00.00,"7,07,844.71",
18-Oct-22,Bill,05.00,00.00,"7,07,849.71",
18-Oct-22,RTGS,04.00,00.00,"7,07,853.71",
18-Oct-22,Bill,"9,68,417.00",00.00,"16,76,270.71",
18-Oct-22,Reversal,06.30,00.00,"16,76,277.01",
18-Oct-22,Tax,31,00.00,"16,76,308.01",
18-Oct-22,Cheque,255.7,00.00,"16,76,563.71",
19-Oct-22,Bill,"1,20,613.50",00.00,"17,97,177.21",
19-Oct-22,NEFT,00.00,"3,59,435.44","14,37,741.77",
19-Oct-22,ATM,00.00,"1,79,717.72","12,58,024.05",
19-Oct-22,Bill,00.00,"1,25,802.41","11,32,221.64",
19-Oct-22,ATM,34,00.00,"11,32,255.64",
19-Oct-22,Interest,00.00,"3,77,418.55","7,54,837.09",
19-Oct-22,Cheque,00.00,"1,50,967.42","6,03,869.67",
19-Oct-22,Interest,00.00,"2,01,289.89","4,02,579.78",
19-Oct-22,Commission,723.32,00.00,"4,03,303.10",
19-Oct-22,RTGS,00.00,"67,217.18","3,36,085.92",
19-Oct-22,IMPS,"3,258.10",00.00,"3,39,344.02",
19-Oct-22,Reversal,00.00,"1,69,672.01","1,69,672.01",
19-Oct-22,NEFT,00.00,"18,852.45","1,50,819.56",
19-Oct-22,RTGS,"9,73,680.75",00.00,"11,24,500.31",
19-Oct-22,RTGS,"17,43,038.50",00.00,"28,67,538.81",
20-Oct-22,Interest,00.00,"4,09,648.40","24,57,890.41",
20-Oct-22,Transportellaneous,00.00,"6,14,472.60","18,43,417.81",
20-Oct-22,Interest,"2,131.00",00.00,"18,45,548.81",
20-Oct-22,Tax,05.70,00.00,"18,45,554.51",
20-Oct-22,Transfer,60.2,00.00,"18,45,614.71",
20-Oct-22,Tax,"1,51,200.00",00.00,"19,96,814.71",
20-Oct-22,Commission,00.00,"19,96,814.71",00.00,
20-Oct-22,Transportellaneous,02.50,00.00,02.50,
20-Oct-22,RTGS,00.00,00.28,02.22,
20-Oct-22,Purchase,"27,604.20",00.00,"27,606.42",
20-Oct-22,IMPS,00.00,"4,601.07","23,005.35",
20-Oct-22,Transportellaneous,00.00,"2,875.67","20,129.68",
20-Oct-22,Cheque,00.00,"5,032.42","15,097.26",
20-Oct-22,Cash,00.00,"3,774.32","11,322.94",
20-Oct-22,Purchase,00.00,"1,415.37","9,907.57",
20-Oct-22,Transportellaneous,00.00,"1,238.45","8,669.12",
20-Oct-22,Interest,00.00,"1,238.45","7,430.67",
20-Oct-22,NEFT,00.00,825.63,"6,605.04",
20-Oct-22,Commission,01.68,00.00,"6,606.72",
20-Oct-22,ATM,00.00,"2,202.24","4,404.48",
20-Oct-22,RTGS,277.49,00.00,"4,681.97",
20-Oct-22,Transportellaneous,00.01,00.00,"4,681.98",
20-Oct-22,Reversal,343.6,00.00,"5,025.58",
20-Oct-22,ATM,00.00,"2,512.79","2,512.79",
20-Oct-22,Cash,00.00,251.28,"2,261.51",
20-Oct-22,ATM,"17,93,402.00",00.00,"17,95,663.51",
20-Oct-22,Commission,32.7,00.00,"17,95,696.21",
20-Oct-22,Tax,750.8,00.00,"17,96,447.01",
20-Oct-22,Tax,00.00,"8,98,223.51","8,98,223.50",
20-Oct-22,Interest,254.85,00.00,"8,98,478.35",
20-Oct-22,Debit Card,01.00,00.00,"8,98,479.35",
20-Oct-22,Bill,"2,57,506.80",00.00,"11,55,986.15",
20-Oct-22,Interest,"3,286.87",00.00,"11,59,273.02",
20-Oct-22,RTGS,"1,813.72",00.00,"11,61,086.74",
20-Oct-22,RTGS,00.00,"5,80,543.37","5,80,543.37",
20-Oct-22,Transfer,00.00,"1,45,135.84","4,35,407.53",
21-Oct-22,Tax,"17,36,609.25",00.00,"21,72,016.78",
21-Oct-22,Commission,00.00,"10,86,008.39","10,86,008.39",
21-Oct-22,Transfer,00.00,"1,20,667.60","9,65,340.79",
21-Oct-22,IMPS,00.00,"1,07,260.09","8,58,080.70",
21-Oct-22,Cheque,00.00,"1,22,582.96","7,35,497.74",
21-Oct-22,Bill,00.00,"1,22,582.96","6,12,914.78",
21-Oct-22,Transfer,04.00,00.00,"6,12,918.78",
21-Oct-22,Transportellaneous,00.00,"6,12,918.78",00.00,
21-Oct-22,IMPS,05.31,00.00,05.31,
21-Oct-22,ATM,33,00.00,38.31,
21-Oct-22,IMPS,03.00,00.00,41.31,
21-Oct-22,Interest,00.00,08.26,33.05,
21-Oct-22,ATM,00.00,33.05,00.00,
21-Oct-22,IMPS,189.68,00.00,189.68,
21-Oct-22,Transportellaneous,"2,09,124.97",00.00,"2,09,314.65",
21-Oct-22,Purchase,00.00,"26,164.33","1,83,150.32",
21-Oct-22,Debit Card,07.14,00.00,"1,83,157.46",
21-Oct-22,NEFT,00.00,"45,789.37","1,37,368.10",
21-Oct-22,IMPS,"1,835.30",00.00,"1,39,203.40",
21-Oct-22,Purchase,00.00,"69,601.70","69,601.70",
21-Oct-22,Cheque,00.00,"6,960.17","62,641.53",
21-Oct-22,Bill,00.00,"20,880.51","41,761.02",
21-Oct-22,Transfer,"1,56,677.70",00.00,"1,98,438.72",
21-Oct-22,Cheque,00.00,"99,219.36","99,219.36",
21-Oct-22,Bill,"7,234.41",00.00,"1,06,453.77",
21-Oct-22,Bill,"25,894.00",00.00,"1,32,347.77",
21-Oct-22,NEFT,"2,56,244.09",00.00,"3,88,591.86",
22-Oct-22,Tax,"1,206.00",00.00,"3,89,797.86",
22-Oct-22,Commission,00.00,"77,959.57","3,11,838.29",
22-Oct-22,Tax,00.00,"3,11,838.29",00.00,
22-Oct-22,NEFT,"2,31,286.50",00.00,"2,31,286.50",
22-Oct-22,Cheque,00.00,"77,095.50","1,54,191.00",
22-Oct-22,Purchase,"27,188.90",00.00,"1,81,379.90",
22-Oct-22,Transfer,00.00,"1,81,379.90",00.00,
22-Oct-22,Reversal,07.00,00.00,07.00,
22-Oct-22,NEFT,07.00,00.00,14,
22-Oct-22,Transportellaneous,"1,994.94",00.00,"2,008.94",
22-Oct-22,Transfer,00.00,401.79,"1,607.15",
22-Oct-22,Transportellaneous,"2,23,031.20",00.00,"2,24,638.35",
22-Oct-22,IMPS,"1,223.30",00.00,"2,25,861.65",
23-Oct-22,Cheque,00.00,"56,465.41","1,69,396.24",
23-Oct-22,Interest,00.00,"24,199.46","1,45,196.78",
23-Oct-22,Transfer,"2,158.00",00.00,"1,47,354.78",
23-Oct-22,Interest,262.2,00.00,"1,47,616.98",
23-Oct-22,Debit Card,00.00,"49,205.66","98,411.32",
23-Oct-22,Cash,00.00,"14,058.76","84,352.56",
23-Oct-22,Purchase,00.00,"8,435.26","75,917.30",
23-Oct-22,Transportellaneous,393.8,00.00,"76,311.10",
23-Oct-22,Cash,00.00,"9,538.89","66,772.21",
23-Oct-22,Transfer,00.00,"13,354.44","53,417.77",
23-Oct-22,Commission,00.00,"53,417.77",00.00,
23-Oct-22,Commission,00.78,00.00,00.78,
23-Oct-22,IMPS,"8,545.00",00.00,"8,545.78",
23-Oct-22,Interest,"65,637.25",00.00,"74,183.03",
23-Oct-22,Reversal,00.00,"8,242.56","65,940.47",
23-Oct-22,ATM,"12,705.18",00.00,"78,645.65",
23-Oct-22,NEFT,00.00,"11,235.09","67,410.56",
23-Oct-22,RTGS,00.00,"13,482.11","53,928.45",
23-Oct-22,Bill,00.00,"7,704.06","46,224.39",
23-Oct-22,IMPS,00.00,"5,778.05","40,446.34",
23-Oct-22,Commission,00.00,"8,089.27","32,357.07",
23-Oct-22,NEFT,00.00,"4,044.63","28,312.44",
23-Oct-22,Reversal,"2,465.40",00.00,"30,777.84",
23-Oct-22,Bill,00.00,"15,388.92","15,388.92",
23-Oct-22,Cash,06.00,00.00,"15,394.92",
23-Oct-22,Transfer,00.00,"1,539.49","13,855.43",
23-Oct-22,Debit Card,00.00,"1,385.54","12,469.89",
23-Oct-22,Purchase,"1,288.80",00.00,"13,758.69",
23-Oct-22,Reversal,00.00,"1,375.87","12,382.82",
23-Oct-22,Purchase,"3,22,966.00",00.00,"3,35,348.82",
23-Oct-22,Reversal,00.00,"1,11,782.94","2,23,565.88",
23-Oct-22,Transportellaneous,"63,358.94",00.00,"2,86,924.82",
23-Oct-22,Reversal,00.00,"2,86,924.82",00.00,
23-Oct-22,Tax,32.42,00.00,32.42,
23-Oct-22,ATM,56.8,00.00,89.22,
23-Oct-22,Commission,"12,11,890.00",00.00,"12,11,979.22",
23-Oct-22,IMPS,00.00,"6,05,989.61","6,05,989.61",
23-Oct-22,NEFT,00.00,"1,00,998.27","5,04,991.34",
23-Oct-22,IMPS,00.00,"1,00,998.27","4,03,993.07",
23-Oct-22,NEFT,01.50,00.00,"4,03,994.57",
23-Oct-22,Cheque,00.00,"44,888.29","3,59,106.28",
23-Oct-22,Reversal,"3,718.20",00.00,"3,62,824.48",
23-Oct-22,Transfer,"1,08,081.30",00.00,"4,70,905.78",
23-Oct-22,Commission,00.00,"67,272.25","4,03,633.53",
23-Oct-22,Debit Card,483.6,00.00,"4,04,117.13",
23-Oct-22,IMPS,"15,304.00",00.00,"4,19,421.13",
23-Oct-22,Cheque,00.00,"59,917.30","3,59,503.83",
24-Oct-22,Reversal,361,00.00,"3,59,864.83",
24-Oct-22,RTGS,00.00,"51,409.26","3,08,455.57",
24-Oct-22,ATM,797,00.00,"3,09,252.57",
24-Oct-22,Reversal,00.00,"34,361.40","2,74,891.17",
24-Oct-22,RTGS,438.1,00.00,"2,75,329.27",
24-Oct-22,Cash,231.97,00.00,"2,75,561.24",
24-Oct-22,Debit Card,00.00,"55,112.25","2,20,448.99",
24-Oct-22,Transfer,00.00,"2,20,448.99",00.00,
24-Oct-22,IMPS,394.9,00.00,394.9,
24-Oct-22,Transfer,"3,68,745.00",00.00,"3,69,139.90",
24-Oct-22,RTGS,00.00,"52,734.27","3,16,405.63",
24-Oct-22,Purchase,00.00,"35,156.18","2,81,249.45",
24-Oct-22,Transportellaneous,"17,43,348.50",00.00,"20,24,597.95",
24-Oct-22,Tax,00.00,"20,24,597.95",00.00,
24-Oct-22,Transfer,34,00.00,34,
24-Oct-22,Purchase,00.00,04.86,29.14,
24-Oct-22,Cash,317,00.00,346.14,
24-Oct-22,Tax,00.00,57.69,288.45,
24-Oct-22,Reversal,"27,736.40",00.00,"28,024.85",
24-Oct-22,Interest,"4,62,812.75",00.00,"4,90,837.60",
24-Oct-22,Bill,03.40,00.00,"4,90,841.00",
24-Oct-22,Bill,00.00,"98,168.20","3,92,672.80",
24-Oct-22,Tax,00.00,"49,084.10","3,43,588.70",
24-Oct-22,Cheque,"31,585.75",00.00,"3,75,174.45",
24-Oct-22,ATM,47,00.00,"3,75,221.45",
24-Oct-22,Commission,00.00,"41,691.27","3,33,530.18",
24-Oct-22,Tax,35,00.00,"3,33,565.18",
24-Oct-22,Interest,00.00,"33,356.52","3,00,208.66",
24-Oct-22,ATM,"24,020.51",00.00,"3,24,229.17",
24-Oct-22,Cheque,00.00,"64,845.83","2,59,383.34",
24-Oct-22,NEFT,"14,60,442.00",00.00,"17,19,825.34",
24-Oct-22,IMPS,"2,983.73",00.00,"17,22,809.07",
24-Oct-22,Reversal,00.00,"1,91,423.23","15,31,385.84",
24-Oct-22,Transfer,407.8,00.00,"15,31,793.64",
24-Oct-22,Purchase,00.00,"1,70,199.29","13,61,594.35",
24-Oct-22,Reversal,31.2,00.00,"13,61,625.55",
24-Oct-22,Tax,"31,502.81",00.00,"13,93,128.36",
24-Oct-22,Cash,108,00.00,"13,93,236.36",
24-Oct-22,Reversal,56.99,00.00,"13,93,293.35",
24-Oct-22,RTGS,55.6,00.00,"13,93,348.95",
24-Oct-22,Cheque,00.00,"1,39,334.90","12,54,014.06",
24-Oct-22,Cheque,00.00,"12,54,014.06",00.00,
24-Oct-22,NEFT,"19,19,547.00",00.00,"19,19,547.00",
24-Oct-22,Commission,00.00,"4,79,886.75","14,39,660.25",
24-Oct-22,Cheque,00.00,"7,19,830.13","7,19,830.12",
24-Oct-22,Transfer,573.3,00.00,"7,20,403.42",
24-Oct-22,Transfer,00.00,"1,80,100.86","5,40,302.57",
24-Oct-22,Tax,00.00,"90,050.43","4,50,252.14",
24-Oct-22,Bill,"47,572.94",00.00,"4,97,825.08",
24-Oct-22,Cheque,"2,308.83",00.00,"5,00,133.91",
24-Oct-22,Transfer,00.00,"1,00,026.78","4,00,107.13",
24-Oct-22,Cash,142,00.00,"4,00,249.13",
24-Oct-22,Transportellaneous,406.7,00.00,"4,00,655.83",
24-Oct-22,Purchase,55,00.00,"4,00,710.83",
25-Oct-22,RTGS,"1,96,156.00",00.00,"5,96,866.83",
25-Oct-22,Cash,"10,510.12",00.00,"6,07,376.95",
25-Oct-22,RTGS,00.00,"3,03,688.48","3,03,688.47",
25-Oct-22,Cash,"14,43,789.00",00.00,"17,47,477.47",
25-Oct-22,Debit Card,00.00,"8,73,738.74","8,73,738.74",
25-Oct-22,Commission,00.00,"1,74,747.75","6,98,990.99",
25-Oct-22,Reversal,00.00,"6,98,990.99",00.00,
25-Oct-22,Transfer,"70,106.00",00.00,"70,106.00",
25-Oct-22,Debit Card,00.00,"10,015.14","60,090.86",
25-Oct-22,Purchase,06.30,00.00,"60,097.16",
25-Oct-22,Transportellaneous,00.00,"10,016.19","50,080.97",
25-Oct-22,Purchase,"19,00,659.20",00.00,"19,50,740.17",
25-Oct-22,ATM,803.5,00.00,"19,51,543.67",
25-Oct-22,IMPS,"3,93,217.00",00.00,"23,44,760.67",
25-Oct-22,Commission,00.00,"7,81,586.89","15,63,173.78",
25-Oct-22,Purchase,00.00,"3,12,634.76","12,50,539.02",
25-Oct-22,NEFT,48.18,00.00,"12,50,587.20",
25-Oct-22,Transfer,00.00,"1,25,058.72","11,25,528.48",
25-Oct-22,Purchase,00.00,"3,75,176.16","7,50,352.32",
25-Oct-22,IMPS,08.00,00.00,"7,50,360.32",
25-Oct-22,Cheque,00.00,"1,50,072.06","6,00,288.26",
25-Oct-22,Interest,116.39,00.00,"6,00,404.65",
25-Oct-22,Reversal,"35,924.60",00.00,"6,36,329.25",
25-Oct-22,Tax,"30,004.40",00.00,"6,66,333.65",
25-Oct-22,Cash,00.00,"2,22,111.22","4,44,222.43",
25-Oct-22,Cheque,00.00,"44,422.24","3,99,800.19",
25-Oct-22,ATM,"14,22,336.00",00.00,"18,22,136.19",
25-Oct-22,Transportellaneous,00.00,"1,82,213.62","16,39,922.57",
25-Oct-22,Reversal,"20,35,145.00",00.00,"36,75,067.57",
25-Oct-22,Reversal,00.00,"4,08,340.84","32,66,726.73",
25-Oct-22,Purchase,00.00,"6,53,345.35","26,13,381.38",
25-Oct-22,Transfer,"3,84,002.25",00.00,"29,97,383.63",
25-Oct-22,NEFT,870,00.00,"29,98,253.63",
25-Oct-22,NEFT,15.68,00.00,"29,98,269.31",
25-Oct-22,Commission,725,00.00,"29,98,994.31",
25-Oct-22,Purchase,"4,036.70",00.00,"30,03,031.01",
25-Oct-22,Transfer,00.00,"7,50,757.75","22,52,273.26",
25-Oct-22,Commission,00.00,"3,21,753.32","19,30,519.94",
25-Oct-22,RTGS,00.00,"4,82,629.99","14,47,889.96",
25-Oct-22,Bill,01.40,00.00,"14,47,891.36",
25-Oct-22,Interest,00.00,"7,23,945.68","7,23,945.68",
25-Oct-22,IMPS,00.00,"1,20,657.61","6,03,288.07",
25-Oct-22,Interest,"10,72,555.50",00.00,"16,75,843.57",
25-Oct-22,Reversal,00.00,"2,39,406.22","14,36,437.35",
25-Oct-22,Transportellaneous,04.80,00.00,"14,36,442.15",
25-Oct-22,Transfer,05.90,00.00,"14,36,448.05",
25-Oct-22,Purchase,447,00.00,"14,36,895.05",
25-Oct-22,Purchase,00.00,"14,36,895.05",00.00,
25-Oct-22,Debit Card,"26,722.00",00.00,"26,722.00",
25-Oct-22,NEFT,00.00,"2,672.20","24,049.80",
25-Oct-22,Purchase,00.00,"3,435.69","20,614.11",
25-Oct-22,Bill,"16,81,713.00",00.00,"17,02,327.11",
25-Oct-22,Tax,00.00,"17,02,327.11",00.00,
25-Oct-22,Cheque,400.3,00.00,400.3,
25-Oct-22,Transportellaneous,"13,963.95",00.00,"14,364.25",
25-Oct-22,IMPS,00.00,"7,182.13","7,182.12",
25-Oct-22,Transportellaneous,00.00,718.21,"6,463.91",
25-Oct-22,Cash,00.00,"1,615.98","4,847.93",
25-Oct-22,Transportellaneous,00.00,538.66,"4,309.27",
25-Oct-22,Transportellaneous,00.00,"1,077.32","3,231.95",
25-Oct-22,ATM,130,00.00,"3,361.95",
25-Oct-22,Transportellaneous,"18,472.60",00.00,"21,834.55",
25-Oct-22,Debit Card,07.93,00.00,"21,842.48",
25-Oct-22,Interest,00.00,"10,921.24","10,921.24",
25-Oct-22,Reversal,07.25,00.00,"10,928.49",
25-Oct-22,ATM,00.00,"2,185.70","8,742.79",
25-Oct-22,Cheque,00.00,"1,457.13","7,285.66",
25-Oct-22,Cheque,00.00,"1,214.28","6,071.38",
25-Oct-22,Transfer,00.00,607.14,"5,464.24",
25-Oct-22,Bill,01.25,00.00,"5,465.49",
25-Oct-22,Interest,157.6,00.00,"5,623.09",
25-Oct-22,Bill,00.00,562.31,"5,060.78",
25-Oct-22,Reversal,07.70,00.00,"5,068.48",
25-Oct-22,RTGS,00.00,506.85,"4,561.63",
25-Oct-22,Debit Card,290,00.00,"4,851.63",
25-Oct-22,Interest,00.00,485.16,"4,366.47",
26-Oct-22,Purchase,"5,87,917.00",00.00,"5,92,283.47",
26-Oct-22,Tax,00.00,"65,809.27","5,26,474.20",
26-Oct-22,Tax,00.00,"1,31,618.55","3,94,855.65",
26-Oct-22,ATM,"19,912.00",00.00,"4,14,767.65",
26-Oct-22,ATM,00.00,"46,085.29","3,68,682.36",
26-Oct-22,Debit Card,"12,28,355.80",00.00,"15,97,038.16",
27-Oct-22,Interest,"25,774.40",00.00,"16,22,812.56",
27-Oct-22,Bill,01.91,00.00,"16,22,814.47",
27-Oct-22,Commission,00.00,"3,24,562.89","12,98,251.58",
27-Oct-22,Purchase,00.00,"3,24,562.90","9,73,688.68",
27-Oct-22,Cheque,00.00,"1,08,187.63","8,65,501.05",
27-Oct-22,Transportellaneous,37.83,00.00,"8,65,538.88",
27-Oct-22,IMPS,00.00,"1,73,107.78","6,92,431.10",
27-Oct-22,Purchase,05.87,00.00,"6,92,436.97",
27-Oct-22,Bill,243.42,00.00,"6,92,680.39",
27-Oct-22,Commission,00.00,"1,15,446.73","5,77,233.66",
27-Oct-22,Commission,"42,361.00",00.00,"6,19,594.66",
28-Oct-22,NEFT,00.00,"2,06,531.55","4,13,063.11",
28-Oct-22,RTGS,00.00,"68,843.85","3,44,219.26",
28-Oct-22,RTGS,"2,087.00",00.00,"3,46,306.26",
28-Oct-22,Cheque,"30,323.06",00.00,"3,76,629.32",
28-Oct-22,Debit Card,"2,08,538.00",00.00,"5,85,167.32",
28-Oct-22,Reversal,00.00,"2,92,583.66","2,92,583.66",
28-Oct-22,Interest,00.00,"2,92,583.66",00.00,
28-Oct-22,Reversal,51,00.00,51,
28-Oct-22,Transportellaneous,445.63,00.00,496.63,
28-Oct-22,RTGS,00.00,62.08,434.55,
28-Oct-22,Reversal,"1,021.30",00.00,"1,455.85",
28-Oct-22,NEFT,00.00,181.98,"1,273.87",
28-Oct-22,Interest,00.00,254.77,"1,019.10",
28-Oct-22,Commission,"9,03,260.00",00.00,"9,04,279.10",
28-Oct-22,Reversal,00.00,"3,01,426.37","6,02,852.73",
28-Oct-22,Interest,00.00,"66,983.64","5,35,869.09",
28-Oct-22,Transfer,"1,559.00",00.00,"5,37,428.09",
28-Oct-22,Transportellaneous,00.00,"67,178.51","4,70,249.58",
28-Oct-22,ATM,60.64,00.00,"4,70,310.22",
28-Oct-22,ATM,00.00,"78,385.04","3,91,925.18",
28-Oct-22,IMPS,00.00,"48,990.65","3,42,934.53",
28-Oct-22,Reversal,208.9,00.00,"3,43,143.43",
28-Oct-22,Cheque,166.19,00.00,"3,43,309.62",
28-Oct-22,ATM,00.00,"85,827.41","2,57,482.22",
28-Oct-22,Transportellaneous,"8,32,783.00",00.00,"10,90,265.22",
28-Oct-22,Cheque,00.00,"10,90,265.22",00.00,
28-Oct-22,Transfer,63.41,00.00,63.41,
28-Oct-22,Cash,"5,13,702.00",00.00,"5,13,765.41",
28-Oct-22,Debit Card,00.00,"64,220.68","4,49,544.73",
28-Oct-22,Transportellaneous,00.00,"1,49,848.24","2,99,696.49",
28-Oct-22,Cash,"1,196.01",00.00,"3,00,892.50",
28-Oct-22,NEFT,00.00,"3,00,892.50",00.00,
28-Oct-22,Interest,"1,95,019.00",00.00,"1,95,019.00",
28-Oct-22,IMPS,"1,48,608.00",00.00,"3,43,627.00",
28-Oct-22,Transportellaneous,"4,153.00",00.00,"3,47,780.00",
28-Oct-22,Purchase,"5,171.50",00.00,"3,52,951.50",
28-Oct-22,Interest,59,00.00,"3,53,010.50",
28-Oct-22,Cheque,04.12,00.00,"3,53,014.62",
28-Oct-22,ATM,00.00,"88,253.66","2,64,760.96",
28-Oct-22,RTGS,00.00,"44,126.83","2,20,634.13",
28-Oct-22,Bill,254,00.00,"2,20,888.13",
28-Oct-22,Cash,"9,16,184.50",00.00,"11,37,072.63",
28-Oct-22,Transfer,58.2,00.00,"11,37,130.83",
28-Oct-22,Bill,18.15,00.00,"11,37,148.98",
28-Oct-22,Reversal,00.00,00.00,"11,37,148.98",
28-Oct-22,RTGS,00.00,"1,26,349.89","10,10,799.09",
29-Oct-22,Cheque,00.00,"1,44,399.87","8,66,399.22",
29-Oct-22,NEFT,00.00,"86,639.92","7,79,759.30",
29-Oct-22,Interest,00.00,"77,975.93","7,01,783.37",
29-Oct-22,Cheque,"4,064.09",00.00,"7,05,847.46",
29-Oct-22,IMPS,00.00,"78,427.50","6,27,419.96",
29-Oct-22,Reversal,00.00,"78,427.50","5,48,992.46",
29-Oct-22,Purchase,00.00,"5,48,992.46",00.00,
29-Oct-22,Commission,18,00.00,18,
29-Oct-22,Interest,"20,05,497.25",00.00,"20,05,515.25",
29-Oct-22,Bill,00.00,"2,86,502.18","17,19,013.07",
29-Oct-22,Transportellaneous,00.00,"2,14,876.63","15,04,136.44",
29-Oct-22,Tax,"17,58,212.50",00.00,"32,62,348.94",
29-Oct-22,Cash,"3,229.90",00.00,"32,65,578.84",
29-Oct-22,Commission,"52,527.80",00.00,"33,18,106.64",
29-Oct-22,Transfer,273,00.00,"33,18,379.64",
29-Oct-22,Interest,44.69,00.00,"33,18,424.33",
29-Oct-22,Cash,"1,447.81",00.00,"33,19,872.14",
30-Oct-22,Purchase,"32,629.00",00.00,"33,52,501.14",
30-Oct-22,Cheque,343,00.00,"33,52,844.14",
31-Oct-22,RTGS,06.65,00.00,"33,52,850.79",
31-Oct-22,Transportellaneous,00.00,"6,70,570.16","26,82,280.63",
31-Oct-22,Cheque,480.9,00.00,"26,82,761.53",
31-Oct-22,Interest,39,00.00,"26,82,800.53",
31-Oct-22,IMPS,"1,41,023.00",00.00,"28,23,823.53",
31-Oct-22,NEFT,00.00,"28,23,823.53",00.00,
31-Oct-22,Cash,478.6,00.00,478.6,
01-Nov-22,ATM,00.00,59.83,418.78,
01-Nov-22,NEFT,"19,686.10",00.00,"20,104.88",
01-Nov-22,Reversal,00.00,"2,872.13","17,232.75",
01-Nov-22,Interest,00.00,"4,308.19","12,924.56",
01-Nov-22,Bill,24,00.00,"12,948.56",
01-Nov-22,Transfer,38,00.00,"12,986.56",
01-Nov-22,Transfer,"2,485.20",00.00,"15,471.76",
01-Nov-22,Reversal,"1,894.00",00.00,"17,365.76",
01-Nov-22,Interest,"1,717.24",00.00,"19,083.00",
01-Nov-22,Reversal,00.00,"1,908.30","17,174.70",
01-Nov-22,Cash,00.00,"1,717.47","15,457.23",
01-Nov-22,Transfer,00.00,"15,457.23",00.00,
01-Nov-22,Purchase,"1,165.77",00.00,"1,165.77",
01-Nov-22,Debit Card,09.00,00.00,"1,174.77",
01-Nov-22,Cash,00.00,146.85,"1,027.92",
01-Nov-22,Commission,07.00,00.00,"1,034.92",
01-Nov-22,Cash,00.00,517.46,517.46,
01-Nov-22,Purchase,00.00,51.75,465.71,
01-Nov-22,Transportellaneous,43,00.00,508.71,
01-Nov-22,IMPS,22,00.00,530.71,
01-Nov-22,Commission,"1,45,010.22",00.00,"1,45,540.93",
01-Nov-22,Tax,220,00.00,"1,45,760.93",
01-Nov-22,Purchase,00.00,"29,152.19","1,16,608.74",
01-Nov-22,ATM,45.2,00.00,"1,16,653.94",
01-Nov-22,Transportellaneous,06.50,00.00,"1,16,660.44",
01-Nov-22,Bill,01.00,00.00,"1,16,661.44",
01-Nov-22,ATM,00.00,"23,332.29","93,329.15",
01-Nov-22,RTGS,00.00,"18,665.83","74,663.32",
01-Nov-22,Transportellaneous,320.88,00.00,"74,984.20",
01-Nov-22,Purchase,00.00,"7,498.42","67,485.78",
01-Nov-22,Interest,00.00,"67,485.78",00.00,
01-Nov-22,Purchase,387.7,00.00,387.7,
01-Nov-22,Bill,"1,961.00",00.00,"2,348.70",
01-Nov-22,Commission,"1,12,497.10",00.00,"1,14,845.80",
01-Nov-22,ATM,117,00.00,"1,14,962.80",
01-Nov-22,IMPS,"21,539.00",00.00,"1,36,501.80",
01-Nov-22,Interest,00.00,"45,500.60","91,001.20",
02-Nov-22,Cheque,195.3,00.00,"91,196.50",
02-Nov-22,Purchase,00.00,"91,196.50",00.00,
02-Nov-22,IMPS,"1,45,389.00",00.00,"1,45,389.00",
02-Nov-22,Interest,00.00,"29,077.80","1,16,311.20",
02-Nov-22,Cheque,00.00,"38,770.40","77,540.80",
02-Nov-22,Transfer,00.00,"77,540.80",00.00,
03-Nov-22,NEFT,"12,499.00",00.00,"12,499.00",
03-Nov-22,Cheque,00.00,"4,166.33","8,332.67",
03-Nov-22,Commission,00.00,"1,041.58","7,291.09",
03-Nov-22,Commission,"4,276.64",00.00,"11,567.73",
03-Nov-22,Purchase,00.00,"1,156.77","10,410.96",
03-Nov-22,Transportellaneous,00.00,"2,602.74","7,808.22",
03-Nov-22,RTGS,00.00,"2,602.74","5,205.48",
03-Nov-22,ATM,00.00,"1,041.10","4,164.38",
03-Nov-22,Interest,268.4,00.00,"4,432.78",
03-Nov-22,Cash,07.00,00.00,"4,439.78",
03-Nov-22,Purchase,145.75,00.00,"4,585.53",
03-Nov-22,Bill,"1,563.00",00.00,"6,148.53",
03-Nov-22,Debit Card,07.18,00.00,"6,155.71",
03-Nov-22,Debit Card,"2,46,803.59",00.00,"2,52,959.30",
03-Nov-22,Purchase,00.00,"1,26,479.65","1,26,479.65",
03-Nov-22,RTGS,00.00,"12,647.97","1,13,831.68",
03-Nov-22,IMPS,00.00,"37,943.89","75,887.79",
03-Nov-22,Cheque,"2,888.60",00.00,"78,776.39",
03-Nov-22,NEFT,"14,775.00",00.00,"93,551.39",
03-Nov-22,NEFT,"1,387.80",00.00,"94,939.19",
03-Nov-22,Bill,"15,70,063.00",00.00,"16,65,002.19",
03-Nov-22,Purchase,00.00,"4,16,250.55","12,48,751.64",
03-Nov-22,Reversal,00.00,"4,16,250.55","8,32,501.09",
03-Nov-22,Tax,00.00,"2,08,125.27","6,24,375.82",
03-Nov-22,ATM,"4,047.80",00.00,"6,28,423.62",
03-Nov-22,Transportellaneous,00.00,"2,09,474.54","4,18,949.08",
03-Nov-22,Cash,"2,57,975.40",00.00,"6,76,924.48",
03-Nov-22,IMPS,"1,63,635.41",00.00,"8,40,559.89",
03-Nov-22,Cash,00.00,"1,40,093.32","7,00,466.58",
03-Nov-22,Cash,00.00,"77,829.62","6,22,636.96",
03-Nov-22,Cash,00.00,"77,829.62","5,44,807.34",
03-Nov-22,Cheque,00.00,"5,44,807.34",00.00,
03-Nov-22,Purchase,202.3,00.00,202.3,
03-Nov-22,Transportellaneous,"1,64,919.00",00.00,"1,65,121.30",
03-Nov-22,Cash,07.00,00.00,"1,65,128.30",
03-Nov-22,Tax,"3,641.40",00.00,"1,68,769.70",
03-Nov-22,Purchase,"1,42,111.38",00.00,"3,10,881.08",
03-Nov-22,Cash,00.00,"3,10,881.08",00.00,
03-Nov-22,NEFT,162.8,00.00,162.8,
03-Nov-22,Cheque,"44,520.53",00.00,"44,683.33",
03-Nov-22,Interest,00.00,"11,170.83","33,512.50",
03-Nov-22,RTGS,58.61,00.00,"33,571.11",
03-Nov-22,Transfer,165.6,00.00,"33,736.71",
03-Nov-22,NEFT,"2,22,413.00",00.00,"2,56,149.71",
03-Nov-22,Transfer,00.00,"64,037.43","1,92,112.28",
03-Nov-22,RTGS,403,00.00,"1,92,515.28",
03-Nov-22,Transportellaneous,00.00,"24,064.41","1,68,450.87",
03-Nov-22,RTGS,31.78,00.00,"1,68,482.65",
03-Nov-22,Bill,00.00,"84,241.33","84,241.32",
03-Nov-22,Reversal,307.8,00.00,"84,549.12",
03-Nov-22,Cash,00.00,"9,394.35","75,154.77",
03-Nov-22,Bill,"16,02,701.25",00.00,"16,77,856.02",
03-Nov-22,NEFT,"13,82,119.00",00.00,"30,59,975.02",
03-Nov-22,Tax,437.24,00.00,"30,60,412.26",
03-Nov-22,Cheque,02.30,00.00,"30,60,414.56",
03-Nov-22,Debit Card,"28,814.25",00.00,"30,89,228.81",
03-Nov-22,Cheque,00.00,"30,89,228.81",00.00,
03-Nov-22,Transfer,"1,00,777.70",00.00,"1,00,777.70",
03-Nov-22,Commission,"38,370.00",00.00,"1,39,147.70",
03-Nov-22,Debit Card,606.6,00.00,"1,39,754.30",
03-Nov-22,Commission,"1,57,939.62",00.00,"2,97,693.92",
03-Nov-22,RTGS,00.00,"74,423.48","2,23,270.44",
03-Nov-22,Bill,00.00,"1,11,635.22","1,11,635.22",
03-Nov-22,ATM,232.84,00.00,"1,11,868.06",
03-Nov-22,Cash,00.00,"12,429.78","99,438.28",
03-Nov-22,Reversal,"4,50,772.00",00.00,"5,50,210.28",
03-Nov-22,Tax,00.00,"1,83,403.43","3,66,806.85",
03-Nov-22,Interest,00.00,"45,850.86","3,20,955.99",
03-Nov-22,Purchase,"1,815.41",00.00,"3,22,771.40",
03-Nov-22,RTGS,00.54,00.00,"3,22,771.94",
03-Nov-22,Tax,"2,60,268.60",00.00,"5,83,040.54",
03-Nov-22,NEFT,312.1,00.00,"5,83,352.64",
03-Nov-22,Debit Card,00.00,"1,45,838.16","4,37,514.48",
03-Nov-22,Interest,00.00,"1,45,838.16","2,91,676.32",
03-Nov-22,Transportellaneous,"6,22,272.00",00.00,"9,13,948.32",
03-Nov-22,Cash,00.00,"1,30,564.05","7,83,384.27",
03-Nov-22,Bill,00.00,"97,923.03","6,85,461.24",
03-Nov-22,Bill,55.3,00.00,"6,85,516.54",
03-Nov-22,Tax,00.00,"97,930.93","5,87,585.61",
03-Nov-22,Transfer,"20,56,386.00",00.00,"26,43,971.61",
03-Nov-22,Reversal,"28,487.30",00.00,"26,72,458.91",
03-Nov-22,Cheque,00.00,"26,72,458.91",00.00,
03-Nov-22,Bill,"17,86,966.00",00.00,"17,86,966.00",
03-Nov-22,Bill,00.00,"1,78,696.60","16,08,269.40",
03-Nov-22,IMPS,"4,99,903.00",00.00,"21,08,172.40",
03-Nov-22,Reversal,00.00,"3,51,362.07","17,56,810.33",
03-Nov-22,NEFT,"6,00,208.50",00.00,"23,57,018.83",
03-Nov-22,NEFT,00.00,"4,71,403.77","18,85,615.06",
03-Nov-22,Tax,00.00,"2,69,373.58","16,16,241.48",
03-Nov-22,Interest,00.00,"5,38,747.16","10,77,494.32",
03-Nov-22,Transportellaneous,00.00,"1,53,927.76","9,23,566.56",
03-Nov-22,Interest,00.00,"2,30,891.64","6,92,674.92",
03-Nov-22,NEFT,941.8,00.00,"6,93,616.72",
03-Nov-22,Commission,"14,26,137.00",00.00,"21,19,753.72",
03-Nov-22,RTGS,"51,709.00",00.00,"21,71,462.72",
03-Nov-22,NEFT,01.34,00.00,"21,71,464.06",
03-Nov-22,Interest,00.00,"3,61,910.68","18,09,553.38",
03-Nov-22,Bill,00.00,"2,26,194.17","15,83,359.21",
03-Nov-22,Purchase,00.00,"2,63,893.20","13,19,466.01",
03-Nov-22,Commission,"16,344.00",00.00,"13,35,810.01",
03-Nov-22,Cash,198.79,00.00,"13,36,008.80",
03-Nov-22,Transfer,56,00.00,"13,36,064.80",
03-Nov-22,IMPS,04.40,00.00,"13,36,069.20",
03-Nov-22,Purchase,00.00,"2,22,678.20","11,13,391.00",
03-Nov-22,Bill,00.00,"3,71,130.33","7,42,260.67",
03-Nov-22,Transfer,00.00,"92,782.58","6,49,478.09",
03-Nov-22,Cheque,00.00,"64,947.81","5,84,530.28",
03-Nov-22,Interest,00.00,"1,16,906.06","4,67,624.22",
03-Nov-22,Tax,00.00,"51,958.25","4,15,665.97",
03-Nov-22,NEFT,"1,70,844.60",00.00,"5,86,510.57",
03-Nov-22,IMPS,294.63,00.00,"5,86,805.20",
03-Nov-22,Interest,"28,843.30",00.00,"6,15,648.50",
03-Nov-22,Transportellaneous,00.00,"3,07,824.25","3,07,824.25",
03-Nov-22,RTGS,432.7,00.00,"3,08,256.95",
03-Nov-22,Tax,00.00,"1,02,752.32","2,05,504.63",
03-Nov-22,Reversal,00.00,"41,100.93","1,64,403.70",
03-Nov-22,Purchase,00.00,"54,801.23","1,09,602.47",
03-Nov-22,Reversal,00.00,"27,400.62","82,201.85",
03-Nov-22,Debit Card,925.1,00.00,"83,126.95",
03-Nov-22,Commission,00.00,"9,236.33","73,890.62",
03-Nov-22,Commission,"2,282.10",00.00,"76,172.72",
03-Nov-22,Commission,"2,391.70",00.00,"78,564.42",
03-Nov-22,Tax,00.00,"39,282.21","39,282.21",
03-Nov-22,Transportellaneous,00.00,"3,928.22","35,353.99",
03-Nov-22,Bill,00.00,"5,892.33","29,461.66",
03-Nov-22,Debit Card,39,00.00,"29,500.66",
03-Nov-22,Tax,"1,69,927.81",00.00,"1,99,428.47",
03-Nov-22,Transportellaneous,"2,36,244.80",00.00,"4,35,673.27",
03-Nov-22,NEFT,"4,512.38",00.00,"4,40,185.65",
03-Nov-22,Reversal,07.70,00.00,"4,40,193.35",
03-Nov-22,Purchase,43,00.00,"4,40,236.35",
03-Nov-22,Purchase,00.00,"48,915.15","3,91,321.20",
03-Nov-22,Interest,"33,360.40",00.00,"4,24,681.60",
03-Nov-22,Bill,00.00,"42,468.16","3,82,213.44",
03-Nov-22,Cheque,"2,41,172.00",00.00,"6,23,385.44",
03-Nov-22,Bill,00.00,"89,055.06","5,34,330.38",
03-Nov-22,Transfer,00.00,"59,370.04","4,74,960.34",
03-Nov-22,Cheque,00.00,"2,37,480.17","2,37,480.17",
03-Nov-22,Debit Card,24,00.00,"2,37,504.17",
03-Nov-22,Transportellaneous,00.50,00.00,"2,37,504.67",
03-Nov-22,Transportellaneous,00.00,"47,500.93","1,90,003.74",
04-Nov-22,IMPS,00.00,"95,001.87","95,001.87",
04-Nov-22,Commission,"67,981.00",00.00,"1,62,982.87",
04-Nov-22,Purchase,00.00,"23,283.27","1,39,699.60",
04-Nov-22,Bill,06.00,00.00,"1,39,705.60",
04-Nov-22,Commission,"14,53,456.00",00.00,"15,93,161.60",
04-Nov-22,Cash,00.00,"1,99,145.20","13,94,016.40",
04-Nov-22,IMPS,00.00,"1,54,890.71","12,39,125.69",
04-Nov-22,Tax,00.00,"2,47,825.14","9,91,300.55",
04-Nov-22,Cash,03.06,00.00,"9,91,303.61",
04-Nov-22,RTGS,00.00,"4,95,651.81","4,95,651.80",
04-Nov-22,Bill,"27,965.00",00.00,"5,23,616.80",
04-Nov-22,Debit Card,00.00,"1,04,723.36","4,18,893.44",
04-Nov-22,Transportellaneous,"4,00,533.80",00.00,"8,19,427.24",
04-Nov-22,Tax,"2,009.60",00.00,"8,21,436.84",
04-Nov-22,IMPS,00.00,"1,02,679.61","7,18,757.24",
04-Nov-22,Purchase,07.60,00.00,"7,18,764.84",
04-Nov-22,Cheque,00.00,"71,876.48","6,46,888.36",
04-Nov-22,Cheque,00.00,"2,15,629.45","4,31,258.91",
04-Nov-22,Transfer,207.5,00.00,"4,31,466.41",
04-Nov-22,Interest,"9,48,464.00",00.00,"13,79,930.41",
04-Nov-22,RTGS,"2,567.00",00.00,"13,82,497.41",
04-Nov-22,Bill,00.00,"4,60,832.47","9,21,664.94",
04-Nov-22,Commission,00.00,"1,53,610.82","7,68,054.12",
04-Nov-22,IMPS,00.00,"1,53,610.82","6,14,443.30",
04-Nov-22,ATM,00.00,"1,53,610.83","4,60,832.48",
04-Nov-22,Tax,04.00,00.00,"4,60,836.48",
04-Nov-22,NEFT,346.6,00.00,"4,61,183.08",
04-Nov-22,Transfer,47.6,00.00,"4,61,230.68",
04-Nov-22,Purchase,00.00,"2,30,615.34","2,30,615.34",
04-Nov-22,Commission,00.00,"57,653.84","1,72,961.50",
04-Nov-22,Commission,00.00,"57,653.83","1,15,307.67",
04-Nov-22,ATM,00.00,"28,826.92","86,480.75",
04-Nov-22,RTGS,03.28,00.00,"86,484.03",
04-Nov-22,Commission,"1,931.00",00.00,"88,415.03",
04-Nov-22,Cheque,00.00,"22,103.76","66,311.27",
04-Nov-22,Bill,247,00.00,"66,558.27",
04-Nov-22,Commission,00.00,"16,639.57","49,918.70",
04-Nov-22,Cash,00.00,"24,959.35","24,959.35",
04-Nov-22,Bill,00.35,00.00,"24,959.70",
04-Nov-22,RTGS,00.00,"4,991.94","19,967.76",
05-Nov-22,Debit Card,00.00,"6,655.92","13,311.84",
05-Nov-22,Transfer,00.00,"2,218.64","11,093.20",
05-Nov-22,NEFT,"46,526.00",00.00,"57,619.20",
05-Nov-22,RTGS,00.00,"57,619.20",00.00,
05-Nov-22,Transfer,"16,83,885.75",00.00,"16,83,885.75",
05-Nov-22,Interest,200.28,00.00,"16,84,086.03",
05-Nov-22,Commission,00.00,"2,80,681.01","14,03,405.02",
05-Nov-22,Commission,08.00,00.00,"14,03,413.02",
05-Nov-22,Purchase,00.00,"4,67,804.34","9,35,608.68",
05-Nov-22,IMPS,00.00,"1,16,951.09","8,18,657.60",
05-Nov-22,ATM,00.00,"1,63,731.52","6,54,926.08",
05-Nov-22,Transportellaneous,00.00,"2,18,308.69","4,36,617.39",
05-Nov-22,Cheque,"1,974.60",00.00,"4,38,591.99",
05-Nov-22,IMPS,00.00,"2,19,296.00","2,19,296.00",
05-Nov-22,NEFT,"1,03,639.00",00.00,"3,22,935.00",
05-Nov-22,Transfer,00.00,"32,293.50","2,90,641.50",
05-Nov-22,IMPS,00.00,"29,064.15","2,61,577.35",
05-Nov-22,Reversal,00.00,"37,368.19","2,24,209.16",
05-Nov-22,ATM,00.00,"44,841.83","1,79,367.33",
05-Nov-22,Cash,"26,240.97",00.00,"2,05,608.30",
05-Nov-22,IMPS,"1,56,007.22",00.00,"3,61,615.52",
05-Nov-22,Transportellaneous,"2,194.10",00.00,"3,63,809.62",
06-Nov-22,Cheque,00.00,"45,476.20","3,18,333.42",
07-Nov-22,Debit Card,79.74,00.00,"3,18,413.16",
07-Nov-22,RTGS,00.00,"1,59,206.58","1,59,206.58",
07-Nov-22,Transfer,00.00,"15,920.66","1,43,285.92",
07-Nov-22,Cheque,446,00.00,"1,43,731.92",
07-Nov-22,Bill,00.00,"1,43,731.92",00.00,
07-Nov-22,NEFT,"12,40,000.00",00.00,"12,40,000.00",
08-Nov-22,Bill,00.95,00.00,"12,40,000.95",
08-Nov-22,RTGS,00.00,"1,55,000.12","10,85,000.83",
08-Nov-22,Tax,125.51,00.00,"10,85,126.34",
08-Nov-22,Transportellaneous,"28,555.80",00.00,"11,13,682.14",
08-Nov-22,RTGS,00.00,"1,11,368.21","10,02,313.93",
08-Nov-22,Tax,00.00,"1,67,052.32","8,35,261.61",
08-Nov-22,Purchase,984,00.00,"8,36,245.61",
08-Nov-22,Tax,695,00.00,"8,36,940.61",
08-Nov-22,Bill,00.00,"1,19,562.94","7,17,377.67",
08-Nov-22,Cheque,07.40,00.00,"7,17,385.07",
08-Nov-22,Debit Card,00.00,"2,39,128.36","4,78,256.71",
08-Nov-22,ATM,00.00,"79,709.45","3,98,547.26",
08-Nov-22,ATM,00.00,"39,854.73","3,58,692.53",
08-Nov-22,NEFT,00.00,"44,836.57","3,13,855.96",
08-Nov-22,RTGS,"47,700.00",00.00,"3,61,555.96",
08-Nov-22,RTGS,00.00,"1,20,518.65","2,41,037.31",
08-Nov-22,Purchase,"2,52,172.19",00.00,"4,93,209.50",
08-Nov-22,Interest,"2,929.27",00.00,"4,96,138.77",
08-Nov-22,Cash,38.9,00.00,"4,96,177.67",
08-Nov-22,Transportellaneous,41,00.00,"4,96,218.67",
08-Nov-22,IMPS,00.00,"99,243.73","3,96,974.94",
08-Nov-22,NEFT,00.00,"56,710.71","3,40,264.23",
08-Nov-22,Reversal,"1,95,427.00",00.00,"5,35,691.23",
08-Nov-22,Cheque,61.8,00.00,"5,35,753.03",
08-Nov-22,ATM,00.00,"1,07,150.61","4,28,602.42",
08-Nov-22,RTGS,"7,727.90",00.00,"4,36,330.32",
08-Nov-22,Bill,00.00,"54,541.29","3,81,789.03",
08-Nov-22,Transfer,257.6,00.00,"3,82,046.63",
08-Nov-22,NEFT,00.00,"76,409.33","3,05,637.30",
08-Nov-22,IMPS,00.00,"3,05,637.30",00.00,
08-Nov-22,RTGS,"2,07,372.00",00.00,"2,07,372.00",
08-Nov-22,Reversal,00.00,"1,03,686.00","1,03,686.00",
08-Nov-22,Bill,00.00,"20,737.20","82,948.80",
08-Nov-22,Tax,"20,312.00",00.00,"1,03,260.80",
08-Nov-22,Transfer,00.00,"20,652.16","82,608.64",
08-Nov-22,RTGS,00.00,"9,178.74","73,429.90",
08-Nov-22,Tax,00.00,"73,429.90",00.00,
08-Nov-22,Purchase,"2,16,164.03",00.00,"2,16,164.03",
08-Nov-22,Debit Card,"1,73,040.20",00.00,"3,89,204.23",
08-Nov-22,Tax,00.00,"3,89,204.23",00.00,
08-Nov-22,Transfer,"3,568.00",00.00,"3,568.00",
09-Nov-22,Reversal,00.00,446,"3,122.00",
09-Nov-22,IMPS,"3,099.30",00.00,"6,221.30",
09-Nov-22,Commission,"7,34,544.80",00.00,"7,40,766.10",
09-Nov-22,Purchase,00.00,"1,48,153.22","5,92,612.88",
09-Nov-22,Transportellaneous,00.00,"5,92,612.88",00.00,
09-Nov-22,NEFT,"2,03,640.00",00.00,"2,03,640.00",
09-Nov-22,RTGS,00.00,"25,455.00","1,78,185.00",
09-Nov-22,Transfer,"2,257.90",00.00,"1,80,442.90",
09-Nov-22,Reversal,00.00,"45,110.73","1,35,332.17",
09-Nov-22,IMPS,00.00,"1,35,332.17",00.00,
09-Nov-22,Tax,58.63,00.00,58.63,
09-Nov-22,Reversal,00.00,11.73,46.9,
09-Nov-22,Cheque,00.00,23.45,23.45,
09-Nov-22,NEFT,"1,343.00",00.00,"1,366.45",
09-Nov-22,Purchase,04.00,00.00,"1,370.45",
09-Nov-22,Cash,00.00,171.31,"1,199.14",
09-Nov-22,Commission,04.52,00.00,"1,203.66",
09-Nov-22,ATM,00.00,150.46,"1,053.20",
09-Nov-22,Reversal,499.09,00.00,"1,552.29",
09-Nov-22,NEFT,00.00,194.04,"1,358.25",
09-Nov-22,Tax,00.00,194.04,"1,164.21",
09-Nov-22,Commission,"17,051.60",00.00,"18,215.81",
09-Nov-22,Cash,"15,91,791.75",00.00,"16,10,007.56",
09-Nov-22,ATM,00.00,"1,61,000.76","14,49,006.80",
09-Nov-22,Transfer,00.00,"2,41,501.13","12,07,505.67",
09-Nov-22,NEFT,00.00,"1,50,938.21","10,56,567.46",
09-Nov-22,Purchase,00.00,"10,56,567.46",00.00,
09-Nov-22,IMPS,"1,51,380.10",00.00,"1,51,380.10",
09-Nov-22,Purchase,00.00,"21,625.73","1,29,754.37",
09-Nov-22,Transfer,00.00,"1,29,754.37",00.00,
09-Nov-22,Commission,"5,507.84",00.00,"5,507.84",
09-Nov-22,Interest,00.00,550.78,"4,957.06",
09-Nov-22,Transportellaneous,00.00,619.63,"4,337.43",
09-Nov-22,Debit Card,00.00,"4,337.43",00.00,
09-Nov-22,Debit Card,33.93,00.00,33.93,
09-Nov-22,Transportellaneous,13,00.00,46.93,
09-Nov-22,Transfer,00.00,23.47,23.46,
10-Nov-22,Transfer,00.00,02.93,20.53,
10-Nov-22,Interest,00.00,02.57,17.96,
10-Nov-22,RTGS,00.00,02.57,15.39,
10-Nov-22,Purchase,35.97,00.00,51.36,
10-Nov-22,Bill,"32,158.90",00.00,"32,210.26",
10-Nov-22,NEFT,507.1,00.00,"32,717.36",
10-Nov-22,NEFT,00.00,"10,905.79","21,811.57",
10-Nov-22,Purchase,00.00,"3,635.26","18,176.31",
10-Nov-22,NEFT,00.00,"6,058.77","12,117.54",
10-Nov-22,Purchase,"2,299.00",00.00,"14,416.54",
10-Nov-22,NEFT,00.00,"4,805.51","9,611.03",
10-Nov-22,Commission,"1,826.00",00.00,"11,437.03",
10-Nov-22,Reversal,142,00.00,"11,579.03",
10-Nov-22,Commission,"12,79,860.75",00.00,"12,91,439.78",
10-Nov-22,Commission,00.00,"1,84,491.40","11,06,948.38",
10-Nov-22,Tax,00.00,"2,21,389.68","8,85,558.70",
10-Nov-22,Purchase,00.00,"8,85,558.70",00.00,
10-Nov-22,Bill,"6,356.10",00.00,"6,356.10",
10-Nov-22,ATM,00.00,"1,589.03","4,767.08",
10-Nov-22,Debit Card,624.65,00.00,"5,391.73",
10-Nov-22,ATM,00.00,"5,391.73",00.00,
10-Nov-22,Transportellaneous,"1,33,947.00",00.00,"1,33,947.00",
10-Nov-22,Debit Card,00.00,"33,486.75","1,00,460.25",
10-Nov-22,Purchase,00.00,"11,162.25","89,298.00",
10-Nov-22,Commission,"75,430.00",00.00,"1,64,728.00",
10-Nov-22,Commission,00.00,"54,909.33","1,09,818.67",
10-Nov-22,RTGS,00.00,"18,303.11","91,515.56",
10-Nov-22,Cheque,00.00,"11,439.45","80,076.11",
11-Nov-22,NEFT,00.00,"8,007.61","72,068.50",
11-Nov-22,Transportellaneous,06.50,00.00,"72,075.00",
11-Nov-22,NEFT,53,00.00,"72,128.00",
11-Nov-22,NEFT,46.9,00.00,"72,174.90",
11-Nov-22,IMPS,00.00,"9,021.86","63,153.04",
11-Nov-22,Cheque,00.00,"7,017.00","56,136.04",
11-Nov-22,Tax,62.14,00.00,"56,198.18",
11-Nov-22,Cash,"2,24,675.20",00.00,"2,80,873.38",
11-Nov-22,Reversal,00.00,"93,624.46","1,87,248.92",
11-Nov-22,Purchase,03.35,00.00,"1,87,252.27",
11-Nov-22,NEFT,00.00,"26,750.32","1,60,501.95",
11-Nov-22,NEFT,00.00,"22,928.85","1,37,573.10",
11-Nov-22,Bill,03.00,00.00,"1,37,576.10",
11-Nov-22,Interest,00.00,"13,757.61","1,23,818.49",
11-Nov-22,Purchase,00.00,"15,477.31","1,08,341.18",
11-Nov-22,NEFT,00.00,"15,477.31","92,863.87",
11-Nov-22,Debit Card,149,00.00,"93,012.87",
11-Nov-22,Bill,05.80,00.00,"93,018.67",
11-Nov-22,Bill,45.3,00.00,"93,063.97",
11-Nov-22,NEFT,00.00,"93,063.97",00.00,
12-Nov-22,NEFT,"7,10,804.00",00.00,"7,10,804.00",
12-Nov-22,NEFT,00.00,"3,55,402.00","3,55,402.00",
12-Nov-22,NEFT,00.00,"88,850.50","2,66,551.50",
12-Nov-22,Transportellaneous,142.2,00.00,"2,66,693.70",
12-Nov-22,RTGS,00.00,"26,669.37","2,40,024.33",
12-Nov-22,NEFT,50.2,00.00,"2,40,074.53",
12-Nov-22,Transportellaneous,00.00,"2,40,074.53",00.00,
12-Nov-22,ATM,00.00,00.00,00.00,
12-Nov-22,Cash,64,00.00,64,
12-Nov-22,Cash,00.00,32,32,
12-Nov-22,Transfer,04.30,00.00,36.3,
12-Nov-22,Transportellaneous,00.00,09.08,27.22,
12-Nov-22,RTGS,00.00,09.07,18.15,
12-Nov-22,Transportellaneous,00.00,01.82,16.33,
12-Nov-22,ATM,00.78,00.00,17.11,
12-Nov-22,IMPS,00.00,02.44,14.67,
12-Nov-22,ATM,"1,432.00",00.00,"1,446.67",
12-Nov-22,ATM,57,00.00,"1,503.67",
12-Nov-22,IMPS,00.00,375.92,"1,127.75",
12-Nov-22,NEFT,00.00,187.96,939.79,
12-Nov-22,Reversal,00.00,156.63,783.16,
12-Nov-22,ATM,00.00,97.9,685.26,
12-Nov-22,Purchase,03.00,00.00,688.26,
12-Nov-22,Cheque,00.00,344.13,344.13,
12-Nov-22,Cheque,"1,643.20",00.00,"1,987.33",
12-Nov-22,Transportellaneous,"17,091.00",00.00,"19,078.33",
12-Nov-22,Transfer,"28,251.40",00.00,"47,329.73",
12-Nov-22,Commission,"18,08,983.25",00.00,"18,56,312.98",
13-Nov-22,Transportellaneous,00.00,"6,18,770.99","12,37,541.99",
13-Nov-22,Transfer,27,00.00,"12,37,568.99",
13-Nov-22,Cash,"3,438.00",00.00,"12,41,006.99",
13-Nov-22,Cheque,196.63,00.00,"12,41,203.62",
13-Nov-22,Reversal,00.00,"4,13,734.54","8,27,469.08",
13-Nov-22,Cheque,33,00.00,"8,27,502.08",
13-Nov-22,ATM,00.00,"1,03,437.76","7,24,064.32",
13-Nov-22,Transfer,"1,68,335.70",00.00,"8,92,400.02",
13-Nov-22,Transportellaneous,00.00,"2,23,100.01","6,69,300.02",
13-Nov-22,Cash,"2,39,725.34",00.00,"9,09,025.36",
13-Nov-22,Cash,00.00,"1,51,504.23","7,57,521.13",
13-Nov-22,IMPS,00.00,"3,78,760.57","3,78,760.56",
13-Nov-22,RTGS,00.00,"37,876.06","3,40,884.50",
13-Nov-22,Cash,295.5,00.00,"3,41,180.00",
13-Nov-22,Cheque,"2,234.30",00.00,"3,43,414.30",
13-Nov-22,Cash,00.00,"85,853.58","2,57,560.72",
13-Nov-22,RTGS,00.00,"36,794.39","2,20,766.33",
13-Nov-22,Reversal,"1,73,494.09",00.00,"3,94,260.42",
13-Nov-22,Purchase,00.00,"49,282.55","3,44,977.87",
13-Nov-22,Cheque,00.00,"57,496.31","2,87,481.56",
13-Nov-22,ATM,00.00,"95,827.19","1,91,654.37",
13-Nov-22,Transportellaneous,"21,439.00",00.00,"2,13,093.37",
13-Nov-22,ATM,00.00,"53,273.34","1,59,820.03",
13-Nov-22,Commission,00.00,"19,977.50","1,39,842.53",
13-Nov-22,RTGS,00.00,"19,977.50","1,19,865.03",
13-Nov-22,Transfer,00.00,"13,318.34","1,06,546.69",
13-Nov-22,Reversal,968,00.00,"1,07,514.69",
13-Nov-22,Tax,07.60,00.00,"1,07,522.29",
13-Nov-22,RTGS,17.6,00.00,"1,07,539.89",
13-Nov-22,Reversal,00.00,"10,753.99","96,785.90",
13-Nov-22,Cash,00.00,"19,357.18","77,428.72",
13-Nov-22,IMPS,00.00,"8,603.19","68,825.53",
13-Nov-22,Transportellaneous,00.00,"8,603.19","60,222.34",
13-Nov-22,Interest,00.00,"15,055.59","45,166.76",
13-Nov-22,Transportellaneous,00.00,"5,645.85","39,520.92",
13-Nov-22,Reversal,"1,53,266.20",00.00,"1,92,787.12",
13-Nov-22,Transfer,"15,017.10",00.00,"2,07,804.22",
13-Nov-22,Commission,00.00,"20,780.42","1,87,023.80",
14-Nov-22,Interest,12,00.00,"1,87,035.80",
15-Nov-22,ATM,00.00,"18,703.58","1,68,332.22",
15-Nov-22,IMPS,00.00,"18,703.58","1,49,628.64",
15-Nov-22,Cheque,13.2,00.00,"1,49,641.84",
15-Nov-22,IMPS,00.00,"29,928.37","1,19,713.47",
15-Nov-22,Bill,00.00,"14,964.18","1,04,749.29",
15-Nov-22,Commission,00.00,"10,474.93","94,274.36",
15-Nov-22,RTGS,00.00,"31,424.79","62,849.57",
15-Nov-22,Cash,02.90,00.00,"62,852.47",
15-Nov-22,Debit Card,36.91,00.00,"62,889.38",
15-Nov-22,Debit Card,"3,669.00",00.00,"66,558.38",
15-Nov-22,Purchase,06.00,00.00,"66,564.38",
15-Nov-22,Transfer,"12,71,638.50",00.00,"13,38,202.88",
15-Nov-22,Debit Card,00.00,"6,69,101.44","6,69,101.44",
15-Nov-22,Debit Card,00.00,"3,34,550.72","3,34,550.72",
15-Nov-22,Reversal,00.00,"37,172.30","2,97,378.42",
15-Nov-22,Cheque,"31,250.00",00.00,"3,28,628.42",
15-Nov-22,Reversal,206.37,00.00,"3,28,834.79",
15-Nov-22,IMPS,00.00,"1,09,611.60","2,19,223.19",
15-Nov-22,Interest,"10,95,311.00",00.00,"13,14,534.19",
15-Nov-22,Cheque,00.00,"1,31,453.42","11,83,080.77",
15-Nov-22,Commission,00.00,"1,69,011.54","10,14,069.23",
15-Nov-22,Cash,00.00,"10,14,069.23",00.00,
15-Nov-22,IMPS,00.01,00.00,00.01,
15-Nov-22,RTGS,11.8,00.00,11.81,
15-Nov-22,RTGS,04.00,00.00,15.81,
15-Nov-22,Transportellaneous,00.00,03.16,12.65,
15-Nov-22,RTGS,"8,15,060.80",00.00,"8,15,073.45",
15-Nov-22,Transfer,02.00,00.00,"8,15,075.45",
15-Nov-22,Cash,07.00,00.00,"8,15,082.45",
15-Nov-22,RTGS,06.05,00.00,"8,15,088.50",
16-Nov-22,ATM,00.00,"4,07,544.25","4,07,544.25",
16-Nov-22,Bill,"1,40,707.70",00.00,"5,48,251.95",
16-Nov-22,NEFT,00.00,"5,48,251.95",00.00,
16-Nov-22,IMPS,"1,070.51",00.00,"1,070.51",
16-Nov-22,Transfer,209.73,00.00,"1,280.24",
16-Nov-22,RTGS,00.00,213.37,"1,066.87",
16-Nov-22,Reversal,00.00,133.36,933.51,
16-Nov-22,Debit Card,00.00,133.36,800.15,
16-Nov-22,RTGS,"3,581.20",00.00,"4,381.35",
16-Nov-22,Reversal,"3,031.60",00.00,"7,412.95",
16-Nov-22,Reversal,"1,89,194.41",00.00,"1,96,607.36",
16-Nov-22,Debit Card,00.00,"24,575.92","1,72,031.44",
16-Nov-22,Tax,"19,07,168.80",00.00,"20,79,200.24",
16-Nov-22,IMPS,"1,395.00",00.00,"20,80,595.24",
16-Nov-22,IMPS,00.00,"5,20,148.81","15,60,446.43",
16-Nov-22,Interest,"17,762.10",00.00,"15,78,208.53",
16-Nov-22,Transportellaneous,00.00,"5,26,069.51","10,52,139.02",
16-Nov-22,Tax,00.00,"1,31,517.38","9,20,621.64",
16-Nov-22,Debit Card,09.00,00.00,"9,20,630.64",
16-Nov-22,ATM,00.00,"4,60,315.32","4,60,315.32",
16-Nov-22,Cheque,00.00,"92,063.06","3,68,252.26",
16-Nov-22,Reversal,01.00,00.00,"3,68,253.26",
16-Nov-22,IMPS,00.00,"1,84,126.63","1,84,126.63",
16-Nov-22,Commission,00.00,"61,375.54","1,22,751.09",
16-Nov-22,Transfer,00.00,"24,550.22","98,200.87",
16-Nov-22,Transportellaneous,"28,603.50",00.00,"1,26,804.37",
16-Nov-22,Transfer,"1,540.60",00.00,"1,28,344.97",
16-Nov-22,Bill,00.00,"64,172.49","64,172.48",
16-Nov-22,Debit Card,00.00,"7,130.28","57,042.20",
16-Nov-22,IMPS,"18,99,482.50",00.00,"19,56,524.70",
16-Nov-22,RTGS,"20,895.50",00.00,"19,77,420.20",
16-Nov-22,Transportellaneous,"18,42,164.00",00.00,"38,19,584.20",
16-Nov-22,Cheque,00.00,"4,24,398.24","33,95,185.96",
16-Nov-22,Bill,"2,102.00",00.00,"33,97,287.96",
16-Nov-22,Transportellaneous,00.00,"4,85,326.85","29,11,961.11",
16-Nov-22,Interest,00.00,"7,27,990.28","21,83,970.83",
16-Nov-22,Transfer,02.20,00.00,"21,83,973.03",
16-Nov-22,Purchase,05.00,00.00,"21,83,978.03",
16-Nov-22,Commission,00.00,"2,42,664.23","19,41,313.80",
16-Nov-22,ATM,07.63,00.00,"19,41,321.43",
16-Nov-22,Transfer,17.93,00.00,"19,41,339.36",
16-Nov-22,Cheque,00.00,"3,88,267.87","15,53,071.49",
16-Nov-22,RTGS,00.00,"2,58,845.25","12,94,226.24",
16-Nov-22,ATM,"2,48,114.62",00.00,"15,42,340.86",
16-Nov-22,Transfer,00.00,"1,54,234.09","13,88,106.77",
16-Nov-22,IMPS,00.00,"1,73,513.35","12,14,593.42",
16-Nov-22,RTGS,00.00,"1,34,954.82","10,79,638.60",
17-Nov-22,Commission,00.00,"5,39,819.30","5,39,819.30",
17-Nov-22,Commission,04.70,00.00,"5,39,824.00",
17-Nov-22,Interest,"2,433.60",00.00,"5,42,257.60",
17-Nov-22,IMPS,"1,97,922.16",00.00,"7,40,179.76",
17-Nov-22,Reversal,00.00,"3,70,089.88","3,70,089.88",
17-Nov-22,Commission,00.00,"74,017.98","2,96,071.90",
17-Nov-22,Transportellaneous,"2,04,603.56",00.00,"5,00,675.46",
17-Nov-22,Reversal,174.32,00.00,"5,00,849.78",
17-Nov-22,NEFT,00.00,"1,66,949.93","3,33,899.85",
17-Nov-22,Bill,00.00,"3,33,899.85",00.00,
17-Nov-22,Purchase,"1,006.00",00.00,"1,006.00",
17-Nov-22,Interest,"10,403.00",00.00,"11,409.00",
17-Nov-22,Interest,"2,217.00",00.00,"13,626.00",
17-Nov-22,IMPS,"2,538.00",00.00,"16,164.00",
18-Nov-22,Interest,00.00,"2,309.14","13,854.86",
18-Nov-22,Commission,06.78,00.00,"13,861.64",
18-Nov-22,NEFT,"12,08,524.00",00.00,"12,22,385.64",
18-Nov-22,Debit Card,00.00,"1,22,238.56","11,00,147.08",
18-Nov-22,RTGS,00.00,"1,22,238.56","9,77,908.52",
19-Nov-22,Transportellaneous,31.52,00.00,"9,77,940.04",
19-Nov-22,IMPS,07.00,00.00,"9,77,947.04",
19-Nov-22,Tax,"1,43,993.34",00.00,"11,21,940.38",
19-Nov-22,IMPS,"14,596.00",00.00,"11,36,536.38",
19-Nov-22,ATM,00.00,"1,42,067.05","9,94,469.33",
19-Nov-22,Commission,"1,24,616.25",00.00,"11,19,085.58",
19-Nov-22,Transportellaneous,12,00.00,"11,19,097.58",
19-Nov-22,Commission,00.00,"5,59,548.79","5,59,548.79",
19-Nov-22,Purchase,06.00,00.00,"5,59,554.79",
19-Nov-22,Debit Card,00.00,"1,86,518.26","3,73,036.53",
19-Nov-22,NEFT,"18,072.26",00.00,"3,91,108.79",
19-Nov-22,Interest,"10,88,094.00",00.00,"14,79,202.79",
19-Nov-22,ATM,00.00,"3,69,800.70","11,09,402.09",
19-Nov-22,Cheque,05.00,00.00,"11,09,407.09",
19-Nov-22,Debit Card,00.00,"1,58,486.73","9,50,920.36",
19-Nov-22,Cheque,00.00,"4,75,460.18","4,75,460.18",
19-Nov-22,IMPS,00.00,"47,546.02","4,27,914.16",
19-Nov-22,Transfer,00.00,"42,791.42","3,85,122.74",
19-Nov-22,Interest,00.00,"1,28,374.25","2,56,748.49",
19-Nov-22,Debit Card,00.00,"51,349.70","2,05,398.79",
19-Nov-22,NEFT,00.00,"1,02,699.40","1,02,699.40",
19-Nov-22,Bill,"30,930.70",00.00,"1,33,630.10",
19-Nov-22,Transfer,00.00,"26,726.02","1,06,904.08",
19-Nov-22,Debit Card,217,00.00,"1,07,121.08",
19-Nov-22,Cash,04.00,00.00,"1,07,125.08",
19-Nov-22,Debit Card,"9,14,009.00",00.00,"10,21,134.08",
19-Nov-22,Reversal,164.1,00.00,"10,21,298.18",
19-Nov-22,Commission,11,00.00,"10,21,309.18",
19-Nov-22,Debit Card,00.00,"1,27,663.65","8,93,645.53",
20-Nov-22,Debit Card,"1,57,108.50",00.00,"10,50,754.03",
20-Nov-22,Cheque,01.00,00.00,"10,50,755.03",
20-Nov-22,Transportellaneous,170,00.00,"10,50,925.03",
20-Nov-22,Cheque,00.00,"2,62,731.26","7,88,193.77",
20-Nov-22,Commission,"2,409.00",00.00,"7,90,602.77",
20-Nov-22,Transportellaneous,00.00,"79,060.28","7,11,542.49",
20-Nov-22,Bill,"15,06,656.50",00.00,"22,18,198.99",
21-Nov-22,Interest,00.00,"7,39,399.66","14,78,799.33",
21-Nov-22,Bill,00.00,"14,78,799.33",00.00,
21-Nov-22,Transfer,02.85,00.00,02.85,
21-Nov-22,Reversal,00.00,00.36,02.49,
21-Nov-22,Reversal,00.00,00.83,01.66,
21-Nov-22,Bill,00.00,00.33,01.33,
21-Nov-22,NEFT,04.00,00.00,05.33,
21-Nov-22,NEFT,00.00,01.07,04.26,
21-Nov-22,IMPS,35.36,00.00,39.62,
21-Nov-22,NEFT,00.00,04.40,35.22,
21-Nov-22,Reversal,00.00,35.22,00.00,
21-Nov-22,Cash,913,00.00,913,
21-Nov-22,Interest,"11,82,785.00",00.00,"11,83,698.00",
22-Nov-22,RTGS,"7,642.00",00.00,"11,91,340.00",
22-Nov-22,RTGS,00.00,"2,38,268.00","9,53,072.00",
22-Nov-22,Cheque,00.00,"9,53,072.00",00.00,
23-Nov-22,NEFT,01.34,00.00,01.34,
23-Nov-22,Bill,00.00,01.34,00.00,
23-Nov-22,Transportellaneous,266,00.00,266,
23-Nov-22,IMPS,183,00.00,449,
23-Nov-22,Tax,"7,45,447.00",00.00,"7,45,896.00",
23-Nov-22,RTGS,00.00,"1,24,316.00","6,21,580.00",
23-Nov-22,Purchase,06.00,00.00,"6,21,586.00",
23-Nov-22,RTGS,00.00,"2,07,195.33","4,14,390.67",
24-Nov-22,NEFT,00.00,"51,798.83","3,62,591.84",
24-Nov-22,NEFT,44.64,00.00,"3,62,636.48",
24-Nov-22,Tax,00.00,"3,62,636.48",00.00,
24-Nov-22,Interest,05.40,00.00,05.40,
24-Nov-22,Transfer,"27,960.00",00.00,"27,965.40",
24-Nov-22,Transportellaneous,12.91,00.00,"27,978.31",
24-Nov-22,RTGS,02.70,00.00,"27,981.01",
24-Nov-22,Transfer,"4,34,616.50",00.00,"4,62,597.51",
24-Nov-22,NEFT,00.00,"4,62,597.51",00.00,
24-Nov-22,Cash,20,00.00,20,
24-Nov-22,Transportellaneous,00.00,03.33,16.67,
24-Nov-22,Transportellaneous,00.00,01.85,14.82,
24-Nov-22,NEFT,00.00,02.47,12.35,
24-Nov-22,RTGS,00.00,06.18,06.18,
24-Nov-22,Interest,"12,33,472.75",00.00,"12,33,478.93",
24-Nov-22,Tax,159,00.00,"12,33,637.93",
24-Nov-22,Purchase,00.00,"3,08,409.48","9,25,228.45",
24-Nov-22,Debit Card,"16,688.00",00.00,"9,41,916.45",
24-Nov-22,Bill,385.1,00.00,"9,42,301.55",
24-Nov-22,Cash,"11,17,481.50",00.00,"20,59,783.05",
24-Nov-22,Cash,02.12,00.00,"20,59,785.17",
24-Nov-22,Transportellaneous,54,00.00,"20,59,839.17",
24-Nov-22,Transportellaneous,"2,732.10",00.00,"20,62,571.27",
24-Nov-22,Tax,"37,212.60",00.00,"20,99,783.87",
24-Nov-22,Purchase,00.00,"2,09,978.39","18,89,805.48",
24-Nov-22,Transportellaneous,921,00.00,"18,90,726.48",
24-Nov-22,Cheque,00.00,"1,89,072.65","17,01,653.83",
24-Nov-22,Transfer,00.00,"1,70,165.38","15,31,488.45",
24-Nov-22,Cash,"3,899.75",00.00,"15,35,388.20",
24-Nov-22,Purchase,00.00,"2,19,341.17","13,16,047.03",
24-Nov-22,Transportellaneous,00.00,"1,88,006.72","11,28,040.31",
24-Nov-22,IMPS,00.00,"1,88,006.72","9,40,033.59",
24-Nov-22,Commission,00.00,"1,56,672.27","7,83,361.32",
24-Nov-22,Purchase,39.7,00.00,"7,83,401.02",
24-Nov-22,Interest,"2,624.44",00.00,"7,86,025.46",
24-Nov-22,Tax,00.00,"1,12,289.35","6,73,736.11",
24-Nov-22,Purchase,00.00,"74,859.57","5,98,876.54",
24-Nov-22,RTGS,00.00,"1,19,775.31","4,79,101.23",
24-Nov-22,Transfer,"7,17,843.00",00.00,"11,96,944.23",
24-Nov-22,Cash,00.00,"1,70,992.03","10,25,952.20",
24-Nov-22,RTGS,"3,866.00",00.00,"10,29,818.20",
24-Nov-22,Transportellaneous,07.00,00.00,"10,29,825.20",
24-Nov-22,Cash,00.00,"2,05,965.04","8,23,860.16",
24-Nov-22,Commission,"70,589.40",00.00,"8,94,449.56",
24-Nov-22,RTGS,00.00,"1,49,074.93","7,45,374.63",
24-Nov-22,Cash,02.60,00.00,"7,45,377.23",
24-Nov-22,IMPS,00.00,"1,24,229.54","6,21,147.69",
24-Nov-22,Interest,00.00,"69,016.41","5,52,131.28",
24-Nov-22,Tax,186.5,00.00,"5,52,317.78",
24-Nov-22,Cash,00.00,"1,38,079.45","4,14,238.34",
24-Nov-22,Debit Card,"1,469.00",00.00,"4,15,707.34",
24-Nov-22,Transportellaneous,430.03,00.00,"4,16,137.37",
24-Nov-22,Transfer,00.00,"46,237.49","3,69,899.88",
24-Nov-22,ATM,"1,27,301.00",00.00,"4,97,200.88",
24-Nov-22,Interest,45.06,00.00,"4,97,245.94",
24-Nov-22,Purchase,"12,80,828.00",00.00,"17,78,073.94",
24-Nov-22,Reversal,00.00,"8,89,036.97","8,89,036.97",
24-Nov-22,Cash,00.00,"2,22,259.24","6,66,777.73",
24-Nov-22,Debit Card,00.00,"1,11,129.62","5,55,648.11",
24-Nov-22,Commission,298.1,00.00,"5,55,946.21",
24-Nov-22,NEFT,"1,57,410.91",00.00,"7,13,357.12",
24-Nov-22,Transfer,33,00.00,"7,13,390.12",
24-Nov-22,Transfer,"25,073.57",00.00,"7,38,463.69",
24-Nov-22,NEFT,"30,014.29",00.00,"7,68,477.98",
24-Nov-22,Tax,00.00,"76,847.80","6,91,630.18",
24-Nov-22,Bill,08.00,00.00,"6,91,638.18",
24-Nov-22,Transportellaneous,00.00,"1,38,327.64","5,53,310.54",
24-Nov-22,RTGS,500,00.00,"5,53,810.54",
24-Nov-22,RTGS,10.95,00.00,"5,53,821.49",
24-Nov-22,Debit Card,00.00,"2,76,910.75","2,76,910.74",
24-Nov-22,NEFT,00.00,"34,613.84","2,42,296.90",
24-Nov-22,RTGS,"27,274.00",00.00,"2,69,570.90",
24-Nov-22,Debit Card,05.00,00.00,"2,69,575.90",
24-Nov-22,Transfer,"49,204.20",00.00,"3,18,780.10",
24-Nov-22,IMPS,00.00,"35,420.01","2,83,360.09",
24-Nov-22,NEFT,00.00,"35,420.01","2,47,940.08",
24-Nov-22,ATM,00.00,"2,47,940.08",00.00,
24-Nov-22,ATM,04.50,00.00,04.50,
24-Nov-22,Transfer,00.00,04.50,00.00,
24-Nov-22,ATM,"15,00,094.00",00.00,"15,00,094.00",
24-Nov-22,Cash,"8,92,966.25",00.00,"23,93,060.25",
24-Nov-22,Reversal,01.55,00.00,"23,93,061.80",
24-Nov-22,NEFT,"1,72,304.50",00.00,"25,65,366.30",
24-Nov-22,Tax,00.00,"2,85,040.70","22,80,325.60",
24-Nov-22,Cash,00.00,"22,80,325.60",00.00,
24-Nov-22,Transfer,07.00,00.00,07.00,
24-Nov-22,Interest,00.00,03.50,03.50,
24-Nov-22,Purchase,00.00,01.75,01.75,
24-Nov-22,Transfer,00.00,00.29,01.46,
25-Nov-22,Interest,00.45,00.00,01.91,
25-Nov-22,Transfer,"5,713.20",00.00,"5,715.11",
25-Nov-22,Purchase,00.00,816.44,"4,898.67",
25-Nov-22,Transfer,26,00.00,"4,924.67",
25-Nov-22,Interest,"17,37,145.00",00.00,"17,42,069.67",
25-Nov-22,Cash,00.00,"1,93,563.30","15,48,506.37",
25-Nov-22,Transportellaneous,"1,735.66",00.00,"15,50,242.03",
25-Nov-22,Purchase,00.00,"1,72,249.11","13,77,992.92",
25-Nov-22,ATM,60,00.00,"13,78,052.92",
25-Nov-22,Debit Card,00.00,"2,75,610.58","11,02,442.34",
25-Nov-22,Reversal,"14,274.00",00.00,"11,16,716.34",
25-Nov-22,RTGS,00.00,"2,23,343.27","8,93,373.07",
25-Nov-22,Interest,"1,17,231.00",00.00,"10,10,604.07",
25-Nov-22,Debit Card,02.70,00.00,"10,10,606.77",
25-Nov-22,Transfer,00.00,"2,02,121.35","8,08,485.42",
25-Nov-22,Transfer,"32,739.40",00.00,"8,41,224.82",
25-Nov-22,IMPS,"71,439.00",00.00,"9,12,663.82",
25-Nov-22,IMPS,"1,48,930.70",00.00,"10,61,594.52",
25-Nov-22,Transportellaneous,00.00,"10,61,594.52",00.00,
25-Nov-22,ATM,"2,809.00",00.00,"2,809.00",
25-Nov-22,Purchase,00.00,401.29,"2,407.71",
25-Nov-22,NEFT,07.10,00.00,"2,414.81",
25-Nov-22,Interest,"2,02,562.80",00.00,"2,04,977.61",
25-Nov-22,Purchase,00.00,"68,325.87","1,36,651.74",
25-Nov-22,IMPS,"23,322.00",00.00,"1,59,973.74",
25-Nov-22,Tax,00.00,"39,993.44","1,19,980.30",
25-Nov-22,Cash,00.00,"23,996.06","95,984.24",
25-Nov-22,ATM,00.00,"15,997.37","79,986.87",
25-Nov-22,Cheque,"2,39,547.40",00.00,"3,19,534.27",
25-Nov-22,Bill,00.00,"3,19,534.27",00.00,
25-Nov-22,IMPS,"1,49,629.60",00.00,"1,49,629.60",
25-Nov-22,Interest,00.00,"14,962.96","1,34,666.64",
25-Nov-22,Tax,00.00,"67,333.32","67,333.32",
25-Nov-22,IMPS,07.40,00.00,"67,340.72",
26-Nov-22,Transportellaneous,"17,99,239.50",00.00,"18,66,580.22",
26-Nov-22,RTGS,00.00,"18,66,580.22",00.00,
26-Nov-22,RTGS,"1,557.00",00.00,"1,557.00",
26-Nov-22,Reversal,348,00.00,"1,905.00",
26-Nov-22,Cheque,"1,88,296.31",00.00,"1,90,201.31",
26-Nov-22,Debit Card,00.00,"21,133.48","1,69,067.83",
26-Nov-22,Debit Card,"2,20,859.50",00.00,"3,89,927.33",
26-Nov-22,Transportellaneous,00.00,"1,94,963.67","1,94,963.66",
26-Nov-22,Bill,00.00,"24,370.46","1,70,593.20",
26-Nov-22,NEFT,28.53,00.00,"1,70,621.73",
26-Nov-22,Transfer,00.00,"18,957.97","1,51,663.76",
26-Nov-22,ATM,00.00,"16,851.53","1,34,812.23",
26-Nov-22,Interest,"10,508.00",00.00,"1,45,320.23",
26-Nov-22,Commission,00.00,"20,760.03","1,24,560.20",
26-Nov-22,Bill,"31,466.20",00.00,"1,56,026.40",
26-Nov-22,ATM,"1,057.59",00.00,"1,57,083.99",
26-Nov-22,Interest,00.00,"15,708.40","1,41,375.59",
26-Nov-22,NEFT,00.00,"47,125.20","94,250.39",
26-Nov-22,NEFT,"92,303.60",00.00,"1,86,553.99",
26-Nov-22,Cheque,06.76,00.00,"1,86,560.75",
26-Nov-22,ATM,00.00,"23,320.09","1,63,240.66",
26-Nov-22,Commission,39.1,00.00,"1,63,279.76",
26-Nov-22,Cash,00.00,"23,325.68","1,39,954.08",
26-Nov-22,Debit Card,"10,874.81",00.00,"1,50,828.89",
26-Nov-22,Reversal,00.00,"50,276.30","1,00,552.59",
26-Nov-22,NEFT,13.5,00.00,"1,00,566.09",
26-Nov-22,ATM,00.00,"50,283.05","50,283.04",
26-Nov-22,Cheque,00.00,"16,761.01","33,522.03",
26-Nov-22,Tax,04.50,00.00,"33,526.53",
26-Nov-22,Interest,"1,81,692.25",00.00,"2,15,218.78",
26-Nov-22,Transfer,"14,391.00",00.00,"2,29,609.78",
26-Nov-22,Transportellaneous,00.00,"38,268.30","1,91,341.48",
26-Nov-22,Interest,"5,939.94",00.00,"1,97,281.42",
26-Nov-22,IMPS,"7,46,975.20",00.00,"9,44,256.62",
26-Nov-22,Reversal,00.00,"94,425.66","8,49,830.96",
26-Nov-22,Debit Card,08.00,00.00,"8,49,838.96",
26-Nov-22,Purchase,"13,88,186.50",00.00,"22,38,025.46",
26-Nov-22,NEFT,00.00,"2,79,753.18","19,58,272.28",
26-Nov-22,Cheque,00.00,"3,26,378.71","16,31,893.57",
26-Nov-22,ATM,245.83,00.00,"16,32,139.40",
26-Nov-22,RTGS,05.80,00.00,"16,32,145.20",
26-Nov-22,Interest,"30,872.08",00.00,"16,63,017.28",
26-Nov-22,Bill,155,00.00,"16,63,172.28",
26-Nov-22,IMPS,"20,73,715.00",00.00,"37,36,887.28",
26-Nov-22,Cash,00.00,"18,68,443.64","18,68,443.64",
26-Nov-22,NEFT,"8,10,504.00",00.00,"26,78,947.64",
26-Nov-22,Tax,00.00,"5,35,789.53","21,43,158.11",
26-Nov-22,Tax,"23,041.00",00.00,"21,66,199.11",
26-Nov-22,NEFT,00.50,00.00,"21,66,199.61",
26-Nov-22,Debit Card,00.00,"4,33,239.92","17,32,959.69",
26-Nov-22,Cheque,03.26,00.00,"17,32,962.95",
26-Nov-22,Cheque,00.00,"2,47,566.14","14,85,396.81",
26-Nov-22,IMPS,178,00.00,"14,85,574.81",
26-Nov-22,Transfer,00.00,"4,95,191.60","9,90,383.21",
26-Nov-22,Transportellaneous,06.80,00.00,"9,90,390.01",
26-Nov-22,IMPS,"6,807.18",00.00,"9,97,197.19",
26-Nov-22,Commission,02.50,00.00,"9,97,199.69",
26-Nov-22,NEFT,00.00,"1,24,649.96","8,72,549.73",
26-Nov-22,Cheque,00.00,"1,45,424.96","7,27,124.78",
26-Nov-22,Transfer,"2,243.75",00.00,"7,29,368.53",
26-Nov-22,IMPS,"29,298.40",00.00,"7,58,666.93",
26-Nov-22,Reversal,"1,68,970.53",00.00,"9,27,637.46",
26-Nov-22,RTGS,05.00,00.00,"9,27,642.46",
26-Nov-22,Purchase,98.9,00.00,"9,27,741.36",
26-Nov-22,Interest,00.00,"1,03,082.37","8,24,658.99",
26-Nov-22,IMPS,45.54,00.00,"8,24,704.53",
26-Nov-22,Interest,"5,829.00",00.00,"8,30,533.53",
26-Nov-22,Transfer,"10,25,220.80",00.00,"18,55,754.33",
27-Nov-22,Transfer,"20,772.00",00.00,"18,76,526.33",
27-Nov-22,Bill,131.1,00.00,"18,76,657.43",
27-Nov-22,Reversal,"18,16,460.00",00.00,"36,93,117.43",
27-Nov-22,Tax,"2,27,415.80",00.00,"39,20,533.23",
27-Nov-22,Debit Card,00.00,"39,20,533.23",00.00,
27-Nov-22,Purchase,"2,775.81",00.00,"2,775.81",
27-Nov-22,Cash,01.00,00.00,"2,776.81",
27-Nov-22,ATM,00.00,462.8,"2,314.01",
27-Nov-22,Commission,05.00,00.00,"2,319.01",
28-Nov-22,ATM,488.8,00.00,"2,807.81",
28-Nov-22,ATM,00.00,"1,403.91","1,403.90",
28-Nov-22,Purchase,00.00,200.56,"1,203.34",
28-Nov-22,Cash,"75,412.40",00.00,"76,615.74",
28-Nov-22,RTGS,00.00,"38,307.87","38,307.87",
28-Nov-22,Interest,00.00,"6,384.65","31,923.22",
28-Nov-22,Transfer,00.00,"31,923.22",00.00,
28-Nov-22,Commission,"1,494.56",00.00,"1,494.56",
28-Nov-22,Interest,00.00,166.06,"1,328.50",
28-Nov-22,Tax,494.6,00.00,"1,823.10",
28-Nov-22,Debit Card,00.00,227.89,"1,595.21",
28-Nov-22,Transportellaneous,04.60,00.00,"1,599.81",
28-Nov-22,Cheque,07.00,00.00,"1,606.81",
28-Nov-22,RTGS,"2,603.69",00.00,"4,210.50",
28-Nov-22,Cheque,00.00,701.75,"3,508.75",
28-Nov-22,Debit Card,00.00,877.19,"2,631.56",
28-Nov-22,Commission,00.00,526.31,"2,105.25",
28-Nov-22,Commission,00.00,526.31,"1,578.94",
28-Nov-22,Commission,"22,171.70",00.00,"23,750.64",
28-Nov-22,Bill,00.00,"11,875.32","11,875.32",
28-Nov-22,NEFT,"18,21,967.20",00.00,"18,33,842.52",
28-Nov-22,Reversal,00.00,"1,83,384.25","16,50,458.27",
29-Nov-22,ATM,"20,52,828.75",00.00,"37,03,287.02",
29-Nov-22,ATM,00.00,"9,25,821.76","27,77,465.26",
29-Nov-22,Transfer,00.00,"13,88,732.63","13,88,732.63",
29-Nov-22,ATM,00.00,"2,77,746.53","11,10,986.10",
29-Nov-22,Transfer,00.00,"1,23,442.90","9,87,543.20",
29-Nov-22,RTGS,00.00,"1,97,508.64","7,90,034.56",
29-Nov-22,Cash,"1,05,510.70",00.00,"8,95,545.26",
29-Nov-22,Debit Card,116.08,00.00,"8,95,661.34",
29-Nov-22,Bill,00.00,"2,98,553.78","5,97,107.56",
29-Nov-22,Tax,43,00.00,"5,97,150.56",
30-Nov-22,NEFT,00.00,"2,98,575.28","2,98,575.28",
30-Nov-22,Transfer,"1,93,659.20",00.00,"4,92,234.48",
30-Nov-22,RTGS,06.86,00.00,"4,92,241.34",
30-Nov-22,Commission,"10,488.00",00.00,"5,02,729.34",
30-Nov-22,Debit Card,62.9,00.00,"5,02,792.24",
30-Nov-22,Transportellaneous,00.00,"83,798.71","4,18,993.53",
30-Nov-22,Tax,421.6,00.00,"4,19,415.13",
30-Nov-22,RTGS,00.00,"69,902.52","3,49,512.61",
30-Nov-22,Reversal,149.19,00.00,"3,49,661.80",
30-Nov-22,IMPS,"3,212.91",00.00,"3,52,874.71",
30-Nov-22,NEFT,"2,06,207.00",00.00,"5,59,081.71",
30-Nov-22,Cheque,39.7,00.00,"5,59,121.41",
01-Dec-22,NEFT,"7,76,449.00",00.00,"13,35,570.41",
01-Dec-22,ATM,00.00,"4,45,190.14","8,90,380.27",
01-Dec-22,Transfer,01.49,00.00,"8,90,381.76",
01-Dec-22,Interest,297,00.00,"8,90,678.76",
01-Dec-22,NEFT,00.00,"4,45,339.38","4,45,339.38",
01-Dec-22,Interest,"11,44,390.00",00.00,"15,89,729.38",
01-Dec-22,Bill,"25,888.03",00.00,"16,15,617.41",
01-Dec-22,ATM,00.00,"2,30,802.49","13,84,814.92",
01-Dec-22,Commission,"1,51,445.00",00.00,"15,36,259.92",
01-Dec-22,Reversal,00.00,"1,53,625.99","13,82,633.93",
01-Dec-22,RTGS,"50,462.59",00.00,"14,33,096.52",
01-Dec-22,Transportellaneous,00.00,"2,04,728.07","12,28,368.45",
01-Dec-22,Debit Card,00.00,"4,09,456.15","8,18,912.30",
01-Dec-22,Reversal,781,00.00,"8,19,693.30",
01-Dec-22,Cheque,00.00,"2,04,923.33","6,14,769.98",
02-Dec-22,Debit Card,00.00,"68,307.78","5,46,462.20",
02-Dec-22,Debit Card,55.46,00.00,"5,46,517.66",
02-Dec-22,RTGS,"4,02,215.00",00.00,"9,48,732.66",
02-Dec-22,NEFT,00.00,"94,873.27","8,53,859.39",
02-Dec-22,Tax,00.00,"94,873.27","7,58,986.12",
02-Dec-22,IMPS,302,00.00,"7,59,288.12",
02-Dec-22,Commission,00.00,"3,79,644.06","3,79,644.06",
02-Dec-22,IMPS,"1,41,197.80",00.00,"5,20,841.86",
02-Dec-22,ATM,58,00.00,"5,20,899.86",
02-Dec-22,Reversal,00.00,"65,112.48","4,55,787.38",
02-Dec-22,Purchase,00.00,"1,51,929.13","3,03,858.25",
02-Dec-22,Commission,348.19,00.00,"3,04,206.44",
02-Dec-22,Transportellaneous,00.00,"43,458.06","2,60,748.38",
02-Dec-22,ATM,"7,406.85",00.00,"2,68,155.23",
02-Dec-22,Tax,00.00,"2,68,155.23",00.00,
02-Dec-22,RTGS,"4,053.50",00.00,"4,053.50",
02-Dec-22,Transfer,"29,727.65",00.00,"33,781.15",
03-Dec-22,Interest,00.00,"3,378.12","30,403.04",
03-Dec-22,Reversal,00.00,"10,134.35","20,268.69",
03-Dec-22,Bill,"15,737.00",00.00,"36,005.69",
04-Dec-22,Reversal,00.00,"7,201.14","28,804.55",
04-Dec-22,Cheque,05.00,00.00,"28,809.55",
04-Dec-22,Transfer,00.00,"3,201.06","25,608.49",
04-Dec-22,Tax,145.1,00.00,"25,753.59",
04-Dec-22,ATM,00.00,"25,753.59",00.00,
04-Dec-22,Commission,"19,281.00",00.00,"19,281.00",
04-Dec-22,Tax,"18,04,489.00",00.00,"18,23,770.00",
04-Dec-22,Bill,00.00,"2,02,641.11","16,21,128.89",
04-Dec-22,Transportellaneous,14.1,00.00,"16,21,142.99",
04-Dec-22,Interest,00.00,"5,40,381.00","10,80,761.99",
04-Dec-22,Bill,00.00,"1,35,095.25","9,45,666.74",
04-Dec-22,Purchase,00.00,"2,36,416.69","7,09,250.06",
04-Dec-22,Transportellaneous,385.29,00.00,"7,09,635.35",
04-Dec-22,RTGS,00.00,"78,848.37","6,30,786.98",
04-Dec-22,NEFT,"27,060.00",00.00,"6,57,846.98",
05-Dec-22,Transfer,01.71,00.00,"6,57,848.69",
05-Dec-22,Tax,01.00,00.00,"6,57,849.69",
05-Dec-22,Cheque,00.00,"3,28,924.85","3,28,924.84",
05-Dec-22,IMPS,25,00.00,"3,28,949.84",
05-Dec-22,Interest,00.00,"3,28,949.84",00.00,
05-Dec-22,RTGS,"3,332.00",00.00,"3,332.00",
05-Dec-22,IMPS,00.00,"1,666.00","1,666.00",
05-Dec-22,ATM,00.00,833,833,
05-Dec-22,Debit Card,"1,01,027.00",00.00,"1,01,860.00",
05-Dec-22,Debit Card,"88,325.00",00.00,"1,90,185.00",
05-Dec-22,IMPS,00.00,"38,037.00","1,52,148.00",
05-Dec-22,RTGS,04.20,00.00,"1,52,152.20",
05-Dec-22,Cash,00.00,"76,076.10","76,076.10",
05-Dec-22,IMPS,12.2,00.00,"76,088.30",
06-Dec-22,Debit Card,237.8,00.00,"76,326.10",
06-Dec-22,Cash,00.00,"25,442.03","50,884.07",
06-Dec-22,Bill,00.00,"5,088.41","45,795.66",
06-Dec-22,Cash,"1,65,311.60",00.00,"2,11,107.26",
06-Dec-22,Transportellaneous,29.21,00.00,"2,11,136.47",
06-Dec-22,RTGS,00.00,"2,11,136.47",00.00,
06-Dec-22,Tax,58.02,00.00,58.02,
06-Dec-22,IMPS,00.00,29.01,29.01,
06-Dec-22,Transfer,00.00,04.14,24.87,
06-Dec-22,Transportellaneous,"11,55,233.00",00.00,"11,55,257.87",
06-Dec-22,IMPS,"3,239.00",00.00,"11,58,496.87",
06-Dec-22,Transportellaneous,"16,88,146.50",00.00,"28,46,643.37",
06-Dec-22,Bill,00.00,"3,16,293.71","25,30,349.66",
06-Dec-22,Debit Card,00.00,"2,81,149.96","22,49,199.70",
06-Dec-22,Debit Card,"2,08,534.97",00.00,"24,57,734.67",
06-Dec-22,Purchase,"1,38,222.00",00.00,"25,95,956.67",
06-Dec-22,ATM,00.00,"25,95,956.67",00.00,
06-Dec-22,Debit Card,56,00.00,56,
06-Dec-22,RTGS,"2,41,821.00",00.00,"2,41,877.00",
06-Dec-22,IMPS,00.00,"24,187.70","2,17,689.30",
06-Dec-22,NEFT,"2,283.50",00.00,"2,19,972.80",
06-Dec-22,IMPS,00.00,"73,324.27","1,46,648.53",
06-Dec-22,Purchase,"16,423.00",00.00,"1,63,071.53",
06-Dec-22,NEFT,"16,24,580.00",00.00,"17,87,651.53",
06-Dec-22,IMPS,249,00.00,"17,87,900.53",
06-Dec-22,Tax,00.00,"5,95,966.84","11,91,933.69",
06-Dec-22,Cash,00.00,"1,70,276.24","10,21,657.45",
06-Dec-22,Tax,"15,322.00",00.00,"10,36,979.45",
06-Dec-22,Debit Card,00.00,"1,48,139.92","8,88,839.53",
06-Dec-22,Cash,00.00,"88,883.95","7,99,955.58",
06-Dec-22,Transportellaneous,"3,985.00",00.00,"8,03,940.58",
06-Dec-22,Transportellaneous,113.4,00.00,"8,04,053.98",
06-Dec-22,NEFT,285.61,00.00,"8,04,339.59",
06-Dec-22,Cash,"12,248.40",00.00,"8,16,587.99",
06-Dec-22,Interest,00.00,"1,16,655.43","6,99,932.56",
06-Dec-22,Transportellaneous,00.00,"69,993.26","6,29,939.30",
06-Dec-22,Tax,35,00.00,"6,29,974.30",
06-Dec-22,Commission,00.00,"69,997.14","5,59,977.16",
06-Dec-22,RTGS,26.21,00.00,"5,60,003.37",
06-Dec-22,RTGS,"13,35,728.00",00.00,"18,95,731.37",
07-Dec-22,Cheque,00.00,"3,15,955.23","15,79,776.14",
07-Dec-22,Cash,"15,15,641.00",00.00,"30,95,417.14",
07-Dec-22,IMPS,00.00,"4,42,202.45","26,53,214.69",
07-Dec-22,Tax,10.79,00.00,"26,53,225.48",
07-Dec-22,Purchase,"29,057.00",00.00,"26,82,282.48",
07-Dec-22,ATM,"63,224.00",00.00,"27,45,506.48",
07-Dec-22,Interest,"68,346.00",00.00,"28,13,852.48",
07-Dec-22,Commission,00.00,"4,68,975.41","23,44,877.07",
07-Dec-22,Transfer,00.00,"11,72,438.54","11,72,438.53",
07-Dec-22,Transfer,00.00,"5,86,219.27","5,86,219.26",
07-Dec-22,RTGS,405.81,00.00,"5,86,625.07",
07-Dec-22,RTGS,00.00,"1,46,656.27","4,39,968.80",
07-Dec-22,Tax,00.00,"73,328.13","3,66,640.67",
07-Dec-22,Bill,00.00,"73,328.13","2,93,312.54",
07-Dec-22,RTGS,00.00,"97,770.85","1,95,541.69",
07-Dec-22,IMPS,"2,233.68",00.00,"1,97,775.37",
07-Dec-22,Tax,00.00,"98,887.69","98,887.68",
07-Dec-22,Commission,915.7,00.00,"99,803.38",
07-Dec-22,Cash,"89,641.10",00.00,"1,89,444.48",
07-Dec-22,IMPS,"24,627.40",00.00,"2,14,071.88",
07-Dec-22,IMPS,41.8,00.00,"2,14,113.68",
07-Dec-22,IMPS,00.00,"2,14,113.68",00.00,
07-Dec-22,Interest,130,00.00,130,
07-Dec-22,Purchase,00.00,16.25,113.75,
07-Dec-22,Reversal,64,00.00,177.75,
07-Dec-22,Tax,196.79,00.00,374.54,
07-Dec-22,Interest,07.00,00.00,381.54,
07-Dec-22,IMPS,02.80,00.00,384.34,
07-Dec-22,Transportellaneous,00.00,54.91,329.43,
07-Dec-22,Interest,00.00,164.72,164.72,
07-Dec-22,Interest,"11,37,761.80",00.00,"11,37,926.52",
07-Dec-22,ATM,00.00,"2,84,481.63","8,53,444.89",
08-Dec-22,Interest,"19,52,519.25",00.00,"28,05,964.14",
08-Dec-22,Commission,00.00,"14,02,982.07","14,02,982.07",
08-Dec-22,RTGS,18.1,00.00,"14,03,000.17",
08-Dec-22,Transportellaneous,00.00,"14,03,000.17",00.00,
08-Dec-22,Debit Card,"12,953.28",00.00,"12,953.28",
08-Dec-22,Bill,00.00,"1,619.16","11,334.12",
08-Dec-22,Transfer,00.00,"1,889.02","9,445.10",
08-Dec-22,Cash,00.00,"1,049.46","8,395.64",
08-Dec-22,Bill,00.00,"4,197.82","4,197.82",
08-Dec-22,RTGS,"5,06,503.00",00.00,"5,10,700.82",
08-Dec-22,Interest,"18,804.00",00.00,"5,29,504.82",
08-Dec-22,Commission,"2,37,755.06",00.00,"7,67,259.88",
08-Dec-22,Transfer,00.00,"85,251.10","6,82,008.78",
08-Dec-22,Reversal,"93,634.00",00.00,"7,75,642.78",
08-Dec-22,NEFT,07.64,00.00,"7,75,650.42",
08-Dec-22,RTGS,"18,36,211.50",00.00,"26,11,861.92",
08-Dec-22,Transfer,41.1,00.00,"26,11,903.02",
08-Dec-22,ATM,"25,356.95",00.00,"26,37,259.97",
08-Dec-22,Commission,"1,95,424.75",00.00,"28,32,684.72",
08-Dec-22,Reversal,"2,46,117.81",00.00,"30,78,802.53",
08-Dec-22,Bill,01.36,00.00,"30,78,803.89",
08-Dec-22,Reversal,"1,65,057.00",00.00,"32,43,860.89",
08-Dec-22,Bill,00.00,"4,05,482.61","28,38,378.28",
08-Dec-22,Commission,04.20,00.00,"28,38,382.48",
08-Dec-22,Interest,00.00,"4,73,063.75","23,65,318.73",
08-Dec-22,Transfer,01.00,00.00,"23,65,319.73",
08-Dec-22,Cash,00.00,"4,73,063.95","18,92,255.78",
08-Dec-22,IMPS,00.00,"2,36,531.97","16,55,723.81",
09-Dec-22,RTGS,00.00,"4,13,930.95","12,41,792.86",
09-Dec-22,Transfer,00.00,"2,48,358.57","9,93,434.29",
09-Dec-22,ATM,00.00,00.00,"9,93,434.29",
09-Dec-22,Cash,00.00,"99,343.43","8,94,090.86",
09-Dec-22,Transportellaneous,00.00,"1,27,727.27","7,66,363.59",
09-Dec-22,Transportellaneous,"1,33,893.10",00.00,"9,00,256.69",
09-Dec-22,RTGS,02.90,00.00,"9,00,259.59",
09-Dec-22,RTGS,00.00,"3,00,086.53","6,00,173.06",
09-Dec-22,NEFT,06.90,00.00,"6,00,179.96",
09-Dec-22,Cheque,00.00,"6,00,179.96",00.00,
09-Dec-22,Tax,"1,03,104.00",00.00,"1,03,104.00",
09-Dec-22,Debit Card,"24,199.80",00.00,"1,27,303.80",
09-Dec-22,Reversal,"17,227.00",00.00,"1,44,530.80",
09-Dec-22,IMPS,00.00,"1,44,530.80",00.00,
10-Dec-22,Transfer,08.30,00.00,08.30,
10-Dec-22,Debit Card,"14,793.00",00.00,"14,801.30",
10-Dec-22,Transfer,00.00,"4,933.77","9,867.53",
10-Dec-22,Transportellaneous,00.00,"1,096.39","8,771.14",
10-Dec-22,Tax,00.00,"1,754.23","7,016.91",
10-Dec-22,IMPS,"1,35,105.00",00.00,"1,42,121.91",
11-Dec-22,Debit Card,06.00,00.00,"1,42,127.91",
11-Dec-22,Interest,348.44,00.00,"1,42,476.35",
11-Dec-22,RTGS,355,00.00,"1,42,831.35",
12-Dec-22,Cheque,"2,04,336.81",00.00,"3,47,168.16",
12-Dec-22,Commission,00.00,"34,716.82","3,12,451.34",
12-Dec-22,Reversal,26,00.00,"3,12,477.34",
12-Dec-22,NEFT,00.00,"1,56,238.67","1,56,238.67",
12-Dec-22,Bill,02.00,00.00,"1,56,240.67",
12-Dec-22,Purchase,00.00,"1,56,240.67",00.00,
12-Dec-22,Debit Card,05.53,00.00,05.53,
12-Dec-22,RTGS,00.00,00.55,04.98,
12-Dec-22,Bill,00.00,00.55,04.43,
12-Dec-22,Debit Card,00.00,00.74,03.69,
12-Dec-22,RTGS,"1,90,443.00",00.00,"1,90,446.69",
12-Dec-22,Interest,00.00,"27,206.67","1,63,240.02",
13-Dec-22,Interest,"6,51,703.50",00.00,"8,14,943.52",
13-Dec-22,ATM,00.00,"1,62,988.70","6,51,954.82",
13-Dec-22,Purchase,"13,14,817.00",00.00,"19,66,771.82",
13-Dec-22,Transfer,05.36,00.00,"19,66,777.18",
13-Dec-22,Cheque,"9,00,018.50",00.00,"28,66,795.68",
13-Dec-22,Interest,00.00,"3,18,532.85","25,48,262.83",
13-Dec-22,IMPS,00.00,"2,54,826.28","22,93,436.55",
13-Dec-22,Purchase,00.00,"3,82,239.43","19,11,197.12",
13-Dec-22,Tax,00.00,"19,11,197.12",00.00,
13-Dec-22,Cash,90,00.00,90,
13-Dec-22,IMPS,02.00,00.00,92,
14-Dec-22,Cheque,445.33,00.00,537.33,
14-Dec-22,Debit Card,00.00,67.17,470.16,
14-Dec-22,RTGS,00.00,94.03,376.13,
14-Dec-22,RTGS,278.23,00.00,654.36,
14-Dec-22,Cash,00.00,130.87,523.49,
14-Dec-22,Commission,02.00,00.00,525.49,
14-Dec-22,Commission,00.00,58.39,467.1,
14-Dec-22,Debit Card,00.00,66.73,400.37,
14-Dec-22,Cheque,00.00,44.49,355.88,
14-Dec-22,Tax,01.50,00.00,357.38,
14-Dec-22,Bill,00.00,44.67,312.71,
14-Dec-22,Cheque,00.00,156.36,156.35,
14-Dec-22,RTGS,"64,948.47",00.00,"65,104.82",
14-Dec-22,Bill,00.00,"7,233.87","57,870.95",
14-Dec-22,Cheque,00.00,"57,870.95",00.00,
14-Dec-22,Interest,"42,180.00",00.00,"42,180.00",
14-Dec-22,Interest,00.00,"10,545.00","31,635.00",
14-Dec-22,Transportellaneous,00.00,"3,163.50","28,471.50",
14-Dec-22,Bill,00.00,"28,471.50",00.00,
14-Dec-22,Interest,39.27,00.00,39.27,
14-Dec-22,Transportellaneous,112.98,00.00,152.25,
14-Dec-22,Transportellaneous,00.57,00.00,152.82,
14-Dec-22,Cash,63.3,00.00,216.12,
14-Dec-22,IMPS,00.00,72.04,144.08,
14-Dec-22,Reversal,00.00,14.41,129.67,
14-Dec-22,IMPS,00.00,25.93,103.74,
14-Dec-22,Debit Card,00.00,10.37,93.37,
14-Dec-22,Debit Card,00.00,46.69,46.68,
14-Dec-22,NEFT,00.00,05.84,40.84,
14-Dec-22,Reversal,"1,900.00",00.00,"1,940.84",
14-Dec-22,Debit Card,417,00.00,"2,357.84",
15-Dec-22,NEFT,00.00,336.83,"2,021.01",
15-Dec-22,Bill,00.00,224.56,"1,796.45",
15-Dec-22,Purchase,00.00,359.29,"1,437.16",
15-Dec-22,Debit Card,00.00,359.29,"1,077.87",
15-Dec-22,ATM,00.00,359.29,718.58,
15-Dec-22,IMPS,00.00,102.65,615.93,
15-Dec-22,Purchase,370.55,00.00,986.48,
15-Dec-22,Interest,"1,26,107.00",00.00,"1,27,093.48",
15-Dec-22,Cheque,"2,307.00",00.00,"1,29,400.48",
16-Dec-22,Cash,224.6,00.00,"1,29,625.08",
16-Dec-22,Cash,00.00,"25,925.02","1,03,700.06",
16-Dec-22,Commission,"7,18,814.00",00.00,"8,22,514.06",
16-Dec-22,ATM,00.00,"1,37,085.68","6,85,428.38",
16-Dec-22,Transfer,"26,131.00",00.00,"7,11,559.38",
16-Dec-22,Tax,07.00,00.00,"7,11,566.38",
16-Dec-22,Cheque,00.00,"1,42,313.28","5,69,253.10",
16-Dec-22,Tax,"45,695.38",00.00,"6,14,948.48",
16-Dec-22,Commission,00.00,"3,07,474.24","3,07,474.24",
16-Dec-22,Debit Card,"2,51,650.00",00.00,"5,59,124.24",
16-Dec-22,Bill,"13,577.00",00.00,"5,72,701.24",
16-Dec-22,Tax,"18,62,918.00",00.00,"24,35,619.24",
16-Dec-22,Tax,"12,227.00",00.00,"24,47,846.24",
16-Dec-22,Reversal,00.00,00.00,"24,47,846.24",
16-Dec-22,NEFT,00.00,"12,23,923.12","12,23,923.12",
16-Dec-22,Debit Card,00.00,"12,23,923.12",00.00,
16-Dec-22,Commission,"19,97,237.00",00.00,"19,97,237.00",
16-Dec-22,ATM,"2,38,860.30",00.00,"22,36,097.30",
16-Dec-22,NEFT,79,00.00,"22,36,176.30",
16-Dec-22,NEFT,00.00,"4,47,235.26","17,88,941.04",
16-Dec-22,Interest,00.00,"1,98,771.23","15,90,169.81",
17-Dec-22,IMPS,49,00.00,"15,90,218.81",
17-Dec-22,Bill,00.00,"7,95,109.41","7,95,109.40",
18-Dec-22,Reversal,"32,584.00",00.00,"8,27,693.40",
18-Dec-22,RTGS,"2,12,399.30",00.00,"10,40,092.70",
18-Dec-22,ATM,00.00,"2,60,023.18","7,80,069.52",
18-Dec-22,Interest,00.00,"1,56,013.90","6,24,055.62",
18-Dec-22,Transfer,50,00.00,"6,24,105.62",
18-Dec-22,Cheque,"2,41,161.70",00.00,"8,65,267.32",
18-Dec-22,IMPS,"3,245.04",00.00,"8,68,512.36",
19-Dec-22,Interest,00.00,"2,89,504.12","5,79,008.24",
19-Dec-22,Cash,00.00,"5,79,008.24",00.00,
19-Dec-22,ATM,345.88,00.00,345.88,
19-Dec-22,Transfer,00.00,43.24,302.64,
19-Dec-22,Debit Card,226.03,00.00,528.67,
19-Dec-22,Cheque,"1,07,309.00",00.00,"1,07,837.67",
19-Dec-22,Bill,04.00,00.00,"1,07,841.67",
19-Dec-22,Cash,385,00.00,"1,08,226.67",
19-Dec-22,IMPS,00.00,"1,08,226.67",00.00,
19-Dec-22,Bill,04.00,00.00,04.00,
19-Dec-22,Bill,"1,430.30",00.00,"1,434.30",
19-Dec-22,Transportellaneous,00.00,239.05,"1,195.25",
19-Dec-22,Transfer,04.10,00.00,"1,199.35",
19-Dec-22,Transportellaneous,00.00,299.84,899.51,
19-Dec-22,Bill,"29,671.00",00.00,"30,570.51",
19-Dec-22,NEFT,00.00,"3,396.72","27,173.79",
19-Dec-22,Bill,00.00,"4,528.97","22,644.82",
19-Dec-22,Tax,442.5,00.00,"23,087.32",
19-Dec-22,Bill,00.00,"4,617.46","18,469.86",
19-Dec-22,NEFT,44.46,00.00,"18,514.32",
20-Dec-22,Transportellaneous,00.00,"6,171.44","12,342.88",
20-Dec-22,RTGS,00.00,"1,763.27","10,579.61",
20-Dec-22,Bill,00.00,"2,115.92","8,463.69",
20-Dec-22,Transfer,"14,21,141.50",00.00,"14,29,605.19",
20-Dec-22,Interest,30.6,00.00,"14,29,635.79",
20-Dec-22,Reversal,501.7,00.00,"14,30,137.49",
20-Dec-22,IMPS,00.00,"3,57,534.37","10,72,603.12",
20-Dec-22,Interest,"75,378.06",00.00,"11,47,981.18",
20-Dec-22,Transfer,00.00,"1,63,997.31","9,83,983.87",
20-Dec-22,RTGS,00.00,"1,22,997.98","8,60,985.89",
20-Dec-22,Cash,00.00,"86,098.59","7,74,887.30",
20-Dec-22,Transportellaneous,11,00.00,"7,74,898.30",
20-Dec-22,RTGS,00.00,"7,74,898.30",00.00,
20-Dec-22,Commission,"28,569.80",00.00,"28,569.80",
20-Dec-22,Debit Card,"12,13,913.00",00.00,"12,42,482.80",
20-Dec-22,NEFT,00.00,"1,77,497.54","10,64,985.26",
20-Dec-22,IMPS,00.00,"1,18,331.70","9,46,653.56",
20-Dec-22,IMPS,00.00,"1,89,330.71","7,57,322.85",
20-Dec-22,Transportellaneous,"4,69,740.00",00.00,"12,27,062.85",
20-Dec-22,Bill,02.83,00.00,"12,27,065.68",
20-Dec-22,Purchase,00.00,"2,45,413.14","9,81,652.54",
20-Dec-22,IMPS,00.00,"1,09,072.50","8,72,580.04",
20-Dec-22,Interest,35.07,00.00,"8,72,615.11",
20-Dec-22,Transfer,00.00,"1,74,523.02","6,98,092.09",
20-Dec-22,Cash,"2,110.00",00.00,"7,00,202.09",
20-Dec-22,Cash,00.00,"1,00,028.87","6,00,173.22",
20-Dec-22,Purchase,00.00,"1,00,028.87","5,00,144.35",
20-Dec-22,Interest,00.00,"1,00,028.87","4,00,115.48",
20-Dec-22,Transfer,"28,823.25",00.00,"4,28,938.73",
20-Dec-22,Bill,"13,309.50",00.00,"4,42,248.23",
20-Dec-22,Transportellaneous,"33,725.00",00.00,"4,75,973.23",
20-Dec-22,Cash,259.32,00.00,"4,76,232.55",
20-Dec-22,Reversal,41.5,00.00,"4,76,274.05",
20-Dec-22,RTGS,00.00,"1,19,068.51","3,57,205.54",
20-Dec-22,Tax,00.00,"71,441.11","2,85,764.43",
20-Dec-22,RTGS,00.00,"28,576.44","2,57,187.99",
20-Dec-22,NEFT,"3,48,861.25",00.00,"6,06,049.24",
20-Dec-22,Transfer,"1,00,786.90",00.00,"7,06,836.14",
20-Dec-22,Transportellaneous,00.00,"1,76,709.04","5,30,127.10",
20-Dec-22,Cheque,00.00,"53,012.71","4,77,114.39",
20-Dec-22,Interest,383,00.00,"4,77,497.39",
20-Dec-22,RTGS,34.95,00.00,"4,77,532.34",
20-Dec-22,Debit Card,27.6,00.00,"4,77,559.94",
21-Dec-22,Cheque,38.9,00.00,"4,77,598.84",
21-Dec-22,Commission,"12,477.60",00.00,"4,90,076.44",
21-Dec-22,Transfer,00.00,"54,452.94","4,35,623.50",
21-Dec-22,Cheque,00.00,"62,231.93","3,73,391.57",
21-Dec-22,Transportellaneous,00.00,"3,73,391.57",00.00,
21-Dec-22,Debit Card,103,00.00,103,
21-Dec-22,Interest,"1,31,171.00",00.00,"1,31,274.00",
21-Dec-22,Reversal,"1,57,504.00",00.00,"2,88,778.00",
21-Dec-22,Transfer,23,00.00,"2,88,801.00",
21-Dec-22,RTGS,03.35,00.00,"2,88,804.35",
21-Dec-22,Bill,00.00,"28,880.44","2,59,923.91",
21-Dec-22,Cheque,00.00,"43,320.65","2,16,603.26",
21-Dec-22,ATM,243.6,00.00,"2,16,846.86",
21-Dec-22,Bill,06.60,00.00,"2,16,853.46",
21-Dec-22,Tax,"1,41,233.80",00.00,"3,58,087.26",
21-Dec-22,ATM,00.00,"1,79,043.63","1,79,043.63",
21-Dec-22,ATM,29.35,00.00,"1,79,072.98",
21-Dec-22,Cash,"6,12,399.00",00.00,"7,91,471.98",
21-Dec-22,Commission,00.00,"1,58,294.40","6,33,177.58",
21-Dec-22,Tax,"3,286.00",00.00,"6,36,463.58",
21-Dec-22,NEFT,"25,325.31",00.00,"6,61,788.89",
21-Dec-22,Commission,"68,766.30",00.00,"7,30,555.19",
21-Dec-22,Transfer,"1,439.00",00.00,"7,31,994.19",
21-Dec-22,Tax,209,00.00,"7,32,203.19",
21-Dec-22,Bill,00.00,"1,83,050.80","5,49,152.39",
21-Dec-22,Commission,00.00,"1,83,050.80","3,66,101.59",
21-Dec-22,Transfer,"2,51,117.90",00.00,"6,17,219.49",
21-Dec-22,Debit Card,35,00.00,"6,17,254.49",
21-Dec-22,Commission,02.10,00.00,"6,17,256.59",
21-Dec-22,Tax,00.00,"1,54,314.15","4,62,942.44",
21-Dec-22,Interest,"1,458.99",00.00,"4,64,401.43",
21-Dec-22,Transportellaneous,00.00,"2,32,200.72","2,32,200.72",
21-Dec-22,RTGS,438,00.00,"2,32,638.72",
21-Dec-22,Cash,"2,20,511.00",00.00,"4,53,149.72",
21-Dec-22,Reversal,00.00,"64,735.67","3,88,414.05",
21-Dec-22,Interest,01.00,00.00,"3,88,415.05",
21-Dec-22,Interest,"17,790.35",00.00,"4,06,205.40",
21-Dec-22,Cash,00.00,"1,01,551.35","3,04,654.05",
21-Dec-22,Debit Card,"7,248.00",00.00,"3,11,902.05",
22-Dec-22,Debit Card,00.00,"62,380.41","2,49,521.64",
22-Dec-22,RTGS,06.90,00.00,"2,49,528.54",
22-Dec-22,Reversal,00.00,"31,191.07","2,18,337.47",
22-Dec-22,Debit Card,00.00,"31,191.07","1,87,146.40",
22-Dec-22,NEFT,00.00,"1,87,146.40",00.00,
22-Dec-22,ATM,"86,318.00",00.00,"86,318.00",
22-Dec-22,Cash,279.79,00.00,"86,597.79",
22-Dec-22,Bill,00.00,"9,621.98","76,975.81",
22-Dec-22,Cash,02.00,00.00,"76,977.81",
22-Dec-22,NEFT,00.00,"10,996.83","65,980.98",
22-Dec-22,Cash,00.98,00.00,"65,981.96",
22-Dec-22,Transportellaneous,"22,428.30",00.00,"88,410.26",
22-Dec-22,RTGS,00.00,"44,205.13","44,205.13",
22-Dec-22,Bill,880.9,00.00,"45,086.03",
22-Dec-22,RTGS,00.00,"7,514.34","37,571.69",
22-Dec-22,Reversal,232.2,00.00,"37,803.89",
22-Dec-22,IMPS,00.00,"12,601.30","25,202.59",
22-Dec-22,Transfer,"2,719.00",00.00,"27,921.59",
22-Dec-22,NEFT,00.00,"27,921.59",00.00,
22-Dec-22,Interest,29,00.00,29,
22-Dec-22,Purchase,39.98,00.00,68.98,
22-Dec-22,Interest,"80,147.06",00.00,"80,216.04",
22-Dec-22,Purchase,00.00,"20,054.01","60,162.03",
22-Dec-22,Transfer,00.00,"12,032.41","48,129.62",
22-Dec-22,Tax,61.7,00.00,"48,191.32",
22-Dec-22,Transportellaneous,00.00,"6,884.47","41,306.85",
22-Dec-22,Transfer,00.00,"13,768.95","27,537.90",
22-Dec-22,Transfer,00.00,"27,537.90",00.00,
22-Dec-22,Reversal,41.84,00.00,41.84,
22-Dec-22,Cash,08.00,00.00,49.84,
22-Dec-22,Interest,00.00,49.84,00.00,
22-Dec-22,Debit Card,"8,22,472.00",00.00,"8,22,472.00",
23-Dec-22,Cash,00.00,"1,64,494.40","6,57,977.60",
23-Dec-22,Bill,"12,94,345.50",00.00,"19,52,323.10",
23-Dec-22,RTGS,00.00,"6,50,774.37","13,01,548.73",
23-Dec-22,Tax,00.00,"1,85,935.53","11,15,613.20",
23-Dec-22,Cheque,00.00,"1,23,957.02","9,91,656.18",
24-Dec-22,Interest,00.00,"1,23,957.02","8,67,699.16",
24-Dec-22,Purchase,00.00,"86,769.92","7,80,929.24",
24-Dec-22,Reversal,"85,863.75",00.00,"8,66,792.99",
24-Dec-22,Commission,"27,320.90",00.00,"8,94,113.89",
24-Dec-22,Commission,00.00,"1,11,764.24","7,82,349.65",
24-Dec-22,Commission,00.00,"2,60,783.22","5,21,566.43",
24-Dec-22,Commission,"30,171.60",00.00,"5,51,738.03",
24-Dec-22,Cheque,"2,304.70",00.00,"5,54,042.73",
24-Dec-22,NEFT,00.00,"79,148.96","4,74,893.77",
24-Dec-22,Tax,00.00,"52,765.97","4,22,127.80",
24-Dec-22,Commission,"12,481.00",00.00,"4,34,608.80",
24-Dec-22,Cash,00.00,"62,086.97","3,72,521.83",
24-Dec-22,Bill,36.5,00.00,"3,72,558.33",
24-Dec-22,NEFT,00.00,"74,511.67","2,98,046.66",
25-Dec-22,Commission,"1,60,355.88",00.00,"4,58,402.54",
25-Dec-22,Transfer,00.00,"1,14,600.64","3,43,801.90",
25-Dec-22,Bill,00.00,"57,300.32","2,86,501.58",
26-Dec-22,Cheque,00.00,"57,300.32","2,29,201.26",
26-Dec-22,Transfer,"20,34,602.00",00.00,"22,63,803.26",
26-Dec-22,Transportellaneous,00.00,"4,52,760.65","18,11,042.61",
26-Dec-22,ATM,"25,507.18",00.00,"18,36,549.79",
26-Dec-22,Cash,00.00,"6,12,183.26","12,24,366.53",
26-Dec-22,NEFT,00.00,"1,53,045.82","10,71,320.71",
26-Dec-22,ATM,"1,400.89",00.00,"10,72,721.60",
26-Dec-22,Tax,00.00,"10,72,721.60",00.00,
26-Dec-22,Transportellaneous,"4,065.72",00.00,"4,065.72",
26-Dec-22,Tax,00.00,508.22,"3,557.50",
26-Dec-22,RTGS,"1,579.60",00.00,"5,137.10",
26-Dec-22,NEFT,00.00,"1,284.28","3,852.82",
26-Dec-22,Debit Card,00.00,550.4,"3,302.42",
26-Dec-22,Transfer,00.00,471.77,"2,830.65",
26-Dec-22,IMPS,00.00,353.83,"2,476.82",
26-Dec-22,Tax,00.00,412.8,"2,064.02",
26-Dec-22,Interest,00.00,229.34,"1,834.68",
26-Dec-22,NEFT,"2,779.00",00.00,"4,613.68",
26-Dec-22,ATM,"16,893.28",00.00,"21,506.96",
26-Dec-22,Purchase,"1,47,342.90",00.00,"1,68,849.86",
26-Dec-22,Cash,00.00,"33,769.97","1,35,079.89",
26-Dec-22,Debit Card,56.9,00.00,"1,35,136.79",
26-Dec-22,NEFT,00.00,"67,568.40","67,568.40",
26-Dec-22,Transportellaneous,00.00,"67,568.40",00.00,
26-Dec-22,Debit Card,"1,78,007.28",00.00,"1,78,007.28",
26-Dec-22,Purchase,00.00,"19,778.59","1,58,228.69",
26-Dec-22,Tax,20.8,00.00,"1,58,249.49",
26-Dec-22,Transfer,"17,78,701.50",00.00,"19,36,950.99",
26-Dec-22,Bill,00.00,"1,93,695.10","17,43,255.89",
26-Dec-22,Cheque,00.00,"8,71,627.95","8,71,627.94",
26-Dec-22,ATM,"10,46,026.75",00.00,"19,17,654.69",
26-Dec-22,ATM,00.00,"3,19,609.12","15,98,045.58",
26-Dec-22,Cheque,00.00,"3,99,511.40","11,98,534.18",
26-Dec-22,RTGS,00.00,"1,49,816.77","10,48,717.41",
26-Dec-22,Tax,"10,79,005.75",00.00,"21,27,723.16",
26-Dec-22,Transfer,00.00,"2,12,772.32","19,14,950.84",
26-Dec-22,IMPS,401,00.00,"19,15,351.84",
26-Dec-22,IMPS,00.00,"2,73,621.69","16,41,730.15",
26-Dec-22,RTGS,00.00,"16,41,730.15",00.00,
26-Dec-22,Cash,"10,36,958.50",00.00,"10,36,958.50",
27-Dec-22,Commission,00.00,"1,03,695.85","9,33,262.65",
27-Dec-22,IMPS,05.00,00.00,"9,33,267.65",
27-Dec-22,Debit Card,16.4,00.00,"9,33,284.05",
27-Dec-22,Debit Card,"2,25,751.00",00.00,"11,59,035.05",
27-Dec-22,Cash,"2,422.46",00.00,"11,61,457.51",
27-Dec-22,Reversal,00.00,"2,32,291.50","9,29,166.01",
27-Dec-22,Tax,00.00,"2,32,291.50","6,96,874.51",
27-Dec-22,Bill,"1,781.20",00.00,"6,98,655.71",
27-Dec-22,Interest,488.8,00.00,"6,99,144.51",
27-Dec-22,Purchase,00.00,"99,877.79","5,99,266.72",
27-Dec-22,IMPS,00.00,"5,99,266.72",00.00,
27-Dec-22,Debit Card,409,00.00,409,
27-Dec-22,Transportellaneous,03.40,00.00,412.4,
27-Dec-22,Tax,00.00,103.1,309.3,
27-Dec-22,Commission,00.00,103.1,206.2,
27-Dec-22,IMPS,00.00,68.73,137.47,
27-Dec-22,Purchase,60.3,00.00,197.77,
27-Dec-22,Reversal,46,00.00,243.77,
27-Dec-22,Reversal,406.47,00.00,650.24,
27-Dec-22,Transfer,00.00,216.75,433.49,
27-Dec-22,Cheque,00.00,72.25,361.24,
27-Dec-22,ATM,00.00,36.12,325.12,
27-Dec-22,Transportellaneous,00.00,36.12,289,
27-Dec-22,NEFT,"34,208.50",00.00,"34,497.50",
27-Dec-22,NEFT,00.00,"3,833.06","30,664.44",
27-Dec-22,NEFT,"20,805.41",00.00,"51,469.85",
27-Dec-22,Cash,00.00,"6,433.73","45,036.12",
27-Dec-22,Debit Card,00.00,"4,503.61","40,532.51",
27-Dec-22,Bill,03.60,00.00,"40,536.11",
27-Dec-22,Cheque,"11,542.10",00.00,"52,078.21",
28-Dec-22,Cash,"7,68,617.00",00.00,"8,20,695.21",
29-Dec-22,ATM,00.00,"4,10,347.61","4,10,347.60",
29-Dec-22,Transfer,00.00,"51,293.45","3,59,054.15",
29-Dec-22,Transportellaneous,436,00.00,"3,59,490.15",
29-Dec-22,Cheque,01.00,00.00,"3,59,491.15",
29-Dec-22,Transfer,"17,90,482.00",00.00,"21,49,973.15",
29-Dec-22,ATM,00.00,"2,14,997.32","19,34,975.84",
29-Dec-22,Transfer,"18,11,131.00",00.00,"37,46,106.84",
29-Dec-22,Transfer,00.00,"7,49,221.37","29,96,885.47",
29-Dec-22,Cash,00.00,"14,98,442.74","14,98,442.74",
29-Dec-22,NEFT,00.00,"14,98,442.74",00.00,
29-Dec-22,RTGS,"91,078.00",00.00,"91,078.00",
29-Dec-22,Transfer,17.2,00.00,"91,095.20",
30-Dec-22,Cash,"4,62,631.50",00.00,"5,53,726.70",
30-Dec-22,Cheque,00.00,"55,372.67","4,98,354.03",
30-Dec-22,ATM,75.2,00.00,"4,98,429.23",
30-Dec-22,Cash,00.00,"4,98,429.23",00.00,
31-Dec-22,NEFT,"31,852.50",00.00,"31,852.50",
31-Dec-22,Interest,22.47,00.00,"31,874.97",
31-Dec-22,RTGS,39,00.00,"31,913.97",
31-Dec-22,Interest,"2,828.00",00.00,"34,741.97",
31-Dec-22,Cash,00.00,"5,790.33","28,951.64",
31-Dec-22,Cash,00.00,"3,216.85","25,734.79",
31-Dec-22,Transfer,"19,970.60",00.00,"45,705.39",
31-Dec-22,Transportellaneous,00.00,"45,705.39",00.00,
31-Dec-22,RTGS,43.8,00.00,43.8,
31-Dec-22,Cash,"13,13,616.20",00.00,"13,13,660.00",
31-Dec-22,Transfer,"61,958.00",00.00,"13,75,618.00",
31-Dec-22,Cheque,05.00,00.00,"13,75,623.00",
31-Dec-22,NEFT,00.00,"2,75,124.60","11,00,498.40",
31-Dec-22,Reversal,00.00,"11,00,498.40",00.00,
31-Dec-22,Cheque,"1,78,219.62",00.00,"1,78,219.62",
31-Dec-22,Reversal,06.40,00.00,"1,78,226.02",
31-Dec-22,Transportellaneous,00.00,"25,460.86","1,52,765.16",
01-Jan-23,Cash,00.00,"15,276.52","1,37,488.64",
01-Jan-23,NEFT,00.00,"22,914.77","1,14,573.87",
01-Jan-23,Cheque,25.72,00.00,"1,14,599.59",
01-Jan-23,Bill,383,00.00,"1,14,982.59",
01-Jan-23,NEFT,"7,61,881.25",00.00,"8,76,863.84",
01-Jan-23,Debit Card,33.44,00.00,"8,76,897.28",
01-Jan-23,Reversal,"2,49,256.80",00.00,"11,26,154.08",
01-Jan-23,Commission,00.00,"2,25,230.82","9,00,923.26",
01-Jan-23,ATM,"25,126.44",00.00,"9,26,049.70",
01-Jan-23,Interest,36,00.00,"9,26,085.70",
01-Jan-23,Reversal,00.00,"1,02,898.41","8,23,187.29",
01-Jan-23,Cheque,00.00,"1,37,197.88","6,85,989.41",
01-Jan-23,Tax,"3,270.90",00.00,"6,89,260.31",
01-Jan-23,RTGS,00.00,"98,465.76","5,90,794.55",
01-Jan-23,Reversal,02.30,00.00,"5,90,796.85",
01-Jan-23,RTGS,502.8,00.00,"5,91,299.65",
02-Jan-23,RTGS,00.00,"84,471.38","5,06,828.27",
02-Jan-23,Debit Card,00.00,"1,26,707.07","3,80,121.20",
02-Jan-23,Transfer,00.00,"42,235.69","3,37,885.51",
02-Jan-23,Reversal,"13,608.00",00.00,"3,51,493.51",
02-Jan-23,IMPS,"1,60,445.00",00.00,"5,11,938.51",
03-Jan-23,NEFT,00.00,"51,193.85","4,60,744.66",
03-Jan-23,Transportellaneous,00.00,"51,193.85","4,09,550.81",
03-Jan-23,Tax,00.00,"1,02,387.70","3,07,163.11",
03-Jan-23,ATM,00.00,"51,193.85","2,55,969.26",
03-Jan-23,RTGS,"11,484.20",00.00,"2,67,453.46",
03-Jan-23,IMPS,08.17,00.00,"2,67,461.63",
03-Jan-23,ATM,00.00,"66,865.41","2,00,596.22",
03-Jan-23,Transportellaneous,162,00.00,"2,00,758.22",
03-Jan-23,ATM,00.00,"50,189.56","1,50,568.66",
03-Jan-23,Purchase,"2,778.39",00.00,"1,53,347.05",
03-Jan-23,NEFT,"2,16,500.80",00.00,"3,69,847.85",
03-Jan-23,Bill,"10,54,158.00",00.00,"14,24,005.85",
03-Jan-23,Transfer,"8,196.00",00.00,"14,32,201.85",
03-Jan-23,Commission,00.00,"2,04,600.26","12,27,601.59",
03-Jan-23,Tax,"6,92,418.00",00.00,"19,20,019.59",
03-Jan-23,NEFT,"14,06,385.25",00.00,"33,26,404.84",
03-Jan-23,Debit Card,115,00.00,"33,26,519.84",
03-Jan-23,ATM,00.00,"6,65,303.97","26,61,215.87",
03-Jan-23,RTGS,00.00,"13,30,607.94","13,30,607.94",
03-Jan-23,Debit Card,00.00,"1,33,060.79","11,97,547.15",
03-Jan-23,Debit Card,61.4,00.00,"11,97,608.55",
03-Jan-23,Interest,"11,35,537.75",00.00,"23,33,146.30",
03-Jan-23,Transportellaneous,00.00,"3,33,306.61","19,99,839.69",
03-Jan-23,Cash,00.00,"2,85,691.38","17,14,148.31",
03-Jan-23,Debit Card,303.06,00.00,"17,14,451.37",
03-Jan-23,Transportellaneous,00.00,"2,14,306.42","15,00,144.95",
03-Jan-23,Tax,00.00,"15,00,144.95",00.00,
03-Jan-23,Cash,38.73,00.00,38.73,
03-Jan-23,Bill,00.00,05.53,33.2,
03-Jan-23,Purchase,00.00,08.30,24.9,
03-Jan-23,ATM,43.64,00.00,68.54,
03-Jan-23,Bill,00.00,09.79,58.75,
03-Jan-23,Bill,360,00.00,418.75,
03-Jan-23,Interest,"3,78,474.80",00.00,"3,78,893.55",
03-Jan-23,Purchase,00.00,"54,127.65","3,24,765.90",
03-Jan-23,RTGS,00.00,"1,08,255.30","2,16,510.60",
03-Jan-23,RTGS,47,00.00,"2,16,557.60",
03-Jan-23,Transfer,00.00,"30,936.80","1,85,620.80",
03-Jan-23,Tax,00.00,"61,873.60","1,23,747.20",
03-Jan-23,Purchase,00.00,"1,23,747.20",00.00,
03-Jan-23,Debit Card,"5,060.20",00.00,"5,060.20",
03-Jan-23,Debit Card,00.00,506.02,"4,554.18",
03-Jan-23,Transfer,00.00,910.84,"3,643.34",
03-Jan-23,RTGS,00.00,"3,643.34",00.00,
03-Jan-23,Reversal,"2,28,667.00",00.00,"2,28,667.00",
03-Jan-23,ATM,00.00,"38,111.17","1,90,555.83",
03-Jan-23,Transportellaneous,00.00,"47,638.96","1,42,916.87",
03-Jan-23,Transfer,00.00,"23,819.48","1,19,097.39",
03-Jan-23,Bill,00.00,"14,887.17","1,04,210.22",
03-Jan-23,Tax,364.8,00.00,"1,04,575.02",
03-Jan-23,NEFT,54,00.00,"1,04,629.02",
03-Jan-23,Reversal,00.00,"20,925.80","83,703.22",
03-Jan-23,IMPS,00.00,"8,370.32","75,332.90",
03-Jan-23,IMPS,00.00,"37,666.45","37,666.45",
03-Jan-23,Interest,00.00,"37,666.45",00.00,
03-Jan-23,Transfer,"12,499.70",00.00,"12,499.70",
03-Jan-23,Cheque,00.00,"1,249.97","11,249.73",
03-Jan-23,NEFT,990.37,00.00,"12,240.10",
03-Jan-23,Tax,"3,429.10",00.00,"15,669.20",
03-Jan-23,Cash,00.00,"1,566.92","14,102.28",
03-Jan-23,Tax,140.33,00.00,"14,242.61",
03-Jan-23,Transportellaneous,00.00,"1,582.51","12,660.10",
03-Jan-23,Debit Card,288.39,00.00,"12,948.49",
03-Jan-23,Transportellaneous,00.00,"1,849.78","11,098.71",
03-Jan-23,Reversal,321,00.00,"11,419.71",
03-Jan-23,Cheque,"1,64,816.00",00.00,"1,76,235.71",
03-Jan-23,Reversal,"10,17,600.50",00.00,"11,93,836.21",
03-Jan-23,Transportellaneous,"18,396.40",00.00,"12,12,232.61",
03-Jan-23,Tax,00.00,"6,06,116.31","6,06,116.31",
03-Jan-23,Interest,30.57,00.00,"6,06,146.88",
03-Jan-23,RTGS,00.00,"60,614.69","5,45,532.19",
03-Jan-23,Cash,00.00,"60,614.69","4,84,917.50",
04-Jan-23,Tax,"2,10,076.62",00.00,"6,94,994.12",
04-Jan-23,RTGS,"51,801.09",00.00,"7,46,795.21",
04-Jan-23,Transportellaneous,00.00,"3,73,397.61","3,73,397.60",
04-Jan-23,Interest,"12,476.00",00.00,"3,85,873.60",
04-Jan-23,Interest,"51,030.00",00.00,"4,36,903.60",
04-Jan-23,Commission,00.00,"48,544.84","3,88,358.76",
04-Jan-23,ATM,"16,66,930.00",00.00,"20,55,288.76",
04-Jan-23,ATM,00.00,"2,28,365.42","18,26,923.34",
04-Jan-23,IMPS,"2,00,003.00",00.00,"20,26,926.34",
04-Jan-23,Cheque,"2,140.78",00.00,"20,29,067.12",
04-Jan-23,Reversal,00.00,"4,05,813.42","16,23,253.70",
04-Jan-23,NEFT,50.9,00.00,"16,23,304.60",
04-Jan-23,NEFT,00.00,"3,24,660.92","12,98,643.68",
04-Jan-23,Cash,00.00,"3,24,660.92","9,73,982.76",
04-Jan-23,ATM,385.28,00.00,"9,74,368.04",
04-Jan-23,IMPS,00.00,"1,39,195.43","8,35,172.61",
04-Jan-23,Transportellaneous,04.00,00.00,"8,35,176.61",
04-Jan-23,Interest,00.00,"1,67,035.32","6,68,141.29",
04-Jan-23,Debit Card,93.28,00.00,"6,68,234.57",
04-Jan-23,Debit Card,"1,807.00",00.00,"6,70,041.57",
04-Jan-23,Transfer,62.6,00.00,"6,70,104.17",
04-Jan-23,Transfer,00.00,"2,23,368.06","4,46,736.11",
04-Jan-23,RTGS,21.19,00.00,"4,46,757.30",
04-Jan-23,ATM,25,00.00,"4,46,782.30",
04-Jan-23,Commission,00.00,"89,356.46","3,57,425.84",
04-Jan-23,Tax,00.00,"35,742.58","3,21,683.26",
04-Jan-23,Cash,04.00,00.00,"3,21,687.26",
04-Jan-23,IMPS,00.00,"1,07,229.09","2,14,458.17",
04-Jan-23,Transportellaneous,00.00,"71,486.06","1,42,972.11",
04-Jan-23,IMPS,"5,97,357.80",00.00,"7,40,329.91",
04-Jan-23,NEFT,"8,552.80",00.00,"7,48,882.71",
04-Jan-23,IMPS,05.50,00.00,"7,48,888.21",
04-Jan-23,Bill,00.00,"7,48,888.21",00.00,
04-Jan-23,ATM,04.20,00.00,04.20,
04-Jan-23,Tax,403.04,00.00,407.24,
04-Jan-23,Debit Card,115.5,00.00,522.74,
04-Jan-23,NEFT,00.00,52.27,470.47,
04-Jan-23,Purchase,230.6,00.00,701.07,
04-Jan-23,ATM,00.00,116.85,584.22,
04-Jan-23,Bill,"1,139.00",00.00,"1,723.22",
04-Jan-23,Debit Card,50,00.00,"1,773.22",
04-Jan-23,Cheque,00.00,253.32,"1,519.90",
04-Jan-23,Transfer,"1,56,816.60",00.00,"1,58,336.50",
04-Jan-23,Reversal,00.00,"17,592.94","1,40,743.56",
04-Jan-23,Purchase,"20,77,182.00",00.00,"22,17,925.56",
04-Jan-23,Interest,00.00,"2,21,792.56","19,96,133.00",
04-Jan-23,Cheque,"90,939.94",00.00,"20,87,072.94",
04-Jan-23,Cheque,00.00,"10,43,536.47","10,43,536.47",
04-Jan-23,Purchase,"4,694.64",00.00,"10,48,231.11",
04-Jan-23,Transfer,00.00,"10,48,231.11",00.00,
04-Jan-23,Reversal,51.55,00.00,51.55,
04-Jan-23,IMPS,"17,35,394.25",00.00,"17,35,445.80",
04-Jan-23,Cash,"16,603.80",00.00,"17,52,049.60",
04-Jan-23,RTGS,00.00,"8,76,024.80","8,76,024.80",
04-Jan-23,Reversal,00.00,"2,92,008.27","5,84,016.53",
04-Jan-23,Transfer,"20,657.10",00.00,"6,04,673.63",
04-Jan-23,Debit Card,07.90,00.00,"6,04,681.53",
04-Jan-23,NEFT,00.00,"6,04,681.53",00.00,
04-Jan-23,Transportellaneous,"2,108.00",00.00,"2,108.00",
04-Jan-23,RTGS,"2,44,617.00",00.00,"2,46,725.00",
04-Jan-23,Reversal,00.00,"24,672.50","2,22,052.50",
04-Jan-23,Bill,06.80,00.00,"2,22,059.30",
04-Jan-23,Reversal,00.00,"24,673.26","1,97,386.04",
04-Jan-23,Transfer,00.00,"98,693.02","98,693.02",
04-Jan-23,Purchase,42.54,00.00,"98,735.56",
04-Jan-23,ATM,"23,099.90",00.00,"1,21,835.46",
04-Jan-23,Cheque,"21,216.80",00.00,"1,43,052.26",
04-Jan-23,Cash,175,00.00,"1,43,227.26",
04-Jan-23,ATM,"19,71,296.00",00.00,"21,14,523.26",
04-Jan-23,Transfer,00.00,"2,11,452.33","19,03,070.93",
04-Jan-23,Interest,00.00,"6,34,356.98","12,68,713.95",
04-Jan-23,Transfer,00.00,"2,11,452.33","10,57,261.62",
04-Jan-23,Tax,00.00,"2,11,452.32","8,45,809.30",
04-Jan-23,RTGS,48,00.00,"8,45,857.30",
04-Jan-23,Purchase,00.00,"4,22,928.65","4,22,928.65",
04-Jan-23,Bill,00.00,"84,585.73","3,38,342.92",
04-Jan-23,Reversal,227,00.00,"3,38,569.92",
04-Jan-23,Transfer,00.00,"48,367.13","2,90,202.79",
04-Jan-23,Debit Card,00.00,"41,457.54","2,48,745.25",
04-Jan-23,Transportellaneous,49.2,00.00,"2,48,794.45",
04-Jan-23,Bill,"31,542.00",00.00,"2,80,336.45",
04-Jan-23,Reversal,00.00,"28,033.65","2,52,302.81",
04-Jan-23,Bill,"14,980.79",00.00,"2,67,283.60",
04-Jan-23,Commission,"3,519.74",00.00,"2,70,803.34",
04-Jan-23,Bill,39.09,00.00,"2,70,842.43",
04-Jan-23,Debit Card,"13,194.00",00.00,"2,84,036.43",
04-Jan-23,Debit Card,"15,355.00",00.00,"2,99,391.43",
04-Jan-23,Debit Card,00.00,"1,49,695.72","1,49,695.72",
04-Jan-23,Bill,00.00,"14,969.57","1,34,726.15",
04-Jan-23,Tax,00.00,"26,945.23","1,07,780.92",
04-Jan-23,Debit Card,01.82,00.00,"1,07,782.74",
04-Jan-23,Transfer,00.00,"21,556.55","86,226.19",
04-Jan-23,IMPS,06.89,00.00,"86,233.08",
04-Jan-23,Debit Card,00.00,"8,623.31","77,609.77",
04-Jan-23,Cheque,"1,32,764.00",00.00,"2,10,373.77",
04-Jan-23,NEFT,"1,50,147.25",00.00,"3,60,521.02",
04-Jan-23,Cash,"7,98,829.00",00.00,"11,59,350.02",
04-Jan-23,Debit Card,00.00,"2,31,870.00","9,27,480.02",
04-Jan-23,Reversal,"2,03,948.00",00.00,"11,31,428.02",
05-Jan-23,NEFT,00.00,"2,26,285.60","9,05,142.42",
05-Jan-23,Cash,00.00,"1,00,571.38","8,04,571.04",
05-Jan-23,Cheque,527.57,00.00,"8,05,098.61",
05-Jan-23,RTGS,00.00,"1,00,637.33","7,04,461.28",
05-Jan-23,Cheque,00.00,"1,40,892.26","5,63,569.02",
05-Jan-23,Interest,332.23,00.00,"5,63,901.25",
05-Jan-23,Transfer,343,00.00,"5,64,244.25",
05-Jan-23,Cheque,364.8,00.00,"5,64,609.05",
05-Jan-23,Debit Card,"6,404.69",00.00,"5,71,013.74",
05-Jan-23,Debit Card,00.00,"95,168.96","4,75,844.78",
05-Jan-23,Cheque,00.00,"1,58,614.93","3,17,229.85",
05-Jan-23,Cheque,00.00,"79,307.46","2,37,922.39",
06-Jan-23,Interest,00.00,"1,18,961.20","1,18,961.20",
06-Jan-23,Reversal,"8,629.39",00.00,"1,27,590.59",
07-Jan-23,Cheque,53.04,00.00,"1,27,643.63",
07-Jan-23,Debit Card,00.00,"14,182.63","1,13,461.00",
07-Jan-23,IMPS,"75,138.28",00.00,"1,88,599.28",
07-Jan-23,Cash,00.00,"1,88,599.28",00.00,
07-Jan-23,Commission,"1,87,574.00",00.00,"1,87,574.00",
07-Jan-23,Transfer,"17,73,094.00",00.00,"19,60,668.00",
07-Jan-23,Cash,04.60,00.00,"19,60,672.60",
07-Jan-23,Transfer,01.10,00.00,"19,60,673.70",
07-Jan-23,Purchase,02.00,00.00,"19,60,675.70",
07-Jan-23,Interest,00.00,"3,92,135.14","15,68,540.56",
07-Jan-23,Interest,05.10,00.00,"15,68,545.66",
07-Jan-23,Cheque,00.00,"1,74,282.85","13,94,262.81",
07-Jan-23,Reversal,966.4,00.00,"13,95,229.21",
07-Jan-23,Purchase,62,00.00,"13,95,291.21",
07-Jan-23,Commission,"40,131.41",00.00,"14,35,422.62",
07-Jan-23,Commission,00.00,"1,43,542.26","12,91,880.36",
07-Jan-23,Commission,"12,72,616.75",00.00,"25,64,497.11",
07-Jan-23,Commission,"13,17,814.50",00.00,"38,82,311.61",
07-Jan-23,Purchase,00.00,"9,70,577.90","29,11,733.71",
07-Jan-23,RTGS,00.00,"5,82,346.74","23,29,386.97",
07-Jan-23,Cash,"15,86,747.75",00.00,"39,16,134.72",
07-Jan-23,Debit Card,"14,45,073.50",00.00,"53,61,208.22",
07-Jan-23,Tax,00.00,"7,65,886.89","45,95,321.33",
07-Jan-23,Debit Card,00.00,"11,48,830.33","34,46,491.00",
07-Jan-23,Cash,07.95,00.00,"34,46,498.95",
07-Jan-23,RTGS,00.00,"17,23,249.48","17,23,249.48",
07-Jan-23,NEFT,"3,733.88",00.00,"17,26,983.36",
07-Jan-23,Transfer,00.00,"17,26,983.36",00.00,
07-Jan-23,Bill,31,00.00,31,
08-Jan-23,Interest,"62,268.90",00.00,"62,299.90",
08-Jan-23,Debit Card,"2,50,599.20",00.00,"3,12,899.10",
08-Jan-23,Cheque,"26,069.00",00.00,"3,38,968.10",
08-Jan-23,IMPS,00.00,"67,793.62","2,71,174.48",
08-Jan-23,ATM,"27,703.50",00.00,"2,98,877.98",
08-Jan-23,Purchase,"2,25,301.30",00.00,"5,24,179.28",
08-Jan-23,RTGS,00.00,"87,363.21","4,36,816.07",
08-Jan-23,Cheque,"27,715.10",00.00,"4,64,531.17",
08-Jan-23,ATM,00.00,"4,64,531.17",00.00,
08-Jan-23,Purchase,"3,200.50",00.00,"3,200.50",
08-Jan-23,Transfer,151.7,00.00,"3,352.20",
08-Jan-23,Interest,00.00,558.7,"2,793.50",
08-Jan-23,Bill,00.00,310.39,"2,483.11",
08-Jan-23,Cash,00.91,00.00,"2,484.02",
08-Jan-23,Commission,258.4,00.00,"2,742.42",
08-Jan-23,RTGS,36.01,00.00,"2,778.43",
08-Jan-23,Transfer,00.00,277.84,"2,500.59",
08-Jan-23,IMPS,00.00,"1,250.30","1,250.30",
08-Jan-23,Purchase,00.00,625.15,625.15,
08-Jan-23,Reversal,53,00.00,678.15,
08-Jan-23,Bill,00.00,169.54,508.61,
08-Jan-23,Transportellaneous,00.00,56.51,452.1,
08-Jan-23,NEFT,36,00.00,488.1,
08-Jan-23,Commission,00.00,81.35,406.75,
08-Jan-23,Bill,464,00.00,870.75,
08-Jan-23,RTGS,10.8,00.00,881.55,
08-Jan-23,Purchase,192,00.00,"1,073.55",
08-Jan-23,Purchase,00.00,119.28,954.27,
08-Jan-23,RTGS,"49,853.00",00.00,"50,807.27",
08-Jan-23,Tax,"88,011.53",00.00,"1,38,818.80",
08-Jan-23,NEFT,"13,14,142.00",00.00,"14,52,960.80",
08-Jan-23,Cash,"22,891.20",00.00,"14,75,852.00",
08-Jan-23,Interest,00.00,"14,75,852.00",00.00,
08-Jan-23,Transfer,190.7,00.00,190.7,
08-Jan-23,Cheque,00.00,47.68,143.02,
08-Jan-23,RTGS,"15,205.00",00.00,"15,348.02",
08-Jan-23,RTGS,00.00,"15,348.02",00.00,
08-Jan-23,IMPS,02.62,00.00,02.62,
08-Jan-23,Bill,06.99,00.00,09.61,
08-Jan-23,Interest,"11,39,679.75",00.00,"11,39,689.36",
08-Jan-23,Purchase,494.3,00.00,"11,40,183.66",
08-Jan-23,ATM,"10,00,101.25",00.00,"21,40,284.91",
08-Jan-23,RTGS,"15,21,983.00",00.00,"36,62,267.91",
08-Jan-23,Transportellaneous,05.60,00.00,"36,62,273.51",
08-Jan-23,Cash,"5,348.30",00.00,"36,67,621.81",
09-Jan-23,Interest,00.00,"5,23,945.97","31,43,675.84",
09-Jan-23,NEFT,00.00,"3,92,959.48","27,50,716.36",
10-Jan-23,Bill,"2,639.45",00.00,"27,53,355.81",
10-Jan-23,NEFT,02.60,00.00,"27,53,358.41",
10-Jan-23,Interest,"3,466.60",00.00,"27,56,825.01",
10-Jan-23,Cash,00.00,"3,93,832.14","23,62,992.87",
10-Jan-23,ATM,"2,36,779.10",00.00,"25,99,771.97",
10-Jan-23,Cheque,404,00.00,"26,00,175.97",
10-Jan-23,ATM,"16,618.00",00.00,"26,16,793.97",
10-Jan-23,RTGS,00.00,"2,90,754.89","23,26,039.08",
10-Jan-23,Transfer,"1,390.20",00.00,"23,27,429.28",
10-Jan-23,RTGS,00.00,"11,63,714.64","11,63,714.64",
10-Jan-23,NEFT,00.00,"3,87,904.88","7,75,809.76",
10-Jan-23,Tax,220,00.00,"7,76,029.76",
10-Jan-23,Transfer,00.00,"1,10,861.39","6,65,168.37",
10-Jan-23,Interest,"11,85,340.50",00.00,"18,50,508.87",
10-Jan-23,ATM,14,00.00,"18,50,522.87",
10-Jan-23,Tax,00.00,"9,25,261.44","9,25,261.44",
10-Jan-23,ATM,"27,121.80",00.00,"9,52,383.24",
10-Jan-23,Transfer,00.00,"1,58,730.54","7,93,652.70",
10-Jan-23,Cheque,346.63,00.00,"7,93,999.33",
11-Jan-23,RTGS,283.8,00.00,"7,94,283.13",
11-Jan-23,ATM,380,00.00,"7,94,663.13",
11-Jan-23,Commission,00.00,"1,98,665.78","5,95,997.35",
11-Jan-23,IMPS,"1,809.00",00.00,"5,97,806.35",
11-Jan-23,Bill,00.00,"74,725.79","5,23,080.56",
11-Jan-23,Tax,285.9,00.00,"5,23,366.46",
11-Jan-23,Interest,00.00,"1,74,455.49","3,48,910.97",
11-Jan-23,NEFT,"1,07,911.66",00.00,"4,56,822.63",
11-Jan-23,Cheque,00.00,"50,758.07","4,06,064.56",
11-Jan-23,Reversal,"1,139.58",00.00,"4,07,204.14",
11-Jan-23,Reversal,01.90,00.00,"4,07,206.04",
11-Jan-23,Purchase,"1,36,512.20",00.00,"5,43,718.24",
11-Jan-23,ATM,00.00,"2,71,859.12","2,71,859.12",
11-Jan-23,ATM,"4,84,349.75",00.00,"7,56,208.87",
11-Jan-23,Debit Card,00.00,"94,526.11","6,61,682.76",
11-Jan-23,Bill,"2,51,164.41",00.00,"9,12,847.17",
11-Jan-23,Cheque,02.00,00.00,"9,12,849.17",
11-Jan-23,RTGS,00.00,"1,52,141.53","7,60,707.64",
11-Jan-23,Transportellaneous,"12,57,150.50",00.00,"20,17,858.14",
11-Jan-23,Debit Card,01.80,00.00,"20,17,859.94",
11-Jan-23,Reversal,00.00,"20,17,859.94",00.00,
11-Jan-23,Interest,06.00,00.00,06.00,
11-Jan-23,Tax,00.00,06.00,00.00,
11-Jan-23,Commission,00.63,00.00,00.63,
11-Jan-23,Cash,18,00.00,18.63,
11-Jan-23,Bill,104.9,00.00,123.53,
11-Jan-23,Debit Card,00.25,00.00,123.78,
11-Jan-23,RTGS,00.00,30.95,92.84,
11-Jan-23,Reversal,"8,876.00",00.00,"8,968.84",
11-Jan-23,Tax,00.00,"1,793.77","7,175.07",
11-Jan-23,Debit Card,"11,30,991.50",00.00,"11,38,166.57",
11-Jan-23,Transfer,00.00,"1,42,270.82","9,95,895.75",
11-Jan-23,Cheque,"9,202.89",00.00,"10,05,098.64",
11-Jan-23,ATM,00.00,"1,00,509.86","9,04,588.78",
11-Jan-23,Reversal,00.00,"2,26,147.20","6,78,441.58",
11-Jan-23,IMPS,00.00,"67,844.16","6,10,597.42",
11-Jan-23,Cheque,00.00,"6,10,597.42",00.00,
11-Jan-23,RTGS,"13,44,015.80",00.00,"13,44,015.80",
11-Jan-23,Purchase,37,00.00,"13,44,052.80",
11-Jan-23,Cash,00.00,"3,36,013.20","10,08,039.60",
11-Jan-23,Purchase,"2,30,639.00",00.00,"12,38,678.60",
11-Jan-23,IMPS,00.00,"12,38,678.60",00.00,
11-Jan-23,Commission,400.61,00.00,400.61,
11-Jan-23,Purchase,00.00,400.61,00.00,
11-Jan-23,RTGS,"22,605.91",00.00,"22,605.91",
11-Jan-23,Commission,04.63,00.00,"22,610.54",
11-Jan-23,NEFT,07.00,00.00,"22,617.54",
11-Jan-23,Interest,126.3,00.00,"22,743.84",
12-Jan-23,IMPS,00.00,"2,527.09","20,216.75",
12-Jan-23,RTGS,38,00.00,"20,254.75",
12-Jan-23,Transportellaneous,"1,47,618.80",00.00,"1,67,873.55",
12-Jan-23,Cash,00.00,"20,984.19","1,46,889.36",
12-Jan-23,Debit Card,00.00,"14,688.94","1,32,200.42",
12-Jan-23,Commission,00.00,"18,885.77","1,13,314.65",
12-Jan-23,Commission,00.00,"18,885.78","94,428.88",
12-Jan-23,Commission,142.4,00.00,"94,571.28",
12-Jan-23,Cash,00.00,"13,510.18","81,061.10",
12-Jan-23,Debit Card,02.00,00.00,"81,063.10",
12-Jan-23,IMPS,00.00,"20,265.78","60,797.32",
12-Jan-23,IMPS,"11,673.00",00.00,"72,470.32",
12-Jan-23,Interest,00.00,"9,058.79","63,411.53",
12-Jan-23,Tax,00.00,"9,058.79","54,352.74",
12-Jan-23,Transportellaneous,43,00.00,"54,395.74",
12-Jan-23,Purchase,00.00,"10,879.15","43,516.59",
12-Jan-23,Interest,00.00,"14,505.53","29,011.06",
12-Jan-23,IMPS,"3,970.00",00.00,"32,981.06",
12-Jan-23,RTGS,00.00,"3,298.11","29,682.95",
12-Jan-23,Cheque,"1,58,817.00",00.00,"1,88,499.95",
12-Jan-23,Transportellaneous,20.1,00.00,"1,88,520.05",
12-Jan-23,Transportellaneous,04.30,00.00,"1,88,524.35",
12-Jan-23,Tax,00.00,"20,947.15","1,67,577.20",
12-Jan-23,RTGS,511,00.00,"1,68,088.20",
12-Jan-23,Interest,02.00,00.00,"1,68,090.20",
12-Jan-23,Debit Card,"1,74,059.34",00.00,"3,42,149.54",
12-Jan-23,Transportellaneous,34.61,00.00,"3,42,184.15",
12-Jan-23,Purchase,00.00,"85,546.04","2,56,638.11",
12-Jan-23,Tax,07.50,00.00,"2,56,645.61",
12-Jan-23,IMPS,58.8,00.00,"2,56,704.41",
12-Jan-23,Cash,05.40,00.00,"2,56,709.81",
12-Jan-23,Transfer,00.00,"51,341.96","2,05,367.85",
12-Jan-23,Transfer,00.00,"20,536.79","1,84,831.06",
12-Jan-23,Reversal,"2,918.81",00.00,"1,87,749.87",
12-Jan-23,Commission,"14,093.70",00.00,"2,01,843.57",
12-Jan-23,Reversal,"1,89,323.00",00.00,"3,91,166.57",
12-Jan-23,ATM,00.00,"97,791.64","2,93,374.93",
12-Jan-23,Transportellaneous,400.11,00.00,"2,93,775.04",
12-Jan-23,Tax,00.00,"97,925.01","1,95,850.03",
12-Jan-23,Transfer,"19,405.00",00.00,"2,15,255.03",
12-Jan-23,Cash,00.00,"53,813.76","1,61,441.27",
12-Jan-23,IMPS,352.9,00.00,"1,61,794.17",
12-Jan-23,Cheque,15,00.00,"1,61,809.17",
12-Jan-23,Purchase,07.19,00.00,"1,61,816.36",
12-Jan-23,Transfer,00.00,"32,363.27","1,29,453.09",
12-Jan-23,Transportellaneous,"1,343.86",00.00,"1,30,796.95",
12-Jan-23,Debit Card,48,00.00,"1,30,844.95",
12-Jan-23,Bill,00.00,"26,168.99","1,04,675.96",
12-Jan-23,Transfer,00.00,"52,337.98","52,337.98",
12-Jan-23,NEFT,"1,713.00",00.00,"54,050.98",
12-Jan-23,NEFT,"3,324.80",00.00,"57,375.78",
12-Jan-23,IMPS,00.00,"28,687.89","28,687.89",
12-Jan-23,Commission,"1,16,662.50",00.00,"1,45,350.39",
12-Jan-23,Reversal,00.00,"1,45,350.39",00.00,
12-Jan-23,Transportellaneous,"21,960.84",00.00,"21,960.84",
12-Jan-23,Cheque,00.00,"10,980.42","10,980.42",
13-Jan-23,NEFT,00.00,"5,490.21","5,490.21",
13-Jan-23,Reversal,62.31,00.00,"5,552.52",
13-Jan-23,Cheque,"1,085.00",00.00,"6,637.52",
13-Jan-23,Debit Card,00.00,829.69,"5,807.83",
14-Jan-23,Bill,"2,909.00",00.00,"8,716.83",
14-Jan-23,RTGS,"17,037.00",00.00,"25,753.83",
14-Jan-23,Cash,"3,039.00",00.00,"28,792.83",
14-Jan-23,Transportellaneous,23,00.00,"28,815.83",
14-Jan-23,Tax,00.00,"7,203.96","21,611.87",
14-Jan-23,Purchase,05.00,00.00,"21,616.87",
14-Jan-23,NEFT,00.00,"2,161.69","19,455.18",
14-Jan-23,Debit Card,00.00,"19,455.18",00.00,
14-Jan-23,Bill,476,00.00,476,
14-Jan-23,Reversal,"2,13,273.47",00.00,"2,13,749.47",
14-Jan-23,Transfer,"19,76,546.00",00.00,"21,90,295.47",
14-Jan-23,ATM,00.00,"2,73,786.93","19,16,508.54",
14-Jan-23,Debit Card,00.00,"19,16,508.54",00.00,
14-Jan-23,Reversal,"2,32,062.80",00.00,"2,32,062.80",
14-Jan-23,ATM,"1,24,147.60",00.00,"3,56,210.40",
14-Jan-23,Commission,00.00,"89,052.60","2,67,157.80",
14-Jan-23,IMPS,00.00,"2,67,157.80",00.00,
14-Jan-23,Debit Card,01.00,00.00,01.00,
14-Jan-23,Purchase,00.00,00.17,00.83,
14-Jan-23,Interest,"8,66,423.20",00.00,"8,66,424.03",
14-Jan-23,Commission,06.80,00.00,"8,66,430.83",
14-Jan-23,Commission,"23,800.60",00.00,"8,90,231.43",
14-Jan-23,Debit Card,00.00,"1,27,175.92","7,63,055.51",
14-Jan-23,Reversal,00.00,"1,90,763.88","5,72,291.63",
14-Jan-23,RTGS,00.00,"2,86,145.82","2,86,145.82",
14-Jan-23,Transportellaneous,00.00,"35,768.23","2,50,377.59",
14-Jan-23,Cheque,00.00,"25,037.76","2,25,339.83",
14-Jan-23,Transfer,00.00,"37,556.64","1,87,783.19",
14-Jan-23,Transportellaneous,00.00,"37,556.64","1,50,226.55",
14-Jan-23,Cash,00.00,"21,460.94","1,28,765.61",
14-Jan-23,Reversal,"1,84,793.00",00.00,"3,13,558.61",
14-Jan-23,ATM,494,00.00,"3,14,052.61",
14-Jan-23,Cheque,00.00,"39,256.58","2,74,796.03",
14-Jan-23,Transfer,00.00,"39,256.58","2,35,539.45",
14-Jan-23,Reversal,55.75,00.00,"2,35,595.20",
14-Jan-23,RTGS,05.00,00.00,"2,35,600.20",
14-Jan-23,ATM,00.00,"23,560.02","2,12,040.18",
15-Jan-23,Debit Card,00.00,"70,680.06","1,41,360.12",
15-Jan-23,ATM,00.00,"15,706.68","1,25,653.44",
15-Jan-23,Cheque,00.00,"31,413.36","94,240.08",
15-Jan-23,NEFT,00.00,"18,848.02","75,392.06",
15-Jan-23,IMPS,00.00,"12,565.34","62,826.72",
15-Jan-23,Purchase,00.00,"15,706.68","47,120.04",
15-Jan-23,Cheque,00.00,"7,853.34","39,266.70",
15-Jan-23,RTGS,00.00,"5,609.53","33,657.17",
15-Jan-23,Bill,"10,426.36",00.00,"44,083.53",
15-Jan-23,IMPS,00.00,"4,898.17","39,185.36",
15-Jan-23,Transportellaneous,00.00,"4,898.17","34,287.19",
15-Jan-23,Purchase,00.00,"11,429.06","22,858.13",
15-Jan-23,Debit Card,00.00,"2,857.27","20,000.86",
15-Jan-23,Reversal,00.00,"2,857.27","17,143.59",
15-Jan-23,Commission,00.00,"5,714.53","11,429.06",
15-Jan-23,Commission,06.00,00.00,"11,435.06",
15-Jan-23,Tax,05.90,00.00,"11,440.96",
15-Jan-23,Interest,177.4,00.00,"11,618.36",
15-Jan-23,Cash,00.00,"1,161.84","10,456.52",
16-Jan-23,Interest,"3,80,772.00",00.00,"3,91,228.52",
16-Jan-23,Transfer,"21,113.75",00.00,"4,12,342.27",
16-Jan-23,Commission,"8,355.60",00.00,"4,20,697.87",
16-Jan-23,Transfer,00.00,"42,069.79","3,78,628.08",
16-Jan-23,Bill,463.77,00.00,"3,79,091.85",
16-Jan-23,RTGS,"2,360.00",00.00,"3,81,451.85",
16-Jan-23,Cheque,"12,80,800.00",00.00,"16,62,251.85",
16-Jan-23,RTGS,00.00,"2,07,781.48","14,54,470.37",
16-Jan-23,Interest,00.00,"1,81,808.80","12,72,661.57",
16-Jan-23,Bill,"32,341.84",00.00,"13,05,003.41",
16-Jan-23,Interest,00.00,"1,45,000.38","11,60,003.03",
16-Jan-23,IMPS,10.77,00.00,"11,60,013.80",
16-Jan-23,Cash,00.00,"2,90,003.45","8,70,010.35",
16-Jan-23,RTGS,"5,232.00",00.00,"8,75,242.35",
16-Jan-23,ATM,00.00,"87,524.24","7,87,718.12",
16-Jan-23,Cash,190.38,00.00,"7,87,908.50",
16-Jan-23,Commission,"1,77,818.00",00.00,"9,65,726.50",
16-Jan-23,Cheque,"2,887.00",00.00,"9,68,613.50",
16-Jan-23,Debit Card,00.00,"2,42,153.38","7,26,460.12",
16-Jan-23,RTGS,"1,88,800.16",00.00,"9,15,260.28",
17-Jan-23,Cheque,00.00,"1,30,751.47","7,84,508.81",
17-Jan-23,ATM,00.00,00.00,"7,84,508.81",
17-Jan-23,IMPS,00.00,"78,450.88","7,06,057.93",
17-Jan-23,Purchase,"33,808.53",00.00,"7,39,866.46",
17-Jan-23,Cash,50.6,00.00,"7,39,917.06",
17-Jan-23,Bill,00.00,"73,991.71","6,65,925.35",
18-Jan-23,Commission,"17,556.90",00.00,"6,83,482.25",
18-Jan-23,Purchase,00.00,"1,13,913.71","5,69,568.54",
18-Jan-23,Commission,"8,07,921.00",00.00,"13,77,489.54",
18-Jan-23,Bill,00.90,00.00,"13,77,490.44",
18-Jan-23,Reversal,"17,410.54",00.00,"13,94,900.98",
18-Jan-23,Tax,00.00,"1,99,271.57","11,95,629.41",
18-Jan-23,NEFT,02.30,00.00,"11,95,631.71",
18-Jan-23,Tax,20.07,00.00,"11,95,651.78",
18-Jan-23,Reversal,00.00,"2,39,130.36","9,56,521.42",
18-Jan-23,Transportellaneous,182.9,00.00,"9,56,704.32",
18-Jan-23,Commission,00.00,"3,18,901.44","6,37,802.88",
18-Jan-23,Commission,"96,759.00",00.00,"7,34,561.88",
18-Jan-23,Purchase,00.00,"91,820.24","6,42,741.64",
18-Jan-23,Tax,00.00,"64,274.16","5,78,467.48",
18-Jan-23,Cash,05.00,00.00,"5,78,472.48",
18-Jan-23,Debit Card,00.00,"1,44,618.12","4,33,854.36",
18-Jan-23,Purchase,"80,714.44",00.00,"5,14,568.80",
18-Jan-23,Debit Card,302.4,00.00,"5,14,871.20",
18-Jan-23,Reversal,00.00,"1,28,717.80","3,86,153.40",
18-Jan-23,ATM,"3,61,984.80",00.00,"7,48,138.20",
18-Jan-23,Debit Card,00.00,"74,813.82","6,73,324.38",
18-Jan-23,Commission,00.00,"67,332.44","6,05,991.94",
18-Jan-23,Cheque,00.00,"1,51,497.99","4,54,493.95",
19-Jan-23,Reversal,00.00,"4,54,493.95",00.00,
19-Jan-23,Cash,"2,169.50",00.00,"2,169.50",
19-Jan-23,Cheque,507.6,00.00,"2,677.10",
19-Jan-23,Tax,00.00,"2,677.10",00.00,
19-Jan-23,RTGS,00.70,00.00,00.70,
19-Jan-23,Transportellaneous,00.00,00.09,00.61,
19-Jan-23,Purchase,00.00,00.20,00.41,
19-Jan-23,Tax,"1,33,252.00",00.00,"1,33,252.41",
19-Jan-23,NEFT,00.00,"19,036.06","1,14,216.35",
19-Jan-23,ATM,00.00,"28,554.09","85,662.26",
19-Jan-23,Interest,"8,477.00",00.00,"94,139.26",
19-Jan-23,RTGS,"15,73,833.00",00.00,"16,67,972.26",
19-Jan-23,Cash,00.00,"1,66,797.23","15,01,175.03",
19-Jan-23,NEFT,"2,60,703.30",00.00,"17,61,878.33",
19-Jan-23,RTGS,00.00,"4,40,469.58","13,21,408.75",
19-Jan-23,Transportellaneous,"7,172.30",00.00,"13,28,581.05",
19-Jan-23,Commission,281.8,00.00,"13,28,862.85",
20-Jan-23,Cheque,02.62,00.00,"13,28,865.47",
20-Jan-23,Cash,"2,679.70",00.00,"13,31,545.17",
20-Jan-23,RTGS,00.00,"3,32,886.29","9,98,658.88",
20-Jan-23,ATM,"3,372.00",00.00,"10,02,030.88",
20-Jan-23,Transportellaneous,00.00,"1,11,336.76","8,90,694.12",
20-Jan-23,Bill,00.00,"4,45,347.06","4,45,347.06",
20-Jan-23,Reversal,00.00,"44,534.71","4,00,812.35",
20-Jan-23,ATM,00.00,"80,162.47","3,20,649.88",
20-Jan-23,ATM,00.00,"1,60,324.94","1,60,324.94",
20-Jan-23,Commission,00.00,"22,903.56","1,37,421.38",
21-Jan-23,Cash,00.00,"17,177.67","1,20,243.71",
21-Jan-23,ATM,00.00,"1,20,243.71",00.00,
21-Jan-23,Tax,"11,84,550.00",00.00,"11,84,550.00",
21-Jan-23,Debit Card,00.00,"1,31,616.67","10,52,933.33",
21-Jan-23,Interest,00.00,"3,50,977.78","7,01,955.55",
21-Jan-23,Purchase,00.00,"1,75,488.89","5,26,466.66",
21-Jan-23,ATM,"15,08,929.50",00.00,"20,35,396.16",
21-Jan-23,Bill,"4,156.77",00.00,"20,39,552.93",
21-Jan-23,Cheque,"1,833.96",00.00,"20,41,386.89",
21-Jan-23,Cheque,645,00.00,"20,42,031.89",
21-Jan-23,Commission,06.70,00.00,"20,42,038.59",
21-Jan-23,Purchase,00.00,"2,55,254.82","17,86,783.77",
21-Jan-23,Transfer,01.00,00.00,"17,86,784.77",
21-Jan-23,Transportellaneous,00.00,"3,57,356.95","14,29,427.82",
21-Jan-23,Commission,00.00,"3,57,356.96","10,72,070.86",
21-Jan-23,Transfer,"20,49,751.00",00.00,"31,21,821.86",
21-Jan-23,Bill,00.00,"3,46,869.10","27,74,952.76",
21-Jan-23,Interest,09.00,00.00,"27,74,961.76",
21-Jan-23,Tax,"1,27,402.30",00.00,"29,02,364.06",
21-Jan-23,RTGS,"2,419.30",00.00,"29,04,783.36",
21-Jan-23,IMPS,371.37,00.00,"29,05,154.73",
21-Jan-23,Cheque,00.00,"14,52,577.37","14,52,577.36",
21-Jan-23,Cheque,"1,43,581.70",00.00,"15,96,159.06",
21-Jan-23,NEFT,00.00,"2,66,026.51","13,30,132.55",
21-Jan-23,IMPS,00.00,"1,66,266.57","11,63,865.98",
21-Jan-23,NEFT,00.00,"1,66,266.57","9,97,599.41",
21-Jan-23,Transfer,"13,06,664.50",00.00,"23,04,263.91",
21-Jan-23,Transportellaneous,00.00,"11,52,131.96","11,52,131.96",
21-Jan-23,Commission,00.00,"2,30,426.39","9,21,705.57",
21-Jan-23,Tax,00.79,00.00,"9,21,706.36",
21-Jan-23,Cash,"4,027.00",00.00,"9,25,733.36",
21-Jan-23,Transportellaneous,00.00,"3,08,577.79","6,17,155.57",
21-Jan-23,Reversal,00.00,"2,05,718.52","4,11,437.05",
21-Jan-23,Debit Card,253.1,00.00,"4,11,690.15",
21-Jan-23,Tax,00.00,"58,812.88","3,52,877.27",
21-Jan-23,Cheque,45.19,00.00,"3,52,922.46",
21-Jan-23,Bill,"1,12,472.00",00.00,"4,65,394.46",
21-Jan-23,Tax,"7,54,755.80",00.00,"12,20,150.26",
21-Jan-23,ATM,00.00,"1,74,307.18","10,45,843.08",
21-Jan-23,Transportellaneous,00.00,"1,16,204.79","9,29,638.29",
21-Jan-23,Transfer,41.45,00.00,"9,29,679.74",
21-Jan-23,Reversal,00.00,"9,29,679.74",00.00,
21-Jan-23,Commission,"57,684.50",00.00,"57,684.50",
21-Jan-23,Cash,00.00,"9,614.08","48,070.42",
21-Jan-23,ATM,"93,242.00",00.00,"1,41,312.42",
21-Jan-23,Cash,00.00,"1,41,312.42",00.00,
21-Jan-23,NEFT,"3,270.30",00.00,"3,270.30",
21-Jan-23,NEFT,"2,039.20",00.00,"5,309.50",
21-Jan-23,Transfer,00.00,"1,061.90","4,247.60",
21-Jan-23,RTGS,04.00,00.00,"4,251.60",
21-Jan-23,Reversal,"15,85,066.00",00.00,"15,89,317.60",
21-Jan-23,Purchase,00.00,"5,29,772.53","10,59,545.07",
21-Jan-23,IMPS,04.00,00.00,"10,59,549.07",
21-Jan-23,IMPS,00.00,"1,32,443.63","9,27,105.44",
21-Jan-23,Interest,07.12,00.00,"9,27,112.56",
21-Jan-23,ATM,"7,15,413.20",00.00,"16,42,525.76",
21-Jan-23,Cheque,00.00,"3,28,505.15","13,14,020.61",
22-Jan-23,Transportellaneous,366,00.00,"13,14,386.61",
22-Jan-23,Purchase,"18,70,976.00",00.00,"31,85,362.61",
22-Jan-23,RTGS,00.00,"3,53,929.18","28,31,433.43",
22-Jan-23,Transfer,04.83,00.00,"28,31,438.26",
22-Jan-23,NEFT,"2,56,827.00",00.00,"30,88,265.26",
22-Jan-23,Reversal,05.30,00.00,"30,88,270.56",
22-Jan-23,Cash,00.00,"3,08,827.06","27,79,443.50",
22-Jan-23,Reversal,322,00.00,"27,79,765.50",
22-Jan-23,Commission,02.43,00.00,"27,79,767.93",
22-Jan-23,Interest,"16,60,886.50",00.00,"44,40,654.43",
22-Jan-23,Cash,183.5,00.00,"44,40,837.93",
22-Jan-23,Cash,04.60,00.00,"44,40,842.53",
22-Jan-23,Debit Card,00.00,"5,55,105.32","38,85,737.21",
22-Jan-23,Debit Card,"1,89,681.50",00.00,"40,75,418.71",
22-Jan-23,Interest,"4,057.00",00.00,"40,79,475.71",
22-Jan-23,ATM,200,00.00,"40,79,675.71",
22-Jan-23,Purchase,25.5,00.00,"40,79,701.21",
22-Jan-23,Bill,248.84,00.00,"40,79,950.05",
23-Jan-23,Commission,00.00,"13,59,983.35","27,19,966.70",
23-Jan-23,Cheque,00.00,"2,71,996.67","24,47,970.03",
23-Jan-23,IMPS,24,00.00,"24,47,994.03",
23-Jan-23,RTGS,26.33,00.00,"24,48,020.36",
23-Jan-23,Debit Card,00.00,"4,08,003.39","20,40,016.97",
23-Jan-23,NEFT,00.00,"6,80,005.66","13,60,011.31",
23-Jan-23,ATM,00.00,"1,51,112.37","12,08,898.94",
23-Jan-23,Purchase,283.63,00.00,"12,09,182.57",
23-Jan-23,IMPS,00.00,"12,09,182.57",00.00,
23-Jan-23,Tax,30,00.00,30,
23-Jan-23,ATM,01.30,00.00,31.3,
23-Jan-23,Interest,00.00,15.65,15.65,
23-Jan-23,Transfer,"19,26,189.20",00.00,"19,26,204.85",
23-Jan-23,Cash,00.00,"1,92,620.49","17,33,584.36",
24-Jan-23,Reversal,"13,68,091.00",00.00,"31,01,675.36",
24-Jan-23,NEFT,"1,544.40",00.00,"31,03,219.76",
24-Jan-23,Transportellaneous,"3,295.59",00.00,"31,06,515.35",
24-Jan-23,ATM,00.00,"6,21,303.07","24,85,212.28",
24-Jan-23,Tax,07.00,00.00,"24,85,219.28",
24-Jan-23,Cash,00.00,"2,76,135.48","22,09,083.80",
24-Jan-23,Transportellaneous,00.00,"3,68,180.63","18,40,903.17",
24-Jan-23,ATM,00.00,"3,06,817.20","15,34,085.98",
24-Jan-23,Reversal,863,00.00,"15,34,948.98",
24-Jan-23,Tax,07.08,00.00,"15,34,956.06",
24-Jan-23,Reversal,00.00,"2,55,826.01","12,79,130.05",
24-Jan-23,Reversal,00.00,"2,13,188.34","10,65,941.71",
24-Jan-23,Tax,"8,91,507.75",00.00,"19,57,449.46",
24-Jan-23,Reversal,"16,17,993.50",00.00,"35,75,442.96",
24-Jan-23,Interest,00.00,"11,91,814.32","23,83,628.64",
24-Jan-23,RTGS,"1,12,558.38",00.00,"24,96,187.02",
24-Jan-23,Reversal,00.00,"24,96,187.02",00.00,
24-Jan-23,Transportellaneous,"22,440.07",00.00,"22,440.07",
24-Jan-23,Purchase,00.00,"3,205.72","19,234.35",
24-Jan-23,NEFT,00.00,"2,404.29","16,830.06",
24-Jan-23,RTGS,00.00,"16,830.06",00.00,
24-Jan-23,Transfer,"31,421.00",00.00,"31,421.00",
24-Jan-23,Cash,00.00,"3,142.10","28,278.90",
24-Jan-23,IMPS,"54,057.00",00.00,"82,335.90",
24-Jan-23,Commission,"15,949.60",00.00,"98,285.50",
24-Jan-23,Purchase,00.00,"14,040.79","84,244.71",
24-Jan-23,Tax,00.00,"10,530.59","73,714.12",
24-Jan-23,Transfer,"4,10,740.00",00.00,"4,84,454.12",
24-Jan-23,Purchase,00.00,"2,42,227.06","2,42,227.06",
24-Jan-23,Reversal,00.00,"24,222.71","2,18,004.35",
24-Jan-23,Cash,"2,58,232.66",00.00,"4,76,237.01",
24-Jan-23,ATM,00.00,"2,38,118.51","2,38,118.50",
24-Jan-23,Commission,00.00,"79,372.83","1,58,745.67",
24-Jan-23,Transfer,00.00,"17,638.41","1,41,107.26",
24-Jan-23,Debit Card,06.90,00.00,"1,41,114.16",
24-Jan-23,Debit Card,00.00,"47,038.05","94,076.11",
24-Jan-23,Interest,00.00,"15,679.35","78,396.76",
24-Jan-23,Tax,00.00,"15,679.35","62,717.41",
24-Jan-23,ATM,"27,969.68",00.00,"90,687.09",
24-Jan-23,Bill,00.00,"10,076.34","80,610.75",
24-Jan-23,ATM,00.00,"8,061.08","72,549.68",
24-Jan-23,IMPS,05.10,00.00,"72,554.78",
24-Jan-23,ATM,00.00,"7,255.48","65,299.30",
24-Jan-23,Commission,"1,91,548.00",00.00,"2,56,847.30",
24-Jan-23,Transfer,00.00,"25,684.73","2,31,162.57",
24-Jan-23,Cheque,03.60,00.00,"2,31,166.17",
25-Jan-23,Tax,00.00,"57,791.54","1,73,374.63",
25-Jan-23,RTGS,00.00,"28,895.77","1,44,478.86",
25-Jan-23,Bill,00.00,"18,059.86","1,26,419.00",
25-Jan-23,Tax,00.00,"18,059.86","1,08,359.14",
25-Jan-23,IMPS,00.00,"18,059.86","90,299.28",
25-Jan-23,Bill,00.00,"18,059.86","72,239.42",
25-Jan-23,Bill,"27,622.30",00.00,"99,861.72",
25-Jan-23,Interest,00.00,"49,930.86","49,930.86",
25-Jan-23,Reversal,24,00.00,"49,954.86",
25-Jan-23,Reversal,00.00,"8,325.81","41,629.05",
25-Jan-23,Transfer,00.00,"6,938.18","34,690.88",
25-Jan-23,RTGS,"1,92,726.30",00.00,"2,27,417.18",
25-Jan-23,ATM,81,00.00,"2,27,498.18",
25-Jan-23,ATM,"16,485.20",00.00,"2,43,983.38",
25-Jan-23,Cheque,00.00,"48,796.68","1,95,186.70",
25-Jan-23,Commission,00.00,"97,593.35","97,593.35",
25-Jan-23,Debit Card,149,00.00,"97,742.35",
25-Jan-23,Debit Card,"16,83,767.00",00.00,"17,81,509.35",
25-Jan-23,RTGS,16.69,00.00,"17,81,526.04",
25-Jan-23,Cash,"4,072.77",00.00,"17,85,598.81",
25-Jan-23,Interest,"24,529.50",00.00,"18,10,128.31",
25-Jan-23,Purchase,"9,00,802.00",00.00,"27,10,930.31",
25-Jan-23,Debit Card,"21,316.46",00.00,"27,32,246.77",
25-Jan-23,Purchase,"12,620.44",00.00,"27,44,867.21",
25-Jan-23,Transfer,"19,216.10",00.00,"27,64,083.31",
25-Jan-23,Reversal,00.00,"6,91,020.83","20,73,062.48",
25-Jan-23,RTGS,03.00,00.00,"20,73,065.48",
25-Jan-23,IMPS,00.00,"2,59,133.19","18,13,932.30",
25-Jan-23,ATM,"14,377.10",00.00,"18,28,309.40",
25-Jan-23,Transportellaneous,00.00,"2,03,145.49","16,25,163.91",
25-Jan-23,Reversal,133,00.00,"16,25,296.91",
26-Jan-23,RTGS,"2,29,343.00",00.00,"18,54,639.91",
26-Jan-23,IMPS,01.10,00.00,"18,54,641.01",
26-Jan-23,Transfer,00.00,"4,63,660.25","13,90,980.76",
26-Jan-23,Purchase,00.00,"4,63,660.25","9,27,320.51",
26-Jan-23,RTGS,00.00,"1,15,915.06","8,11,405.45",
26-Jan-23,Transportellaneous,"1,61,110.00",00.00,"9,72,515.45",
26-Jan-23,Commission,00.00,"1,21,564.43","8,50,951.02",
26-Jan-23,RTGS,00.00,"1,41,825.17","7,09,125.85",
26-Jan-23,Cash,"2,24,833.94",00.00,"9,33,959.79",
26-Jan-23,NEFT,"12,52,559.25",00.00,"21,86,519.04",
26-Jan-23,Bill,00.00,"3,64,419.84","18,22,099.20",
26-Jan-23,Purchase,00.00,"1,82,209.92","16,39,889.28",
26-Jan-23,ATM,40,00.00,"16,39,929.28",
26-Jan-23,Commission,"3,738.79",00.00,"16,43,668.07",
26-Jan-23,Reversal,00.00,"8,21,834.04","8,21,834.04",
26-Jan-23,Purchase,00.00,"91,314.89","7,30,519.15",
26-Jan-23,Cash,00.00,"1,46,103.83","5,84,415.32",
26-Jan-23,Transfer,00.00,"97,402.55","4,87,012.77",
26-Jan-23,Transportellaneous,00.00,"69,573.25","4,17,439.52",
26-Jan-23,Interest,00.00,"83,487.90","3,33,951.62",
26-Jan-23,ATM,"2,567.00",00.00,"3,36,518.62",
26-Jan-23,Purchase,00.00,"1,12,172.87","2,24,345.75",
26-Jan-23,ATM,"12,01,562.00",00.00,"14,25,907.75",
26-Jan-23,Tax,207.1,00.00,"14,26,114.85",
26-Jan-23,Interest,04.00,00.00,"14,26,118.85",
26-Jan-23,Debit Card,04.00,00.00,"14,26,122.85",
26-Jan-23,Interest,00.00,"2,37,687.14","11,88,435.71",
26-Jan-23,Cash,"6,549.10",00.00,"11,94,984.81",
26-Jan-23,RTGS,44,00.00,"11,95,028.81",
27-Jan-23,Purchase,43.1,00.00,"11,95,071.91",
27-Jan-23,Transportellaneous,00.00,"1,70,724.56","10,24,347.35",
27-Jan-23,Cheque,00.00,"1,02,434.74","9,21,912.62",
27-Jan-23,Reversal,00.00,"1,15,239.08","8,06,673.54",
27-Jan-23,Purchase,00.00,"8,06,673.54",00.00,
28-Jan-23,Commission,"16,91,387.00",00.00,"16,91,387.00",
28-Jan-23,NEFT,00.00,"4,22,846.75","12,68,540.25",
28-Jan-23,Cheque,00.00,"1,81,220.04","10,87,320.21",
28-Jan-23,Debit Card,00.00,"1,55,331.46","9,31,988.75",
28-Jan-23,Bill,00.00,"2,32,997.19","6,98,991.56",
28-Jan-23,Reversal,00.00,"77,665.73","6,21,325.83",
28-Jan-23,Interest,00.00,"77,665.73","5,43,660.10",
28-Jan-23,NEFT,"98,701.00",00.00,"6,42,361.10",
28-Jan-23,NEFT,00.00,"80,295.14","5,62,065.96",
28-Jan-23,Debit Card,00.00,"2,81,032.98","2,81,032.98",
28-Jan-23,Cash,"7,788.30",00.00,"2,88,821.28",
28-Jan-23,Cheque,00.00,"32,091.25","2,56,730.03",
29-Jan-23,Transportellaneous,"27,628.00",00.00,"2,84,358.03",
29-Jan-23,Bill,00.00,"2,84,358.03",00.00,
29-Jan-23,IMPS,43.46,00.00,43.46,
29-Jan-23,Tax,00.00,06.21,37.25,
29-Jan-23,RTGS,00.00,09.31,27.94,
29-Jan-23,ATM,33,00.00,60.94,
29-Jan-23,NEFT,00.00,12.19,48.75,
29-Jan-23,IMPS,00.00,00.00,48.75,
29-Jan-23,Reversal,00.00,09.75,39,
29-Jan-23,Cheque,00.00,07.80,31.2,
29-Jan-23,Transportellaneous,00.00,06.24,24.96,
29-Jan-23,NEFT,170,00.00,194.96,
29-Jan-23,Transfer,"1,24,851.62",00.00,"1,25,046.58",
29-Jan-23,Reversal,52.9,00.00,"1,25,099.48",
29-Jan-23,RTGS,00.00,"41,699.83","83,399.65",
29-Jan-23,Transfer,00.00,"16,679.93","66,719.72",
29-Jan-23,Tax,00.00,"6,671.97","60,047.75",
29-Jan-23,NEFT,00.00,"6,671.97","53,375.78",
29-Jan-23,Cheque,00.00,"5,337.58","48,038.20",
29-Jan-23,Transportellaneous,"5,75,065.00",00.00,"6,23,103.20",
29-Jan-23,Tax,"1,36,346.00",00.00,"7,59,449.20",
29-Jan-23,Tax,05.00,00.00,"7,59,454.20",
29-Jan-23,ATM,"2,926.00",00.00,"7,62,380.20",
29-Jan-23,Tax,00.00,"1,52,476.04","6,09,904.16",
29-Jan-23,Commission,"6,635.47",00.00,"6,16,539.63",
29-Jan-23,RTGS,265.8,00.00,"6,16,805.43",
29-Jan-23,Purchase,"2,026.40",00.00,"6,18,831.83",
29-Jan-23,Interest,00.00,"1,23,766.37","4,95,065.46",
29-Jan-23,Tax,138.1,00.00,"4,95,203.56",
29-Jan-23,Bill,06.00,00.00,"4,95,209.56",
29-Jan-23,Transportellaneous,00.00,"61,901.20","4,33,308.36",
29-Jan-23,Transportellaneous,"19,995.00",00.00,"4,53,303.36",
29-Jan-23,Transfer,00.00,"1,13,325.84","3,39,977.52",
29-Jan-23,Debit Card,445,00.00,"3,40,422.52",
29-Jan-23,Cash,00.00,"56,737.09","2,83,685.43",
29-Jan-23,Transportellaneous,"4,721.00",00.00,"2,88,406.43",
29-Jan-23,IMPS,"23,642.98",00.00,"3,12,049.41",
29-Jan-23,Interest,00.00,"1,04,016.47","2,08,032.94",
29-Jan-23,NEFT,"75,730.00",00.00,"2,83,762.94",
29-Jan-23,Interest,00.00,"28,376.29","2,55,386.65",
29-Jan-23,NEFT,"2,35,369.25",00.00,"4,90,755.90",
29-Jan-23,Cheque,"1,61,292.72",00.00,"6,52,048.62",
29-Jan-23,Transportellaneous,00.00,"81,506.08","5,70,542.54",
29-Jan-23,ATM,"3,463.40",00.00,"5,74,005.94",
29-Jan-23,NEFT,00.00,"71,750.74","5,02,255.20",
29-Jan-23,RTGS,00.00,"1,00,451.04","4,01,804.16",
29-Jan-23,Debit Card,00.00,"2,00,902.08","2,00,902.08",
29-Jan-23,Cash,00.00,"40,180.42","1,60,721.66",
29-Jan-23,Reversal,223.33,00.00,"1,60,944.99",
29-Jan-23,IMPS,00.00,"20,118.12","1,40,826.87",
29-Jan-23,Tax,01.00,00.00,"1,40,827.87",
29-Jan-23,NEFT,00.00,"35,206.97","1,05,620.90",
29-Jan-23,IMPS,"9,098.70",00.00,"1,14,719.60",
29-Jan-23,RTGS,08.00,00.00,"1,14,727.60",
29-Jan-23,Interest,00.00,"11,472.76","1,03,254.84",
29-Jan-23,ATM,05.00,00.00,"1,03,259.84",
29-Jan-23,Debit Card,00.00,"10,325.98","92,933.86",
29-Jan-23,Cheque,00.00,"23,233.47","69,700.40",
29-Jan-23,Cash,"31,624.37",00.00,"1,01,324.77",
29-Jan-23,IMPS,00.00,"16,887.46","84,437.31",
29-Jan-23,Purchase,00.00,"8,443.73","75,993.58",
29-Jan-23,Bill,00.00,"10,856.23","65,137.35",
29-Jan-23,Cash,00.00,"13,027.47","52,109.88",
29-Jan-23,Transfer,00.40,00.00,"52,110.28",
29-Jan-23,Transportellaneous,31,00.00,"52,141.28",
29-Jan-23,Reversal,00.00,"5,214.13","46,927.15",
29-Jan-23,NEFT,00.00,"6,703.88","40,223.27",
30-Jan-23,Bill,00.00,"4,022.33","36,200.94",
30-Jan-23,Cash,"17,442.36",00.00,"53,643.30",
30-Jan-23,Transfer,00.00,"10,728.66","42,914.64",
30-Jan-23,Transportellaneous,00.00,"4,768.29","38,146.35",
30-Jan-23,Tax,"1,65,848.00",00.00,"2,03,994.35",
30-Jan-23,ATM,00.00,"33,999.06","1,69,995.29",
30-Jan-23,RTGS,00.00,"56,665.10","1,13,330.19",
30-Jan-23,RTGS,00.50,00.00,"1,13,330.69",
30-Jan-23,Tax,06.00,00.00,"1,13,336.69",
30-Jan-23,Cash,"1,26,285.00",00.00,"2,39,621.69",
30-Jan-23,Cheque,"1,90,558.09",00.00,"4,30,179.78",
30-Jan-23,ATM,"1,09,191.80",00.00,"5,39,371.58",
30-Jan-23,IMPS,00.00,"1,07,874.32","4,31,497.26",
30-Jan-23,ATM,"18,09,944.00",00.00,"22,41,441.26",
30-Jan-23,Reversal,00.00,"7,47,147.09","14,94,294.17",
30-Jan-23,Purchase,23.8,00.00,"14,94,317.97",
30-Jan-23,Cash,"4,044.77",00.00,"14,98,362.74",
30-Jan-23,RTGS,00.00,"1,66,484.75","13,31,877.99",
30-Jan-23,RTGS,00.00,"6,65,939.00","6,65,939.00",
30-Jan-23,NEFT,"17,54,132.00",00.00,"24,20,071.00",
30-Jan-23,Bill,20,00.00,"24,20,091.00",
30-Jan-23,IMPS,00.00,"8,06,697.00","16,13,394.00",
30-Jan-23,Cash,00.00,"16,13,394.00",00.00,
30-Jan-23,NEFT,07.00,00.00,07.00,
30-Jan-23,Commission,"1,37,574.00",00.00,"1,37,581.00",
30-Jan-23,Tax,"1,565.10",00.00,"1,39,146.10",
31-Jan-23,Transfer,00.00,"27,829.22","1,11,316.88",
31-Jan-23,Interest,"2,44,813.31",00.00,"3,56,130.19",
31-Jan-23,Cheque,00.00,"39,570.02","3,16,560.17",
31-Jan-23,Cash,00.00,"31,656.02","2,84,904.15",
31-Jan-23,Purchase,"4,046.20",00.00,"2,88,950.35",
31-Jan-23,Interest,"37,126.00",00.00,"3,26,076.35",
31-Jan-23,IMPS,00.00,"46,582.34","2,79,494.01",
31-Jan-23,IMPS,00.00,"46,582.34","2,32,911.68",
01-Feb-23,Reversal,"2,976.40",00.00,"2,35,888.08",
01-Feb-23,Cheque,00.00,"26,209.79","2,09,678.29",
01-Feb-23,Interest,00.00,"20,967.83","1,88,710.46",
01-Feb-23,Cash,00.00,"62,903.49","1,25,806.97",
01-Feb-23,Transportellaneous,00.00,"62,903.49","62,903.48",
01-Feb-23,NEFT,14,00.00,"62,917.48",
01-Feb-23,Cash,07.00,00.00,"62,924.48",
01-Feb-23,Debit Card,16.76,00.00,"62,941.24",
01-Feb-23,Cash,00.00,"15,735.31","47,205.93",
01-Feb-23,IMPS,00.00,"5,245.10","41,960.83",
01-Feb-23,Interest,00.00,"10,490.21","31,470.62",
01-Feb-23,RTGS,00.00,"3,147.06","28,323.56",
01-Feb-23,Commission,00.00,"9,441.19","18,882.37",
01-Feb-23,IMPS,00.00,"3,776.47","15,105.90",
01-Feb-23,Transportellaneous,00.12,00.00,"15,106.02",
01-Feb-23,Reversal,00.00,"1,510.60","13,595.42",
02-Feb-23,IMPS,00.00,"1,510.60","12,084.82",
02-Feb-23,Tax,38.2,00.00,"12,123.02",
02-Feb-23,Bill,00.00,"2,424.60","9,698.42",
02-Feb-23,Debit Card,504.2,00.00,"10,202.62",
02-Feb-23,ATM,"11,937.00",00.00,"22,139.62",
02-Feb-23,Commission,00.00,"2,213.96","19,925.66",
02-Feb-23,Transfer,00.00,"19,925.66",00.00,
02-Feb-23,Interest,22,00.00,22,
02-Feb-23,Cash,00.00,02.20,19.8,
02-Feb-23,RTGS,"3,926.00",00.00,"3,945.80",
02-Feb-23,Transportellaneous,00.00,438.42,"3,507.38",
02-Feb-23,ATM,00.00,701.48,"2,805.90",
02-Feb-23,Commission,00.00,"1,402.95","1,402.95",
02-Feb-23,Bill,00.00,467.65,935.3,
02-Feb-23,Reversal,09.63,00.00,944.93,
02-Feb-23,Transportellaneous,26,00.00,970.93,
03-Feb-23,Transportellaneous,"31,235.00",00.00,"32,205.93",
03-Feb-23,Cash,"54,168.50",00.00,"86,374.43",
03-Feb-23,Interest,"18,768.00",00.00,"1,05,142.43",
03-Feb-23,Purchase,"23,935.30",00.00,"1,29,077.73",
03-Feb-23,IMPS,00.00,"64,538.87","64,538.86",
03-Feb-23,Debit Card,00.00,"6,453.89","58,084.97",
03-Feb-23,ATM,"19,82,867.25",00.00,"20,40,952.22",
03-Feb-23,ATM,00.00,"20,40,952.22",00.00,
03-Feb-23,Debit Card,"44,833.00",00.00,"44,833.00",
03-Feb-23,Cash,"5,027.70",00.00,"49,860.70",
03-Feb-23,ATM,"2,674.90",00.00,"52,535.60",
03-Feb-23,Cash,00.00,"8,755.93","43,779.67",
03-Feb-23,Interest,00.00,"10,944.92","32,834.75",
03-Feb-23,Transportellaneous,00.00,"16,417.38","16,417.38",
04-Feb-23,Interest,"41,367.20",00.00,"57,784.58",
05-Feb-23,IMPS,"1,286.10",00.00,"59,070.68",
06-Feb-23,Commission,00.00,"7,383.84","51,686.84",
06-Feb-23,Tax,08.00,00.00,"51,694.84",
06-Feb-23,Reversal,"16,393.00",00.00,"68,087.84",
06-Feb-23,IMPS,"17,91,550.00",00.00,"18,59,637.84",
06-Feb-23,NEFT,"2,373.00",00.00,"18,62,010.84",
06-Feb-23,Interest,63,00.00,"18,62,073.84",
06-Feb-23,Bill,00.00,"2,32,759.23","16,29,314.61",
06-Feb-23,RTGS,00.00,"2,32,759.23","13,96,555.38",
06-Feb-23,Interest,00.00,"13,96,555.38",00.00,
06-Feb-23,Purchase,02.09,00.00,02.09,
06-Feb-23,NEFT,48.1,00.00,50.19,
06-Feb-23,Transfer,06.07,00.00,56.26,
06-Feb-23,Bill,00.00,08.04,48.22,
06-Feb-23,Bill,00.00,48.22,00.00,
06-Feb-23,Cheque,"34,384.70",00.00,"34,384.70",
06-Feb-23,Transportellaneous,500.88,00.00,"34,885.58",
06-Feb-23,Transfer,00.00,"3,876.18","31,009.40",
06-Feb-23,Interest,00.00,"10,336.47","20,672.93",
06-Feb-23,RTGS,"9,578.10",00.00,"30,251.03",
06-Feb-23,RTGS,358.4,00.00,"30,609.43",
06-Feb-23,NEFT,"3,290.00",00.00,"33,899.43",
06-Feb-23,Commission,00.00,"3,389.94","30,509.49",
06-Feb-23,Interest,"1,74,501.00",00.00,"2,05,010.49",
06-Feb-23,IMPS,00.00,"68,336.83","1,36,673.66",
06-Feb-23,Debit Card,00.00,"22,778.94","1,13,894.72",
06-Feb-23,Debit Card,00.00,"56,947.36","56,947.36",
06-Feb-23,Bill,133.4,00.00,"57,080.76",
06-Feb-23,Commission,00.00,"14,270.19","42,810.57",
06-Feb-23,RTGS,00.00,"8,562.11","34,248.46",
06-Feb-23,Transportellaneous,00.00,"4,281.06","29,967.40",
06-Feb-23,RTGS,00.00,"14,983.70","14,983.70",
06-Feb-23,Bill,"1,95,905.40",00.00,"2,10,889.10",
06-Feb-23,Tax,00.00,"26,361.14","1,84,527.96",
06-Feb-23,Transportellaneous,40.9,00.00,"1,84,568.86",
06-Feb-23,ATM,00.00,"1,84,568.86",00.00,
07-Feb-23,Tax,04.90,00.00,04.90,
07-Feb-23,IMPS,"2,38,666.22",00.00,"2,38,671.12",
07-Feb-23,Commission,00.00,"34,095.87","2,04,575.25",
07-Feb-23,IMPS,00.00,"29,225.04","1,75,350.21",
07-Feb-23,Interest,00.50,00.00,"1,75,350.71",
07-Feb-23,Purchase,02.00,00.00,"1,75,352.71",
07-Feb-23,Bill,303.6,00.00,"1,75,656.31",
07-Feb-23,Reversal,"9,014.90",00.00,"1,84,671.21",
07-Feb-23,Tax,00.00,"26,381.60","1,58,289.61",
07-Feb-23,RTGS,"2,086.40",00.00,"1,60,376.01",
07-Feb-23,Cash,02.00,00.00,"1,60,378.01",
07-Feb-23,Bill,"7,36,285.25",00.00,"8,96,663.26",
07-Feb-23,Debit Card,61.75,00.00,"8,96,725.01",
07-Feb-23,Reversal,01.12,00.00,"8,96,726.13",
07-Feb-23,Interest,00.00,"8,96,726.13",00.00,
07-Feb-23,Bill,"27,685.00",00.00,"27,685.00",
07-Feb-23,Reversal,"3,819.00",00.00,"31,504.00",
07-Feb-23,Bill,00.00,"3,150.40","28,353.60",
08-Feb-23,Transfer,19.32,00.00,"28,372.92",
08-Feb-23,Reversal,"17,04,131.20",00.00,"17,32,504.12",
08-Feb-23,IMPS,"1,32,502.00",00.00,"18,65,006.12",
09-Feb-23,Cheque,"1,86,218.00",00.00,"20,51,224.12",
09-Feb-23,NEFT,"2,063.00",00.00,"20,53,287.12",
09-Feb-23,Bill,07.00,00.00,"20,53,294.12",
09-Feb-23,Cash,296.7,00.00,"20,53,590.82",
09-Feb-23,Interest,00.00,"6,84,530.27","13,69,060.55",
09-Feb-23,NEFT,00.00,"6,84,530.28","6,84,530.28",
09-Feb-23,Transfer,06.30,00.00,"6,84,536.58",
09-Feb-23,IMPS,00.00,"68,453.66","6,16,082.92",
09-Feb-23,Interest,"1,44,899.00",00.00,"7,60,981.92",
09-Feb-23,IMPS,26.92,00.00,"7,61,008.84",
09-Feb-23,IMPS,00.00,"95,126.11","6,65,882.74",
09-Feb-23,Reversal,"1,662.00",00.00,"6,67,544.74",
09-Feb-23,Debit Card,00.00,"95,363.53","5,72,181.21",
09-Feb-23,Commission,428,00.00,"5,72,609.21",
09-Feb-23,Transfer,00.00,"1,90,869.74","3,81,739.47",
09-Feb-23,ATM,00.00,"38,173.95","3,43,565.52",
09-Feb-23,Interest,251,00.00,"3,43,816.52",
09-Feb-23,Cash,06.00,00.00,"3,43,822.52",
09-Feb-23,RTGS,00.00,"1,71,911.26","1,71,911.26",
09-Feb-23,Reversal,00.00,"17,191.13","1,54,720.13",
09-Feb-23,IMPS,"9,21,583.75",00.00,"10,76,303.88",
09-Feb-23,Commission,00.00,"1,79,383.98","8,96,919.90",
09-Feb-23,ATM,00.00,"1,49,486.65","7,47,433.25",
09-Feb-23,ATM,"31,546.00",00.00,"7,78,979.25",
09-Feb-23,NEFT,"1,57,220.00",00.00,"9,36,199.25",
09-Feb-23,Debit Card,00.00,"1,87,239.85","7,48,959.40",
09-Feb-23,Transportellaneous,"4,016.00",00.00,"7,52,975.40",
09-Feb-23,RTGS,01.42,00.00,"7,52,976.82",
09-Feb-23,Cheque,"1,11,838.70",00.00,"8,64,815.52",
09-Feb-23,Purchase,00.00,"86,481.55","7,78,333.97",
09-Feb-23,NEFT,00.00,"3,89,166.99","3,89,166.98",
09-Feb-23,Transportellaneous,00.00,"55,595.28","3,33,571.70",
09-Feb-23,Interest,00.00,"1,11,190.57","2,22,381.13",
09-Feb-23,RTGS,138,00.00,"2,22,519.13",
10-Feb-23,Transfer,"9,406.00",00.00,"2,31,925.13",
10-Feb-23,Transportellaneous,00.00,"38,654.19","1,93,270.94",
10-Feb-23,IMPS,00.00,"32,211.82","1,61,059.12",
10-Feb-23,RTGS,04.50,00.00,"1,61,063.62",
10-Feb-23,Transportellaneous,00.00,"20,132.95","1,40,930.67",
10-Feb-23,Cash,382,00.00,"1,41,312.67",
10-Feb-23,Tax,00.00,"15,701.41","1,25,611.26",
10-Feb-23,Purchase,00.00,"1,25,611.26",00.00,
10-Feb-23,Cheque,"10,51,140.20",00.00,"10,51,140.20",
10-Feb-23,Tax,"25,851.00",00.00,"10,76,991.20",
10-Feb-23,RTGS,"20,47,105.75",00.00,"31,24,096.95",
10-Feb-23,Purchase,"42,820.90",00.00,"31,66,917.85",
10-Feb-23,NEFT,00.00,"6,33,383.57","25,33,534.28",
10-Feb-23,Bill,00.00,"25,33,534.28",00.00,
10-Feb-23,Transfer,"14,390.00",00.00,"14,390.00",
10-Feb-23,Interest,"89,284.30",00.00,"1,03,674.30",
10-Feb-23,Commission,"8,508.00",00.00,"1,12,182.30",
10-Feb-23,Cash,00.00,"37,394.10","74,788.20",
10-Feb-23,Reversal,12,00.00,"74,800.20",
10-Feb-23,Bill,06.00,00.00,"74,806.20",
10-Feb-23,Tax,"10,66,829.20",00.00,"11,41,635.40",
10-Feb-23,Reversal,"6,383.00",00.00,"11,48,018.40",
10-Feb-23,Transportellaneous,62,00.00,"11,48,080.40",
10-Feb-23,Commission,15,00.00,"11,48,095.40",
10-Feb-23,NEFT,"9,41,648.25",00.00,"20,89,743.65",
10-Feb-23,Debit Card,00.00,"10,44,871.83","10,44,871.82",
10-Feb-23,Cash,00.00,"1,16,096.87","9,28,774.95",
10-Feb-23,Cheque,00.00,"2,32,193.74","6,96,581.21",
10-Feb-23,Tax,00.00,"1,74,145.30","5,22,435.91",
10-Feb-23,Reversal,"1,502.00",00.00,"5,23,937.91",
10-Feb-23,Commission,00.00,"65,492.24","4,58,445.67",
10-Feb-23,Bill,00.00,"91,689.13","3,66,756.54",
10-Feb-23,Purchase,00.00,"1,22,252.18","2,44,504.36",
10-Feb-23,Debit Card,"99,173.00",00.00,"3,43,677.36",
10-Feb-23,Transfer,00.00,"34,367.74","3,09,309.62",
10-Feb-23,RTGS,00.00,"1,03,103.21","2,06,206.41",
10-Feb-23,Debit Card,07.00,00.00,"2,06,213.41",
10-Feb-23,RTGS,00.00,"22,912.60","1,83,300.81",
10-Feb-23,NEFT,00.00,"36,660.16","1,46,640.65",
10-Feb-23,IMPS,02.06,00.00,"1,46,642.71",
10-Feb-23,Debit Card,00.00,"14,664.27","1,31,978.44",
10-Feb-23,Commission,"2,904.81",00.00,"1,34,883.25",
10-Feb-23,Transportellaneous,00.00,"16,860.41","1,18,022.84",
10-Feb-23,Bill,03.40,00.00,"1,18,026.24",
10-Feb-23,Transfer,07.75,00.00,"1,18,033.99",
10-Feb-23,Interest,36.08,00.00,"1,18,070.07",
10-Feb-23,Debit Card,00.00,"13,118.90","1,04,951.17",
10-Feb-23,IMPS,00.00,"34,983.72","69,967.45",
10-Feb-23,Tax,"57,712.30",00.00,"1,27,679.75",
10-Feb-23,Transportellaneous,00.00,"31,919.94","95,759.81",
10-Feb-23,Commission,00.00,"15,959.97","79,799.84",
10-Feb-23,RTGS,00.00,"15,959.97","63,839.87",
10-Feb-23,Interest,484.56,00.00,"64,324.43",
10-Feb-23,Transfer,"30,741.98",00.00,"95,066.41",
10-Feb-23,Bill,00.00,00.00,"95,066.41",
10-Feb-23,Cash,"11,96,368.50",00.00,"12,91,434.91",
10-Feb-23,ATM,19.63,00.00,"12,91,454.54",
10-Feb-23,Purchase,00.00,"1,61,431.82","11,30,022.72",
10-Feb-23,NEFT,00.00,"11,30,022.72",00.00,
10-Feb-23,Cash,01.10,00.00,01.10,
10-Feb-23,Transportellaneous,00.00,00.28,00.82,
10-Feb-23,Transportellaneous,00.00,00.16,00.66,
10-Feb-23,Debit Card,00.00,00.22,00.44,
10-Feb-23,IMPS,"2,268.00",00.00,"2,268.44",
10-Feb-23,Transportellaneous,00.00,567.11,"1,701.33",
10-Feb-23,Interest,"1,870.00",00.00,"3,571.33",
10-Feb-23,Cash,"11,674.68",00.00,"15,246.01",
10-Feb-23,Transportellaneous,00.00,"3,811.50","11,434.51",
10-Feb-23,NEFT,"2,18,390.20",00.00,"2,29,824.71",
10-Feb-23,IMPS,"2,41,197.38",00.00,"4,71,022.09",
11-Feb-23,ATM,08.00,00.00,"4,71,030.09",
11-Feb-23,Cash,"3,327.20",00.00,"4,74,357.29",
11-Feb-23,ATM,00.00,"59,294.66","4,15,062.63",
11-Feb-23,Debit Card,00.00,"69,177.11","3,45,885.52",
11-Feb-23,RTGS,35.9,00.00,"3,45,921.42",
11-Feb-23,Reversal,"97,690.94",00.00,"4,43,612.36",
11-Feb-23,Transportellaneous,00.00,"73,935.39","3,69,676.97",
11-Feb-23,IMPS,"3,564.60",00.00,"3,73,241.57",
11-Feb-23,Commission,32,00.00,"3,73,273.57",
11-Feb-23,Transfer,"4,22,610.50",00.00,"7,95,884.07",
11-Feb-23,Commission,00.00,"88,431.56","7,07,452.51",
11-Feb-23,IMPS,00.40,00.00,"7,07,452.91",
11-Feb-23,Transportellaneous,00.00,"3,53,726.46","3,53,726.46",
11-Feb-23,NEFT,"2,718.21",00.00,"3,56,444.67",
11-Feb-23,ATM,319.2,00.00,"3,56,763.87",
11-Feb-23,NEFT,411.67,00.00,"3,57,175.54",
11-Feb-23,Cheque,00.00,"71,435.11","2,85,740.43",
11-Feb-23,Tax,00.00,"31,748.94","2,53,991.49",
11-Feb-23,Tax,00.00,"63,497.87","1,90,493.62",
11-Feb-23,Cash,00.00,"38,098.72","1,52,394.90",
12-Feb-23,Bill,00.00,"19,049.36","1,33,345.54",
12-Feb-23,IMPS,"31,530.10",00.00,"1,64,875.64",
12-Feb-23,Tax,00.00,"23,553.66","1,41,321.98",
12-Feb-23,Commission,00.00,"20,188.85","1,21,133.13",
12-Feb-23,Cash,"71,286.10",00.00,"1,92,419.23",
12-Feb-23,Purchase,00.00,"1,92,419.23",00.00,
12-Feb-23,Transportellaneous,38.8,00.00,38.8,
12-Feb-23,Bill,31,00.00,69.8,
12-Feb-23,Cash,"14,039.10",00.00,"14,108.90",
12-Feb-23,Tax,00.00,"4,702.97","9,405.93",
12-Feb-23,Debit Card,"8,61,769.00",00.00,"8,71,174.93",
12-Feb-23,Interest,00.00,"96,797.21","7,74,377.72",
12-Feb-23,IMPS,"1,45,935.00",00.00,"9,20,312.72",
12-Feb-23,Bill,00.00,"1,84,062.54","7,36,250.18",
13-Feb-23,Debit Card,07.00,00.00,"7,36,257.18",
13-Feb-23,NEFT,00.00,"73,625.72","6,62,631.46",
13-Feb-23,Interest,00.00,"2,20,877.15","4,41,754.31",
13-Feb-23,Cheque,"24,712.70",00.00,"4,66,467.01",
13-Feb-23,Interest,"28,319.70",00.00,"4,94,786.71",
13-Feb-23,Debit Card,00.00,"2,47,393.36","2,47,393.36",
13-Feb-23,Reversal,01.00,00.00,"2,47,394.36",
13-Feb-23,IMPS,00.00,"24,739.44","2,22,654.92",
14-Feb-23,Transportellaneous,00.00,"24,739.44","1,97,915.48",
14-Feb-23,NEFT,00.00,"1,97,915.48",00.00,
14-Feb-23,Transfer,"17,48,047.80",00.00,"17,48,047.80",
14-Feb-23,Bill,"2,51,256.70",00.00,"19,99,304.50",
14-Feb-23,Interest,00.00,"6,66,434.83","13,32,869.67",
14-Feb-23,RTGS,03.00,00.00,"13,32,872.67",
14-Feb-23,Cheque,00.00,"13,32,872.67",00.00,
14-Feb-23,RTGS,35,00.00,35,
14-Feb-23,NEFT,00.00,08.75,26.25,
14-Feb-23,Purchase,"9,310.91",00.00,"9,337.16",
14-Feb-23,Transfer,00.00,"1,167.15","8,170.02",
14-Feb-23,RTGS,00.00,"1,361.67","6,808.35",
14-Feb-23,Tax,12.7,00.00,"6,821.05",
14-Feb-23,NEFT,00.00,852.63,"5,968.42",
14-Feb-23,IMPS,00.00,852.63,"5,115.79",
14-Feb-23,Commission,00.00,730.83,"4,384.96",
14-Feb-23,IMPS,00.00,730.83,"3,654.13",
14-Feb-23,IMPS,00.00,"1,218.04","2,436.09",
14-Feb-23,Interest,"3,862.43",00.00,"6,298.52",
14-Feb-23,IMPS,41,00.00,"6,339.52",
14-Feb-23,RTGS,181,00.00,"6,520.52",
14-Feb-23,IMPS,17,00.00,"6,537.52",
14-Feb-23,IMPS,00.00,"1,089.59","5,447.93",
14-Feb-23,Bill,00.00,544.79,"4,903.14",
14-Feb-23,Tax,"3,746.20",00.00,"8,649.34",
14-Feb-23,Cheque,50.95,00.00,"8,700.29",
14-Feb-23,RTGS,00.00,"1,242.90","7,457.39",
14-Feb-23,Transportellaneous,164,00.00,"7,621.39",
14-Feb-23,ATM,00.00,952.67,"6,668.72",
14-Feb-23,Transportellaneous,340,00.00,"7,008.72",
14-Feb-23,Transportellaneous,"1,22,555.00",00.00,"1,29,563.72",
14-Feb-23,ATM,"5,758.04",00.00,"1,35,321.76",
15-Feb-23,Commission,00.00,"13,532.18","1,21,789.58",
15-Feb-23,Purchase,00.00,"60,894.79","60,894.79",
15-Feb-23,Interest,00.00,"15,223.70","45,671.09",
15-Feb-23,NEFT,514,00.00,"46,185.09",
15-Feb-23,Cheque,06.00,00.00,"46,191.09",
15-Feb-23,NEFT,00.00,"6,598.73","39,592.36",
15-Feb-23,IMPS,"11,88,251.00",00.00,"12,27,843.36",
16-Feb-23,Cash,00.00,"2,45,568.67","9,82,274.69",
16-Feb-23,Commission,00.00,"1,40,324.96","8,41,949.73",
16-Feb-23,Tax,00.00,"93,549.97","7,48,399.76",
16-Feb-23,NEFT,00.00,"1,06,914.25","6,41,485.51",
16-Feb-23,Interest,"25,621.00",00.00,"6,67,106.51",
16-Feb-23,Interest,336,00.00,"6,67,442.51",
16-Feb-23,Cheque,00.00,"1,66,860.63","5,00,581.88",
16-Feb-23,Commission,00.00,"2,50,290.94","2,50,290.94",
16-Feb-23,Transfer,00.00,"83,430.31","1,66,860.63",
16-Feb-23,Reversal,"2,858.00",00.00,"1,69,718.63",
16-Feb-23,Commission,00.00,"42,429.66","1,27,288.97",
16-Feb-23,Cheque,00.00,"18,184.14","1,09,104.83",
16-Feb-23,Commission,138.4,00.00,"1,09,243.23",
16-Feb-23,Cheque,"13,414.00",00.00,"1,22,657.23",
16-Feb-23,Cheque,06.00,00.00,"1,22,663.23",
16-Feb-23,Transfer,06.00,00.00,"1,22,669.23",
16-Feb-23,ATM,702.1,00.00,"1,23,371.33",
16-Feb-23,RTGS,339,00.00,"1,23,710.33",
17-Feb-23,NEFT,393,00.00,"1,24,103.33",
17-Feb-23,RTGS,00.00,"24,820.67","99,282.66",
17-Feb-23,ATM,"17,21,567.50",00.00,"18,20,850.16",
17-Feb-23,Cheque,"20,27,295.00",00.00,"38,48,145.16",
17-Feb-23,Cash,00.00,"19,24,072.58","19,24,072.58",
17-Feb-23,Reversal,02.00,00.00,"19,24,074.58",
17-Feb-23,Cash,00.00,"2,40,509.32","16,83,565.26",
17-Feb-23,ATM,01.00,00.00,"16,83,566.26",
17-Feb-23,Reversal,69,00.00,"16,83,635.26",
17-Feb-23,Reversal,00.00,"3,36,727.05","13,46,908.21",
17-Feb-23,Debit Card,00.00,"1,34,690.82","12,12,217.39",
17-Feb-23,Cheque,302,00.00,"12,12,519.39",
17-Feb-23,Purchase,"1,57,595.88",00.00,"13,70,115.27",
17-Feb-23,Purchase,05.90,00.00,"13,70,121.17",
17-Feb-23,NEFT,00.00,"3,42,530.29","10,27,590.88",
17-Feb-23,Cheque,00.00,"10,27,590.88",00.00,
17-Feb-23,Bill,467.84,00.00,467.84,
17-Feb-23,Debit Card,00.00,93.57,374.27,
17-Feb-23,Interest,"9,210.00",00.00,"9,584.27",
17-Feb-23,Bill,404.6,00.00,"9,988.87",
17-Feb-23,Transportellaneous,00.00,"2,497.22","7,491.65",
17-Feb-23,Cash,"10,04,025.00",00.00,"10,11,516.65",
17-Feb-23,Commission,"14,216.10",00.00,"10,25,732.75",
17-Feb-23,IMPS,00.00,"1,13,970.31","9,11,762.44",
17-Feb-23,Tax,"16,17,760.00",00.00,"25,29,522.44",
17-Feb-23,NEFT,"9,804.20",00.00,"25,39,326.64",
17-Feb-23,Tax,462,00.00,"25,39,788.64",
17-Feb-23,Bill,"86,498.16",00.00,"26,26,286.80",
17-Feb-23,Purchase,"3,260.40",00.00,"26,29,547.20",
17-Feb-23,Cheque,00.00,"26,29,547.20",00.00,
17-Feb-23,Cheque,"1,799.90",00.00,"1,799.90",
17-Feb-23,IMPS,00.00,199.99,"1,599.91",
17-Feb-23,Purchase,00.00,228.56,"1,371.35",
17-Feb-23,Cash,"1,189.53",00.00,"2,560.88",
17-Feb-23,Tax,00.00,"2,560.88",00.00,
17-Feb-23,Cheque,"7,226.86",00.00,"7,226.86",
17-Feb-23,Cash,00.00,"1,806.72","5,420.14",
17-Feb-23,Cash,00.00,"1,355.04","4,065.11",
17-Feb-23,Purchase,00.00,"1,355.04","2,710.07",
17-Feb-23,Reversal,00.00,338.76,"2,371.31",
17-Feb-23,Transfer,00.00,338.76,"2,032.55",
17-Feb-23,ATM,53.5,00.00,"2,086.05",
17-Feb-23,Commission,00.60,00.00,"2,086.65",
17-Feb-23,IMPS,00.00,260.83,"1,825.82",
17-Feb-23,Reversal,"30,778.86",00.00,"32,604.68",
17-Feb-23,Bill,"1,356.90",00.00,"33,961.58",
17-Feb-23,Reversal,05.40,00.00,"33,966.98",
17-Feb-23,Commission,00.00,"11,322.33","22,644.65",
17-Feb-23,Transportellaneous,00.00,"7,548.22","15,096.43",
17-Feb-23,Cash,00.00,"2,156.63","12,939.80",
17-Feb-23,IMPS,00.00,"1,437.76","11,502.04",
17-Feb-23,Transfer,"92,080.00",00.00,"1,03,582.04",
17-Feb-23,Tax,"10,59,693.00",00.00,"11,63,275.04",
17-Feb-23,Transfer,00.00,"2,32,655.01","9,30,620.03",
17-Feb-23,Transfer,"1,217.48",00.00,"9,31,837.51",
17-Feb-23,IMPS,00.00,"1,33,119.64","7,98,717.87",
17-Feb-23,Tax,06.00,00.00,"7,98,723.87",
17-Feb-23,Transportellaneous,"21,000.60",00.00,"8,19,724.47",
17-Feb-23,Commission,02.24,00.00,"8,19,726.71",
17-Feb-23,Reversal,00.00,"91,080.75","7,28,645.96",
17-Feb-23,Purchase,191.9,00.00,"7,28,837.86",
17-Feb-23,NEFT,00.00,"3,64,418.93","3,64,418.93",
18-Feb-23,Cheque,00.00,"36,441.89","3,27,977.04",
18-Feb-23,Transfer,18.2,00.00,"3,27,995.24",
18-Feb-23,Tax,00.00,"1,63,997.62","1,63,997.62",
18-Feb-23,Debit Card,"99,369.80",00.00,"2,63,367.42",
18-Feb-23,Transfer,"13,12,656.00",00.00,"15,76,023.42",
18-Feb-23,Transfer,"72,393.91",00.00,"16,48,417.33",
18-Feb-23,Purchase,47,00.00,"16,48,464.33",
18-Feb-23,NEFT,00.00,"4,12,116.08","12,36,348.25",
18-Feb-23,RTGS,"12,57,098.50",00.00,"24,93,446.75",
18-Feb-23,RTGS,"25,852.29",00.00,"25,19,299.04",
18-Feb-23,Tax,246,00.00,"25,19,545.04",
18-Feb-23,RTGS,00.00,"6,29,886.26","18,89,658.78",
18-Feb-23,Cheque,183.6,00.00,"18,89,842.38",
18-Feb-23,Commission,00.00,"2,09,982.49","16,79,859.89",
18-Feb-23,ATM,00.00,"3,35,971.98","13,43,887.91",
18-Feb-23,Debit Card,00.00,"13,43,887.91",00.00,
18-Feb-23,Transportellaneous,"25,196.10",00.00,"25,196.10",
18-Feb-23,Tax,00.00,"25,196.10",00.00,
18-Feb-23,Bill,304.2,00.00,304.2,
18-Feb-23,Interest,"30,199.00",00.00,"30,503.20",
18-Feb-23,ATM,107,00.00,"30,610.20",
18-Feb-23,Interest,00.00,"30,610.20",00.00,
18-Feb-23,Transfer,31,00.00,31,
18-Feb-23,IMPS,00.00,04.43,26.57,
18-Feb-23,IMPS,"16,64,694.00",00.00,"16,64,720.57",
18-Feb-23,Commission,00.00,"5,54,906.86","11,09,813.71",
18-Feb-23,Tax,08.30,00.00,"11,09,822.01",
18-Feb-23,Transportellaneous,217.6,00.00,"11,10,039.61",
18-Feb-23,Transportellaneous,79,00.00,"11,10,118.61",
18-Feb-23,Bill,06.10,00.00,"11,10,124.71",
18-Feb-23,Commission,"1,30,447.40",00.00,"12,40,572.11",
18-Feb-23,IMPS,00.00,"1,55,071.51","10,85,500.60",
18-Feb-23,Reversal,"78,097.56",00.00,"11,63,598.16",
18-Feb-23,NEFT,00.00,"1,66,228.31","9,97,369.85",
18-Feb-23,RTGS,00.00,"9,97,369.85",00.00,
18-Feb-23,IMPS,27.8,00.00,27.8,
18-Feb-23,Cheque,00.00,05.56,22.24,
18-Feb-23,Tax,"18,52,903.20",00.00,"18,52,925.44",
19-Feb-23,Interest,00.00,"18,52,925.44",00.00,
19-Feb-23,ATM,05.00,00.00,05.00,
19-Feb-23,Transportellaneous,03.71,00.00,08.71,
19-Feb-23,Reversal,00.00,08.71,00.00,
19-Feb-23,Tax,"8,21,372.00",00.00,"8,21,372.00",
20-Feb-23,Cash,"19,407.12",00.00,"8,40,779.12",
20-Feb-23,Tax,00.00,"1,40,129.85","7,00,649.27",
20-Feb-23,Cheque,00.00,"87,581.16","6,13,068.11",
20-Feb-23,Debit Card,"2,28,685.00",00.00,"8,41,753.11",
20-Feb-23,Transfer,"1,94,111.34",00.00,"10,35,864.45",
20-Feb-23,ATM,00.00,"2,58,966.11","7,76,898.34",
20-Feb-23,RTGS,95.2,00.00,"7,76,993.54",
20-Feb-23,ATM,00.00,"97,124.19","6,79,869.35",
20-Feb-23,Transfer,"12,54,605.80",00.00,"19,34,475.15",
20-Feb-23,Cheque,00.00,"9,67,237.58","9,67,237.58",
20-Feb-23,Cash,48.2,00.00,"9,67,285.78",
20-Feb-23,Bill,35.69,00.00,"9,67,321.47",
20-Feb-23,Cheque,00.00,"9,67,321.47",00.00,
20-Feb-23,Purchase,29,00.00,29,
20-Feb-23,IMPS,"9,716.00",00.00,"9,745.00",
20-Feb-23,Cash,"1,59,805.00",00.00,"1,69,550.00",
20-Feb-23,Transfer,00.00,"33,910.00","1,35,640.00",
20-Feb-23,Interest,"5,82,441.50",00.00,"7,18,081.50",
20-Feb-23,Bill,"2,03,771.00",00.00,"9,21,852.50",
20-Feb-23,Cheque,00.00,"92,185.25","8,29,667.25",
20-Feb-23,Debit Card,"1,69,504.84",00.00,"9,99,172.09",
20-Feb-23,ATM,"7,812.00",00.00,"10,06,984.09",
20-Feb-23,Reversal,"15,44,540.00",00.00,"25,51,524.09",
20-Feb-23,Bill,00.00,"25,51,524.09",00.00,
20-Feb-23,Commission,01.60,00.00,01.60,
20-Feb-23,Purchase,00.00,00.80,00.80,
20-Feb-23,Tax,06.34,00.00,07.14,
20-Feb-23,Bill,07.60,00.00,14.74,
20-Feb-23,Transfer,"5,97,068.80",00.00,"5,97,083.54",
20-Feb-23,Bill,05.00,00.00,"5,97,088.54",
20-Feb-23,Commission,00.00,"2,98,544.27","2,98,544.27",
20-Feb-23,Tax,"2,67,604.00",00.00,"5,66,148.27",
20-Feb-23,Commission,00.00,"1,13,229.65","4,52,918.62",
20-Feb-23,Cash,"76,282.69",00.00,"5,29,201.31",
20-Feb-23,Transportellaneous,00.00,"5,29,201.31",00.00,
20-Feb-23,RTGS,"2,53,575.88",00.00,"2,53,575.88",
21-Feb-23,Commission,00.00,"2,53,575.88",00.00,
21-Feb-23,Cash,42.53,00.00,42.53,
21-Feb-23,Transfer,"1,645.00",00.00,"1,687.53",
21-Feb-23,Bill,"85,273.00",00.00,"86,960.53",
21-Feb-23,Commission,428,00.00,"87,388.53",
21-Feb-23,Interest,00.00,"21,847.13","65,541.40",
21-Feb-23,Transportellaneous,"24,841.00",00.00,"90,382.40",
21-Feb-23,Cash,00.10,00.00,"90,382.50",
21-Feb-23,Cheque,19.3,00.00,"90,401.80",
21-Feb-23,Cash,00.00,"11,300.23","79,101.58",
21-Feb-23,Commission,00.00,"11,300.23","67,801.35",
21-Feb-23,RTGS,"9,483.00",00.00,"77,284.35",
21-Feb-23,Reversal,"1,312.00",00.00,"78,596.35",
21-Feb-23,Cheque,00.00,"19,649.09","58,947.26",
21-Feb-23,Purchase,41.9,00.00,"58,989.16",
21-Feb-23,Debit Card,03.00,00.00,"58,992.16",
22-Feb-23,NEFT,"1,51,971.84",00.00,"2,10,964.00",
22-Feb-23,Transportellaneous,"10,89,852.00",00.00,"13,00,816.00",
22-Feb-23,Purchase,00.00,"4,33,605.33","8,67,210.67",
22-Feb-23,Reversal,"30,733.00",00.00,"8,97,943.67",
22-Feb-23,ATM,06.20,00.00,"8,97,949.87",
22-Feb-23,Debit Card,00.00,"1,49,658.31","7,48,291.56",
22-Feb-23,Commission,"15,80,311.25",00.00,"23,28,602.81",
22-Feb-23,Transportellaneous,"19,679.50",00.00,"23,48,282.31",
22-Feb-23,IMPS,00.00,"2,93,535.29","20,54,747.02",
22-Feb-23,IMPS,00.00,"2,56,843.38","17,97,903.64",
22-Feb-23,Transportellaneous,00.00,"1,79,790.36","16,18,113.28",
22-Feb-23,Purchase,03.50,00.00,"16,18,116.78",
22-Feb-23,IMPS,"12,94,840.00",00.00,"29,12,956.78",
22-Feb-23,Transfer,"1,803.59",00.00,"29,14,760.37",
22-Feb-23,Debit Card,334,00.00,"29,15,094.37",
22-Feb-23,Transfer,"1,971.00",00.00,"29,17,065.37",
22-Feb-23,RTGS,00.00,"3,64,633.17","25,52,432.20",
23-Feb-23,NEFT,"21,217.63",00.00,"25,73,649.83",
23-Feb-23,Transfer,"1,18,024.00",00.00,"26,91,673.83",
23-Feb-23,RTGS,00.00,"8,97,224.61","17,94,449.22",
23-Feb-23,Transfer,05.00,00.00,"17,94,454.22",
23-Feb-23,Transfer,343.3,00.00,"17,94,797.52",
23-Feb-23,Transportellaneous,"2,26,172.41",00.00,"20,20,969.93",
23-Feb-23,Transfer,00.00,00.00,"20,20,969.93",
23-Feb-23,Transportellaneous,00.00,"10,10,484.97","10,10,484.96",
23-Feb-23,Tax,00.00,"2,02,096.99","8,08,387.97",
23-Feb-23,Reversal,00.00,"8,08,387.97",00.00,
23-Feb-23,Commission,"3,765.80",00.00,"3,765.80",
23-Feb-23,NEFT,00.00,376.58,"3,389.22",
23-Feb-23,Bill,"69,179.00",00.00,"72,568.22",
23-Feb-23,ATM,00.00,"36,284.11","36,284.11",
23-Feb-23,Interest,322,00.00,"36,606.11",
23-Feb-23,Purchase,00.00,"12,202.04","24,404.07",
23-Feb-23,Interest,00.00,"2,711.56","21,692.51",
23-Feb-23,Transfer,00.00,"21,692.51",00.00,
23-Feb-23,Cheque,31,00.00,31,
23-Feb-23,Cash,00.00,03.44,27.56,
23-Feb-23,Tax,00.00,05.51,22.05,
23-Feb-23,Transportellaneous,33.04,00.00,55.09,
23-Feb-23,RTGS,00.00,06.89,48.2,
23-Feb-23,Transfer,00.00,24.1,24.1,
23-Feb-23,Commission,"1,90,717.30",00.00,"1,90,741.40",
23-Feb-23,Cheque,00.00,"1,90,741.40",00.00,
23-Feb-23,Transfer,00.60,00.00,00.60,
23-Feb-23,Commission,"2,24,418.00",00.00,"2,24,418.60",
23-Feb-23,ATM,00.00,"28,052.33","1,96,366.28",
24-Feb-23,Cash,119.05,00.00,"1,96,485.33",
24-Feb-23,Cash,"3,44,047.00",00.00,"5,40,532.33",
24-Feb-23,Bill,"2,817.00",00.00,"5,43,349.33",
24-Feb-23,Bill,00.00,"5,43,349.33",00.00,
24-Feb-23,Debit Card,"21,467.00",00.00,"21,467.00",
24-Feb-23,Purchase,54.9,00.00,"21,521.90",
24-Feb-23,IMPS,00.00,"3,586.98","17,934.92",
24-Feb-23,Purchase,00.00,"2,241.87","15,693.05",
24-Feb-23,NEFT,00.00,"1,743.67","13,949.38",
24-Feb-23,Debit Card,00.00,"1,394.94","12,554.44",
24-Feb-23,Bill,19.6,00.00,"12,574.04",
24-Feb-23,Cheque,"92,674.81",00.00,"1,05,248.85",
24-Feb-23,NEFT,"3,53,982.20",00.00,"4,59,231.05",
24-Feb-23,Transfer,00.00,"1,53,077.02","3,06,154.03",
24-Feb-23,Transfer,"20,65,819.80",00.00,"23,71,973.83",
24-Feb-23,ATM,"2,570.60",00.00,"23,74,544.43",
24-Feb-23,IMPS,00.00,00.00,"23,74,544.43",
25-Feb-23,Tax,27.41,00.00,"23,74,571.84",
25-Feb-23,Interest,00.00,"3,95,761.97","19,78,809.87",
26-Feb-23,IMPS,00.00,"9,89,404.94","9,89,404.94",
26-Feb-23,Transfer,00.00,"1,23,675.62","8,65,729.32",
26-Feb-23,Commission,03.00,00.00,"8,65,732.32",
26-Feb-23,Transfer,144,00.00,"8,65,876.32",
26-Feb-23,Transportellaneous,00.00,"1,73,175.26","6,92,701.06",
26-Feb-23,Tax,00.00,"76,966.78","6,15,734.28",
26-Feb-23,Transportellaneous,06.00,00.00,"6,15,740.28",
26-Feb-23,Commission,"8,474.00",00.00,"6,24,214.28",
26-Feb-23,Commission,00.00,"2,08,071.43","4,16,142.85",
26-Feb-23,Transfer,00.00,"1,04,035.71","3,12,107.14",
26-Feb-23,Interest,"25,775.40",00.00,"3,37,882.54",
27-Feb-23,Transportellaneous,58,00.00,"3,37,940.54",
27-Feb-23,Commission,00.00,"37,548.95","3,00,391.59",
27-Feb-23,Bill,283,00.00,"3,00,674.59",
27-Feb-23,Cash,"25,095.10",00.00,"3,25,769.69",
27-Feb-23,Transfer,"1,29,099.34",00.00,"4,54,869.03",
27-Feb-23,Debit Card,00.00,"56,858.63","3,98,010.40",
27-Feb-23,ATM,23.8,00.00,"3,98,034.20",
27-Feb-23,Tax,00.00,"49,754.28","3,48,279.92",
27-Feb-23,Purchase,"12,14,766.00",00.00,"15,63,045.92",
27-Feb-23,Debit Card,227,00.00,"15,63,272.92",
27-Feb-23,Tax,347.69,00.00,"15,63,620.61",
27-Feb-23,Tax,00.00,"3,12,724.12","12,50,896.49",
27-Feb-23,Tax,"1,52,084.09",00.00,"14,02,980.58",
27-Feb-23,IMPS,"33,229.80",00.00,"14,36,210.38",
27-Feb-23,Reversal,00.00,"1,59,578.93","12,76,631.45",
27-Feb-23,Transportellaneous,01.90,00.00,"12,76,633.35",
27-Feb-23,Interest,15,00.00,"12,76,648.35",
27-Feb-23,RTGS,00.00,"4,25,549.45","8,51,098.90",
27-Feb-23,Interest,00.00,"85,109.89","7,65,989.01",
27-Feb-23,Purchase,33.3,00.00,"7,66,022.31",
27-Feb-23,Purchase,00.00,"7,66,022.31",00.00,
27-Feb-23,RTGS,58.1,00.00,58.1,
27-Feb-23,Cash,565.87,00.00,623.97,
27-Feb-23,Transportellaneous,"1,29,143.80",00.00,"1,29,767.77",
27-Feb-23,Transportellaneous,00.00,"1,29,767.77",00.00,
27-Feb-23,Purchase,"15,422.50",00.00,"15,422.50",
27-Feb-23,Reversal,"1,17,115.91",00.00,"1,32,538.41",
27-Feb-23,ATM,"14,525.60",00.00,"1,47,064.01",
27-Feb-23,Cash,"18,11,629.00",00.00,"19,58,693.01",
27-Feb-23,Cheque,08.00,00.00,"19,58,701.01",
27-Feb-23,RTGS,00.00,"3,26,450.17","16,32,250.84",
27-Feb-23,RTGS,"84,758.00",00.00,"17,17,008.84",
27-Feb-23,Purchase,34,00.00,"17,17,042.84",
27-Feb-23,RTGS,00.00,"2,45,291.83","14,71,751.01",
27-Feb-23,IMPS,184.75,00.00,"14,71,935.76",
27-Feb-23,Reversal,19,00.00,"14,71,954.76",
27-Feb-23,Cash,00.00,"1,47,195.48","13,24,759.28",
27-Feb-23,Tax,00.00,"3,31,189.82","9,93,569.46",
27-Feb-23,Transfer,00.00,"9,93,569.46",00.00,
27-Feb-23,Purchase,481,00.00,481,
27-Feb-23,IMPS,"11,033.10",00.00,"11,514.10",
27-Feb-23,RTGS,"8,78,923.50",00.00,"8,90,437.60",
27-Feb-23,Commission,931.3,00.00,"8,91,368.90",
27-Feb-23,NEFT,176,00.00,"8,91,544.90",
27-Feb-23,Transfer,"1,84,407.09",00.00,"10,75,951.99",
27-Feb-23,NEFT,"2,266.39",00.00,"10,78,218.38",
27-Feb-23,IMPS,06.16,00.00,"10,78,224.54",
28-Feb-23,NEFT,344.5,00.00,"10,78,569.04",
28-Feb-23,IMPS,"1,09,945.47",00.00,"11,88,514.51",
28-Feb-23,ATM,00.00,"1,32,057.17","10,56,457.34",
28-Feb-23,Cheque,"16,94,673.00",00.00,"27,51,130.34",
28-Feb-23,NEFT,336.5,00.00,"27,51,466.84",
28-Feb-23,Interest,00.00,"3,93,066.69","23,58,400.15",
28-Feb-23,Transfer,00.00,"23,58,400.15",00.00,
28-Feb-23,Commission,"18,004.25",00.00,"18,004.25",
28-Feb-23,ATM,00.00,"3,600.85","14,403.40",
28-Feb-23,Commission,"32,207.28",00.00,"46,610.68",
28-Feb-23,IMPS,00.00,"23,305.34","23,305.34",
28-Feb-23,Debit Card,"3,757.86",00.00,"27,063.20",
28-Feb-23,Reversal,"2,131.63",00.00,"29,194.83",
28-Feb-23,Bill,"2,837.00",00.00,"32,031.83",
28-Feb-23,IMPS,00.00,"4,003.98","28,027.85",
28-Feb-23,Debit Card,"1,17,479.30",00.00,"1,45,507.15",
28-Feb-23,Cheque,"9,12,780.00",00.00,"10,58,287.15",
28-Feb-23,NEFT,"1,951.20",00.00,"10,60,238.35",
28-Feb-23,Transfer,06.10,00.00,"10,60,244.45",
28-Feb-23,RTGS,00.00,"2,12,048.89","8,48,195.56",
28-Feb-23,Purchase,00.00,"1,06,024.45","7,42,171.12",
28-Feb-23,Bill,"3,421.00",00.00,"7,45,592.12",
28-Feb-23,Reversal,00.00,"93,199.02","6,52,393.10",
28-Feb-23,NEFT,00.00,"65,239.31","5,87,153.79",
28-Feb-23,Reversal,00.00,"1,46,788.45","4,40,365.34",
28-Feb-23,RTGS,"2,454.00",00.00,"4,42,819.34",
28-Feb-23,Cash,00.00,"88,563.87","3,54,255.47",
28-Feb-23,RTGS,00.00,"1,18,085.16","2,36,170.31",
28-Feb-23,Interest,00.00,"59,042.58","1,77,127.73",
28-Feb-23,NEFT,00.00,"35,425.55","1,41,702.18",
28-Feb-23,Purchase,"1,00,451.81",00.00,"2,42,153.99",
28-Feb-23,Cash,"1,90,225.00",00.00,"4,32,378.99",
28-Feb-23,Commission,00.00,"43,237.90","3,89,141.09",
28-Feb-23,RTGS,00.00,"97,285.27","2,91,855.82",
28-Feb-23,ATM,103,00.00,"2,91,958.82",
28-Feb-23,Debit Card,00.00,"97,319.61","1,94,639.21",
28-Feb-23,RTGS,05.00,00.00,"1,94,644.21",
28-Feb-23,Debit Card,19.1,00.00,"1,94,663.31",
28-Feb-23,Bill,147.68,00.00,"1,94,810.99",
28-Feb-23,Transfer,00.00,"1,94,810.99",00.00,
28-Feb-23,IMPS,03.26,00.00,03.26,
28-Feb-23,Cash,"3,190.50",00.00,"3,193.76",
28-Feb-23,Cheque,"7,497.00",00.00,"10,690.76",
28-Feb-23,Cash,00.00,"1,781.79","8,908.97",
28-Feb-23,Commission,00.00,"8,908.97",00.00,
28-Feb-23,Debit Card,04.00,00.00,04.00,
28-Feb-23,IMPS,"6,47,498.00",00.00,"6,47,502.00",
28-Feb-23,Commission,"14,59,154.00",00.00,"21,06,656.00",
28-Feb-23,NEFT,"18,29,476.00",00.00,"39,36,132.00",
28-Feb-23,Transportellaneous,00.00,"7,87,226.40","31,48,905.60",
28-Feb-23,Debit Card,00.00,"31,48,905.60",00.00,
28-Feb-23,Tax,"1,16,967.00",00.00,"1,16,967.00",
28-Feb-23,Transfer,"2,395.70",00.00,"1,19,362.70",
28-Feb-23,IMPS,447.2,00.00,"1,19,809.90",
28-Feb-23,Purchase,"2,251.10",00.00,"1,22,061.00",
28-Feb-23,Tax,03.50,00.00,"1,22,064.50",
28-Feb-23,RTGS,00.00,"13,562.72","1,08,501.78",
28-Feb-23,Interest,07.44,00.00,"1,08,509.22",
28-Feb-23,Bill,"9,808.00",00.00,"1,18,317.22",
28-Feb-23,RTGS,02.83,00.00,"1,18,320.05",
28-Feb-23,Commission,00.00,"59,160.03","59,160.02",
28-Feb-23,ATM,"1,30,013.09",00.00,"1,89,173.11",
28-Feb-23,Transfer,00.00,"47,293.28","1,41,879.83",
28-Feb-23,Reversal,00.00,"28,375.97","1,13,503.86",
28-Feb-23,NEFT,36.62,00.00,"1,13,540.48",
28-Feb-23,Reversal,05.00,00.00,"1,13,545.48",
28-Feb-23,Debit Card,00.00,"1,13,545.48",00.00,
28-Feb-23,Tax,"2,300.00",00.00,"2,300.00",
28-Feb-23,Transfer,32,00.00,"2,332.00",
28-Feb-23,Cash,00.00,233.2,"2,098.80",
28-Feb-23,Transfer,"11,949.00",00.00,"14,047.80",
28-Feb-23,Commission,00.00,"7,023.90","7,023.90",
28-Feb-23,Debit Card,00.00,"7,023.90",00.00,
28-Feb-23,Purchase,13.11,00.00,13.11,
28-Feb-23,RTGS,00.00,02.19,10.92,
28-Feb-23,NEFT,00.00,01.56,09.36,
28-Feb-23,Tax,444.93,00.00,454.29,
28-Feb-23,Interest,11,00.00,465.29,
28-Feb-23,Reversal,00.00,116.32,348.97,
28-Feb-23,NEFT,"2,913.66",00.00,"3,262.63",
28-Feb-23,Interest,"12,605.00",00.00,"15,867.63",
28-Feb-23,NEFT,00.00,"3,966.91","11,900.72",
28-Feb-23,Bill,01.20,00.00,"11,901.92",
28-Feb-23,Interest,00.00,"3,967.31","7,934.61",
28-Feb-23,ATM,00.00,"1,983.65","5,950.96",
28-Feb-23,IMPS,"17,25,114.80",00.00,"17,31,065.76",
28-Feb-23,IMPS,296,00.00,"17,31,361.76",
01-Mar-23,Cheque,120,00.00,"17,31,481.76",
01-Mar-23,Cheque,00.00,"17,31,481.76",00.00,
01-Mar-23,Reversal,"20,918.00",00.00,"20,918.00",
01-Mar-23,Reversal,00.00,"2,614.75","18,303.25",
01-Mar-23,RTGS,00.00,"3,660.65","14,642.60",
01-Mar-23,ATM,299.6,00.00,"14,942.20",
01-Mar-23,Tax,341,00.00,"15,283.20",
01-Mar-23,IMPS,"66,298.00",00.00,"81,581.20",
01-Mar-23,RTGS,05.60,00.00,"81,586.80",
01-Mar-23,Cash,00.00,"11,655.26","69,931.54",
01-Mar-23,IMPS,00.00,"34,965.77","34,965.77",
01-Mar-23,Commission,09.73,00.00,"34,975.50",
02-Mar-23,Cash,"20,92,185.25",00.00,"21,27,160.75",
02-Mar-23,RTGS,"17,41,075.00",00.00,"38,68,235.75",
02-Mar-23,NEFT,00.00,"19,34,117.88","19,34,117.88",
02-Mar-23,Transportellaneous,16.2,00.00,"19,34,134.08",
03-Mar-23,Transportellaneous,00.00,"2,14,903.79","17,19,230.29",
03-Mar-23,NEFT,00.00,"8,59,615.15","8,59,615.14",
03-Mar-23,Reversal,05.00,00.00,"8,59,620.14",
03-Mar-23,NEFT,"2,970.50",00.00,"8,62,590.64",
03-Mar-23,Bill,00.00,"86,259.06","7,76,331.58",
03-Mar-23,NEFT,"13,43,177.00",00.00,"21,19,508.58",
03-Mar-23,Debit Card,00.00,"21,19,508.58",00.00,
03-Mar-23,Tax,"3,150.99",00.00,"3,150.99",
03-Mar-23,ATM,"12,372.04",00.00,"15,523.03",
03-Mar-23,NEFT,"1,89,314.00",00.00,"2,04,837.03",
03-Mar-23,Cheque,00.00,"25,604.63","1,79,232.40",
03-Mar-23,ATM,"18,95,061.50",00.00,"20,74,293.90",
03-Mar-23,IMPS,00.00,"4,14,858.78","16,59,435.12",
03-Mar-23,Interest,"16,96,511.00",00.00,"33,55,946.12",
03-Mar-23,IMPS,"9,07,986.80",00.00,"42,63,932.92",
03-Mar-23,Debit Card,00.00,"7,10,655.49","35,53,277.43",
04-Mar-23,Debit Card,00.00,"17,76,638.72","17,76,638.72",
04-Mar-23,Cash,00.00,"2,22,079.84","15,54,558.88",
04-Mar-23,Tax,00.00,"1,55,455.89","13,99,102.99",
04-Mar-23,Transportellaneous,00.00,"2,79,820.60","11,19,282.39",
04-Mar-23,NEFT,00.00,"5,59,641.20","5,59,641.19",
04-Mar-23,Tax,194,00.00,"5,59,835.19",
04-Mar-23,NEFT,00.00,"79,976.46","4,79,858.73",
05-Mar-23,NEFT,51,00.00,"4,79,909.73",
05-Mar-23,Transportellaneous,00.00,"1,59,969.91","3,19,939.82",
05-Mar-23,Transfer,"2,45,040.00",00.00,"5,64,979.82",
05-Mar-23,Bill,00.00,"94,163.30","4,70,816.52",
05-Mar-23,Transfer,"65,064.00",00.00,"5,35,880.52",
05-Mar-23,Debit Card,00.00,"66,985.07","4,68,895.46",
05-Mar-23,Commission,328.93,00.00,"4,69,224.39",
05-Mar-23,Bill,02.80,00.00,"4,69,227.19",
05-Mar-23,NEFT,20,00.00,"4,69,247.19",
05-Mar-23,Debit Card,288,00.00,"4,69,535.19",
05-Mar-23,RTGS,87.6,00.00,"4,69,622.79",
05-Mar-23,NEFT,"2,48,070.00",00.00,"7,17,692.79",
05-Mar-23,ATM,00.00,"1,02,527.54","6,15,165.25",
05-Mar-23,Cheque,"79,674.90",00.00,"6,94,840.15",
05-Mar-23,NEFT,"3,00,705.00",00.00,"9,95,545.15",
05-Mar-23,Debit Card,00.00,"3,31,848.38","6,63,696.77",
05-Mar-23,RTGS,684.2,00.00,"6,64,380.97",
05-Mar-23,Cash,"6,53,722.00",00.00,"13,18,102.97",
05-Mar-23,Bill,05.08,00.00,"13,18,108.05",
05-Mar-23,Cheque,"1,693.00",00.00,"13,19,801.05",
05-Mar-23,Bill,00.00,"13,19,801.05",00.00,
05-Mar-23,IMPS,"2,60,479.66",00.00,"2,60,479.66",
05-Mar-23,RTGS,"2,762.40",00.00,"2,63,242.06",
05-Mar-23,Debit Card,00.00,"52,648.41","2,10,593.65",
05-Mar-23,Tax,00.00,"70,197.88","1,40,395.77",
05-Mar-23,Bill,00.00,"15,599.53","1,24,796.24",
05-Mar-23,NEFT,00.00,"15,599.53","1,09,196.71",
05-Mar-23,Interest,"2,855.90",00.00,"1,12,052.61",
05-Mar-23,Purchase,02.00,00.00,"1,12,054.61",
05-Mar-23,Bill,"7,76,355.00",00.00,"8,88,409.61",
05-Mar-23,Transfer,00.00,"2,96,136.54","5,92,273.07",
05-Mar-23,Reversal,153.32,00.00,"5,92,426.39",
05-Mar-23,Tax,05.90,00.00,"5,92,432.29",
05-Mar-23,Cheque,00.00,"74,054.04","5,18,378.25",
05-Mar-23,Commission,"43,595.00",00.00,"5,61,973.25",
06-Mar-23,RTGS,"3,060.00",00.00,"5,65,033.25",
06-Mar-23,Cash,01.00,00.00,"5,65,034.25",
06-Mar-23,Bill,"6,399.00",00.00,"5,71,433.25",
06-Mar-23,Tax,00.00,"1,90,477.75","3,80,955.50",
06-Mar-23,Cheque,00.00,"95,238.88","2,85,716.62",
06-Mar-23,Tax,09.00,00.00,"2,85,725.62",
06-Mar-23,Debit Card,00.00,"57,145.12","2,28,580.50",
06-Mar-23,Bill,"3,358.40",00.00,"2,31,938.90",
06-Mar-23,IMPS,49,00.00,"2,31,987.90",
06-Mar-23,Debit Card,00.00,"23,198.79","2,08,789.11",
06-Mar-23,RTGS,31,00.00,"2,08,820.11",
06-Mar-23,Purchase,01.00,00.00,"2,08,821.11",
06-Mar-23,Purchase,226.08,00.00,"2,09,047.19",
06-Mar-23,Cheque,"89,941.31",00.00,"2,98,988.50",
06-Mar-23,Bill,00.00,"42,712.64","2,56,275.86",
06-Mar-23,RTGS,00.00,"28,475.10","2,27,800.76",
06-Mar-23,Transportellaneous,01.53,00.00,"2,27,802.29",
06-Mar-23,Tax,00.00,"75,934.10","1,51,868.19",
06-Mar-23,RTGS,00.00,"30,373.64","1,21,494.55",
06-Mar-23,Debit Card,00.00,"15,186.82","1,06,307.73",
06-Mar-23,Cash,00.00,"15,186.82","91,120.91",
07-Mar-23,Bill,"14,942.00",00.00,"1,06,062.91",
07-Mar-23,IMPS,00.00,"53,031.46","53,031.46",
07-Mar-23,Cash,00.00,"6,628.93","46,402.53",
07-Mar-23,Transfer,"3,006.40",00.00,"49,408.93",
07-Mar-23,Cash,00.00,"6,176.12","43,232.81",
07-Mar-23,ATM,00.00,"5,404.10","37,828.71",
07-Mar-23,Reversal,00.00,"37,828.71",00.00,
07-Mar-23,ATM,135,00.00,135,
07-Mar-23,Debit Card,53,00.00,188,
07-Mar-23,Purchase,33,00.00,221,
07-Mar-23,Purchase,402,00.00,623,
07-Mar-23,Purchase,00.00,155.75,467.25,
07-Mar-23,Commission,00.00,93.45,373.8,
07-Mar-23,Purchase,"3,954.70",00.00,"4,328.50",
07-Mar-23,Interest,00.00,"1,082.13","3,246.38",
07-Mar-23,Cash,00.00,360.71,"2,885.67",
07-Mar-23,Reversal,00.00,"2,885.67",00.00,
07-Mar-23,Interest,"3,478.90",00.00,"3,478.90",
07-Mar-23,IMPS,"17,96,006.00",00.00,"17,99,484.90",
07-Mar-23,Reversal,00.00,"5,99,828.30","11,99,656.60",
07-Mar-23,Tax,00.00,"2,39,931.32","9,59,725.28",
07-Mar-23,RTGS,00.00,"3,19,908.43","6,39,816.85",
07-Mar-23,Commission,21.99,00.00,"6,39,838.84",
07-Mar-23,Transportellaneous,00.00,"1,59,959.71","4,79,879.13",
07-Mar-23,Debit Card,03.04,00.00,"4,79,882.17",
07-Mar-23,Purchase,00.00,"2,39,941.09","2,39,941.08",
07-Mar-23,Tax,00.00,"1,19,970.54","1,19,970.54",
07-Mar-23,RTGS,00.00,"14,996.32","1,04,974.22",
07-Mar-23,Cheque,"13,026.50",00.00,"1,18,000.72",
07-Mar-23,Cash,369.45,00.00,"1,18,370.17",
07-Mar-23,Cash,339.03,00.00,"1,18,709.20",
07-Mar-23,Transfer,47,00.00,"1,18,756.20",
07-Mar-23,Interest,433.7,00.00,"1,19,189.90",
07-Mar-23,Transportellaneous,00.00,"14,898.74","1,04,291.16",
07-Mar-23,RTGS,"10,57,810.00",00.00,"11,62,101.16",
07-Mar-23,Cheque,06.21,00.00,"11,62,107.37",
07-Mar-23,IMPS,58.7,00.00,"11,62,166.07",
07-Mar-23,Reversal,"30,675.00",00.00,"11,92,841.07",
07-Mar-23,Debit Card,203.6,00.00,"11,93,044.67",
07-Mar-23,Transportellaneous,00.00,"2,98,261.17","8,94,783.50",
07-Mar-23,Purchase,426.07,00.00,"8,95,209.57",
07-Mar-23,Debit Card,"2,34,115.00",00.00,"11,29,324.57",
07-Mar-23,Reversal,"1,25,825.00",00.00,"12,55,149.57",
07-Mar-23,Interest,01.00,00.00,"12,55,150.57",
07-Mar-23,Transportellaneous,00.00,"12,55,150.57",00.00,
07-Mar-23,Tax,54.4,00.00,54.4,
07-Mar-23,Reversal,53.9,00.00,108.3,
07-Mar-23,Cash,00.00,13.54,94.76,
07-Mar-23,Bill,"12,75,140.50",00.00,"12,75,235.26",
07-Mar-23,Bill,00.00,"1,27,523.53","11,47,711.73",
07-Mar-23,RTGS,16,00.00,"11,47,727.73",
07-Mar-23,Tax,16.72,00.00,"11,47,744.45",
07-Mar-23,Tax,00.00,"1,14,774.45","10,32,970.00",
07-Mar-23,Transportellaneous,00.00,"3,44,323.33","6,88,646.67",
07-Mar-23,Interest,00.00,"1,14,774.45","5,73,872.23",
07-Mar-23,ATM,00.00,"71,734.03","5,02,138.20",
07-Mar-23,Purchase,989.4,00.00,"5,03,127.60",
07-Mar-23,Transfer,00.00,"1,00,625.52","4,02,502.08",
07-Mar-23,Transportellaneous,00.00,"1,00,625.52","3,01,876.56",
07-Mar-23,RTGS,60.72,00.00,"3,01,937.28",
07-Mar-23,Bill,00.00,"1,50,968.64","1,50,968.64",
07-Mar-23,Transportellaneous,00.00,"30,193.73","1,20,774.91",
07-Mar-23,Cheque,02.28,00.00,"1,20,777.19",
07-Mar-23,Bill,"1,989.60",00.00,"1,22,766.79",
07-Mar-23,Reversal,00.00,"40,922.26","81,844.53",
07-Mar-23,NEFT,"1,900.00",00.00,"83,744.53",
07-Mar-23,NEFT,"3,189.00",00.00,"86,933.53",
07-Mar-23,Commission,00.00,"14,488.92","72,444.61",
07-Mar-23,Cheque,23.66,00.00,"72,468.27",
07-Mar-23,NEFT,63,00.00,"72,531.27",
07-Mar-23,RTGS,00.00,"36,265.64","36,265.64",
07-Mar-23,Reversal,00.00,"12,088.55","24,177.09",
07-Mar-23,Purchase,00.00,"4,835.42","19,341.67",
07-Mar-23,Tax,508,00.00,"19,849.67",
07-Mar-23,Interest,00.00,"19,849.67",00.00,
07-Mar-23,Interest,"3,490.27",00.00,"3,490.27",
07-Mar-23,Purchase,"12,65,313.50",00.00,"12,68,803.77",
07-Mar-23,Commission,00.00,"2,11,467.30","10,57,336.48",
07-Mar-23,Commission,21.2,00.00,"10,57,357.68",
07-Mar-23,Interest,00.00,"1,76,226.28","8,81,131.40",
07-Mar-23,Interest,31,00.00,"8,81,162.40",
07-Mar-23,Purchase,04.00,00.00,"8,81,166.40",
07-Mar-23,Interest,00.00,"8,81,166.40",00.00,
07-Mar-23,RTGS,"4,046.30",00.00,"4,046.30",
07-Mar-23,Commission,00.00,"4,046.30",00.00,
07-Mar-23,Purchase,20.56,00.00,20.56,
07-Mar-23,ATM,30,00.00,50.56,
07-Mar-23,Cheque,00.00,12.64,37.92,
07-Mar-23,Reversal,"1,350.79",00.00,"1,388.71",
07-Mar-23,Interest,"1,31,967.30",00.00,"1,33,356.01",
07-Mar-23,Transfer,154,00.00,"1,33,510.01",
07-Mar-23,Bill,27,00.00,"1,33,537.01",
07-Mar-23,Transfer,02.00,00.00,"1,33,539.01",
07-Mar-23,Reversal,26,00.00,"1,33,565.01",
07-Mar-23,Transportellaneous,"10,672.86",00.00,"1,44,237.87",
07-Mar-23,Transportellaneous,05.20,00.00,"1,44,243.07",
07-Mar-23,Tax,00.00,"48,081.02","96,162.05",
07-Mar-23,Cheque,00.00,"96,162.05",00.00,
07-Mar-23,Bill,"10,343.03",00.00,"10,343.03",
07-Mar-23,Reversal,56,00.00,"10,399.03",
07-Mar-23,IMPS,00.00,"1,155.45","9,243.58",
07-Mar-23,NEFT,00.00,"2,310.90","6,932.68",
07-Mar-23,Tax,00.00,693.27,"6,239.41",
07-Mar-23,Commission,48,00.00,"6,287.41",
07-Mar-23,Transportellaneous,"11,36,094.00",00.00,"11,42,381.41",
07-Mar-23,Commission,00.00,"5,71,190.71","5,71,190.70",
07-Mar-23,Interest,00.00,"95,198.45","4,75,992.25",
07-Mar-23,NEFT,02.20,00.00,"4,75,994.45",
07-Mar-23,IMPS,"30,631.90",00.00,"5,06,626.35",
07-Mar-23,Tax,00.00,"50,662.64","4,55,963.72",
07-Mar-23,NEFT,00.00,"65,137.67","3,90,826.05",
07-Mar-23,NEFT,00.00,"1,30,275.35","2,60,550.70",
07-Mar-23,Transportellaneous,00.00,"52,110.14","2,08,440.56",
07-Mar-23,IMPS,"4,25,388.00",00.00,"6,33,828.56",
07-Mar-23,Reversal,00.00,"79,228.57","5,54,599.99",
07-Mar-23,Cheque,00.00,"61,622.22","4,92,977.77",
07-Mar-23,Reversal,329.8,00.00,"4,93,307.57",
07-Mar-23,Cheque,"53,753.91",00.00,"5,47,061.48",
07-Mar-23,Commission,"3,603.00",00.00,"5,50,664.48",
07-Mar-23,NEFT,"2,53,236.00",00.00,"8,03,900.48",
07-Mar-23,Transfer,07.00,00.00,"8,03,907.48",
07-Mar-23,Cash,00.00,"80,390.75","7,23,516.73",
07-Mar-23,Tax,00.00,"7,23,516.73",00.00,
07-Mar-23,Interest,62.5,00.00,62.5,
07-Mar-23,Transportellaneous,"2,007.30",00.00,"2,069.80",
07-Mar-23,Reversal,00.00,517.45,"1,552.35",
07-Mar-23,Tax,"1,40,482.00",00.00,"1,42,034.35",
07-Mar-23,Reversal,00.00,"14,203.44","1,27,830.92",
07-Mar-23,Reversal,00.00,"14,203.44","1,13,627.48",
07-Mar-23,Transfer,00.00,"56,813.74","56,813.74",
07-Mar-23,ATM,06.92,00.00,"56,820.66",
07-Mar-23,Cheque,220.08,00.00,"57,040.74",
07-Mar-23,Reversal,00.00,"19,013.58","38,027.16",
07-Mar-23,Purchase,00.00,"3,802.72","34,224.44",
07-Mar-23,Cash,00.00,"4,889.21","29,335.23",
07-Mar-23,RTGS,00.00,"4,190.75","25,144.48",
07-Mar-23,RTGS,00.00,"3,143.06","22,001.42",
07-Mar-23,NEFT,02.00,00.00,"22,003.42",
07-Mar-23,Tax,00.00,"2,444.82","19,558.60",
07-Mar-23,Cheque,00.00,"9,779.30","9,779.30",
07-Mar-23,Debit Card,06.10,00.00,"9,785.40",
07-Mar-23,Transfer,00.00,"1,397.91","8,387.49",
07-Mar-23,Transfer,"9,20,059.00",00.00,"9,28,446.49",
07-Mar-23,Interest,"1,14,638.00",00.00,"10,43,084.49",
07-Mar-23,Transportellaneous,00.00,"3,47,694.83","6,95,389.66",
07-Mar-23,Tax,00.00,"69,538.97","6,25,850.69",
07-Mar-23,Bill,"18,43,974.00",00.00,"24,69,824.69",
08-Mar-23,Cheque,00.00,"8,23,274.90","16,46,549.79",
08-Mar-23,Bill,00.00,"3,29,309.96","13,17,239.83",
09-Mar-23,NEFT,327.96,00.00,"13,17,567.79",
09-Mar-23,Cash,00.00,"2,19,594.63","10,97,973.16",
09-Mar-23,Purchase,02.25,00.00,"10,97,975.41",
09-Mar-23,Tax,00.00,"5,48,987.71","5,48,987.70",
09-Mar-23,Transportellaneous,00.00,"1,09,797.54","4,39,190.16",
09-Mar-23,Bill,00.00,"2,19,595.08","2,19,595.08",
09-Mar-23,RTGS,03.00,00.00,"2,19,598.08",
09-Mar-23,NEFT,05.00,00.00,"2,19,603.08",
09-Mar-23,Tax,24.8,00.00,"2,19,627.88",
09-Mar-23,Cheque,340.5,00.00,"2,19,968.38",
09-Mar-23,Transfer,"7,117.92",00.00,"2,27,086.30",
10-Mar-23,IMPS,00.00,"37,847.72","1,89,238.58",
10-Mar-23,Transportellaneous,00.00,"31,539.76","1,57,698.82",
10-Mar-23,Commission,00.00,"78,849.41","78,849.41",
10-Mar-23,Debit Card,00.00,"7,884.94","70,964.47",
10-Mar-23,RTGS,00.67,00.00,"70,965.14",
10-Mar-23,Commission,217.39,00.00,"71,182.53",
10-Mar-23,Purchase,58.44,00.00,"71,240.97",
10-Mar-23,Purchase,00.00,"11,873.50","59,367.48",
10-Mar-23,Reversal,"3,541.30",00.00,"62,908.78",
10-Mar-23,Transportellaneous,27,00.00,"62,935.78",
10-Mar-23,IMPS,"10,68,904.00",00.00,"11,31,839.78",
10-Mar-23,Transfer,773,00.00,"11,32,612.78",
10-Mar-23,Interest,00.00,"1,25,845.86","10,06,766.92",
10-Mar-23,Purchase,00.00,"1,67,794.49","8,38,972.43",
10-Mar-23,Interest,00.00,"1,39,828.74","6,99,143.69",
10-Mar-23,Commission,"29,898.11",00.00,"7,29,041.80",
10-Mar-23,RTGS,00.00,"1,04,148.83","6,24,892.97",
10-Mar-23,IMPS,160,00.00,"6,25,052.97",
10-Mar-23,Tax,"3,415.00",00.00,"6,28,467.97",
10-Mar-23,IMPS,00.00,"3,14,233.99","3,14,233.98",
10-Mar-23,Commission,00.00,"3,14,233.98",00.00,
11-Mar-23,Reversal,"7,92,319.20",00.00,"7,92,319.20",
11-Mar-23,Interest,00.00,"3,96,159.60","3,96,159.60",
11-Mar-23,Bill,00.00,"3,96,159.60",00.00,
11-Mar-23,Purchase,05.95,00.00,05.95,
11-Mar-23,Reversal,"3,788.90",00.00,"3,794.85",
11-Mar-23,Bill,"33,882.50",00.00,"37,677.35",
11-Mar-23,Tax,17.4,00.00,"37,694.75",
11-Mar-23,Interest,00.00,"9,423.69","28,271.06",
11-Mar-23,Debit Card,"4,79,013.20",00.00,"5,07,284.26",
11-Mar-23,Reversal,00.00,"1,01,456.85","4,05,827.41",
11-Mar-23,ATM,00.00,"2,02,913.71","2,02,913.70",
11-Mar-23,Interest,"76,082.00",00.00,"2,78,995.70",
11-Mar-23,Purchase,"2,95,720.25",00.00,"5,74,715.95",
11-Mar-23,Debit Card,"5,706.00",00.00,"5,80,421.95",
11-Mar-23,Commission,00.00,"1,45,105.49","4,35,316.46",
11-Mar-23,Reversal,"71,981.00",00.00,"5,07,297.46",
11-Mar-23,Transportellaneous,38,00.00,"5,07,335.46",
11-Mar-23,Interest,00.00,"84,555.91","4,22,779.55",
11-Mar-23,Commission,"7,89,464.80",00.00,"12,12,244.35",
11-Mar-23,Transportellaneous,00.00,"1,73,177.76","10,39,066.59",
11-Mar-23,Cash,49.4,00.00,"10,39,115.99",
11-Mar-23,Cash,03.00,00.00,"10,39,118.99",
11-Mar-23,Tax,00.00,"5,19,559.50","5,19,559.50",
11-Mar-23,Interest,07.30,00.00,"5,19,566.80",
11-Mar-23,Cheque,00.00,"1,73,188.93","3,46,377.87",
11-Mar-23,NEFT,00.00,"43,297.23","3,03,080.64",
11-Mar-23,NEFT,"1,11,059.84",00.00,"4,14,140.48",
11-Mar-23,Cash,"97,496.00",00.00,"5,11,636.48",
11-Mar-23,Cheque,730.73,00.00,"5,12,367.21",
11-Mar-23,Transportellaneous,00.00,"1,70,789.07","3,41,578.14",
11-Mar-23,Bill,"2,25,521.75",00.00,"5,67,099.89",
11-Mar-23,Debit Card,00.00,"1,13,419.98","4,53,679.91",
12-Mar-23,Bill,01.33,00.00,"4,53,681.24",
12-Mar-23,RTGS,31.92,00.00,"4,53,713.16",
12-Mar-23,NEFT,00.66,00.00,"4,53,713.82",
12-Mar-23,RTGS,00.00,"1,13,428.46","3,40,285.36",
12-Mar-23,Debit Card,761,00.00,"3,41,046.36",
12-Mar-23,Cash,05.00,00.00,"3,41,051.36",
12-Mar-23,Cheque,00.00,"56,841.89","2,84,209.47",
12-Mar-23,Cheque,00.00,"56,841.89","2,27,367.58",
12-Mar-23,Transportellaneous,00.00,"32,481.08","1,94,886.50",
12-Mar-23,Commission,"22,286.40",00.00,"2,17,172.90",
12-Mar-23,Debit Card,00.00,"43,434.58","1,73,738.32",
12-Mar-23,Reversal,"1,90,397.06",00.00,"3,64,135.38",
12-Mar-23,Purchase,00.00,"60,689.23","3,03,446.15",
12-Mar-23,Transportellaneous,00.00,"3,03,446.15",00.00,
12-Mar-23,Commission,524,00.00,524,
12-Mar-23,Commission,00.00,87.33,436.67,
12-Mar-23,Purchase,00.00,218.34,218.34,
12-Mar-23,Commission,"1,268.00",00.00,"1,486.34",
12-Mar-23,Cheque,00.00,185.79,"1,300.55",
12-Mar-23,Cash,51.2,00.00,"1,351.75",
12-Mar-23,Bill,00.00,168.97,"1,182.78",
12-Mar-23,Bill,14.45,00.00,"1,197.23",
12-Mar-23,Transportellaneous,56,00.00,"1,253.23",
12-Mar-23,Transfer,00.00,156.65,"1,096.58",
12-Mar-23,NEFT,00.00,182.76,913.82,
12-Mar-23,IMPS,"1,78,288.00",00.00,"1,79,201.82",
12-Mar-23,Reversal,46,00.00,"1,79,247.82",
12-Mar-23,Cash,100.94,00.00,"1,79,348.76",
12-Mar-23,Bill,00.00,"59,782.92","1,19,565.84",
12-Mar-23,Transfer,00.00,"11,956.58","1,07,609.26",
12-Mar-23,Bill,00.00,"10,760.93","96,848.33",
12-Mar-23,IMPS,00.00,"32,282.78","64,565.55",
12-Mar-23,NEFT,"24,824.74",00.00,"89,390.29",
12-Mar-23,RTGS,"87,719.12",00.00,"1,77,109.41",
12-Mar-23,IMPS,00.00,"1,77,109.41",00.00,
12-Mar-23,Debit Card,"2,02,157.30",00.00,"2,02,157.30",
13-Mar-23,Cash,"16,940.00",00.00,"2,19,097.30",
13-Mar-23,Commission,00.00,"43,819.46","1,75,277.84",
13-Mar-23,IMPS,06.71,00.00,"1,75,284.55",
13-Mar-23,Transportellaneous,"13,75,237.50",00.00,"15,50,522.05",
13-Mar-23,Commission,29,00.00,"15,50,551.05",
13-Mar-23,Tax,"2,165.73",00.00,"15,52,716.78",
13-Mar-23,Bill,00.00,"1,72,524.09","13,80,192.69",
13-Mar-23,Cash,"2,573.10",00.00,"13,82,765.79",
13-Mar-23,Commission,00.00,"2,76,553.16","11,06,212.63",
13-Mar-23,Transfer,12.2,00.00,"11,06,224.83",
13-Mar-23,Transportellaneous,"53,426.72",00.00,"11,59,651.55",
14-Mar-23,Cheque,04.68,00.00,"11,59,656.23",
14-Mar-23,RTGS,00.00,"1,15,965.62","10,43,690.61",
14-Mar-23,Cash,00.00,"1,04,369.06","9,39,321.55",
14-Mar-23,Cheque,00.00,"1,56,553.59","7,82,767.96",
14-Mar-23,Transfer,"4,054.00",00.00,"7,86,821.96",
14-Mar-23,Cheque,17.4,00.00,"7,86,839.36",
14-Mar-23,Commission,06.07,00.00,"7,86,845.43",
14-Mar-23,RTGS,27.6,00.00,"7,86,873.03",
14-Mar-23,NEFT,00.00,"7,86,873.03",00.00,
14-Mar-23,Transfer,123,00.00,123,
14-Mar-23,Tax,93.08,00.00,216.08,
14-Mar-23,IMPS,35.49,00.00,251.57,
14-Mar-23,ATM,"2,26,285.56",00.00,"2,26,537.13",
14-Mar-23,Interest,00.00,"75,512.38","1,51,024.75",
14-Mar-23,Interest,"2,20,774.00",00.00,"3,71,798.75",
14-Mar-23,Cheque,228.7,00.00,"3,72,027.45",
14-Mar-23,NEFT,18,00.00,"3,72,045.45",
14-Mar-23,Bill,"3,687.00",00.00,"3,75,732.45",
14-Mar-23,RTGS,25.7,00.00,"3,75,758.15",
14-Mar-23,Cash,49.8,00.00,"3,75,807.95",
14-Mar-23,IMPS,00.00,"46,975.99","3,28,831.96",
14-Mar-23,IMPS,00.00,"1,64,415.98","1,64,415.98",
14-Mar-23,RTGS,203.6,00.00,"1,64,619.58",
14-Mar-23,IMPS,62.3,00.00,"1,64,681.88",
14-Mar-23,ATM,"24,653.50",00.00,"1,89,335.38",
14-Mar-23,Purchase,"53,373.70",00.00,"2,42,709.08",
14-Mar-23,ATM,00.00,"60,677.27","1,82,031.81",
14-Mar-23,IMPS,18,00.00,"1,82,049.81",
14-Mar-23,Debit Card,00.00,"22,756.23","1,59,293.58",
14-Mar-23,Transfer,"3,155.47",00.00,"1,62,449.05",
14-Mar-23,Cheque,221,00.00,"1,62,670.05",
14-Mar-23,Transfer,00.00,"54,223.35","1,08,446.70",
14-Mar-23,IMPS,"4,27,379.50",00.00,"5,35,826.20",
14-Mar-23,Cash,05.00,00.00,"5,35,831.20",
14-Mar-23,Cash,"2,76,477.00",00.00,"8,12,308.20",
14-Mar-23,RTGS,00.00,"2,03,077.05","6,09,231.15",
14-Mar-23,RTGS,22.41,00.00,"6,09,253.56",
14-Mar-23,Interest,"8,675.00",00.00,"6,17,928.56",
14-Mar-23,Tax,00.00,"77,241.07","5,40,687.49",
14-Mar-23,Cheque,"1,355.10",00.00,"5,42,042.59",
14-Mar-23,ATM,39,00.00,"5,42,081.59",
14-Mar-23,Transportellaneous,"10,231.20",00.00,"5,52,312.79",
14-Mar-23,Transfer,00.00,"55,231.28","4,97,081.51",
14-Mar-23,Purchase,"14,13,863.00",00.00,"19,10,944.51",
14-Mar-23,Bill,00.00,"9,55,472.26","9,55,472.26",
14-Mar-23,Debit Card,00.00,"9,55,472.26",00.00,
14-Mar-23,Commission,03.00,00.00,03.00,
14-Mar-23,Commission,"1,274.00",00.00,"1,277.00",
14-Mar-23,Bill,13,00.00,"1,290.00",
14-Mar-23,IMPS,00.00,322.5,967.5,
14-Mar-23,Debit Card,230.81,00.00,"1,198.31",
14-Mar-23,IMPS,"31,512.70",00.00,"32,711.01",
14-Mar-23,Commission,00.00,"3,271.10","29,439.91",
14-Mar-23,Reversal,00.00,"4,205.70","25,234.21",
14-Mar-23,ATM,00.00,"12,617.11","12,617.10",
14-Mar-23,Interest,00.00,"1,802.44","10,814.66",
14-Mar-23,Bill,"1,929.00",00.00,"12,743.66",
14-Mar-23,Reversal,00.00,"1,415.96","11,327.70",
14-Mar-23,Cheque,"90,403.88",00.00,"1,01,731.58",
14-Mar-23,Cheque,03.00,00.00,"1,01,734.58",
14-Mar-23,Reversal,"27,180.00",00.00,"1,28,914.58",
15-Mar-23,Reversal,09.36,00.00,"1,28,923.94",
15-Mar-23,Reversal,00.00,"25,784.79","1,03,139.15",
15-Mar-23,Bill,00.00,"51,569.58","51,569.58",
15-Mar-23,Cash,543,00.00,"52,112.58",
15-Mar-23,Debit Card,00.00,"52,112.58",00.00,
15-Mar-23,RTGS,05.62,00.00,05.62,
15-Mar-23,Debit Card,"1,89,496.75",00.00,"1,89,502.37",
15-Mar-23,Bill,00.00,"63,167.46","1,26,334.91",
15-Mar-23,NEFT,00.00,"21,055.82","1,05,279.09",
15-Mar-23,Transfer,00.00,"10,527.91","94,751.18",
15-Mar-23,RTGS,"1,56,585.47",00.00,"2,51,336.65",
15-Mar-23,Tax,88.59,00.00,"2,51,425.24",
15-Mar-23,Reversal,"14,71,825.20",00.00,"17,23,250.44",
15-Mar-23,ATM,00.00,"1,91,472.27","15,31,778.17",
16-Mar-23,Cheque,"17,40,542.75",00.00,"32,72,320.92",
16-Mar-23,NEFT,00.00,"4,09,040.12","28,63,280.80",
16-Mar-23,Tax,00.00,"9,54,426.93","19,08,853.87",
16-Mar-23,Cheque,00.00,"3,18,142.31","15,90,711.56",
16-Mar-23,Purchase,"6,40,337.75",00.00,"22,31,049.31",
16-Mar-23,Debit Card,"26,953.90",00.00,"22,58,003.21",
16-Mar-23,NEFT,430.3,00.00,"22,58,433.51",
16-Mar-23,NEFT,00.00,"7,52,811.17","15,05,622.34",
16-Mar-23,Reversal,00.00,"3,76,405.59","11,29,216.76",
16-Mar-23,NEFT,00.00,"5,64,608.38","5,64,608.38",
16-Mar-23,Bill,446.05,00.00,"5,65,054.43",
16-Mar-23,Commission,00.00,"1,13,010.89","4,52,043.54",
16-Mar-23,NEFT,"22,719.40",00.00,"4,74,762.94",
16-Mar-23,Commission,35.95,00.00,"4,74,798.89",
16-Mar-23,Purchase,00.00,"59,349.86","4,15,449.03",
17-Mar-23,Debit Card,47.21,00.00,"4,15,496.24",
17-Mar-23,Bill,00.00,"51,937.03","3,63,559.21",
17-Mar-23,NEFT,"2,575.60",00.00,"3,66,134.81",
17-Mar-23,Debit Card,02.84,00.00,"3,66,137.65",
17-Mar-23,ATM,280.25,00.00,"3,66,417.90",
17-Mar-23,Bill,"1,886.43",00.00,"3,68,304.33",
17-Mar-23,Cheque,00.00,"1,84,152.17","1,84,152.16",
17-Mar-23,IMPS,"27,599.10",00.00,"2,11,751.26",
17-Mar-23,Cash,"1,556.00",00.00,"2,13,307.26",
17-Mar-23,Tax,00.00,"53,326.82","1,59,980.44",
17-Mar-23,Debit Card,32.82,00.00,"1,60,013.26",
17-Mar-23,RTGS,"2,13,056.80",00.00,"3,73,070.06",
17-Mar-23,RTGS,"15,759.00",00.00,"3,88,829.06",
17-Mar-23,Cash,04.45,00.00,"3,88,833.51",
17-Mar-23,IMPS,00.00,"77,766.70","3,11,066.81",
18-Mar-23,Purchase,00.00,"31,106.68","2,79,960.13",
18-Mar-23,Reversal,00.00,"55,992.03","2,23,968.10",
18-Mar-23,Interest,06.00,00.00,"2,23,974.10",
18-Mar-23,Cheque,00.00,"44,794.82","1,79,179.28",
18-Mar-23,Transportellaneous,05.00,00.00,"1,79,184.28",
18-Mar-23,Debit Card,00.00,"44,796.07","1,34,388.21",
18-Mar-23,Transportellaneous,00.00,"67,194.11","67,194.10",
18-Mar-23,Purchase,00.00,"7,466.01","59,728.09",
18-Mar-23,Cheque,00.00,"29,864.05","29,864.04",
18-Mar-23,Tax,00.00,"5,972.81","23,891.23",
18-Mar-23,Interest,00.00,"2,986.40","20,904.83",
18-Mar-23,RTGS,10.6,00.00,"20,915.43",
18-Mar-23,Cash,228.8,00.00,"21,144.23",
18-Mar-23,Reversal,47,00.00,"21,191.23",
18-Mar-23,Commission,"3,193.47",00.00,"24,384.70",
18-Mar-23,Tax,00.00,"3,048.09","21,336.61",
18-Mar-23,IMPS,00.00,"3,556.10","17,780.51",
18-Mar-23,Debit Card,00.00,"5,926.84","11,853.67",
18-Mar-23,Tax,25,00.00,"11,878.67",
18-Mar-23,Cheque,57.22,00.00,"11,935.89",
18-Mar-23,Tax,00.00,"5,967.95","5,967.94",
18-Mar-23,Interest,00.00,745.99,"5,221.95",
18-Mar-23,Tax,00.00,"5,221.95",00.00,
18-Mar-23,Transportellaneous,58.82,00.00,58.82,
18-Mar-23,Transportellaneous,00.00,06.54,52.28,
18-Mar-23,Reversal,"19,15,781.00",00.00,"19,15,833.28",
18-Mar-23,Transfer,02.50,00.00,"19,15,835.78",
18-Mar-23,Interest,60.74,00.00,"19,15,896.52",
18-Mar-23,Transfer,00.00,"2,12,877.39","17,03,019.13",
18-Mar-23,Reversal,57,00.00,"17,03,076.13",
18-Mar-23,Tax,490.22,00.00,"17,03,566.35",
18-Mar-23,Transfer,00.00,"5,67,855.45","11,35,710.90",
18-Mar-23,Bill,317.53,00.00,"11,36,028.43",
18-Mar-23,Commission,00.00,"1,62,289.78","9,73,738.65",
18-Mar-23,IMPS,"5,24,079.00",00.00,"14,97,817.65",
18-Mar-23,Tax,00.00,"1,49,781.77","13,48,035.88",
18-Mar-23,Reversal,00.00,"1,34,803.59","12,13,232.29",
18-Mar-23,Reversal,273.61,00.00,"12,13,505.90",
18-Mar-23,Reversal,"22,398.03",00.00,"12,35,903.93",
18-Mar-23,Bill,"27,813.00",00.00,"12,63,716.93",
18-Mar-23,Purchase,"20,71,591.25",00.00,"33,35,308.18",
18-Mar-23,Transportellaneous,00.00,"3,33,530.82","30,01,777.36",
18-Mar-23,Bill,00.00,"3,33,530.82","26,68,246.54",
18-Mar-23,NEFT,05.70,00.00,"26,68,252.24",
18-Mar-23,Reversal,"3,52,746.20",00.00,"30,20,998.44",
18-Mar-23,IMPS,413.8,00.00,"30,21,412.24",
18-Mar-23,Transfer,05.00,00.00,"30,21,417.24",
18-Mar-23,Commission,440.05,00.00,"30,21,857.29",
19-Mar-23,Transportellaneous,00.00,"15,10,928.65","15,10,928.64",
19-Mar-23,Interest,00.00,"1,88,866.08","13,22,062.56",
19-Mar-23,Transportellaneous,00.00,"1,32,206.26","11,89,856.30",
19-Mar-23,Debit Card,00.00,"2,97,464.08","8,92,392.23",
19-Mar-23,Debit Card,"5,69,680.20",00.00,"14,62,072.43",
19-Mar-23,NEFT,00.00,"7,31,036.22","7,31,036.22",
19-Mar-23,Tax,"13,76,013.75",00.00,"21,07,049.97",
19-Mar-23,Transportellaneous,"5,80,307.50",00.00,"26,87,357.47",
19-Mar-23,RTGS,00.00,"3,35,919.68","23,51,437.79",
19-Mar-23,Interest,27,00.00,"23,51,464.79",
19-Mar-23,Interest,"16,49,280.75",00.00,"40,00,745.54",
19-Mar-23,NEFT,147.83,00.00,"40,00,893.37",
19-Mar-23,Tax,00.00,"8,00,178.67","32,00,714.70",
19-Mar-23,Transfer,00.00,"16,00,357.35","16,00,357.35",
19-Mar-23,Transportellaneous,35,00.00,"16,00,392.35",
19-Mar-23,Cash,"7,09,482.00",00.00,"23,09,874.35",
19-Mar-23,Transportellaneous,00.00,"5,77,468.59","17,32,405.76",
19-Mar-23,Commission,"2,08,531.00",00.00,"19,40,936.76",
19-Mar-23,Bill,07.20,00.00,"19,40,943.96",
19-Mar-23,Reversal,"14,628.60",00.00,"19,55,572.56",
19-Mar-23,Cheque,00.00,"19,55,572.56",00.00,
19-Mar-23,Transportellaneous,"2,25,683.80",00.00,"2,25,683.80",
19-Mar-23,Cheque,00.00,"37,613.97","1,88,069.83",
19-Mar-23,Debit Card,02.20,00.00,"1,88,072.03",
19-Mar-23,Cash,00.00,"94,036.02","94,036.02",
19-Mar-23,Transfer,00.00,"18,807.20","75,228.82",
19-Mar-23,Cash,220.91,00.00,"75,449.73",
19-Mar-23,NEFT,00.00,"12,574.96","62,874.77",
19-Mar-23,Transportellaneous,"16,46,210.00",00.00,"17,09,084.77",
19-Mar-23,Commission,00.00,"4,27,271.19","12,81,813.58",
19-Mar-23,Bill,00.00,"6,40,906.79","6,40,906.79",
19-Mar-23,Debit Card,04.53,00.00,"6,40,911.32",
19-Mar-23,ATM,"5,88,773.20",00.00,"12,29,684.52",
19-Mar-23,Interest,476,00.00,"12,30,160.52",
19-Mar-23,IMPS,01.00,00.00,"12,30,161.52",
19-Mar-23,Debit Card,52.6,00.00,"12,30,214.12",
19-Mar-23,NEFT,"1,963.95",00.00,"12,32,178.07",
19-Mar-23,Bill,00.00,"12,32,178.07",00.00,
19-Mar-23,NEFT,46.1,00.00,46.1,
19-Mar-23,Tax,60,00.00,106.1,
19-Mar-23,Reversal,160,00.00,266.1,
19-Mar-23,Tax,04.40,00.00,270.5,
19-Mar-23,Tax,00.00,67.63,202.88,
19-Mar-23,RTGS,18,00.00,220.88,
19-Mar-23,ATM,"6,05,134.00",00.00,"6,05,354.88",
19-Mar-23,Purchase,339.44,00.00,"6,05,694.32",
19-Mar-23,Cheque,00.00,"6,05,694.32",00.00,
19-Mar-23,NEFT,"1,587.40",00.00,"1,587.40",
19-Mar-23,NEFT,00.00,158.74,"1,428.66",
19-Mar-23,Purchase,00.00,204.09,"1,224.57",
19-Mar-23,ATM,00.00,136.06,"1,088.51",
19-Mar-23,IMPS,00.00,181.42,907.09,
19-Mar-23,IMPS,04.80,00.00,911.89,
19-Mar-23,Debit Card,"19,695.00",00.00,"20,606.89",
19-Mar-23,NEFT,"2,381.00",00.00,"22,987.89",
19-Mar-23,Commission,00.00,"11,493.95","11,493.94",
19-Mar-23,RTGS,02.74,00.00,"11,496.68",
19-Mar-23,Purchase,"2,730.06",00.00,"14,226.74",
19-Mar-23,Interest,00.00,"4,742.25","9,484.49",
19-Mar-23,NEFT,00.00,"2,371.12","7,113.37",
19-Mar-23,ATM,00.00,"7,113.37",00.00,
19-Mar-23,Cheque,30,00.00,30,
19-Mar-23,Cash,00.00,03.00,27,
19-Mar-23,NEFT,00.00,03.86,23.14,
19-Mar-23,Commission,00.00,03.31,19.83,
19-Mar-23,Transportellaneous,00.00,03.97,15.86,
19-Mar-23,Cash,364.78,00.00,380.64,
19-Mar-23,Reversal,00.00,38.06,342.58,
19-Mar-23,Commission,00.00,57.1,285.48,
20-Mar-23,Cash,16,00.00,301.48,
20-Mar-23,ATM,07.00,00.00,308.48,
21-Mar-23,Transportellaneous,00.00,44.07,264.41,
21-Mar-23,Commission,00.00,66.1,198.31,
21-Mar-23,Cash,09.81,00.00,208.12,
21-Mar-23,Bill,295.4,00.00,503.52,
21-Mar-23,Transfer,00.00,71.93,431.59,
21-Mar-23,Cash,00.00,215.8,215.8,
21-Mar-23,NEFT,"3,199.40",00.00,"3,415.20",
21-Mar-23,Tax,00.00,853.8,"2,561.40",
21-Mar-23,Cash,"48,195.19",00.00,"50,756.59",
21-Mar-23,IMPS,"7,525.10",00.00,"58,281.69",
21-Mar-23,Commission,00.00,"5,828.17","52,453.52",
21-Mar-23,Transfer,00.00,"10,490.70","41,962.82",
21-Mar-23,Transportellaneous,"2,247.32",00.00,"44,210.14",
21-Mar-23,Cash,"1,382.00",00.00,"45,592.14",
21-Mar-23,ATM,474.64,00.00,"46,066.78",
21-Mar-23,Debit Card,00.00,"9,213.36","36,853.42",
21-Mar-23,Cash,00.00,"7,370.68","29,482.74",
21-Mar-23,Cash,"90,973.91",00.00,"1,20,456.65",
21-Mar-23,NEFT,00.00,"30,114.16","90,342.49",
21-Mar-23,Cash,00.00,"90,342.49",00.00,
21-Mar-23,Cheque,00.10,00.00,00.10,
21-Mar-23,RTGS,"14,78,578.20",00.00,"14,78,578.30",
21-Mar-23,Transportellaneous,"29,677.00",00.00,"15,08,255.30",
21-Mar-23,Cheque,00.00,"1,88,531.91","13,19,723.39",
21-Mar-23,Transfer,54,00.00,"13,19,777.39",
21-Mar-23,RTGS,"2,45,474.70",00.00,"15,65,252.09",
21-Mar-23,Transfer,00.00,"5,21,750.70","10,43,501.39",
21-Mar-23,Cheque,"15,506.00",00.00,"10,59,007.39",
21-Mar-23,Transfer,00.00,"1,51,286.77","9,07,720.62",
21-Mar-23,Bill,590.55,00.00,"9,08,311.17",
21-Mar-23,Cash,28.9,00.00,"9,08,340.07",
21-Mar-23,NEFT,00.00,"90,834.01","8,17,506.06",
21-Mar-23,Purchase,106,00.00,"8,17,612.06",
21-Mar-23,Transfer,00.00,"1,36,268.68","6,81,343.38",
21-Mar-23,Commission,00.00,"97,334.77","5,84,008.61",
21-Mar-23,NEFT,492.4,00.00,"5,84,501.01",
21-Mar-23,Interest,15,00.00,"5,84,516.01",
21-Mar-23,Transfer,"2,07,519.78",00.00,"7,92,035.79",
21-Mar-23,Transportellaneous,00.00,"2,64,011.93","5,28,023.86",
21-Mar-23,Tax,00.00,"52,802.39","4,75,221.47",
21-Mar-23,RTGS,"15,638.00",00.00,"4,90,859.47",
21-Mar-23,Commission,"2,17,052.16",00.00,"7,07,911.63",
21-Mar-23,Cash,00.00,"88,488.95","6,19,422.68",
21-Mar-23,Tax,"1,37,201.84",00.00,"7,56,624.52",
21-Mar-23,IMPS,00.00,"1,51,324.90","6,05,299.62",
21-Mar-23,Cheque,"8,941.00",00.00,"6,14,240.62",
22-Mar-23,Transportellaneous,01.33,00.00,"6,14,241.95",
22-Mar-23,Purchase,00.00,"61,424.20","5,52,817.76",
22-Mar-23,Tax,00.00,"61,424.20","4,91,393.56",
22-Mar-23,Cheque,00.00,"49,139.36","4,42,254.20",
22-Mar-23,Transportellaneous,00.00,"1,47,418.07","2,94,836.13",
22-Mar-23,ATM,"1,32,891.00",00.00,"4,27,727.13",
22-Mar-23,IMPS,"3,54,946.50",00.00,"7,82,673.63",
22-Mar-23,Purchase,00.00,"1,30,445.61","6,52,228.02",
22-Mar-23,Cheque,"13,824.44",00.00,"6,66,052.46",
22-Mar-23,RTGS,"1,933.00",00.00,"6,67,985.46",
22-Mar-23,Debit Card,00.00,"66,798.55","6,01,186.91",
22-Mar-23,Transfer,00.00,"60,118.69","5,41,068.22",
23-Mar-23,Interest,00.00,"60,118.69","4,80,949.53",
23-Mar-23,Transportellaneous,00.00,"2,40,474.77","2,40,474.76",
23-Mar-23,IMPS,"14,981.38",00.00,"2,55,456.14",
23-Mar-23,IMPS,00.00,"1,27,728.07","1,27,728.07",
23-Mar-23,RTGS,00.00,"25,545.61","1,02,182.46",
23-Mar-23,ATM,"2,22,062.00",00.00,"3,24,244.46",
23-Mar-23,ATM,"79,366.44",00.00,"4,03,610.90",
23-Mar-23,ATM,"1,63,370.41",00.00,"5,66,981.31",
23-Mar-23,RTGS,00.00,"80,997.33","4,85,983.98",
23-Mar-23,IMPS,48.77,00.00,"4,86,032.75",
23-Mar-23,NEFT,"14,27,118.50",00.00,"19,13,151.25",
23-Mar-23,Tax,07.59,00.00,"19,13,158.84",
23-Mar-23,NEFT,00.00,"2,12,573.20","17,00,585.64",
23-Mar-23,Tax,00.00,"1,88,953.96","15,11,631.68",
23-Mar-23,IMPS,579,00.00,"15,12,210.68",
23-Mar-23,Purchase,00.00,"2,52,035.11","12,60,175.57",
23-Mar-23,Transfer,00.00,"1,26,017.56","11,34,158.01",
23-Mar-23,Transfer,00.00,"1,13,415.80","10,20,742.21",
23-Mar-23,IMPS,00.00,"2,04,148.44","8,16,593.77",
23-Mar-23,Transfer,00.00,"1,63,318.75","6,53,275.02",
23-Mar-23,Transfer,00.00,"1,08,879.17","5,44,395.85",
23-Mar-23,ATM,07.00,00.00,"5,44,402.85",
23-Mar-23,IMPS,02.36,00.00,"5,44,405.21",
23-Mar-23,Cheque,"24,968.00",00.00,"5,69,373.21",
23-Mar-23,IMPS,00.00,"2,84,686.61","2,84,686.60",
23-Mar-23,Commission,30.68,00.00,"2,84,717.28",
23-Mar-23,Reversal,00.00,"40,673.90","2,44,043.38",
23-Mar-23,Cheque,00.00,"81,347.79","1,62,695.59",
23-Mar-23,IMPS,49,00.00,"1,62,744.59",
23-Mar-23,NEFT,"14,94,400.00",00.00,"16,57,144.59",
23-Mar-23,IMPS,"1,61,199.00",00.00,"18,18,343.59",
23-Mar-23,Debit Card,00.00,"3,03,057.27","15,15,286.33",
23-Mar-23,Reversal,00.00,"5,05,095.44","10,10,190.89",
23-Mar-23,Reversal,00.00,"2,02,038.18","8,08,152.71",
23-Mar-23,Tax,00.00,"2,69,384.24","5,38,768.47",
23-Mar-23,Interest,"4,617.00",00.00,"5,43,385.47",
23-Mar-23,NEFT,"18,74,026.00",00.00,"24,17,411.47",
23-Mar-23,Interest,"4,016.00",00.00,"24,21,427.47",
23-Mar-23,Bill,"1,85,649.44",00.00,"26,07,076.91",
23-Mar-23,ATM,00.00,"5,21,415.38","20,85,661.53",
23-Mar-23,NEFT,"2,11,605.00",00.00,"22,97,266.53",
24-Mar-23,Bill,00.00,"7,65,755.51","15,31,511.02",
24-Mar-23,Purchase,00.00,"1,91,438.88","13,40,072.14",
24-Mar-23,NEFT,"1,543.10",00.00,"13,41,615.24",
24-Mar-23,Cheque,"12,64,224.00",00.00,"26,05,839.24",
24-Mar-23,RTGS,"2,683.00",00.00,"26,08,522.24",
24-Mar-23,Bill,00.00,"4,34,753.71","21,73,768.53",
24-Mar-23,NEFT,00.00,"10,86,884.27","10,86,884.26",
24-Mar-23,IMPS,01.00,00.00,"10,86,885.26",
24-Mar-23,Tax,"12,350.98",00.00,"10,99,236.24",
24-Mar-23,Tax,394,00.00,"10,99,630.24",
24-Mar-23,Cheque,02.40,00.00,"10,99,632.64",
24-Mar-23,ATM,06.47,00.00,"10,99,639.11",
24-Mar-23,Commission,"2,45,186.00",00.00,"13,44,825.11",
24-Mar-23,ATM,"8,10,295.50",00.00,"21,55,120.61",
24-Mar-23,NEFT,00.00,"3,07,874.37","18,47,246.24",
24-Mar-23,ATM,00.00,"2,05,249.58","16,41,996.66",
24-Mar-23,Transportellaneous,"14,16,452.75",00.00,"30,58,449.41",
24-Mar-23,RTGS,35,00.00,"30,58,484.41",
24-Mar-23,Reversal,"2,258.70",00.00,"30,60,743.11",
24-Mar-23,IMPS,00.00,"4,37,249.02","26,23,494.09",
24-Mar-23,NEFT,"8,866.37",00.00,"26,32,360.46",
25-Mar-23,RTGS,00.00,"3,76,051.49","22,56,308.97",
25-Mar-23,Bill,"1,389.93",00.00,"22,57,698.90",
25-Mar-23,ATM,00.00,"2,25,769.89","20,31,929.01",
25-Mar-23,Purchase,00.00,"6,77,309.67","13,54,619.34",
25-Mar-23,Tax,"2,07,937.00",00.00,"15,62,556.34",
25-Mar-23,Bill,00.00,"15,62,556.34",00.00,
25-Mar-23,Purchase,324,00.00,324,
25-Mar-23,Bill,184.4,00.00,508.4,
25-Mar-23,Bill,11.1,00.00,519.5,
25-Mar-23,Commission,00.00,74.21,445.29,
25-Mar-23,Transportellaneous,00.00,63.61,381.68,
25-Mar-23,Reversal,"11,196.30",00.00,"11,577.98",
25-Mar-23,Debit Card,"1,213.68",00.00,"12,791.66",
25-Mar-23,RTGS,00.00,"1,421.30","11,370.36",
25-Mar-23,Transfer,00.00,"2,842.59","8,527.77",
25-Mar-23,Commission,00.00,"4,263.89","4,263.88",
25-Mar-23,Debit Card,"3,439.74",00.00,"7,703.62",
25-Mar-23,Tax,00.00,"1,925.91","5,777.72",
25-Mar-23,NEFT,412.82,00.00,"6,190.54",
25-Mar-23,Purchase,38.9,00.00,"6,229.44",
26-Mar-23,Transfer,00.00,"3,114.72","3,114.72",
26-Mar-23,Reversal,00.00,778.68,"2,336.04",
26-Mar-23,NEFT,"14,92,398.00",00.00,"14,94,734.04",
26-Mar-23,ATM,"27,804.70",00.00,"15,22,538.74",
26-Mar-23,Transfer,00.00,"1,52,253.87","13,70,284.87",
26-Mar-23,IMPS,"8,05,199.20",00.00,"21,75,484.07",
27-Mar-23,NEFT,00.00,"2,17,548.41","19,57,935.66",
27-Mar-23,RTGS,00.00,"2,17,548.41","17,40,387.25",
27-Mar-23,Commission,00.00,"4,35,096.81","13,05,290.44",
27-Mar-23,Tax,149,00.00,"13,05,439.44",
27-Mar-23,Transportellaneous,00.00,"1,30,543.94","11,74,895.50",
27-Mar-23,ATM,57.34,00.00,"11,74,952.84",
27-Mar-23,Debit Card,00.00,"1,30,550.32","10,44,402.52",
27-Mar-23,Debit Card,00.00,"5,22,201.26","5,22,201.26",
27-Mar-23,Cash,00.00,"58,022.36","4,64,178.90",
27-Mar-23,Commission,65.31,00.00,"4,64,244.21",
27-Mar-23,Debit Card,00.00,"58,030.53","4,06,213.68",
27-Mar-23,Bill,"9,84,952.20",00.00,"13,91,165.88",
27-Mar-23,Cheque,03.09,00.00,"13,91,168.97",
27-Mar-23,Bill,00.00,"1,39,116.90","12,52,052.07",
27-Mar-23,Commission,00.00,"2,50,410.41","10,01,641.66",
27-Mar-23,Bill,00.20,00.00,"10,01,641.86",
27-Mar-23,Debit Card,489.08,00.00,"10,02,130.94",
27-Mar-23,Reversal,00.00,"1,25,266.37","8,76,864.57",
27-Mar-23,Reversal,"2,51,446.80",00.00,"11,28,311.37",
27-Mar-23,Transfer,22.5,00.00,"11,28,333.87",
27-Mar-23,Transportellaneous,00.00,"1,41,041.73","9,87,292.14",
27-Mar-23,RTGS,00.00,"9,87,292.14",00.00,
27-Mar-23,Tax,"13,03,249.50",00.00,"13,03,249.50",
27-Mar-23,Bill,00.00,"1,44,805.50","11,58,444.00",
27-Mar-23,Cash,322,00.00,"11,58,766.00",
27-Mar-23,IMPS,"98,302.00",00.00,"12,57,068.00",
27-Mar-23,ATM,"14,414.00",00.00,"12,71,482.00",
27-Mar-23,IMPS,00.00,"2,54,296.40","10,17,185.60",
27-Mar-23,Transportellaneous,00.00,"10,17,185.60",00.00,
27-Mar-23,Cheque,25.1,00.00,25.1,
28-Mar-23,RTGS,00.00,03.59,21.51,
29-Mar-23,Debit Card,05.20,00.00,26.71,
29-Mar-23,IMPS,02.00,00.00,28.71,
29-Mar-23,Cheque,00.00,03.59,25.12,
29-Mar-23,Tax,338,00.00,363.12,
29-Mar-23,ATM,"3,70,346.20",00.00,"3,70,709.32",
29-Mar-23,Commission,00.00,"1,23,569.77","2,47,139.55",
29-Mar-23,Commission,00.00,"61,784.89","1,85,354.66",
29-Mar-23,Debit Card,"3,821.75",00.00,"1,89,176.41",
29-Mar-23,Purchase,00.00,"27,025.20","1,62,151.21",
29-Mar-23,ATM,45.29,00.00,"1,62,196.50",
29-Mar-23,NEFT,00.00,"16,219.65","1,45,976.85",
29-Mar-23,Interest,63.5,00.00,"1,46,040.35",
29-Mar-23,Bill,"8,472.00",00.00,"1,54,512.35",
29-Mar-23,Bill,00.00,"15,451.24","1,39,061.12",
29-Mar-23,Purchase,00.00,"19,865.87","1,19,195.25",
29-Mar-23,Debit Card,"73,906.40",00.00,"1,93,101.65",
29-Mar-23,RTGS,"11,326.80",00.00,"2,04,428.45",
29-Mar-23,Interest,03.00,00.00,"2,04,431.45",
29-Mar-23,NEFT,00.00,"51,107.86","1,53,323.59",
29-Mar-23,RTGS,00.00,"25,553.93","1,27,769.66",
29-Mar-23,Interest,06.30,00.00,"1,27,775.96",
29-Mar-23,RTGS,337.81,00.00,"1,28,113.77",
29-Mar-23,ATM,00.00,"42,704.59","85,409.18",
29-Mar-23,Transportellaneous,332.9,00.00,"85,742.08",
29-Mar-23,Interest,04.27,00.00,"85,746.35",
29-Mar-23,Tax,00.00,"17,149.27","68,597.08",
29-Mar-23,Interest,00.00,"13,719.42","54,877.66",
29-Mar-23,Transfer,"9,391.57",00.00,"64,269.23",
29-Mar-23,Cheque,01.10,00.00,"64,270.33",
30-Mar-23,Transfer,00.00,"12,854.07","51,416.26",
30-Mar-23,Debit Card,00.00,"12,854.07","38,562.20",
30-Mar-23,NEFT,"5,62,496.00",00.00,"6,01,058.20",
30-Mar-23,NEFT,"4,46,591.20",00.00,"10,47,649.40",
30-Mar-23,Debit Card,"1,54,465.00",00.00,"12,02,114.40",
30-Mar-23,RTGS,06.74,00.00,"12,02,121.14",
30-Mar-23,Interest,539,00.00,"12,02,660.14",
30-Mar-23,NEFT,00.00,"1,20,266.01","10,82,394.13",
30-Mar-23,Commission,"99,850.50",00.00,"11,82,244.63",
30-Mar-23,Commission,"1,428.94",00.00,"11,83,673.57",
30-Mar-23,IMPS,00.00,"1,69,096.22","10,14,577.35",
30-Mar-23,Bill,00.00,"1,44,939.62","8,69,637.73",
30-Mar-23,RTGS,00.00,"2,89,879.24","5,79,758.49",
30-Mar-23,Interest,215.8,00.00,"5,79,974.29",
30-Mar-23,IMPS,00.00,"2,89,987.15","2,89,987.14",
30-Mar-23,NEFT,00.00,"1,44,993.57","1,44,993.57",
30-Mar-23,Reversal,00.00,"14,499.36","1,30,494.21",
30-Mar-23,Transfer,14.31,00.00,"1,30,508.52",
30-Mar-23,NEFT,00.00,"26,101.70","1,04,406.82",
30-Mar-23,Debit Card,00.00,"26,101.71","78,305.12",
30-Mar-23,Cash,00.00,"19,576.28","58,728.84",
30-Mar-23,Reversal,"1,83,723.09",00.00,"2,42,451.93",
30-Mar-23,Interest,00.00,"30,306.49","2,12,145.44",
30-Mar-23,IMPS,00.00,"26,518.18","1,85,627.26",
30-Mar-23,Purchase,"1,95,512.00",00.00,"3,81,139.26",
30-Mar-23,Interest,00.00,"95,284.82","2,85,854.44",
30-Mar-23,Tax,"14,17,601.50",00.00,"17,03,455.94",
30-Mar-23,Commission,00.00,"17,03,455.94",00.00,
30-Mar-23,Bill,"10,477.00",00.00,"10,477.00",
30-Mar-23,RTGS,00.00,"1,746.17","8,730.83",
30-Mar-23,Debit Card,00.00,"1,746.17","6,984.66",
30-Mar-23,Reversal,00.00,"1,746.17","5,238.50",
30-Mar-23,Debit Card,00.00,654.81,"4,583.69",
30-Mar-23,ATM,00.00,"1,145.92","3,437.77",
30-Mar-23,IMPS,00.00,572.96,"2,864.81",
30-Mar-23,Bill,"3,400.05",00.00,"6,264.86",
30-Mar-23,IMPS,"13,56,513.00",00.00,"13,62,777.86",
30-Mar-23,Purchase,00.00,"1,94,682.55","11,68,095.31",
30-Mar-23,Reversal,13.4,00.00,"11,68,108.71",
30-Mar-23,Purchase,"1,00,603.00",00.00,"12,68,711.71",
30-Mar-23,Purchase,00.00,"12,68,711.71",00.00,
30-Mar-23,Transfer,"22,164.00",00.00,"22,164.00",
30-Mar-23,IMPS,00.00,"3,166.29","18,997.71",
30-Mar-23,Transportellaneous,00.00,"2,110.86","16,886.85",
30-Mar-23,Reversal,00.00,"8,443.43","8,443.42",
30-Mar-23,Transfer,158.82,00.00,"8,602.24",
30-Mar-23,Tax,00.00,"8,602.24",00.00,
30-Mar-23,Cash,"27,373.00",00.00,"27,373.00",
30-Mar-23,Tax,"7,242.50",00.00,"34,615.50",
30-Mar-23,Reversal,59.3,00.00,"34,674.80",
30-Mar-23,Reversal,"20,609.00",00.00,"55,283.80",
30-Mar-23,IMPS,00.00,"6,910.48","48,373.32",
30-Mar-23,Reversal,00.00,"5,374.81","42,998.51",
30-Mar-23,RTGS,00.00,"6,142.64","36,855.87",
30-Mar-23,Cash,00.00,"9,213.97","27,641.90",
30-Mar-23,Purchase,00.00,"3,071.32","24,570.58",
30-Mar-23,Interest,00.00,"3,071.32","21,499.26",
30-Mar-23,Commission,00.00,"21,499.26",00.00,
30-Mar-23,Bill,229.8,00.00,229.8,
30-Mar-23,Bill,00.00,76.6,153.2,
30-Mar-23,Debit Card,00.00,15.32,137.88,
30-Mar-23,RTGS,00.00,34.47,103.41,
30-Mar-23,IMPS,06.00,00.00,109.41,
30-Mar-23,RTGS,05.90,00.00,115.31,
30-Mar-23,ATM,00.00,16.47,98.84,
30-Mar-23,Cheque,19,00.00,117.84,
30-Mar-23,NEFT,"11,872.00",00.00,"11,989.84",
30-Mar-23,Reversal,00.00,"3,996.61","7,993.23",
30-Mar-23,Commission,95.2,00.00,"8,088.43",
30-Mar-23,Reversal,00.00,"2,696.14","5,392.29",
30-Mar-23,Interest,04.15,00.00,"5,396.44",
30-Mar-23,Reversal,00.00,"1,798.81","3,597.63",
30-Mar-23,Reversal,"2,95,428.00",00.00,"2,99,025.63",
30-Mar-23,Debit Card,00.00,"2,99,025.63",00.00,
30-Mar-23,Transportellaneous,435,00.00,435,
30-Mar-23,Cash,00.00,217.5,217.5,
30-Mar-23,ATM,"57,181.90",00.00,"57,399.40",
30-Mar-23,Commission,23.04,00.00,"57,422.44",
30-Mar-23,Cash,00.00,"11,484.49","45,937.95",
30-Mar-23,Interest,63.1,00.00,"46,001.05",
30-Mar-23,Tax,33.6,00.00,"46,034.65",
30-Mar-23,Reversal,00.00,"46,034.65",00.00,
30-Mar-23,Commission,"1,68,243.44",00.00,"1,68,243.44",
30-Mar-23,Commission,00.00,"42,060.86","1,26,182.58",
30-Mar-23,Transportellaneous,00.00,"63,091.29","63,091.29",
30-Mar-23,Interest,08.60,00.00,"63,099.89",
30-Mar-23,ATM,"37,730.81",00.00,"1,00,830.70",
30-Mar-23,Debit Card,"1,63,640.00",00.00,"2,64,470.70",
30-Mar-23,Reversal,00.00,"44,078.45","2,20,392.25",
30-Mar-23,Debit Card,"1,140.30",00.00,"2,21,532.55",
30-Mar-23,Purchase,05.75,00.00,"2,21,538.30",
30-Mar-23,Transportellaneous,00.00,"27,692.29","1,93,846.01",
30-Mar-23,Transportellaneous,00.00,"96,923.01","96,923.00",
30-Mar-23,NEFT,00.00,"10,769.22","86,153.78",
30-Mar-23,IMPS,"18,28,076.50",00.00,"19,14,230.28",
30-Mar-23,Tax,"3,120.60",00.00,"19,17,350.88",
30-Mar-23,Reversal,02.59,00.00,"19,17,353.47",
30-Mar-23,IMPS,"3,534.00",00.00,"19,20,887.47",
30-Mar-23,Reversal,"6,52,615.50",00.00,"25,73,502.97",
30-Mar-23,Commission,00.00,"8,57,834.32","17,15,668.65",
30-Mar-23,ATM,00.00,"1,71,566.87","15,44,101.78",
30-Mar-23,NEFT,"11,49,333.00",00.00,"26,93,434.78",
30-Mar-23,Debit Card,"1,838.60",00.00,"26,95,273.38",
30-Mar-23,Transportellaneous,11.07,00.00,"26,95,284.45",
30-Mar-23,Purchase,16.6,00.00,"26,95,301.05",
30-Mar-23,Transportellaneous,00.00,"8,98,433.68","17,96,867.37",
30-Mar-23,Reversal,00.00,"1,99,651.93","15,97,215.44",
30-Mar-23,Interest,431,00.00,"15,97,646.44",
30-Mar-23,Debit Card,01.81,00.00,"15,97,648.25",
30-Mar-23,Reversal,00.00,"3,99,412.06","11,98,236.19",
30-Mar-23,IMPS,00.00,"1,19,823.62","10,78,412.57",
30-Mar-23,Transportellaneous,"1,95,086.03",00.00,"12,73,498.60",
30-Mar-23,Tax,00.00,"2,12,249.77","10,61,248.83",
31-Mar-23,Tax,00.00,"3,53,749.61","7,07,499.22",
31-Mar-23,Commission,00.00,"2,35,833.07","4,71,666.15",
31-Mar-23,IMPS,00.00,"52,407.35","4,19,258.80",
31-Mar-23,Cash,00.30,00.00,"4,19,259.10",
31-Mar-23,Purchase,03.58,00.00,"4,19,262.68",
31-Mar-23,Reversal,00.00,"46,584.74","3,72,677.94",
01-Apr-23,Reversal,08.00,00.00,"3,72,685.94",
01-Apr-23,Tax,"14,78,728.00",00.00,"18,51,413.94",
01-Apr-23,Bill,00.00,"2,64,487.71","15,86,926.23",
01-Apr-23,ATM,00.00,"5,28,975.41","10,57,950.82",
01-Apr-23,RTGS,00.00,"2,64,487.71","7,93,463.12",
01-Apr-23,Interest,"2,802.00",00.00,"7,96,265.12",
01-Apr-23,Interest,00.00,"1,32,710.85","6,63,554.27",
02-Apr-23,Transportellaneous,00.00,"1,10,592.38","5,52,961.89",
02-Apr-23,ATM,00.00,"2,76,480.95","2,76,480.94",
02-Apr-23,Transportellaneous,"2,127.00",00.00,"2,78,607.94",
02-Apr-23,Transportellaneous,00.00,"30,956.44","2,47,651.50",
02-Apr-23,Transportellaneous,00.00,"1,23,825.75","1,23,825.75",
02-Apr-23,Debit Card,00.00,"24,765.15","99,060.60",
03-Apr-23,IMPS,"2,901.20",00.00,"1,01,961.80",
03-Apr-23,Purchase,00.00,"25,490.45","76,471.35",
03-Apr-23,Commission,"3,646.41",00.00,"80,117.76",
03-Apr-23,Purchase,00.30,00.00,"80,118.06",
03-Apr-23,ATM,00.00,"26,706.02","53,412.04",
03-Apr-23,ATM,00.00,"53,412.04",00.00,
03-Apr-23,Transportellaneous,"11,98,133.50",00.00,"11,98,133.50",
03-Apr-23,Tax,36,00.00,"11,98,169.50",
03-Apr-23,Purchase,00.00,"1,19,816.95","10,78,352.55",
03-Apr-23,Transfer,00.00,"1,07,835.26","9,70,517.30",
03-Apr-23,NEFT,"16,961.76",00.00,"9,87,479.06",
03-Apr-23,Transportellaneous,"1,835.50",00.00,"9,89,314.56",
03-Apr-23,RTGS,10.9,00.00,"9,89,325.46",
03-Apr-23,Debit Card,"5,029.10",00.00,"9,94,354.56",
03-Apr-23,Bill,00.00,"9,94,354.56",00.00,
03-Apr-23,Tax,"26,421.41",00.00,"26,421.41",
03-Apr-23,Transportellaneous,"6,53,653.00",00.00,"6,80,074.41",
03-Apr-23,RTGS,372.36,00.00,"6,80,446.77",
03-Apr-23,ATM,00.00,"3,40,223.39","3,40,223.38",
03-Apr-23,Purchase,"2,201.00",00.00,"3,42,424.38",
03-Apr-23,Transportellaneous,00.00,"3,42,424.38",00.00,
03-Apr-23,Commission,"52,939.75",00.00,"52,939.75",
03-Apr-23,Cash,00.00,"6,617.47","46,322.28",
04-Apr-23,Transportellaneous,54.12,00.00,"46,376.40",
04-Apr-23,IMPS,02.00,00.00,"46,378.40",
04-Apr-23,Bill,00.00,"15,459.47","30,918.93",
04-Apr-23,Commission,00.00,"4,416.99","26,501.94",
04-Apr-23,Interest,00.00,"3,785.99","22,715.95",
04-Apr-23,Debit Card,"3,628.80",00.00,"26,344.75",
04-Apr-23,RTGS,449,00.00,"26,793.75",
04-Apr-23,Debit Card,00.00,"3,349.22","23,444.53",
04-Apr-23,Bill,417.9,00.00,"23,862.43",
04-Apr-23,Transportellaneous,00.00,"11,931.22","11,931.22",
04-Apr-23,Cash,19,00.00,"11,950.22",
04-Apr-23,RTGS,00.00,"1,327.80","10,622.42",
04-Apr-23,Cash,04.40,00.00,"10,626.82",
04-Apr-23,Interest,00.00,"1,328.35","9,298.47",
04-Apr-23,Bill,00.00,"4,649.24","4,649.23",
04-Apr-23,Reversal,00.00,664.18,"3,985.05",
04-Apr-23,Transportellaneous,00.00,"1,328.35","2,656.70",
04-Apr-23,Cheque,"32,737.86",00.00,"35,394.56",
04-Apr-23,Commission,07.81,00.00,"35,402.37",
04-Apr-23,Reversal,"16,15,048.50",00.00,"16,50,450.87",
04-Apr-23,IMPS,00.00,"1,65,045.09","14,85,405.78",
04-Apr-23,Interest,00.00,"14,85,405.78",00.00,
04-Apr-23,Transportellaneous,"1,49,964.00",00.00,"1,49,964.00",
04-Apr-23,Transportellaneous,00.00,"1,49,964.00",00.00,
04-Apr-23,RTGS,46.9,00.00,46.9,
04-Apr-23,NEFT,44.29,00.00,91.19,
04-Apr-23,Cash,00.00,13.03,78.16,
05-Apr-23,Transportellaneous,"2,33,923.81",00.00,"2,34,001.97",
05-Apr-23,Interest,00.00,"1,17,000.99","1,17,000.98",
05-Apr-23,Cash,"1,12,447.00",00.00,"2,29,447.98",
05-Apr-23,Bill,00.00,"2,29,447.98",00.00,
05-Apr-23,Commission,00.00,00.00,00.00,
05-Apr-23,Debit Card,60.85,00.00,60.85,
05-Apr-23,RTGS,288.52,00.00,349.37,
05-Apr-23,Tax,00.00,43.67,305.7,
05-Apr-23,Commission,"3,171.00",00.00,"3,476.70",
05-Apr-23,Debit Card,00.00,695.34,"2,781.36",
05-Apr-23,Debit Card,00.00,309.04,"2,472.32",
05-Apr-23,Interest,00.00,274.7,"2,197.62",
05-Apr-23,NEFT,06.12,00.00,"2,203.74",
05-Apr-23,Transfer,"3,859.00",00.00,"6,062.74",
05-Apr-23,Interest,80.1,00.00,"6,142.84",
05-Apr-23,Purchase,02.00,00.00,"6,144.84",
05-Apr-23,Transportellaneous,00.00,"2,048.28","4,096.56",
05-Apr-23,ATM,"9,39,730.25",00.00,"9,43,826.81",
05-Apr-23,Commission,05.00,00.00,"9,43,831.81",
05-Apr-23,Transportellaneous,"10,641.75",00.00,"9,54,473.56",
05-Apr-23,Cash,06.20,00.00,"9,54,479.76",
05-Apr-23,NEFT,62,00.00,"9,54,541.76",
05-Apr-23,RTGS,"1,081.00",00.00,"9,55,622.76",
05-Apr-23,ATM,00.00,"4,77,811.38","4,77,811.38",
06-Apr-23,Transportellaneous,00.00,"95,562.28","3,82,249.10",
06-Apr-23,Reversal,"27,527.00",00.00,"4,09,776.10",
06-Apr-23,NEFT,00.00,"45,530.68","3,64,245.42",
06-Apr-23,Reversal,"64,366.70",00.00,"4,28,612.12",
06-Apr-23,Purchase,06.00,00.00,"4,28,618.12",
06-Apr-23,Bill,"11,32,763.00",00.00,"15,61,381.12",
06-Apr-23,ATM,"3,804.50",00.00,"15,65,185.62",
06-Apr-23,Transfer,"17,45,384.80",00.00,"33,10,570.42",
06-Apr-23,Commission,00.00,"4,13,821.30","28,96,749.12",
06-Apr-23,IMPS,00.00,"4,82,791.52","24,13,957.60",
06-Apr-23,Interest,"1,909.41",00.00,"24,15,867.01",
06-Apr-23,Tax,"1,41,983.47",00.00,"25,57,850.48",
06-Apr-23,Debit Card,394,00.00,"25,58,244.48",
06-Apr-23,Reversal,00.00,"5,11,648.90","20,46,595.58",
06-Apr-23,Reversal,28,00.00,"20,46,623.58",
06-Apr-23,Bill,00.00,"2,27,402.62","18,19,220.96",
06-Apr-23,Bill,00.00,"2,27,402.62","15,91,818.34",
06-Apr-23,Debit Card,00.90,00.00,"15,91,819.24",
06-Apr-23,Commission,00.00,"5,30,606.41","10,61,212.83",
06-Apr-23,Purchase,00.00,"2,12,242.57","8,48,970.26",
06-Apr-23,Cheque,"31,210.62",00.00,"8,80,180.88",
06-Apr-23,Transfer,00.00,"1,25,740.13","7,54,440.75",
06-Apr-23,Purchase,00.00,"1,88,610.19","5,65,830.56",
06-Apr-23,Commission,"30,663.82",00.00,"5,96,494.38",
06-Apr-23,Reversal,"5,62,850.50",00.00,"11,59,344.88",
06-Apr-23,Commission,00.00,"2,31,868.98","9,27,475.90",
06-Apr-23,Debit Card,00.00,"1,85,495.18","7,41,980.72",
06-Apr-23,Transportellaneous,"80,369.00",00.00,"8,22,349.72",
06-Apr-23,IMPS,"2,14,728.00",00.00,"10,37,077.72",
06-Apr-23,RTGS,00.00,"2,07,415.54","8,29,662.18",
06-Apr-23,Purchase,"14,672.60",00.00,"8,44,334.78",
06-Apr-23,Reversal,02.21,00.00,"8,44,336.99",
06-Apr-23,ATM,"8,86,136.00",00.00,"17,30,472.99",
06-Apr-23,Cash,"11,70,128.25",00.00,"29,00,601.24",
06-Apr-23,Interest,03.90,00.00,"29,00,605.14",
06-Apr-23,Tax,00.00,"2,90,060.51","26,10,544.63",
06-Apr-23,ATM,"26,122.44",00.00,"26,36,667.07",
06-Apr-23,Commission,"9,009.80",00.00,"26,45,676.87",
06-Apr-23,Purchase,00.00,"3,30,709.61","23,14,967.26",
06-Apr-23,Cheque,"41,344.09",00.00,"23,56,311.35",
06-Apr-23,Purchase,04.60,00.00,"23,56,315.95",
06-Apr-23,Debit Card,00.00,"4,71,263.19","18,85,052.76",
06-Apr-23,Commission,"31,246.62",00.00,"19,16,299.38",
06-Apr-23,Commission,00.00,"6,38,766.46","12,77,532.92",
06-Apr-23,NEFT,"16,24,297.50",00.00,"29,01,830.42",
06-Apr-23,Interest,00.00,"29,01,830.42",00.00,
06-Apr-23,IMPS,39.6,00.00,39.6,
06-Apr-23,Debit Card,00.00,19.8,19.8,
06-Apr-23,Transfer,00.00,04.95,14.85,
06-Apr-23,Cash,00.00,02.48,12.38,
06-Apr-23,Reversal,51.95,00.00,64.33,
06-Apr-23,Purchase,00.00,16.08,48.25,
06-Apr-23,NEFT,"1,55,647.50",00.00,"1,55,695.75",
06-Apr-23,RTGS,00.00,"25,949.29","1,29,746.46",
06-Apr-23,Transfer,"11,12,521.00",00.00,"12,42,267.46",
06-Apr-23,Transportellaneous,00.00,"12,42,267.46",00.00,
06-Apr-23,Cheque,35,00.00,35,
06-Apr-23,Transportellaneous,227,00.00,262,
06-Apr-23,Bill,00.00,87.33,174.67,
06-Apr-23,IMPS,00.00,19.41,155.26,
06-Apr-23,IMPS,"15,702.30",00.00,"15,857.56",
06-Apr-23,NEFT,"1,323.00",00.00,"17,180.56",
06-Apr-23,Transfer,02.40,00.00,"17,182.96",
06-Apr-23,Purchase,21.86,00.00,"17,204.82",
06-Apr-23,Cash,02.58,00.00,"17,207.40",
06-Apr-23,Bill,06.01,00.00,"17,213.41",
06-Apr-23,Transfer,313.7,00.00,"17,527.11",
06-Apr-23,Cheque,00.00,"4,381.78","13,145.33",
06-Apr-23,Tax,06.00,00.00,"13,151.33",
06-Apr-23,Interest,00.00,"1,878.76","11,272.57",
06-Apr-23,Reversal,00.00,"1,127.26","10,145.31",
06-Apr-23,Cash,00.00,"2,536.33","7,608.98",
06-Apr-23,Reversal,00.00,"7,608.98",00.00,
06-Apr-23,Interest,"1,59,913.78",00.00,"1,59,913.78",
06-Apr-23,IMPS,00.00,"22,844.83","1,37,068.95",
06-Apr-23,Interest,00.00,"15,229.88","1,21,839.07",
06-Apr-23,Commission,"3,182.00",00.00,"1,25,021.07",
06-Apr-23,Tax,00.00,"25,004.21","1,00,016.86",
06-Apr-23,Purchase,00.00,"11,112.98","88,903.88",
06-Apr-23,Cheque,"17,475.48",00.00,"1,06,379.36",
06-Apr-23,Interest,999.49,00.00,"1,07,378.85",
06-Apr-23,Interest,00.00,"26,844.71","80,534.14",
06-Apr-23,Transfer,938.48,00.00,"81,472.62",
06-Apr-23,Purchase,00.00,"16,294.52","65,178.10",
06-Apr-23,Tax,00.00,"7,242.01","57,936.09",
06-Apr-23,Debit Card,00.00,"8,276.58","49,659.51",
07-Apr-23,Transfer,"1,800.81",00.00,"51,460.32",
07-Apr-23,Bill,00.00,"10,292.06","41,168.26",
07-Apr-23,NEFT,54,00.00,"41,222.26",
07-Apr-23,NEFT,00.00,"41,222.26",00.00,
08-Apr-23,Commission,"17,839.70",00.00,"17,839.70",
08-Apr-23,Transfer,370,00.00,"18,209.70",
08-Apr-23,Debit Card,00.00,"3,034.95","15,174.75",
08-Apr-23,RTGS,"15,868.00",00.00,"31,042.75",
08-Apr-23,Tax,36.62,00.00,"31,079.37",
08-Apr-23,Transportellaneous,00.00,"10,359.79","20,719.58",
08-Apr-23,NEFT,480.38,00.00,"21,199.96",
08-Apr-23,NEFT,"1,21,344.03",00.00,"1,42,543.99",
08-Apr-23,Interest,00.00,"1,42,543.99",00.00,
08-Apr-23,Reversal,"6,19,198.00",00.00,"6,19,198.00",
08-Apr-23,Tax,"13,100.05",00.00,"6,32,298.05",
08-Apr-23,ATM,00.00,"1,05,383.01","5,26,915.04",
08-Apr-23,Debit Card,00.00,"1,75,638.35","3,51,276.69",
08-Apr-23,Bill,428.1,00.00,"3,51,704.79",
08-Apr-23,Tax,445,00.00,"3,52,149.79",
08-Apr-23,Transfer,"2,10,876.80",00.00,"5,63,026.59",
08-Apr-23,Transfer,00.00,"1,87,675.53","3,75,351.06",
08-Apr-23,ATM,"2,81,155.75",00.00,"6,56,506.81",
08-Apr-23,Tax,"1,37,971.00",00.00,"7,94,477.81",
08-Apr-23,NEFT,00.00,"1,32,412.97","6,62,064.84",
08-Apr-23,NEFT,"17,81,699.00",00.00,"24,43,763.84",
08-Apr-23,ATM,"22,867.90",00.00,"24,66,631.74",
08-Apr-23,RTGS,"1,019.70",00.00,"24,67,651.44",
08-Apr-23,Reversal,00.00,"4,93,530.29","19,74,121.15",
08-Apr-23,Cheque,145,00.00,"19,74,266.15",
08-Apr-23,NEFT,00.00,"3,94,853.23","15,79,412.92",
08-Apr-23,Transportellaneous,00.00,"7,89,706.46","7,89,706.46",
08-Apr-23,Tax,00.00,"1,57,941.29","6,31,765.17",
08-Apr-23,Debit Card,00.00,"70,196.13","5,61,569.04",
08-Apr-23,Bill,"3,378.00",00.00,"5,64,947.04",
08-Apr-23,NEFT,00.00,"56,494.70","5,08,452.34",
08-Apr-23,Bill,00.10,00.00,"5,08,452.44",
08-Apr-23,Bill,00.00,"2,54,226.22","2,54,226.22",
08-Apr-23,Purchase,00.00,"36,318.03","2,17,908.19",
08-Apr-23,Bill,"1,74,472.70",00.00,"3,92,380.89",
08-Apr-23,Tax,00.00,"56,054.41","3,36,326.48",
08-Apr-23,ATM,"27,055.00",00.00,"3,63,381.48",
08-Apr-23,Transportellaneous,00.00,"60,563.58","3,02,817.90",
08-Apr-23,Tax,00.00,"3,02,817.90",00.00,
09-Apr-23,Debit Card,"8,70,040.25",00.00,"8,70,040.25",
09-Apr-23,Interest,00.00,"1,74,008.05","6,96,032.20",
09-Apr-23,Interest,31,00.00,"6,96,063.20",
09-Apr-23,Transportellaneous,00.00,"77,340.36","6,18,722.84",
09-Apr-23,Transfer,00.00,"1,03,120.47","5,15,602.37",
09-Apr-23,Transportellaneous,00.00,"1,03,120.47","4,12,481.90",
09-Apr-23,Bill,00.00,"1,37,493.97","2,74,987.93",
09-Apr-23,Purchase,00.00,"30,554.21","2,44,433.72",
09-Apr-23,Tax,393.91,00.00,"2,44,827.63",
09-Apr-23,Bill,"12,93,872.00",00.00,"15,38,699.63",
09-Apr-23,Transfer,00.00,"1,70,966.63","13,67,733.00",
09-Apr-23,RTGS,"25,323.77",00.00,"13,93,056.77",
09-Apr-23,IMPS,481.5,00.00,"13,93,538.27",
09-Apr-23,NEFT,00.00,"2,78,707.65","11,14,830.62",
09-Apr-23,ATM,00.00,"2,78,707.66","8,36,122.97",
09-Apr-23,Cheque,00.76,00.00,"8,36,123.73",
09-Apr-23,Bill,00.00,"1,67,224.75","6,68,898.98",
09-Apr-23,Tax,00.00,"83,612.37","5,85,286.61",
09-Apr-23,RTGS,"83,297.80",00.00,"6,68,584.41",
09-Apr-23,Transportellaneous,00.00,"1,11,430.74","5,57,153.68",
09-Apr-23,Reversal,06.79,00.00,"5,57,160.47",
09-Apr-23,NEFT,"1,18,570.00",00.00,"6,75,730.47",
09-Apr-23,Tax,00.00,"67,573.05","6,08,157.42",
09-Apr-23,Interest,00.00,"1,01,359.57","5,06,797.85",
09-Apr-23,Interest,615,00.00,"5,07,412.85",
09-Apr-23,Interest,"29,750.40",00.00,"5,37,163.25",
09-Apr-23,Interest,00.00,"1,07,432.65","4,29,730.60",
09-Apr-23,RTGS,00.00,"61,390.09","3,68,340.51",
09-Apr-23,Commission,"17,193.00",00.00,"3,85,533.51",
09-Apr-23,Cash,00.00,"96,383.38","2,89,150.13",
09-Apr-23,Debit Card,"3,315.00",00.00,"2,92,465.13",
09-Apr-23,ATM,20.3,00.00,"2,92,485.43",
09-Apr-23,Transportellaneous,"1,83,462.03",00.00,"4,75,947.46",
09-Apr-23,Interest,00.00,"79,324.58","3,96,622.88",
09-Apr-23,Purchase,00.00,"56,660.41","3,39,962.47",
09-Apr-23,NEFT,00.00,"33,996.25","3,05,966.22",
09-Apr-23,Commission,00.00,"61,193.24","2,44,772.98",
09-Apr-23,Cheque,00.00,"81,590.99","1,63,181.99",
09-Apr-23,Transfer,00.00,"32,636.40","1,30,545.59",
09-Apr-23,IMPS,00.00,"16,318.20","1,14,227.39",
09-Apr-23,Cash,"1,043.50",00.00,"1,15,270.89",
10-Apr-23,Reversal,"1,06,209.00",00.00,"2,21,479.89",
10-Apr-23,Commission,06.59,00.00,"2,21,486.48",
10-Apr-23,Transportellaneous,00.00,"73,828.83","1,47,657.65",
10-Apr-23,Tax,00.00,"29,531.53","1,18,126.12",
10-Apr-23,IMPS,"8,398.00",00.00,"1,26,524.12",
10-Apr-23,Reversal,"1,01,029.00",00.00,"2,27,553.12",
10-Apr-23,NEFT,00.00,"37,925.52","1,89,627.60",
10-Apr-23,Tax,"52,847.53",00.00,"2,42,475.13",
10-Apr-23,Interest,19.67,00.00,"2,42,494.80",
10-Apr-23,Transportellaneous,00.00,"2,42,494.80",00.00,
10-Apr-23,IMPS,"19,01,920.00",00.00,"19,01,920.00",
10-Apr-23,RTGS,273.7,00.00,"19,02,193.70",
10-Apr-23,Debit Card,00.00,"19,02,193.70",00.00,
10-Apr-23,Bill,29,00.00,29,
10-Apr-23,Purchase,00.00,05.80,23.2,
11-Apr-23,IMPS,91,00.00,114.2,
11-Apr-23,Transportellaneous,231.7,00.00,345.9,
11-Apr-23,Cash,"15,23,455.75",00.00,"15,23,801.65",
11-Apr-23,IMPS,00.00,"3,80,950.41","11,42,851.24",
11-Apr-23,Purchase,00.00,"1,14,285.12","10,28,566.12",
11-Apr-23,Transportellaneous,205.3,00.00,"10,28,771.42",
11-Apr-23,Cash,05.80,00.00,"10,28,777.22",
11-Apr-23,Interest,37.1,00.00,"10,28,814.32",
11-Apr-23,Cash,"1,42,280.00",00.00,"11,71,094.32",
11-Apr-23,RTGS,"8,471.70",00.00,"11,79,566.02",
11-Apr-23,Reversal,327.1,00.00,"11,79,893.12",
11-Apr-23,Cash,"77,793.44",00.00,"12,57,686.56",
11-Apr-23,Cash,"26,317.41",00.00,"12,84,003.97",
11-Apr-23,IMPS,00.00,"3,21,000.99","9,63,002.98",
12-Apr-23,Bill,"10,78,904.80",00.00,"20,41,907.78",
12-Apr-23,Interest,00.00,"5,10,476.95","15,31,430.84",
12-Apr-23,Cheque,"22,446.25",00.00,"15,53,877.09",
12-Apr-23,Bill,"1,03,164.00",00.00,"16,57,041.09",
12-Apr-23,RTGS,"1,85,585.00",00.00,"18,42,626.09",
12-Apr-23,Transfer,"1,98,452.20",00.00,"20,41,078.29",
12-Apr-23,Transportellaneous,00.00,"2,26,786.48","18,14,291.81",
12-Apr-23,Debit Card,00.00,"9,07,145.91","9,07,145.90",
12-Apr-23,Reversal,00.00,"1,81,429.18","7,25,716.72",
12-Apr-23,Commission,"10,113.40",00.00,"7,35,830.12",
12-Apr-23,Commission,200.88,00.00,"7,36,031.00",
12-Apr-23,Reversal,00.00,"92,003.88","6,44,027.12",
12-Apr-23,Cash,00.00,"3,22,013.56","3,22,013.56",
12-Apr-23,Reversal,"19,95,448.00",00.00,"23,17,461.56",
12-Apr-23,ATM,17.46,00.00,"23,17,479.02",
12-Apr-23,RTGS,00.00,"5,79,369.76","17,38,109.26",
12-Apr-23,Debit Card,02.00,00.00,"17,38,111.26",
12-Apr-23,NEFT,00.00,"4,34,527.82","13,03,583.44",
13-Apr-23,ATM,434.9,00.00,"13,04,018.34",
13-Apr-23,Reversal,00.00,"2,17,336.39","10,86,681.95",
13-Apr-23,ATM,00.00,"2,71,670.49","8,15,011.46",
13-Apr-23,Debit Card,02.90,00.00,"8,15,014.36",
13-Apr-23,Purchase,00.00,"1,35,835.73","6,79,178.63",
13-Apr-23,Interest,"3,475.61",00.00,"6,82,654.24",
13-Apr-23,Cash,"11,209.30",00.00,"6,93,863.54",
14-Apr-23,Transportellaneous,286,00.00,"6,94,149.54",
14-Apr-23,IMPS,02.15,00.00,"6,94,151.69",
15-Apr-23,Interest,103.3,00.00,"6,94,254.99",
15-Apr-23,Bill,00.00,"6,94,254.99",00.00,
15-Apr-23,Cheque,45.75,00.00,45.75,
15-Apr-23,Purchase,597,00.00,642.75,
15-Apr-23,Cash,00.00,107.13,535.62,
15-Apr-23,ATM,00.00,267.81,267.81,
15-Apr-23,Purchase,00.00,66.95,200.86,
15-Apr-23,IMPS,403.02,00.00,603.88,
15-Apr-23,Purchase,00.00,150.97,452.91,
15-Apr-23,Tax,00.00,150.97,301.94,
15-Apr-23,ATM,"32,596.00",00.00,"32,897.94",
15-Apr-23,Transportellaneous,"18,98,793.00",00.00,"19,31,690.94",
15-Apr-23,RTGS,429.45,00.00,"19,32,120.39",
15-Apr-23,Cheque,00.00,"6,44,040.13","12,88,080.26",
15-Apr-23,Cash,00.00,"6,44,040.13","6,44,040.13",
15-Apr-23,Interest,00.00,"80,505.02","5,63,535.11",
15-Apr-23,Reversal,07.00,00.00,"5,63,542.11",
15-Apr-23,Bill,"2,60,266.00",00.00,"8,23,808.11",
15-Apr-23,IMPS,03.40,00.00,"8,23,811.51",
15-Apr-23,Reversal,00.00,"91,534.61","7,32,276.90",
15-Apr-23,Transfer,"54,299.12",00.00,"7,86,576.02",
15-Apr-23,Transportellaneous,08.00,00.00,"7,86,584.02",
15-Apr-23,Commission,"89,866.50",00.00,"8,76,450.52",
15-Apr-23,Cheque,07.00,00.00,"8,76,457.52",
15-Apr-23,RTGS,00.00,"8,76,457.52",00.00,
15-Apr-23,Transportellaneous,271,00.00,271,
15-Apr-23,Purchase,257.6,00.00,528.6,
15-Apr-23,Interest,531.48,00.00,"1,060.08",
15-Apr-23,IMPS,30,00.00,"1,090.08",
15-Apr-23,Transportellaneous,00.00,181.68,908.4,
15-Apr-23,Purchase,00.00,908.4,00.00,
15-Apr-23,RTGS,00.42,00.00,00.42,
15-Apr-23,ATM,00.00,00.21,00.21,
15-Apr-23,RTGS,00.00,00.02,00.19,
15-Apr-23,Cheque,00.00,00.02,00.17,
15-Apr-23,Transportellaneous,00.00,00.04,00.13,
15-Apr-23,Debit Card,335.5,00.00,335.63,
15-Apr-23,RTGS,"6,475.00",00.00,"6,810.63",
15-Apr-23,RTGS,00.00,"1,362.13","5,448.50",
15-Apr-23,Transfer,"1,368.40",00.00,"6,816.90",
15-Apr-23,Cash,"2,54,514.00",00.00,"2,61,330.90",
15-Apr-23,Debit Card,154.86,00.00,"2,61,485.76",
15-Apr-23,Cash,00.00,"32,685.72","2,28,800.04",
15-Apr-23,Cash,00.00,"76,266.68","1,52,533.36",
15-Apr-23,Debit Card,01.00,00.00,"1,52,534.36",
15-Apr-23,Debit Card,"11,80,014.75",00.00,"13,32,549.11",
15-Apr-23,Commission,"18,57,804.00",00.00,"31,90,353.11",
15-Apr-23,ATM,75.7,00.00,"31,90,428.81",
15-Apr-23,Purchase,00.00,"7,97,607.20","23,92,821.61",
15-Apr-23,NEFT,06.00,00.00,"23,92,827.61",
15-Apr-23,RTGS,06.04,00.00,"23,92,833.65",
15-Apr-23,NEFT,00.00,"2,39,283.37","21,53,550.28",
15-Apr-23,Purchase,00.00,"7,17,850.09","14,35,700.19",
15-Apr-23,Reversal,"14,602.82",00.00,"14,50,303.01",
15-Apr-23,Reversal,"1,093.00",00.00,"14,51,396.01",
15-Apr-23,Interest,00.00,"7,25,698.01","7,25,698.00",
15-Apr-23,NEFT,00.00,"1,20,949.67","6,04,748.33",
15-Apr-23,IMPS,"2,404.14",00.00,"6,07,152.47",
15-Apr-23,NEFT,00.00,"1,01,192.08","5,05,960.39",
15-Apr-23,Interest,00.00,"1,01,192.08","4,04,768.31",
15-Apr-23,Tax,00.00,"4,04,768.31",00.00,
15-Apr-23,Interest,07.40,00.00,07.40,
15-Apr-23,Cash,00.00,01.06,06.34,
15-Apr-23,Purchase,00.00,03.17,03.17,
15-Apr-23,Tax,448.65,00.00,451.82,
15-Apr-23,Debit Card,33.7,00.00,485.52,
15-Apr-23,Cheque,"1,91,330.40",00.00,"1,91,815.92",
15-Apr-23,Cash,00.00,"31,969.32","1,59,846.60",
15-Apr-23,Debit Card,00.00,"39,961.65","1,19,884.95",
15-Apr-23,ATM,"10,227.00",00.00,"1,30,111.95",
15-Apr-23,IMPS,"9,14,830.00",00.00,"10,44,941.95",
15-Apr-23,Commission,26,00.00,"10,44,967.95",
15-Apr-23,Transportellaneous,00.00,"10,44,967.95",00.00,
15-Apr-23,Tax,"16,819.00",00.00,"16,819.00",
15-Apr-23,Cash,"2,913.83",00.00,"19,732.83",
15-Apr-23,Debit Card,"25,777.40",00.00,"45,510.23",
15-Apr-23,Commission,00.00,"7,585.04","37,925.19",
15-Apr-23,Reversal,12,00.00,"37,937.19",
15-Apr-23,Commission,760.7,00.00,"38,697.89",
15-Apr-23,Transfer,02.00,00.00,"38,699.89",
15-Apr-23,Purchase,00.00,"38,699.89",00.00,
15-Apr-23,ATM,"15,65,401.75",00.00,"15,65,401.75",
15-Apr-23,Cheque,05.54,00.00,"15,65,407.29",
15-Apr-23,Transfer,00.00,"5,21,802.43","10,43,604.86",
15-Apr-23,Interest,00.00,"3,47,868.29","6,95,736.57",
15-Apr-23,Bill,00.00,"1,73,934.14","5,21,802.43",
15-Apr-23,ATM,00.00,"65,225.30","4,56,577.13",
15-Apr-23,Reversal,00.00,"1,52,192.38","3,04,384.75",
15-Apr-23,ATM,00.00,"33,820.53","2,70,564.22",
15-Apr-23,ATM,05.00,00.00,"2,70,569.22",
15-Apr-23,Debit Card,"3,23,669.50",00.00,"5,94,238.72",
16-Apr-23,NEFT,00.00,"1,48,559.68","4,45,679.04",
16-Apr-23,IMPS,00.00,"1,48,559.68","2,97,119.36",
16-Apr-23,Bill,00.00,"29,711.94","2,67,407.42",
16-Apr-23,ATM,"76,434.00",00.00,"3,43,841.42",
16-Apr-23,NEFT,"1,515.10",00.00,"3,45,356.52",
17-Apr-23,Transportellaneous,06.89,00.00,"3,45,363.41",
17-Apr-23,RTGS,00.00,"34,536.34","3,10,827.07",
17-Apr-23,Reversal,00.00,"34,536.34","2,76,290.73",
17-Apr-23,Bill,00.00,"69,072.68","2,07,218.05",
17-Apr-23,NEFT,00.00,"41,443.61","1,65,774.44",
17-Apr-23,ATM,"5,77,240.80",00.00,"7,43,015.24",
17-Apr-23,Commission,"3,567.60",00.00,"7,46,582.84",
17-Apr-23,RTGS,05.92,00.00,"7,46,588.76",
17-Apr-23,Transportellaneous,00.00,"1,86,647.19","5,59,941.57",
17-Apr-23,Transfer,43,00.00,"5,59,984.57",
18-Apr-23,Commission,06.00,00.00,"5,59,990.57",
18-Apr-23,Commission,00.00,"2,79,995.29","2,79,995.28",
18-Apr-23,ATM,"3,50,379.00",00.00,"6,30,374.28",
18-Apr-23,Transfer,00.00,"70,041.59","5,60,332.69",
18-Apr-23,Cheque,00.00,"62,259.19","4,98,073.50",
18-Apr-23,Transportellaneous,"15,42,260.00",00.00,"20,40,333.50",
18-Apr-23,Tax,00.00,"3,40,055.58","17,00,277.92",
18-Apr-23,Debit Card,"18,40,114.00",00.00,"35,40,391.92",
18-Apr-23,Commission,00.00,"3,54,039.19","31,86,352.73",
18-Apr-23,Transportellaneous,00.00,"3,98,294.09","27,88,058.64",
18-Apr-23,RTGS,00.00,"27,88,058.64",00.00,
18-Apr-23,Transportellaneous,35.8,00.00,35.8,
18-Apr-23,Purchase,19,00.00,54.8,
18-Apr-23,NEFT,64,00.00,118.8,
18-Apr-23,Transportellaneous,06.40,00.00,125.2,
18-Apr-23,NEFT,"21,199.00",00.00,"21,324.20",
18-Apr-23,Commission,"42,741.70",00.00,"64,065.90",
18-Apr-23,NEFT,"8,14,013.00",00.00,"8,78,078.90",
18-Apr-23,ATM,00.00,"97,564.32","7,80,514.58",
18-Apr-23,ATM,"9,29,451.00",00.00,"17,09,965.58",
18-Apr-23,Interest,"1,66,173.10",00.00,"18,76,138.68",
19-Apr-23,RTGS,206,00.00,"18,76,344.68",
19-Apr-23,Tax,"19,713.00",00.00,"18,96,057.68",
19-Apr-23,ATM,62,00.00,"18,96,119.68",
19-Apr-23,ATM,00.00,"1,89,611.97","17,06,507.71",
19-Apr-23,Cash,00.00,"2,84,417.95","14,22,089.76",
19-Apr-23,ATM,04.50,00.00,"14,22,094.26",
19-Apr-23,Cheque,00.00,"1,58,010.47","12,64,083.79",
19-Apr-23,Tax,00.00,"6,32,041.90","6,32,041.90",
19-Apr-23,Commission,"2,05,478.25",00.00,"8,37,520.15",
19-Apr-23,Cheque,00.00,"1,39,586.69","6,97,933.46",
19-Apr-23,Transportellaneous,04.10,00.00,"6,97,937.56",
19-Apr-23,RTGS,00.00,"1,39,587.51","5,58,350.05",
19-Apr-23,ATM,63.97,00.00,"5,58,414.02",
19-Apr-23,ATM,"2,175.26",00.00,"5,60,589.28",
19-Apr-23,NEFT,20.2,00.00,"5,60,609.48",
19-Apr-23,RTGS,"11,69,940.50",00.00,"17,30,549.98",
19-Apr-23,Bill,"1,22,209.50",00.00,"18,52,759.48",
19-Apr-23,Tax,"14,29,134.00",00.00,"32,81,893.48",
19-Apr-23,Interest,07.10,00.00,"32,81,900.58",
19-Apr-23,RTGS,00.00,"4,68,842.94","28,13,057.64",
19-Apr-23,Interest,"32,452.74",00.00,"28,45,510.38",
19-Apr-23,IMPS,02.00,00.00,"28,45,512.38",
19-Apr-23,Bill,"22,995.95",00.00,"28,68,508.33",
19-Apr-23,Bill,"12,76,010.00",00.00,"41,44,518.33",
19-Apr-23,Tax,00.00,"20,72,259.17","20,72,259.16",
19-Apr-23,ATM,"12,784.00",00.00,"20,85,043.16",
19-Apr-23,ATM,00.00,"3,47,507.19","17,37,535.97",
19-Apr-23,Debit Card,02.35,00.00,"17,37,538.32",
19-Apr-23,NEFT,29,00.00,"17,37,567.32",
19-Apr-23,Transfer,39.7,00.00,"17,37,607.02",
19-Apr-23,IMPS,00.00,"17,37,607.02",00.00,
19-Apr-23,Tax,"1,810.63",00.00,"1,810.63",
19-Apr-23,Reversal,00.00,"1,810.63",00.00,
19-Apr-23,Bill,443.49,00.00,443.49,
19-Apr-23,Transfer,00.00,147.83,295.66,
19-Apr-23,Reversal,"2,48,803.44",00.00,"2,49,099.10",
19-Apr-23,RTGS,00.00,"2,49,099.10",00.00,
19-Apr-23,Interest,293.4,00.00,293.4,
19-Apr-23,Interest,"24,492.00",00.00,"24,785.40",
19-Apr-23,Tax,26.5,00.00,"24,811.90",
19-Apr-23,RTGS,929.6,00.00,"25,741.50",
19-Apr-23,Debit Card,"1,38,398.00",00.00,"1,64,139.50",
19-Apr-23,Debit Card,00.00,"18,237.72","1,45,901.78",
19-Apr-23,Debit Card,327.36,00.00,"1,46,229.14",
19-Apr-23,Cheque,"15,252.50",00.00,"1,61,481.64",
19-Apr-23,RTGS,"14,385.40",00.00,"1,75,867.04",
19-Apr-23,Cash,"9,991.00",00.00,"1,85,858.04",
19-Apr-23,Tax,00.00,"92,929.02","92,929.02",
19-Apr-23,Reversal,00.00,"46,464.51","46,464.51",
19-Apr-23,IMPS,00.00,"15,488.17","30,976.34",
19-Apr-23,Transportellaneous,"11,09,537.75",00.00,"11,40,514.09",
19-Apr-23,Interest,05.00,00.00,"11,40,519.09",
19-Apr-23,ATM,00.00,"1,42,564.89","9,97,954.20",
19-Apr-23,ATM,06.00,00.00,"9,97,960.20",
19-Apr-23,Cash,00.00,"1,66,326.70","8,31,633.50",
19-Apr-23,ATM,00.00,"1,66,326.70","6,65,306.80",
19-Apr-23,Commission,00.00,"1,33,061.36","5,32,245.44",
19-Apr-23,Commission,00.00,"1,33,061.36","3,99,184.08",
19-Apr-23,Commission,"17,70,663.75",00.00,"21,69,847.83",
19-Apr-23,Commission,00.00,"7,23,282.61","14,46,565.22",
19-Apr-23,ATM,00.00,"4,82,188.41","9,64,376.81",
19-Apr-23,Cash,21.21,00.00,"9,64,398.02",
19-Apr-23,Interest,00.00,"1,37,771.15","8,26,626.87",
20-Apr-23,Reversal,00.00,"1,65,325.37","6,61,301.50",
20-Apr-23,ATM,00.00,"66,130.15","5,95,171.35",
20-Apr-23,Bill,00.00,"1,48,792.84","4,46,378.51",
20-Apr-23,Tax,"9,33,293.75",00.00,"13,79,672.26",
20-Apr-23,Purchase,"1,24,430.44",00.00,"15,04,102.70",
20-Apr-23,Purchase,03.00,00.00,"15,04,105.70",
20-Apr-23,Bill,793.5,00.00,"15,04,899.20",
20-Apr-23,Commission,"24,789.00",00.00,"15,29,688.20",
20-Apr-23,Purchase,00.00,"2,54,948.03","12,74,740.17",
20-Apr-23,NEFT,"28,719.30",00.00,"13,03,459.47",
20-Apr-23,Transportellaneous,"30,071.00",00.00,"13,33,530.47",
20-Apr-23,Cash,00.00,"4,44,510.16","8,89,020.31",
20-Apr-23,Purchase,00.00,"4,44,510.16","4,44,510.16",
20-Apr-23,ATM,00.00,"44,451.02","4,00,059.14",
20-Apr-23,Interest,00.00,"57,151.31","3,42,907.83",
20-Apr-23,NEFT,"19,032.00",00.00,"3,61,939.83",
20-Apr-23,RTGS,00.00,"1,20,646.61","2,41,293.22",
20-Apr-23,RTGS,35.3,00.00,"2,41,328.52",
21-Apr-23,IMPS,58,00.00,"2,41,386.52",
21-Apr-23,NEFT,281.5,00.00,"2,41,668.02",
21-Apr-23,Purchase,00.00,"48,333.60","1,93,334.42",
21-Apr-23,Debit Card,"3,644.19",00.00,"1,96,978.61",
21-Apr-23,Commission,00.00,"65,659.54","1,31,319.07",
21-Apr-23,Transfer,00.00,"13,131.91","1,18,187.16",
21-Apr-23,Cheque,35.91,00.00,"1,18,223.07",
21-Apr-23,RTGS,40.37,00.00,"1,18,263.44",
21-Apr-23,RTGS,00.00,"19,710.57","98,552.87",
21-Apr-23,Reversal,00.00,"12,319.11","86,233.76",
21-Apr-23,Bill,00.00,"8,623.38","77,610.38",
21-Apr-23,Tax,00.00,"12,935.06","64,675.32",
21-Apr-23,ATM,364.26,00.00,"65,039.58",
21-Apr-23,Debit Card,"2,12,446.30",00.00,"2,77,485.88",
21-Apr-23,Transportellaneous,"1,19,486.06",00.00,"3,96,971.94",
21-Apr-23,ATM,00.00,"3,96,971.94",00.00,
21-Apr-23,IMPS,01.28,00.00,01.28,
21-Apr-23,Transportellaneous,"1,789.40",00.00,"1,790.68",
21-Apr-23,Transfer,00.00,447.67,"1,343.01",
21-Apr-23,RTGS,00.00,268.6,"1,074.41",
21-Apr-23,Bill,00.00,537.21,537.21,
21-Apr-23,Cheque,00.00,76.74,460.47,
21-Apr-23,Cheque,00.00,115.12,345.35,
21-Apr-23,Transportellaneous,06.00,00.00,351.35,
21-Apr-23,Debit Card,00.00,58.56,292.79,
21-Apr-23,Cash,00.00,36.6,256.19,
21-Apr-23,IMPS,"2,362.19",00.00,"2,618.38",
21-Apr-23,NEFT,"62,730.16",00.00,"65,348.54",
21-Apr-23,Interest,00.00,"7,260.95","58,087.59",
21-Apr-23,RTGS,"18,72,383.00",00.00,"19,30,470.59",
21-Apr-23,Bill,408.19,00.00,"19,30,878.78",
21-Apr-23,Debit Card,00.00,"3,86,175.76","15,44,703.02",
21-Apr-23,Cash,244,00.00,"15,44,947.02",
21-Apr-23,Tax,05.60,00.00,"15,44,952.62",
21-Apr-23,Cash,00.00,"1,54,495.26","13,90,457.36",
21-Apr-23,ATM,00.00,"13,90,457.36",00.00,
21-Apr-23,Reversal,"8,43,713.00",00.00,"8,43,713.00",
21-Apr-23,Debit Card,"1,927.63",00.00,"8,45,640.63",
21-Apr-23,Transportellaneous,"23,102.00",00.00,"8,68,742.63",
21-Apr-23,Cash,03.70,00.00,"8,68,746.33",
21-Apr-23,Reversal,00.00,"2,89,582.11","5,79,164.22",
21-Apr-23,Debit Card,"18,39,831.80",00.00,"24,18,996.02",
21-Apr-23,ATM,00.00,"2,41,899.60","21,77,096.42",
21-Apr-23,Purchase,05.27,00.00,"21,77,101.69",
21-Apr-23,ATM,00.00,"3,62,850.28","18,14,251.41",
21-Apr-23,IMPS,00.00,"3,62,850.28","14,51,401.13",
21-Apr-23,Interest,"5,289.13",00.00,"14,56,690.26",
21-Apr-23,Tax,00.00,"1,61,854.47","12,94,835.79",
21-Apr-23,Purchase,00.00,"4,31,611.93","8,63,223.86",
21-Apr-23,Purchase,00.00,"86,322.39","7,76,901.47",
21-Apr-23,Cheque,13.1,00.00,"7,76,914.57",
21-Apr-23,Reversal,55.8,00.00,"7,76,970.37",
21-Apr-23,Cash,00.00,"2,58,990.12","5,17,980.25",
21-Apr-23,IMPS,288.66,00.00,"5,18,268.91",
21-Apr-23,Transfer,00.00,"86,378.15","4,31,890.76",
21-Apr-23,NEFT,377.31,00.00,"4,32,268.07",
21-Apr-23,Purchase,00.00,"4,32,268.07",00.00,
21-Apr-23,Transfer,"17,16,067.80",00.00,"17,16,067.80",
21-Apr-23,RTGS,00.00,"2,14,508.48","15,01,559.32",
21-Apr-23,Cheque,00.00,"7,50,779.66","7,50,779.66",
21-Apr-23,IMPS,00.00,"75,077.97","6,75,701.69",
21-Apr-23,Commission,00.00,"67,570.17","6,08,131.52",
21-Apr-23,Commission,00.00,"1,52,032.88","4,56,098.64",
21-Apr-23,Bill,00.00,"91,219.73","3,64,878.91",
21-Apr-23,Cash,43.83,00.00,"3,64,922.74",
21-Apr-23,Interest,00.00,"45,615.34","3,19,307.40",
21-Apr-23,NEFT,00.00,"31,930.74","2,87,376.66",
21-Apr-23,Debit Card,00.00,"28,737.67","2,58,638.99",
21-Apr-23,Debit Card,00.00,"2,58,638.99",00.00,
21-Apr-23,Tax,30.68,00.00,30.68,
21-Apr-23,Bill,321,00.00,351.68,
21-Apr-23,NEFT,"14,66,450.00",00.00,"14,66,801.68",
21-Apr-23,Transportellaneous,"5,94,660.00",00.00,"20,61,461.68",
21-Apr-23,NEFT,00.96,00.00,"20,61,462.64",
21-Apr-23,RTGS,00.00,"20,61,462.64",00.00,
21-Apr-23,RTGS,309.23,00.00,309.23,
21-Apr-23,Cheque,"10,03,471.00",00.00,"10,03,780.23",
21-Apr-23,Transfer,00.00,"5,01,890.12","5,01,890.12",
21-Apr-23,Transfer,00.00,"1,25,472.53","3,76,417.59",
21-Apr-23,IMPS,00.00,"94,104.40","2,82,313.19",
21-Apr-23,Transfer,"5,49,466.00",00.00,"8,31,779.19",
21-Apr-23,IMPS,05.50,00.00,"8,31,784.69",
21-Apr-23,IMPS,58.2,00.00,"8,31,842.89",
22-Apr-23,Bill,32.5,00.00,"8,31,875.39",
22-Apr-23,Commission,00.00,"4,15,937.70","4,15,937.70",
22-Apr-23,NEFT,00.00,"46,215.30","3,69,722.40",
22-Apr-23,Transfer,00.00,"41,080.27","3,28,642.13",
22-Apr-23,Transfer,"1,834.80",00.00,"3,30,476.93",
22-Apr-23,Reversal,00.00,"1,10,158.98","2,20,317.95",
22-Apr-23,Transportellaneous,00.00,"55,079.49","1,65,238.46",
22-Apr-23,Purchase,00.00,"27,539.74","1,37,698.72",
22-Apr-23,IMPS,00.00,"27,539.74","1,10,158.98",
22-Apr-23,ATM,00.00,"18,359.83","91,799.15",
22-Apr-23,Cheque,00.00,"13,114.16","78,684.99",
22-Apr-23,Commission,00.00,"8,742.78","69,942.21",
22-Apr-23,Bill,00.00,"13,988.44","55,953.77",
22-Apr-23,Cheque,00.00,"18,651.26","37,302.51",
22-Apr-23,IMPS,200.2,00.00,"37,502.71",
22-Apr-23,Interest,"12,805.00",00.00,"50,307.71",
22-Apr-23,Interest,00.00,"8,384.62","41,923.09",
22-Apr-23,IMPS,496.47,00.00,"42,419.56",
22-Apr-23,NEFT,17.2,00.00,"42,436.76",
22-Apr-23,Interest,05.00,00.00,"42,441.76",
22-Apr-23,Transportellaneous,00.00,"42,441.76",00.00,
22-Apr-23,NEFT,"1,659.90",00.00,"1,659.90",
22-Apr-23,Debit Card,"47,136.97",00.00,"48,796.87",
22-Apr-23,Cheque,00.00,"48,796.87",00.00,
22-Apr-23,NEFT,442.83,00.00,442.83,
22-Apr-23,Bill,00.00,110.71,332.12,
22-Apr-23,Transfer,00.00,36.9,295.22,
23-Apr-23,RTGS,"23,595.88",00.00,"23,891.10",
23-Apr-23,Transportellaneous,00.00,"23,891.10",00.00,
23-Apr-23,RTGS,"2,692.78",00.00,"2,692.78",
23-Apr-23,Transportellaneous,00.00,538.56,"2,154.22",
23-Apr-23,Interest,"3,61,939.50",00.00,"3,64,093.72",
23-Apr-23,IMPS,00.00,"3,64,093.72",00.00,
23-Apr-23,Purchase,05.90,00.00,05.90,
23-Apr-23,Tax,00.00,00.74,05.16,
23-Apr-23,Transfer,00.00,02.58,02.58,
23-Apr-23,Commission,00.00,00.37,02.21,
23-Apr-23,Reversal,00.00,00.22,01.99,
23-Apr-23,Reversal,00.00,01.00,01.00,
23-Apr-23,IMPS,00.00,00.20,00.80,
23-Apr-23,Commission,00.00,00.09,00.71,
23-Apr-23,Cheque,00.00,00.18,00.53,
23-Apr-23,Transportellaneous,35,00.00,35.53,
23-Apr-23,Cash,"3,498.00",00.00,"3,533.53",
23-Apr-23,Transfer,112,00.00,"3,645.53",
23-Apr-23,Transfer,"26,526.00",00.00,"30,171.53",
23-Apr-23,ATM,00.00,"6,034.31","24,137.22",
23-Apr-23,Tax,00.00,"12,068.61","12,068.61",
23-Apr-23,Commission,00.00,"3,017.15","9,051.46",
23-Apr-23,NEFT,54.4,00.00,"9,105.86",
23-Apr-23,Tax,00.00,"9,105.86",00.00,
23-Apr-23,Debit Card,"16,91,258.50",00.00,"16,91,258.50",
23-Apr-23,Debit Card,00.00,"4,22,814.63","12,68,443.88",
23-Apr-23,Bill,180,00.00,"12,68,623.88",
23-Apr-23,Cash,00.00,"1,40,958.21","11,27,665.67",
23-Apr-23,Interest,00.00,"1,61,095.10","9,66,570.57",
23-Apr-23,Bill,00.00,"1,38,081.51","8,28,489.06",
23-Apr-23,Purchase,"19,32,159.00",00.00,"27,60,648.06",
23-Apr-23,Transfer,00.00,"9,20,216.02","18,40,432.04",
23-Apr-23,Reversal,37,00.00,"18,40,469.04",
23-Apr-23,NEFT,00.00,"1,84,046.90","16,56,422.14",
23-Apr-23,Tax,26.6,00.00,"16,56,448.74",
23-Apr-23,ATM,00.00,"1,65,644.87","14,90,803.87",
23-Apr-23,Reversal,48,00.00,"14,90,851.87",
23-Apr-23,Reversal,19.9,00.00,"14,90,871.77",
23-Apr-23,Cash,329,00.00,"14,91,200.77",
23-Apr-23,NEFT,271.97,00.00,"14,91,472.74",
24-Apr-23,Purchase,00.00,"14,91,472.74",00.00,
24-Apr-23,Purchase,"3,80,622.20",00.00,"3,80,622.20",
24-Apr-23,IMPS,55.6,00.00,"3,80,677.80",
24-Apr-23,Tax,07.00,00.00,"3,80,684.80",
24-Apr-23,Bill,"1,09,112.00",00.00,"4,89,796.80",
24-Apr-23,NEFT,"5,179.00",00.00,"4,94,975.80",
24-Apr-23,Interest,00.00,"1,23,743.95","3,71,231.85",
24-Apr-23,ATM,32.14,00.00,"3,71,263.99",
24-Apr-23,NEFT,"4,63,996.00",00.00,"8,35,259.99",
25-Apr-23,Cash,"1,06,407.00",00.00,"9,41,666.99",
25-Apr-23,Debit Card,"20,746.00",00.00,"9,62,412.99",
25-Apr-23,Transfer,00.00,"1,37,487.57","8,24,925.42",
25-Apr-23,Interest,"2,31,515.00",00.00,"10,56,440.42",
25-Apr-23,Transfer,86.4,00.00,"10,56,526.82",
25-Apr-23,Interest,00.00,"2,11,305.36","8,45,221.46",
25-Apr-23,Tax,00.00,"84,522.15","7,60,699.31",
25-Apr-23,Purchase,288.6,00.00,"7,60,987.91",
25-Apr-23,Bill,00.00,"2,53,662.64","5,07,325.27",
25-Apr-23,Commission,447.6,00.00,"5,07,772.87",
25-Apr-23,Commission,00.00,"63,471.61","4,44,301.26",
25-Apr-23,NEFT,00.00,"63,471.61","3,80,829.65",
25-Apr-23,IMPS,00.00,"54,404.24","3,26,425.41",
25-Apr-23,Bill,"18,79,383.00",00.00,"22,05,808.41",
25-Apr-23,Interest,00.00,"2,20,580.84","19,85,227.57",
25-Apr-23,Transfer,00.00,"9,92,613.79","9,92,613.78",
25-Apr-23,Transfer,"21,478.00",00.00,"10,14,091.78",
26-Apr-23,IMPS,00.00,"10,14,091.78",00.00,
26-Apr-23,Commission,08.00,00.00,08.00,
26-Apr-23,Bill,"99,344.00",00.00,"99,352.00",
26-Apr-23,Transportellaneous,00.00,"9,935.20","89,416.80",
26-Apr-23,Cheque,00.00,"12,773.83","76,642.97",
26-Apr-23,Reversal,00.00,"8,515.89","68,127.08",
26-Apr-23,Purchase,00.00,"17,031.77","51,095.31",
26-Apr-23,Reversal,00.00,"6,386.91","44,708.40",
26-Apr-23,Transportellaneous,00.00,"5,588.55","39,119.85",
26-Apr-23,Transportellaneous,"6,639.10",00.00,"45,758.95",
26-Apr-23,Debit Card,01.00,00.00,"45,759.95",
26-Apr-23,RTGS,24.8,00.00,"45,784.75",
26-Apr-23,Transportellaneous,00.00,"45,784.75",00.00,
26-Apr-23,Tax,125.4,00.00,125.4,
26-Apr-23,NEFT,"2,782.42",00.00,"2,907.82",
26-Apr-23,Tax,00.00,323.09,"2,584.73",
26-Apr-23,Debit Card,00.00,287.19,"2,297.54",
26-Apr-23,Bill,00.00,328.22,"1,969.32",
26-Apr-23,Interest,"20,230.00",00.00,"22,199.32",
26-Apr-23,Debit Card,00.00,"2,466.59","19,732.73",
26-Apr-23,IMPS,00.00,"3,288.79","16,443.94",
26-Apr-23,Transfer,"3,650.87",00.00,"20,094.81",
26-Apr-23,Interest,06.30,00.00,"20,101.11",
26-Apr-23,Transfer,"2,385.35",00.00,"22,486.46",
26-Apr-23,Bill,00.00,"2,810.81","19,675.65",
26-Apr-23,ATM,00.00,"2,459.46","17,216.19",
26-Apr-23,RTGS,"3,008.89",00.00,"20,225.08",
26-Apr-23,ATM,"1,52,898.66",00.00,"1,73,123.74",
26-Apr-23,Bill,20.45,00.00,"1,73,144.19",
26-Apr-23,Transfer,00.00,"19,238.24","1,53,905.95",
26-Apr-23,Purchase,00.00,"21,986.56","1,31,919.39",
26-Apr-23,Transportellaneous,"2,45,251.00",00.00,"3,77,170.39",
26-Apr-23,IMPS,00.00,"53,881.48","3,23,288.91",
26-Apr-23,Purchase,"5,04,149.75",00.00,"8,27,438.66",
26-Apr-23,Bill,"3,365.00",00.00,"8,30,803.66",
26-Apr-23,NEFT,420.05,00.00,"8,31,223.71",
26-Apr-23,IMPS,"1,35,868.62",00.00,"9,67,092.33",
26-Apr-23,Debit Card,37.2,00.00,"9,67,129.53",
26-Apr-23,Bill,00.00,"1,20,891.19","8,46,238.34",
26-Apr-23,Bill,00.00,"84,623.83","7,61,614.51",
26-Apr-23,Purchase,"8,239.00",00.00,"7,69,853.51",
26-Apr-23,Bill,00.24,00.00,"7,69,853.75",
26-Apr-23,Bill,"6,67,762.00",00.00,"14,37,615.75",
26-Apr-23,Debit Card,00.00,"3,59,403.94","10,78,211.81",
26-Apr-23,Cash,00.00,"3,59,403.94","7,18,807.87",
27-Apr-23,Transfer,00.00,"1,19,801.31","5,99,006.56",
27-Apr-23,Debit Card,00.00,"59,900.66","5,39,105.90",
27-Apr-23,RTGS,00.00,"2,69,552.95","2,69,552.95",
28-Apr-23,Interest,"11,26,438.00",00.00,"13,95,990.95",
28-Apr-23,Tax,00.00,"3,48,997.74","10,46,993.21",
28-Apr-23,Cash,00.00,"2,09,398.64","8,37,594.57",
28-Apr-23,Reversal,"1,398.00",00.00,"8,38,992.57",
28-Apr-23,Transportellaneous,"3,611.40",00.00,"8,42,603.97",
28-Apr-23,Cash,00.00,"1,40,434.00","7,02,169.98",
28-Apr-23,RTGS,10,00.00,"7,02,179.98",
28-Apr-23,ATM,"87,882.00",00.00,"7,90,061.98",
28-Apr-23,Tax,"13,50,428.00",00.00,"21,40,489.98",
28-Apr-23,ATM,"2,430.70",00.00,"21,42,920.68",
28-Apr-23,Transfer,00.00,"2,67,865.09","18,75,055.60",
28-Apr-23,Reversal,"78,965.66",00.00,"19,54,021.26",
28-Apr-23,NEFT,00.00,"9,77,010.63","9,77,010.63",
29-Apr-23,Bill,"2,964.00",00.00,"9,79,974.63",
29-Apr-23,IMPS,00.00,"1,95,994.93","7,83,979.70",
29-Apr-23,Commission,00.00,"1,30,663.28","6,53,316.42",
29-Apr-23,NEFT,00.00,"65,331.64","5,87,984.78",
29-Apr-23,Cheque,264,00.00,"5,88,248.78",
29-Apr-23,Bill,"17,27,283.50",00.00,"23,15,532.28",
29-Apr-23,Tax,04.72,00.00,"23,15,537.00",
29-Apr-23,Transportellaneous,00.00,"2,31,553.70","20,83,983.30",
29-Apr-23,Reversal,24.3,00.00,"20,84,007.60",
29-Apr-23,Bill,00.00,"10,42,003.80","10,42,003.80",
29-Apr-23,RTGS,415,00.00,"10,42,418.80",
29-Apr-23,Commission,"7,954.12",00.00,"10,50,372.92",
29-Apr-23,NEFT,00.40,00.00,"10,50,373.32",
29-Apr-23,Reversal,00.00,"1,31,296.67","9,19,076.66",
29-Apr-23,Transfer,00.00,"1,31,296.67","7,87,779.99",
29-Apr-23,Transportellaneous,429,00.00,"7,88,208.99",
29-Apr-23,Transportellaneous,"1,86,023.00",00.00,"9,74,231.99",
30-Apr-23,RTGS,00.00,"1,08,248.00","8,65,983.99",
30-Apr-23,Bill,00.00,"2,88,661.33","5,77,322.66",
30-Apr-23,Interest,00.00,"1,44,330.67","4,32,992.00",
30-Apr-23,Transportellaneous,25,00.00,"4,33,017.00",
30-Apr-23,Purchase,49.21,00.00,"4,33,066.21",
30-Apr-23,Cheque,00.00,"72,177.70","3,60,888.51",
30-Apr-23,NEFT,771.3,00.00,"3,61,659.81",
30-Apr-23,Tax,00.00,"51,665.69","3,09,994.12",
30-Apr-23,Cash,00.00,"51,665.69","2,58,328.43",
30-Apr-23,Reversal,00.00,"64,582.11","1,93,746.32",
30-Apr-23,Commission,"8,21,236.00",00.00,"10,14,982.32",
30-Apr-23,Tax,63.38,00.00,"10,15,045.70",
30-Apr-23,Bill,00.00,"2,53,761.43","7,61,284.27",
30-Apr-23,Debit Card,00.00,"1,26,880.71","6,34,403.56",
30-Apr-23,NEFT,00.00,"70,489.28","5,63,914.28",
30-Apr-23,Debit Card,14,00.00,"5,63,928.28",
30-Apr-23,Transfer,588,00.00,"5,64,516.28",
30-Apr-23,IMPS,00.00,"1,88,172.09","3,76,344.19",
30-Apr-23,Transportellaneous,00.00,"41,816.02","3,34,528.17",
30-Apr-23,NEFT,280,00.00,"3,34,808.17",
30-Apr-23,RTGS,01.00,00.00,"3,34,809.17",
30-Apr-23,Commission,152,00.00,"3,34,961.17",
30-Apr-23,Tax,419.35,00.00,"3,35,380.52",
30-Apr-23,Reversal,00.00,"3,35,380.52",00.00,
30-Apr-23,ATM,72,00.00,72,
30-Apr-23,Debit Card,"29,316.70",00.00,"29,388.70",
30-Apr-23,RTGS,"9,10,688.00",00.00,"9,40,076.70",
30-Apr-23,Interest,00.00,"9,40,076.70",00.00,
30-Apr-23,Bill,13.37,00.00,13.37,
30-Apr-23,Reversal,"2,37,218.16",00.00,"2,37,231.53",
30-Apr-23,ATM,"1,783.40",00.00,"2,39,014.93",
30-Apr-23,IMPS,00.00,"34,144.99","2,04,869.94",
30-Apr-23,ATM,00.00,"2,04,869.94",00.00,
30-Apr-23,Interest,"15,37,940.20",00.00,"15,37,940.20",
30-Apr-23,Commission,00.00,"1,53,794.02","13,84,146.18",
30-Apr-23,ATM,37.1,00.00,"13,84,183.28",
30-Apr-23,Commission,00.00,"1,73,022.91","12,11,160.37",
30-Apr-23,Cash,00.00,"6,05,580.19","6,05,580.19",
30-Apr-23,Transfer,00.00,"2,01,860.06","4,03,720.13",
30-Apr-23,RTGS,112,00.00,"4,03,832.13",
30-Apr-23,Cash,"2,29,446.00",00.00,"6,33,278.13",
30-Apr-23,Reversal,"1,628.00",00.00,"6,34,906.13",
30-Apr-23,Interest,05.72,00.00,"6,34,911.85",
30-Apr-23,IMPS,00.00,"79,363.98","5,55,547.87",
30-Apr-23,Cheque,"6,06,157.50",00.00,"11,61,705.37",
30-Apr-23,Commission,"20,02,653.20",00.00,"31,64,358.57",
30-Apr-23,RTGS,63,00.00,"31,64,421.57",
30-Apr-23,Purchase,01.00,00.00,"31,64,422.57",
01-May-23,Cash,00.00,"5,27,403.76","26,37,018.81",
01-May-23,IMPS,00.00,"3,29,627.35","23,07,391.46",
01-May-23,Debit Card,00.00,"23,07,391.46",00.00,
01-May-23,Reversal,42.5,00.00,42.5,
01-May-23,Commission,259.4,00.00,301.9,
01-May-23,Purchase,00.00,30.19,271.71,
01-May-23,ATM,"1,97,677.62",00.00,"1,97,949.33",
01-May-23,Interest,17,00.00,"1,97,966.33",
01-May-23,ATM,00.00,"32,994.39","1,64,971.94",
01-May-23,Purchase,"20,95,558.00",00.00,"22,60,529.94",
01-May-23,IMPS,00.00,"3,76,754.99","18,83,774.95",
01-May-23,Interest,00.00,"2,69,110.71","16,14,664.24",
01-May-23,Purchase,00.00,"4,03,666.06","12,10,998.18",
01-May-23,RTGS,00.00,"1,51,374.77","10,59,623.41",
01-May-23,Transfer,"3,386.00",00.00,"10,63,009.41",
01-May-23,Reversal,00.00,"10,63,009.41",00.00,
01-May-23,Transfer,"8,80,180.00",00.00,"8,80,180.00",
01-May-23,Commission,00.00,"1,76,036.00","7,04,144.00",
01-May-23,Commission,154,00.00,"7,04,298.00",
02-May-23,NEFT,00.00,"1,00,614.00","6,03,684.00",
02-May-23,Transportellaneous,101.85,00.00,"6,03,785.85",
02-May-23,Tax,00.00,"1,20,757.17","4,83,028.68",
02-May-23,Transfer,00.00,"60,378.59","4,22,650.10",
02-May-23,Tax,"1,447.10",00.00,"4,24,097.20",
03-May-23,Debit Card,"6,289.31",00.00,"4,30,386.51",
03-May-23,Commission,51,00.00,"4,30,437.51",
03-May-23,ATM,02.90,00.00,"4,30,440.41",
03-May-23,Transportellaneous,04.00,00.00,"4,30,444.41",
03-May-23,ATM,00.00,"1,07,611.10","3,22,833.31",
03-May-23,Purchase,"12,801.83",00.00,"3,35,635.14",
03-May-23,Bill,"9,978.00",00.00,"3,45,613.14",
03-May-23,Cash,00.00,"1,72,806.57","1,72,806.57",
03-May-23,NEFT,"15,526.00",00.00,"1,88,332.57",
03-May-23,Purchase,00.00,"20,925.84","1,67,406.73",
03-May-23,Bill,"46,883.25",00.00,"2,14,289.98",
03-May-23,Purchase,00.00,"23,810.00","1,90,479.98",
03-May-23,RTGS,"1,80,199.40",00.00,"3,70,679.38",
03-May-23,Purchase,"2,51,875.40",00.00,"6,22,554.78",
03-May-23,IMPS,35,00.00,"6,22,589.78",
03-May-23,IMPS,00.00,"69,176.64","5,53,413.14",
03-May-23,Cash,00.00,"2,76,706.57","2,76,706.57",
03-May-23,NEFT,00.00,"30,745.17","2,45,961.40",
03-May-23,Debit Card,00.00,"49,192.28","1,96,769.12",
03-May-23,Cheque,00.00,"24,596.14","1,72,172.98",
03-May-23,RTGS,44.9,00.00,"1,72,217.88",
03-May-23,Purchase,00.00,"17,221.79","1,54,996.09",
03-May-23,Cheque,00.00,"19,374.51","1,35,621.58",
03-May-23,NEFT,01.50,00.00,"1,35,623.08",
03-May-23,Bill,00.00,"22,603.85","1,13,019.23",
03-May-23,IMPS,"4,755.07",00.00,"1,17,774.30",
03-May-23,Cash,00.00,"11,777.43","1,05,996.87",
03-May-23,Interest,22.3,00.00,"1,06,019.17",
03-May-23,Commission,"3,341.50",00.00,"1,09,360.67",
03-May-23,Bill,00.00,"21,872.13","87,488.54",
03-May-23,Transportellaneous,00.00,"17,497.71","69,990.83",
03-May-23,Transportellaneous,206,00.00,"70,196.83",
03-May-23,Cash,00.00,"8,774.60","61,422.23",
03-May-23,Purchase,00.00,"15,355.56","46,066.67",
03-May-23,Transfer,00.00,"46,066.67",00.00,
03-May-23,ATM,"2,791.12",00.00,"2,791.12",
03-May-23,Bill,"7,38,941.50",00.00,"7,41,732.62",
03-May-23,Cheque,00.00,"1,23,622.10","6,18,110.52",
03-May-23,IMPS,"2,224.20",00.00,"6,20,334.72",
03-May-23,Purchase,"4,832.00",00.00,"6,25,166.72",
03-May-23,IMPS,00.00,"1,04,194.45","5,20,972.27",
03-May-23,Interest,"6,94,544.25",00.00,"12,15,516.52",
03-May-23,Transfer,00.00,"6,07,758.26","6,07,758.26",
03-May-23,Cheque,00.00,"86,822.61","5,20,935.65",
03-May-23,ATM,03.42,00.00,"5,20,939.07",
03-May-23,Purchase,00.00,"52,093.91","4,68,845.16",
03-May-23,Commission,483.1,00.00,"4,69,328.26",
03-May-23,RTGS,00.00,"78,221.38","3,91,106.88",
03-May-23,Cash,00.00,"65,184.48","3,25,922.40",
03-May-23,Debit Card,"1,105.48",00.00,"3,27,027.88",
03-May-23,Bill,05.68,00.00,"3,27,033.56",
03-May-23,Cash,00.40,00.00,"3,27,033.96",
03-May-23,Cheque,00.00,"3,27,033.96",00.00,
03-May-23,Commission,"1,186.90",00.00,"1,186.90",
03-May-23,ATM,"32,481.00",00.00,"33,667.90",
03-May-23,NEFT,"55,008.84",00.00,"88,676.74",
03-May-23,Commission,"10,971.57",00.00,"99,648.31",
04-May-23,NEFT,00.00,"16,608.05","83,040.26",
04-May-23,IMPS,"3,407.18",00.00,"86,447.44",
05-May-23,Purchase,"14,033.40",00.00,"1,00,480.84",
05-May-23,Cheque,23.5,00.00,"1,00,504.34",
05-May-23,Transportellaneous,00.00,"14,357.76","86,146.58",
05-May-23,Tax,00.00,"28,715.53","57,431.05",
05-May-23,Transfer,00.00,"5,743.11","51,687.94",
05-May-23,Reversal,"13,76,570.00",00.00,"14,28,257.94",
05-May-23,Interest,00.00,"1,78,532.24","12,49,725.70",
05-May-23,Reversal,00.00,"1,78,532.24","10,71,193.46",
05-May-23,Reversal,"65,947.97",00.00,"11,37,141.43",
05-May-23,ATM,00.00,"1,13,714.14","10,23,427.29",
05-May-23,NEFT,15,00.00,"10,23,442.29",
05-May-23,RTGS,"1,845.10",00.00,"10,25,287.39",
05-May-23,Tax,00.00,"1,28,160.92","8,97,126.47",
05-May-23,IMPS,05.00,00.00,"8,97,131.47",
05-May-23,Purchase,00.00,"99,681.27","7,97,450.20",
05-May-23,ATM,34,00.00,"7,97,484.20",
05-May-23,ATM,00.00,"2,65,828.07","5,31,656.13",
05-May-23,Interest,00.00,"1,06,331.23","4,25,324.90",
05-May-23,IMPS,00.00,"70,887.48","3,54,437.42",
05-May-23,IMPS,05.58,00.00,"3,54,443.00",
05-May-23,Interest,06.00,00.00,"3,54,449.00",
05-May-23,Cheque,46,00.00,"3,54,495.00",
06-May-23,Reversal,479,00.00,"3,54,974.00",
06-May-23,Purchase,00.00,"1,18,324.67","2,36,649.33",
06-May-23,Bill,00.00,"78,883.11","1,57,766.22",
06-May-23,ATM,00.00,"15,776.62","1,41,989.60",
06-May-23,Cheque,"1,965.70",00.00,"1,43,955.30",
06-May-23,Cheque,135.39,00.00,"1,44,090.69",
06-May-23,Interest,00.00,"28,818.14","1,15,272.55",
06-May-23,IMPS,00.00,"23,054.51","92,218.04",
06-May-23,ATM,03.11,00.00,"92,221.15",
06-May-23,Cash,"18,148.80",00.00,"1,10,369.95",
06-May-23,NEFT,00.00,"15,767.14","94,602.81",
06-May-23,Purchase,"2,470.80",00.00,"97,073.61",
06-May-23,Cash,07.25,00.00,"97,080.86",
06-May-23,Commission,44.36,00.00,"97,125.22",
06-May-23,Tax,00.00,"13,875.03","83,250.19",
06-May-23,Cash,"20,974.00",00.00,"1,04,224.19",
06-May-23,ATM,00.00,"11,580.47","92,643.72",
06-May-23,Purchase,"15,89,292.00",00.00,"16,81,935.72",
06-May-23,Interest,47,00.00,"16,81,982.72",
06-May-23,Bill,"29,620.70",00.00,"17,11,603.42",
06-May-23,Commission,00.00,"8,55,801.71","8,55,801.71",
06-May-23,Commission,398,00.00,"8,56,199.71",
07-May-23,Bill,"2,16,581.34",00.00,"10,72,781.05",
07-May-23,Cheque,00.00,"2,14,556.21","8,58,224.84",
07-May-23,Commission,00.00,"2,86,074.95","5,72,149.89",
07-May-23,Reversal,"4,86,818.00",00.00,"10,58,967.89",
07-May-23,Interest,00.00,"3,52,989.30","7,05,978.59",
07-May-23,Commission,00.00,"1,17,663.10","5,88,315.49",
07-May-23,Interest,00.00,"84,045.07","5,04,270.42",
07-May-23,Interest,35.8,00.00,"5,04,306.22",
07-May-23,Transportellaneous,00.00,"1,68,102.07","3,36,204.15",
07-May-23,Debit Card,00.00,"1,12,068.05","2,24,136.10",
07-May-23,NEFT,05.00,00.00,"2,24,141.10",
07-May-23,Tax,"1,69,011.00",00.00,"3,93,152.10",
08-May-23,IMPS,"53,904.00",00.00,"4,47,056.10",
08-May-23,Bill,"13,29,113.50",00.00,"17,76,169.60",
08-May-23,Cheque,"5,96,233.00",00.00,"23,72,402.60",
08-May-23,Purchase,00.00,"5,93,100.65","17,79,301.95",
08-May-23,IMPS,31,00.00,"17,79,332.95",
08-May-23,Transportellaneous,00.00,"2,54,190.42","15,25,142.53",
08-May-23,Transfer,"1,17,393.53",00.00,"16,42,536.06",
08-May-23,Cash,00.00,"1,64,253.61","14,78,282.45",
08-May-23,Interest,00.00,"1,84,785.31","12,93,497.14",
08-May-23,Reversal,"5,74,192.00",00.00,"18,67,689.14",
08-May-23,Commission,"20,58,927.20",00.00,"39,26,616.34",
08-May-23,Debit Card,05.00,00.00,"39,26,621.34",
08-May-23,Tax,"1,03,120.00",00.00,"40,29,741.34",
08-May-23,Tax,00.00,"8,05,948.27","32,23,793.07",
08-May-23,Tax,00.00,"8,05,948.27","24,17,844.80",
08-May-23,Commission,"4,33,412.00",00.00,"28,51,256.80",
08-May-23,RTGS,"1,173.53",00.00,"28,52,430.33",
08-May-23,Bill,"20,71,686.00",00.00,"49,24,116.33",
08-May-23,Cash,"54,997.00",00.00,"49,79,113.33",
08-May-23,Transfer,"71,357.90",00.00,"50,50,471.23",
08-May-23,Cheque,00.00,"50,50,471.23",00.00,
09-May-23,ATM,"15,18,272.50",00.00,"15,18,272.50",
09-May-23,NEFT,00.00,"7,59,136.25","7,59,136.25",
09-May-23,Commission,07.50,00.00,"7,59,143.75",
09-May-23,IMPS,00.00,"1,26,523.96","6,32,619.79",
09-May-23,Debit Card,04.00,00.00,"6,32,623.79",
09-May-23,IMPS,"30,454.00",00.00,"6,63,077.79",
09-May-23,Interest,00.00,"2,21,025.93","4,42,051.86",
09-May-23,Transportellaneous,00.00,"55,256.48","3,86,795.38",
09-May-23,IMPS,"19,59,446.50",00.00,"23,46,241.88",
09-May-23,Transfer,00.00,"23,46,241.88",00.00,
09-May-23,Interest,"3,225.20",00.00,"3,225.20",
09-May-23,IMPS,"11,99,004.00",00.00,"12,02,229.20",
09-May-23,Transportellaneous,00.00,"1,33,581.02","10,68,648.18",
09-May-23,RTGS,"1,855.00",00.00,"10,70,503.18",
09-May-23,ATM,"30,887.00",00.00,"11,01,390.18",
09-May-23,Reversal,"1,805.20",00.00,"11,03,195.38",
09-May-23,IMPS,00.00,"1,57,599.34","9,45,596.04",
09-May-23,IMPS,00.00,"1,89,119.21","7,56,476.83",
09-May-23,Transfer,42,00.00,"7,56,518.83",
09-May-23,Tax,00.00,"1,51,303.77","6,05,215.06",
09-May-23,Reversal,00.00,"3,02,607.53","3,02,607.53",
09-May-23,Reversal,00.00,"43,229.65","2,59,377.88",
09-May-23,RTGS,"17,09,457.00",00.00,"19,68,834.88",
09-May-23,Interest,00.00,"2,18,759.43","17,50,075.45",
09-May-23,RTGS,05.50,00.00,"17,50,080.95",
09-May-23,Transportellaneous,00.00,"1,75,008.10","15,75,072.86",
09-May-23,IMPS,"23,943.40",00.00,"15,99,016.26",
09-May-23,Transportellaneous,"21,464.62",00.00,"16,20,480.88",
09-May-23,Transfer,"2,47,419.69",00.00,"18,67,900.57",
09-May-23,Reversal,00.00,"2,66,842.94","16,01,057.63",
09-May-23,Reversal,00.00,"2,28,722.52","13,72,335.11",
09-May-23,Commission,00.00,"6,86,167.56","6,86,167.56",
09-May-23,Bill,"4,21,656.50",00.00,"11,07,824.06",
09-May-23,Tax,00.00,"2,21,564.81","8,86,259.25",
09-May-23,Interest,26.5,00.00,"8,86,285.75",
09-May-23,Reversal,00.00,"88,628.58","7,97,657.18",
09-May-23,Purchase,00.00,"79,765.72","7,17,891.46",
09-May-23,Transfer,00.00,"3,58,945.73","3,58,945.73",
09-May-23,Cheque,38.38,00.00,"3,58,984.11",
09-May-23,IMPS,"1,291.31",00.00,"3,60,275.42",
09-May-23,RTGS,00.00,"60,045.90","3,00,229.52",
09-May-23,Transportellaneous,"1,877.00",00.00,"3,02,106.52",
09-May-23,RTGS,"12,461.10",00.00,"3,14,567.62",
09-May-23,Cash,00.00,"1,57,283.81","1,57,283.81",
09-May-23,Transfer,00.00,"52,427.94","1,04,855.87",
09-May-23,ATM,47,00.00,"1,04,902.87",
09-May-23,Transportellaneous,"2,22,198.40",00.00,"3,27,101.27",
09-May-23,Transfer,"2,38,316.84",00.00,"5,65,418.11",
09-May-23,IMPS,00.00,"1,88,472.70","3,76,945.41",
09-May-23,Transfer,00.00,"1,88,472.71","1,88,472.70",
09-May-23,Transportellaneous,00.00,"31,412.12","1,57,060.58",
09-May-23,Transportellaneous,"17,826.90",00.00,"1,74,887.48",
09-May-23,IMPS,00.00,"17,488.75","1,57,398.73",
09-May-23,Cash,"17,607.00",00.00,"1,75,005.73",
09-May-23,RTGS,498.34,00.00,"1,75,504.07",
09-May-23,Tax,00.00,"21,938.01","1,53,566.06",
10-May-23,Purchase,00.00,"51,188.69","1,02,377.37",
10-May-23,Tax,"15,587.00",00.00,"1,17,964.37",
10-May-23,Transportellaneous,00.00,"1,17,964.37",00.00,
10-May-23,Commission,05.00,00.00,05.00,
10-May-23,RTGS,00.00,00.83,04.17,
10-May-23,Transportellaneous,00.00,00.52,03.65,
10-May-23,Debit Card,"3,153.00",00.00,"3,156.65",
11-May-23,Purchase,07.42,00.00,"3,164.07",
11-May-23,Reversal,00.00,452.01,"2,712.06",
11-May-23,Commission,"26,280.00",00.00,"28,992.06",
11-May-23,Cash,25.6,00.00,"29,017.66",
11-May-23,Transportellaneous,"31,793.09",00.00,"60,810.75",
11-May-23,Tax,00.00,"7,601.34","53,209.41",
11-May-23,RTGS,00.00,"5,320.94","47,888.47",
11-May-23,Purchase,00.00,"15,962.82","31,925.65",
11-May-23,Transportellaneous,"15,75,096.75",00.00,"16,07,022.40",
11-May-23,ATM,"24,875.10",00.00,"16,31,897.50",
11-May-23,Tax,"80,061.80",00.00,"17,11,959.30",
11-May-23,Bill,00.00,"8,55,979.65","8,55,979.65",
11-May-23,NEFT,05.00,00.00,"8,55,984.65",
11-May-23,Bill,"13,70,593.50",00.00,"22,26,578.15",
11-May-23,Commission,00.00,"2,47,397.57","19,79,180.58",
11-May-23,Cash,"2,08,817.40",00.00,"21,87,997.98",
11-May-23,Purchase,51.2,00.00,"21,88,049.18",
11-May-23,Bill,00.00,"7,29,349.73","14,58,699.45",
11-May-23,Interest,03.00,00.00,"14,58,702.45",
11-May-23,Transfer,"10,450.00",00.00,"14,69,152.45",
11-May-23,Cheque,00.00,"1,83,644.06","12,85,508.39",
11-May-23,Transportellaneous,00.00,"3,21,377.10","9,64,131.29",
11-May-23,Transfer,04.00,00.00,"9,64,135.29",
11-May-23,Transfer,00.00,"1,07,126.14","8,57,009.15",
11-May-23,Debit Card,07.17,00.00,"8,57,016.32",
11-May-23,Tax,00.00,"95,224.04","7,61,792.28",
12-May-23,Bill,00.00,"1,08,827.47","6,52,964.81",
12-May-23,IMPS,"9,100.00",00.00,"6,62,064.81",
12-May-23,Reversal,"17,70,583.80",00.00,"24,32,648.61",
12-May-23,Commission,242,00.00,"24,32,890.61",
12-May-23,Cash,00.00,"12,16,445.31","12,16,445.30",
12-May-23,Bill,17.4,00.00,"12,16,462.70",
12-May-23,Transfer,00.00,"6,08,231.35","6,08,231.35",
12-May-23,Reversal,"26,303.13",00.00,"6,34,534.48",
12-May-23,IMPS,64,00.00,"6,34,598.48",
12-May-23,Purchase,"21,220.03",00.00,"6,55,818.51",
12-May-23,Cash,04.00,00.00,"6,55,822.51",
12-May-23,Cash,00.00,"93,688.93","5,62,133.58",
12-May-23,RTGS,134,00.00,"5,62,267.58",
12-May-23,Commission,34,00.00,"5,62,301.58",
12-May-23,RTGS,00.00,"70,287.70","4,92,013.88",
12-May-23,NEFT,00.00,"98,402.78","3,93,611.10",
12-May-23,Cheque,04.59,00.00,"3,93,615.69",
12-May-23,Transportellaneous,"30,035.88",00.00,"4,23,651.57",
12-May-23,Interest,00.00,"47,072.40","3,76,579.17",
12-May-23,Cash,00.00,"41,842.13","3,34,737.04",
12-May-23,ATM,41.25,00.00,"3,34,778.29",
12-May-23,RTGS,00.00,"55,796.38","2,78,981.91",
12-May-23,ATM,00.00,"55,796.38","2,23,185.53",
12-May-23,Transfer,00.00,"74,395.18","1,48,790.35",
12-May-23,NEFT,00.00,"18,598.79","1,30,191.56",
12-May-23,Transportellaneous,00.00,"16,273.95","1,13,917.62",
12-May-23,Cheque,451.2,00.00,"1,14,368.82",
12-May-23,RTGS,00.00,"28,592.21","85,776.62",
12-May-23,Purchase,00.00,"28,592.21","57,184.41",
12-May-23,Interest,00.00,"19,061.47","38,122.94",
12-May-23,Transfer,00.09,00.00,"38,123.03",
12-May-23,RTGS,15,00.00,"38,138.03",
12-May-23,Bill,02.00,00.00,"38,140.03",
12-May-23,NEFT,00.00,"12,713.34","25,426.69",
12-May-23,Reversal,00.00,"12,713.35","12,713.34",
12-May-23,Interest,00.00,"2,118.89","10,594.45",
12-May-23,Reversal,00.00,"2,118.89","8,475.56",
12-May-23,Transportellaneous,"3,863.00",00.00,"12,338.56",
12-May-23,Cheque,00.00,"2,467.71","9,870.85",
12-May-23,IMPS,00.00,"1,974.17","7,896.68",
12-May-23,Cheque,00.00,987.09,"6,909.60",
12-May-23,Transfer,"29,759.40",00.00,"36,669.00",
12-May-23,Transfer,191.9,00.00,"36,860.90",
12-May-23,RTGS,00.00,"12,286.97","24,573.93",
12-May-23,Commission,00.00,"3,071.74","21,502.19",
12-May-23,Tax,45,00.00,"21,547.19",
12-May-23,Commission,01.00,00.00,"21,548.19",
12-May-23,Purchase,00.00,"10,774.10","10,774.10",
12-May-23,Reversal,00.00,"1,539.16","9,234.94",
12-May-23,ATM,"94,394.00",00.00,"1,03,628.94",
12-May-23,RTGS,"1,883.99",00.00,"1,05,512.93",
12-May-23,Debit Card,00.00,"21,102.59","84,410.34",
12-May-23,Cheque,00.00,"10,551.29","73,859.05",
13-May-23,Commission,00.00,"8,206.56","65,652.49",
13-May-23,Interest,00.00,"9,378.93","56,273.56",
13-May-23,NEFT,"3,11,628.50",00.00,"3,67,902.06",
13-May-23,Cash,00.00,"1,83,951.03","1,83,951.03",
13-May-23,Purchase,"1,38,312.80",00.00,"3,22,263.83",
13-May-23,RTGS,"20,304.00",00.00,"3,42,567.83",
13-May-23,Tax,00.00,"85,641.96","2,56,925.87",
13-May-23,Interest,"13,29,319.20",00.00,"15,86,245.07",
13-May-23,Cash,00.00,"1,76,249.45","14,09,995.62",
13-May-23,Transportellaneous,00.00,"1,56,666.18","12,53,329.44",
13-May-23,Reversal,00.00,"6,26,664.72","6,26,664.72",
13-May-23,Cash,00.00,"62,666.47","5,63,998.25",
13-May-23,Bill,00.00,"93,999.71","4,69,998.54",
13-May-23,Purchase,00.00,"1,17,499.64","3,52,498.90",
13-May-23,Transfer,00.00,"70,499.78","2,81,999.12",
13-May-23,NEFT,00.00,"46,999.85","2,34,999.27",
13-May-23,Reversal,00.00,"39,166.55","1,95,832.72",
13-May-23,Cash,00.00,"24,479.09","1,71,353.63",
13-May-23,Transfer,"8,769.90",00.00,"1,80,123.53",
13-May-23,Interest,00.00,"20,013.73","1,60,109.80",
13-May-23,Cash,00.00,"16,010.98","1,44,098.82",
13-May-23,RTGS,00.00,"48,032.94","96,065.88",
13-May-23,Purchase,00.00,"19,213.18","76,852.70",
13-May-23,Cheque,60,00.00,"76,912.70",
13-May-23,Reversal,"2,51,388.00",00.00,"3,28,300.70",
13-May-23,Purchase,41.6,00.00,"3,28,342.30",
13-May-23,Tax,57,00.00,"3,28,399.30",
13-May-23,Interest,707.86,00.00,"3,29,107.16",
13-May-23,ATM,"1,039.33",00.00,"3,30,146.49",
13-May-23,NEFT,00.00,"1,10,048.83","2,20,097.66",
13-May-23,Tax,00.00,"55,024.42","1,65,073.24",
14-May-23,Debit Card,00.65,00.00,"1,65,073.89",
14-May-23,Debit Card,"13,340.30",00.00,"1,78,414.19",
14-May-23,Transfer,"3,91,110.80",00.00,"5,69,524.99",
14-May-23,Transfer,00.00,"81,360.71","4,88,164.28",
14-May-23,Commission,00.00,"2,44,082.14","2,44,082.14",
14-May-23,RTGS,00.00,"48,816.43","1,95,265.71",
14-May-23,Debit Card,377.8,00.00,"1,95,643.51",
15-May-23,NEFT,00.00,"39,128.70","1,56,514.81",
15-May-23,Cash,"5,65,311.20",00.00,"7,21,826.01",
15-May-23,Commission,"8,81,865.00",00.00,"16,03,691.01",
15-May-23,Tax,83.19,00.00,"16,03,774.20",
15-May-23,RTGS,"6,68,666.00",00.00,"22,72,440.20",
15-May-23,Bill,"10,63,682.00",00.00,"33,36,122.20",
15-May-23,Transportellaneous,05.83,00.00,"33,36,128.03",
15-May-23,Tax,00.00,00.00,"33,36,128.03",
15-May-23,Cash,28,00.00,"33,36,156.03",
15-May-23,ATM,00.00,"16,68,078.02","16,68,078.02",
15-May-23,NEFT,00.00,"2,08,509.75","14,59,568.27",
15-May-23,Tax,00.00,"2,08,509.75","12,51,058.52",
15-May-23,Bill,00.00,"12,51,058.52",00.00,
15-May-23,Debit Card,298,00.00,298,
15-May-23,Purchase,00.00,59.6,238.4,
15-May-23,Purchase,00.00,29.8,208.6,
15-May-23,Cash,90,00.00,298.6,
15-May-23,ATM,00.00,149.3,149.3,
15-May-23,Debit Card,00.00,24.88,124.42,
16-May-23,RTGS,00.00,12.44,111.98,
16-May-23,RTGS,00.00,37.33,74.65,
16-May-23,Purchase,00.00,74.65,00.00,
16-May-23,Bill,"11,390.00",00.00,"11,390.00",
16-May-23,Commission,03.70,00.00,"11,393.70",
16-May-23,Tax,00.00,"2,848.43","8,545.28",
16-May-23,Debit Card,00.00,"4,272.64","4,272.64",
16-May-23,ATM,00.00,"4,272.64",00.00,
16-May-23,Bill,46.16,00.00,46.16,
16-May-23,Debit Card,"1,17,567.60",00.00,"1,17,613.76",
17-May-23,IMPS,00.00,"16,801.97","1,00,811.79",
17-May-23,Purchase,00.00,"33,603.93","67,207.86",
17-May-23,Commission,504.89,00.00,"67,712.75",
17-May-23,Cheque,08.69,00.00,"67,721.44",
17-May-23,Debit Card,00.00,"6,772.14","60,949.30",
17-May-23,Tax,00.00,"7,618.66","53,330.64",
17-May-23,Transfer,00.00,"7,618.66","45,711.98",
17-May-23,Cheque,"11,09,586.00",00.00,"11,55,297.98",
17-May-23,Debit Card,"24,702.40",00.00,"11,80,000.38",
17-May-23,Cheque,232.4,00.00,"11,80,232.78",
18-May-23,Transportellaneous,00.00,"11,80,232.78",00.00,
19-May-23,Tax,64,00.00,64,
19-May-23,Purchase,"3,992.99",00.00,"4,056.99",
19-May-23,Commission,"1,23,227.00",00.00,"1,27,283.99",
19-May-23,Commission,00.00,"12,728.40","1,14,555.59",
19-May-23,Transportellaneous,05.00,00.00,"1,14,560.59",
19-May-23,Transportellaneous,00.00,"1,14,560.59",00.00,
19-May-23,ATM,"8,722.00",00.00,"8,722.00",
19-May-23,Transportellaneous,457.4,00.00,"9,179.40",
19-May-23,Commission,38.92,00.00,"9,218.32",
19-May-23,Reversal,347.91,00.00,"9,566.23",
19-May-23,NEFT,00.00,"3,188.74","6,377.49",
19-May-23,IMPS,"3,725.60",00.00,"10,103.09",
19-May-23,Bill,00.00,"10,103.09",00.00,
19-May-23,Transfer,"17,90,182.25",00.00,"17,90,182.25",
19-May-23,ATM,00.00,"4,47,545.56","13,42,636.69",
19-May-23,Transportellaneous,00.00,"2,23,772.78","11,18,863.91",
19-May-23,Reversal,00.00,"1,11,886.39","10,06,977.52",
19-May-23,Transportellaneous,06.70,00.00,"10,06,984.22",
19-May-23,Reversal,00.00,"2,01,396.84","8,05,587.38",
20-May-23,IMPS,171.98,00.00,"8,05,759.36",
20-May-23,IMPS,00.00,"2,01,439.84","6,04,319.52",
20-May-23,Tax,00.00,"1,20,863.90","4,83,455.62",
20-May-23,RTGS,47.9,00.00,"4,83,503.52",
20-May-23,ATM,58.5,00.00,"4,83,562.02",
21-May-23,Commission,00.00,"1,61,187.34","3,22,374.68",
21-May-23,Reversal,00.00,"64,474.94","2,57,899.74",
21-May-23,Interest,34.1,00.00,"2,57,933.84",
21-May-23,Tax,00.00,"85,977.95","1,71,955.89",
21-May-23,RTGS,00.00,"28,659.32","1,43,296.58",
21-May-23,Tax,00.00,"35,824.15","1,07,472.44",
21-May-23,Commission,00.00,"17,912.07","89,560.37",
21-May-23,Debit Card,62.24,00.00,"89,622.61",
21-May-23,Purchase,00.00,"89,622.61",00.00,
21-May-23,Transportellaneous,"25,614.30",00.00,"25,614.30",
21-May-23,NEFT,02.50,00.00,"25,616.80",
21-May-23,Cash,00.00,"5,123.36","20,493.44",
21-May-23,Tax,00.00,"3,415.57","17,077.87",
21-May-23,Transportellaneous,00.00,"2,134.73","14,943.14",
21-May-23,Debit Card,40,00.00,"14,983.14",
21-May-23,Purchase,"5,08,629.75",00.00,"5,23,612.89",
21-May-23,RTGS,"8,028.00",00.00,"5,31,640.89",
21-May-23,Commission,00.00,"1,32,910.22","3,98,730.67",
21-May-23,Transfer,"2,21,804.60",00.00,"6,20,535.27",
22-May-23,Transfer,00.00,"3,10,267.64","3,10,267.64",
22-May-23,Transportellaneous,00.00,"31,026.76","2,79,240.88",
22-May-23,Interest,"1,944.75",00.00,"2,81,185.63",
22-May-23,Interest,69.6,00.00,"2,81,255.23",
22-May-23,Cash,"1,746.00",00.00,"2,83,001.23",
22-May-23,Cheque,00.00,"1,41,500.62","1,41,500.62",
22-May-23,Debit Card,00.00,"14,150.06","1,27,350.56",
22-May-23,Commission,00.00,"25,470.11","1,01,880.45",
22-May-23,Transfer,00.00,"11,320.05","90,560.40",
22-May-23,IMPS,00.00,"45,280.20","45,280.20",
22-May-23,Purchase,00.00,"45,280.20",00.00,
22-May-23,Transfer,"19,574.60",00.00,"19,574.60",
22-May-23,Cheque,00.00,"2,174.96","17,399.64",
22-May-23,Debit Card,04.92,00.00,"17,404.56",
22-May-23,ATM,00.00,"3,480.91","13,923.65",
22-May-23,Commission,287,00.00,"14,210.65",
22-May-23,Cash,03.50,00.00,"14,214.15",
22-May-23,Cash,"9,056.00",00.00,"23,270.15",
22-May-23,Transportellaneous,752.4,00.00,"24,022.55",
22-May-23,Commission,322.54,00.00,"24,345.09",
22-May-23,Transfer,14.9,00.00,"24,359.99",
22-May-23,Commission,505,00.00,"24,864.99",
22-May-23,ATM,00.00,"6,216.25","18,648.74",
22-May-23,IMPS,"21,713.00",00.00,"40,361.74",
22-May-23,NEFT,"2,32,739.00",00.00,"2,73,100.74",
22-May-23,Tax,"16,51,160.00",00.00,"19,24,260.74",
22-May-23,Transportellaneous,"2,652.10",00.00,"19,26,912.84",
22-May-23,Transfer,42,00.00,"19,26,954.84",
22-May-23,Transportellaneous,00.00,"3,21,159.14","16,05,795.70",
22-May-23,ATM,491.04,00.00,"16,06,286.74",
22-May-23,Interest,"3,886.90",00.00,"16,10,173.64",
22-May-23,Cheque,00.20,00.00,"16,10,173.84",
22-May-23,Cheque,00.00,"2,68,362.31","13,41,811.53",
22-May-23,Debit Card,00.00,"1,67,726.44","11,74,085.09",
22-May-23,Tax,00.00,"1,67,726.44","10,06,358.65",
22-May-23,Transportellaneous,00.00,"2,51,589.66","7,54,768.99",
22-May-23,Reversal,34,00.00,"7,54,802.99",
22-May-23,Transfer,"16,837.00",00.00,"7,71,639.99",
22-May-23,Bill,"3,683.90",00.00,"7,75,323.89",
22-May-23,Interest,42.86,00.00,"7,75,366.75",
22-May-23,IMPS,03.00,00.00,"7,75,369.75",
22-May-23,Transportellaneous,"1,861.51",00.00,"7,77,231.26",
22-May-23,Interest,31,00.00,"7,77,262.26",
22-May-23,Transportellaneous,00.00,"1,29,543.71","6,47,718.55",
22-May-23,ATM,00.00,"6,47,718.55",00.00,
22-May-23,Transportellaneous,"28,865.49",00.00,"28,865.49",
23-May-23,Transportellaneous,"3,399.31",00.00,"32,264.80",
23-May-23,Purchase,00.00,"5,377.47","26,887.33",
23-May-23,Transfer,"3,10,125.00",00.00,"3,37,012.33",
23-May-23,Purchase,00.00,"37,445.81","2,99,566.52",
23-May-23,Tax,00.00,"33,285.17","2,66,281.35",
23-May-23,Reversal,00.00,"44,380.23","2,21,901.12",
23-May-23,NEFT,00.00,"36,983.52","1,84,917.60",
23-May-23,Debit Card,00.00,"30,819.60","1,54,098.00",
23-May-23,Cheque,23,00.00,"1,54,121.00",
23-May-23,Reversal,00.00,"25,686.83","1,28,434.17",
23-May-23,ATM,"31,300.80",00.00,"1,59,734.97",
23-May-23,Purchase,08.00,00.00,"1,59,742.97",
23-May-23,Purchase,344,00.00,"1,60,086.97",
23-May-23,Tax,"1,93,565.25",00.00,"3,53,652.22",
23-May-23,Transportellaneous,"23,124.09",00.00,"3,76,776.31",
23-May-23,Interest,00.00,"1,25,592.10","2,51,184.21",
23-May-23,RTGS,00.00,"83,728.07","1,67,456.14",
23-May-23,ATM,"11,59,957.00",00.00,"13,27,413.14",
23-May-23,IMPS,"2,06,639.09",00.00,"15,34,052.23",
23-May-23,Transportellaneous,01.50,00.00,"15,34,053.73",
23-May-23,Purchase,938.7,00.00,"15,34,992.43",
23-May-23,Purchase,00.00,"1,91,874.05","13,43,118.38",
23-May-23,ATM,36.1,00.00,"13,43,154.48",
23-May-23,Cash,"2,38,740.00",00.00,"15,81,894.48",
23-May-23,Cheque,00.00,"7,90,947.24","7,90,947.24",
23-May-23,RTGS,00.00,"79,094.72","7,11,852.52",
23-May-23,Transfer,00.00,"2,37,284.17","4,74,568.35",
23-May-23,Reversal,"2,89,628.50",00.00,"7,64,196.85",
23-May-23,Transfer,00.00,"1,91,049.21","5,73,147.64",
23-May-23,Transfer,00.00,"1,14,629.53","4,58,518.11",
23-May-23,NEFT,142.16,00.00,"4,58,660.27",
23-May-23,Transportellaneous,"27,254.90",00.00,"4,85,915.17",
23-May-23,Reversal,14.4,00.00,"4,85,929.57",
23-May-23,Commission,"1,278.00",00.00,"4,87,207.57",
23-May-23,Debit Card,01.00,00.00,"4,87,208.57",
23-May-23,Interest,00.00,"69,601.22","4,17,607.35",
23-May-23,Interest,"51,263.28",00.00,"4,68,870.63",
23-May-23,Interest,00.00,"2,34,435.32","2,34,435.32",
23-May-23,Interest,00.00,"78,145.11","1,56,290.21",
23-May-23,NEFT,"9,80,301.50",00.00,"11,36,591.71",
23-May-23,NEFT,00.00,"1,62,370.24","9,74,221.47",
23-May-23,RTGS,23.77,00.00,"9,74,245.24",
23-May-23,Reversal,"14,213.20",00.00,"9,88,458.44",
23-May-23,ATM,00.00,"1,09,828.72","8,78,629.72",
23-May-23,Tax,00.00,"1,46,438.29","7,32,191.43",
23-May-23,Commission,00.00,"7,32,191.43",00.00,
23-May-23,IMPS,163.6,00.00,163.6,
23-May-23,Commission,00.00,27.27,136.33,
24-May-23,Commission,"2,42,592.40",00.00,"2,42,728.73",
24-May-23,ATM,00.00,"1,21,364.37","1,21,364.36",
24-May-23,Purchase,00.00,"17,337.77","1,04,026.59",
24-May-23,ATM,"1,967.48",00.00,"1,05,994.07",
24-May-23,Transportellaneous,"1,20,936.78",00.00,"2,26,930.85",
24-May-23,Cash,00.00,"2,26,930.85",00.00,
24-May-23,Cheque,151.6,00.00,151.6,
24-May-23,Cheque,00.00,151.6,00.00,
24-May-23,NEFT,54.3,00.00,54.3,
24-May-23,Interest,00.00,54.3,00.00,
24-May-23,Reversal,95.52,00.00,95.52,
24-May-23,Reversal,00.00,09.55,85.97,
25-May-23,Cheque,00.00,21.49,64.48,
25-May-23,Transportellaneous,"20,35,246.00",00.00,"20,35,310.48",
25-May-23,Debit Card,03.40,00.00,"20,35,313.88",
25-May-23,Commission,"56,929.90",00.00,"20,92,243.78",
25-May-23,Interest,00.00,"4,18,448.76","16,73,795.02",
25-May-23,NEFT,00.00,"2,78,965.84","13,94,829.18",
26-May-23,Tax,00.00,"1,39,482.92","12,55,346.26",
26-May-23,Tax,"66,881.30",00.00,"13,22,227.56",
26-May-23,Interest,470.91,00.00,"13,22,698.47",
26-May-23,ATM,00.00,"1,32,269.85","11,90,428.62",
26-May-23,Debit Card,00.00,"5,95,214.31","5,95,214.31",
26-May-23,Cheque,00.00,"99,202.39","4,96,011.93",
26-May-23,Bill,57.7,00.00,"4,96,069.63",
26-May-23,Cheque,00.00,"1,24,017.41","3,72,052.22",
26-May-23,Cheque,00.00,"3,72,052.22",00.00,
26-May-23,NEFT,12.37,00.00,12.37,
26-May-23,Transportellaneous,00.00,01.24,11.13,
26-May-23,ATM,"1,843.30",00.00,"1,854.43",
26-May-23,Commission,00.00,927.22,927.22,
26-May-23,ATM,00.00,132.46,794.76,
26-May-23,IMPS,00.00,88.31,706.45,
26-May-23,Commission,00.00,100.92,605.53,
26-May-23,RTGS,06.00,00.00,611.53,
26-May-23,Purchase,337,00.00,948.53,
26-May-23,Interest,00.00,135.5,813.03,
26-May-23,Debit Card,58.79,00.00,871.82,
26-May-23,ATM,30.13,00.00,901.95,
26-May-23,Tax,"14,59,025.50",00.00,"14,59,927.45",
26-May-23,Reversal,00.00,"1,62,214.16","12,97,713.29",
26-May-23,NEFT,05.60,00.00,"12,97,718.89",
26-May-23,Bill,44,00.00,"12,97,762.89",
26-May-23,Tax,270.25,00.00,"12,98,033.14",
26-May-23,Interest,25,00.00,"12,98,058.14",
26-May-23,RTGS,"2,28,129.00",00.00,"15,26,187.14",
26-May-23,RTGS,830,00.00,"15,27,017.14",
26-May-23,IMPS,"16,50,791.50",00.00,"31,77,808.64",
26-May-23,ATM,691,00.00,"31,78,499.64",
26-May-23,Tax,00.00,"3,17,849.96","28,60,649.68",
26-May-23,ATM,00.00,"4,08,664.24","24,51,985.44",
26-May-23,Debit Card,"1,578.19",00.00,"24,53,563.63",
26-May-23,Purchase,00.00,"3,06,695.45","21,46,868.18",
26-May-23,Transportellaneous,56.59,00.00,"21,46,924.77",
26-May-23,ATM,00.00,"2,38,547.20","19,08,377.57",
26-May-23,NEFT,03.00,00.00,"19,08,380.57",
26-May-23,Interest,00.00,"1,90,838.06","17,17,542.51",
26-May-23,NEFT,02.69,00.00,"17,17,545.20",
26-May-23,Purchase,320,00.00,"17,17,865.20",
26-May-23,Purchase,"1,99,271.06",00.00,"19,17,136.26",
26-May-23,Debit Card,380.16,00.00,"19,17,516.42",
26-May-23,Bill,00.00,"3,19,586.07","15,97,930.35",
26-May-23,ATM,31.77,00.00,"15,97,962.12",
26-May-23,Bill,00.00,"3,99,490.53","11,98,471.59",
26-May-23,Transportellaneous,39,00.00,"11,98,510.59",
26-May-23,Interest,50.36,00.00,"11,98,560.95",
26-May-23,Reversal,03.00,00.00,"11,98,563.95",
26-May-23,Interest,04.03,00.00,"11,98,567.98",
26-May-23,Interest,00.00,"2,99,642.00","8,98,925.98",
27-May-23,Bill,39,00.00,"8,98,964.98",
27-May-23,Cash,00.00,"99,885.00","7,99,079.98",
27-May-23,Cheque,00.00,"1,33,180.00","6,65,899.98",
27-May-23,Interest,00.00,"6,65,899.98",00.00,
27-May-23,Reversal,"20,823.00",00.00,"20,823.00",
27-May-23,Transfer,00.00,"4,164.60","16,658.40",
27-May-23,Cheque,"15,39,172.00",00.00,"15,55,830.40",
27-May-23,Interest,00.00,"7,77,915.20","7,77,915.20",
27-May-23,Cash,00.00,"77,791.52","7,00,123.68",
27-May-23,Cheque,00.00,"1,75,030.92","5,25,092.76",
27-May-23,IMPS,"76,472.00",00.00,"6,01,564.76",
27-May-23,Debit Card,00.00,"2,00,521.59","4,01,043.17",
27-May-23,Commission,217.22,00.00,"4,01,260.39",
27-May-23,Bill,"23,311.20",00.00,"4,24,571.59",
27-May-23,Commission,06.40,00.00,"4,24,577.99",
27-May-23,Reversal,35.5,00.00,"4,24,613.49",
27-May-23,Commission,"2,604.40",00.00,"4,27,217.89",
27-May-23,Interest,00.00,"4,27,217.89",00.00,
27-May-23,RTGS,"20,54,997.50",00.00,"20,54,997.50",
27-May-23,RTGS,00.00,"5,13,749.38","15,41,248.12",
27-May-23,Reversal,00.00,"1,54,124.81","13,87,123.31",
27-May-23,Transfer,"3,424.80",00.00,"13,90,548.11",
27-May-23,Interest,00.00,"4,63,516.04","9,27,032.07",
27-May-23,Cheque,04.79,00.00,"9,27,036.86",
27-May-23,Interest,870.14,00.00,"9,27,907.00",
27-May-23,ATM,05.52,00.00,"9,27,912.52",
27-May-23,Commission,194,00.00,"9,28,106.52",
27-May-23,IMPS,00.00,"9,28,106.52",00.00,
28-May-23,Interest,"64,079.00",00.00,"64,079.00",
28-May-23,Purchase,00.00,"32,039.50","32,039.50",
28-May-23,Tax,04.69,00.00,"32,044.19",
28-May-23,Purchase,"1,00,257.78",00.00,"1,32,301.97",
28-May-23,RTGS,00.00,"33,075.49","99,226.48",
28-May-23,Cash,"38,621.00",00.00,"1,37,847.48",
28-May-23,Reversal,00.00,"27,569.50","1,10,277.98",
28-May-23,Purchase,00.00,"1,10,277.98",00.00,
28-May-23,ATM,04.89,00.00,04.89,
28-May-23,Interest,00.00,01.63,03.26,
28-May-23,Commission,00.00,01.09,02.17,
28-May-23,Interest,00.00,00.72,01.45,
28-May-23,Cash,06.70,00.00,08.15,
28-May-23,Bill,00.00,01.16,06.99,
28-May-23,RTGS,03.80,00.00,10.79,
28-May-23,ATM,163.8,00.00,174.59,
28-May-23,Cash,"1,54,988.00",00.00,"1,55,162.59",
28-May-23,Bill,00.00,"1,55,162.59",00.00,
28-May-23,Purchase,14.8,00.00,14.8,
28-May-23,Cash,"20,24,538.00",00.00,"20,24,552.80",
28-May-23,Cash,"20,18,732.00",00.00,"40,43,284.80",
28-May-23,Cash,"13,41,815.80",00.00,"53,85,100.60",
28-May-23,Bill,"2,34,581.70",00.00,"56,19,682.30",
28-May-23,Bill,00.00,"28,09,841.15","28,09,841.15",
28-May-23,Tax,00.00,"2,80,984.12","25,28,857.04",
28-May-23,NEFT,"9,62,986.75",00.00,"34,91,843.79",
28-May-23,Bill,00.00,"5,81,973.97","29,09,869.82",
28-May-23,Cash,00.00,"9,69,956.61","19,39,913.21",
28-May-23,IMPS,461.6,00.00,"19,40,374.81",
28-May-23,Purchase,00.00,"2,15,597.20","17,24,777.61",
28-May-23,Bill,"1,808.00",00.00,"17,26,585.61",
28-May-23,NEFT,"32,750.00",00.00,"17,59,335.61",
28-May-23,Bill,00.00,"1,95,481.73","15,63,853.88",
28-May-23,Cheque,"29,231.76",00.00,"15,93,085.64",
28-May-23,Transportellaneous,36.4,00.00,"15,93,122.04",
28-May-23,Transfer,"1,626.80",00.00,"15,94,748.84",
29-May-23,Purchase,00.00,"1,59,474.88","14,35,273.96",
29-May-23,Transportellaneous,00.00,"7,17,636.98","7,17,636.98",
29-May-23,Transportellaneous,00.00,"3,58,818.49","3,58,818.49",
29-May-23,Debit Card,"1,81,841.16",00.00,"5,40,659.65",
29-May-23,Cheque,00.00,"1,35,164.91","4,05,494.74",
29-May-23,Tax,466,00.00,"4,05,960.74",
29-May-23,Bill,00.00,"40,596.07","3,65,364.67",
29-May-23,Bill,00.00,"52,194.95","3,13,169.72",
29-May-23,IMPS,00.00,"78,292.43","2,34,877.29",
29-May-23,Transportellaneous,417,00.00,"2,35,294.29",
29-May-23,Purchase,00.00,"1,17,647.15","1,17,647.14",
29-May-23,ATM,914.1,00.00,"1,18,561.24",
29-May-23,ATM,00.00,"39,520.41","79,040.83",
29-May-23,Transportellaneous,00.00,"19,760.21","59,280.62",
29-May-23,Cheque,"9,34,762.00",00.00,"9,94,042.62",
29-May-23,Transportellaneous,"3,160.50",00.00,"9,97,203.12",
29-May-23,Bill,39.3,00.00,"9,97,242.42",
29-May-23,Transfer,00.00,"3,32,414.14","6,64,828.28",
29-May-23,IMPS,00.00,"66,482.83","5,98,345.45",
29-May-23,Commission,06.80,00.00,"5,98,352.25",
29-May-23,IMPS,00.00,"2,99,176.13","2,99,176.12",
29-May-23,Cheque,00.00,"99,725.37","1,99,450.75",
29-May-23,Transfer,"8,385.00",00.00,"2,07,835.75",
29-May-23,Transportellaneous,36,00.00,"2,07,871.75",
29-May-23,NEFT,"6,719.00",00.00,"2,14,590.75",
29-May-23,Transfer,"6,958.30",00.00,"2,21,549.05",
29-May-23,Tax,"10,280.40",00.00,"2,31,829.45",
29-May-23,RTGS,"1,77,915.20",00.00,"4,09,744.65",
29-May-23,Transfer,00.00,"1,36,581.55","2,73,163.10",
29-May-23,IMPS,00.00,"27,316.31","2,45,846.79",
29-May-23,IMPS,00.00,"30,730.85","2,15,115.94",
29-May-23,Commission,00.00,"1,07,557.97","1,07,557.97",
29-May-23,Purchase,00.00,"35,852.66","71,705.31",
29-May-23,Commission,"19,444.00",00.00,"91,149.31",
29-May-23,Transfer,118,00.00,"91,267.31",
29-May-23,Debit Card,00.00,"13,038.19","78,229.12",
29-May-23,ATM,"1,82,507.00",00.00,"2,60,736.12",
29-May-23,RTGS,00.40,00.00,"2,60,736.52",
29-May-23,ATM,00.00,"65,184.13","1,95,552.39",
29-May-23,Transfer,00.00,"1,95,552.39",00.00,
29-May-23,Reversal,22,00.00,22,
29-May-23,Interest,00.00,03.14,18.86,
29-May-23,NEFT,"2,39,288.90",00.00,"2,39,307.76",
29-May-23,Commission,"1,77,784.91",00.00,"4,17,092.67",
29-May-23,Transportellaneous,00.00,"2,08,546.34","2,08,546.34",
29-May-23,IMPS,"1,463.04",00.00,"2,10,009.38",
29-May-23,Cheque,"6,199.00",00.00,"2,16,208.38",
29-May-23,NEFT,00.00,"27,026.05","1,89,182.33",
29-May-23,Cheque,21.9,00.00,"1,89,204.23",
29-May-23,IMPS,"2,931.83",00.00,"1,92,136.06",
29-May-23,Cash,00.00,"21,348.45","1,70,787.61",
29-May-23,Commission,02.48,00.00,"1,70,790.09",
29-May-23,Bill,18.7,00.00,"1,70,808.79",
29-May-23,Debit Card,00.00,"17,080.88","1,53,727.91",
29-May-23,Purchase,01.00,00.00,"1,53,728.91",
29-May-23,RTGS,10.6,00.00,"1,53,739.51",
29-May-23,Debit Card,00.00,"19,217.44","1,34,522.07",
29-May-23,IMPS,00.00,"19,217.44","1,15,304.63",
29-May-23,Interest,"24,429.80",00.00,"1,39,734.43",
29-May-23,Interest,00.00,"1,39,734.43",00.00,
29-May-23,Commission,02.00,00.00,02.00,
29-May-23,Cheque,00.00,01.00,01.00,
29-May-23,Bill,00.00,00.13,00.88,
29-May-23,Commission,00.00,00.18,00.70,
29-May-23,ATM,00.00,00.70,00.00,
29-May-23,Tax,01.84,00.00,01.84,
29-May-23,Commission,"2,486.00",00.00,"2,487.84",
29-May-23,Cash,00.00,276.43,"2,211.41",
29-May-23,Cash,"79,782.40",00.00,"81,993.81",
29-May-23,Transportellaneous,00.00,"16,398.76","65,595.05",
29-May-23,Cash,"1,22,296.56",00.00,"1,87,891.61",
29-May-23,Commission,00.00,"1,87,891.61",00.00,
29-May-23,Commission,28,00.00,28,
29-May-23,Commission,00.00,03.50,24.5,
29-May-23,Cash,"13,75,007.50",00.00,"13,75,032.00",
29-May-23,Reversal,"9,12,223.20",00.00,"22,87,255.20",
29-May-23,RTGS,63,00.00,"22,87,318.20",
29-May-23,Bill,"3,494.10",00.00,"22,90,812.30",
29-May-23,IMPS,00.00,"7,63,604.10","15,27,208.20",
29-May-23,Cheque,36.52,00.00,"15,27,244.72",
29-May-23,Tax,"29,296.81",00.00,"15,56,541.53",
29-May-23,Transfer,"1,91,320.00",00.00,"17,47,861.53",
29-May-23,Bill,00.00,"4,36,965.38","13,10,896.15",
29-May-23,RTGS,00.00,"4,36,965.38","8,73,930.77",
30-May-23,IMPS,"20,451.90",00.00,"8,94,382.67",
30-May-23,ATM,00.00,"2,98,127.56","5,96,255.11",
30-May-23,Cheque,"1,72,272.50",00.00,"7,68,527.61",
31-May-23,Bill,00.00,"85,391.96","6,83,135.65",
31-May-23,Interest,00.00,"75,903.96","6,07,231.69",
31-May-23,NEFT,00.00,"75,903.96","5,31,327.73",
31-May-23,Bill,00.00,"1,06,265.55","4,25,062.18",
31-May-23,Commission,50.3,00.00,"4,25,112.48",
31-May-23,Tax,00.00,"60,730.35","3,64,382.13",
31-May-23,Transfer,08.80,00.00,"3,64,390.93",
31-May-23,Purchase,00.00,"72,878.19","2,91,512.74",
31-May-23,Tax,"1,35,022.00",00.00,"4,26,534.74",
31-May-23,IMPS,00.00,"4,26,534.74",00.00,
31-May-23,Cash,"16,96,587.75",00.00,"16,96,587.75",
31-May-23,Cheque,00.00,"1,69,658.78","15,26,928.98",
31-May-23,Tax,00.00,"1,90,866.12","13,36,062.86",
31-May-23,IMPS,"31,340.17",00.00,"13,67,403.03",
31-May-23,Commission,00.00,"1,36,740.30","12,30,662.73",
31-May-23,Transportellaneous,00.00,"1,36,740.30","10,93,922.43",
31-May-23,Bill,00.00,"1,82,320.41","9,11,602.02",
31-May-23,Commission,03.30,00.00,"9,11,605.32",
31-May-23,Commission,06.09,00.00,"9,11,611.41",
31-May-23,Interest,340.2,00.00,"9,11,951.61",
31-May-23,Cheque,"63,838.91",00.00,"9,75,790.52",
31-May-23,Cash,"1,50,360.12",00.00,"11,26,150.64",
31-May-23,RTGS,00.00,"1,87,691.77","9,38,458.87",
31-May-23,Bill,"8,553.79",00.00,"9,47,012.66",
31-May-23,Debit Card,"1,32,794.00",00.00,"10,79,806.66",
31-May-23,Transfer,00.00,"10,79,806.66",00.00,
31-May-23,Transportellaneous,00.49,00.00,00.49,
31-May-23,Bill,00.00,00.16,00.33,
31-May-23,RTGS,00.00,00.07,00.26,
31-May-23,ATM,00.00,00.09,00.17,
31-May-23,Transfer,32,00.00,32.17,
31-May-23,NEFT,00.00,04.60,27.57,
31-May-23,NEFT,00.00,06.89,20.68,
31-May-23,Reversal,174.4,00.00,195.08,
31-May-23,Purchase,03.00,00.00,198.08,
31-May-23,Cheque,18,00.00,216.08,
31-May-23,IMPS,00.00,21.61,194.47,
31-May-23,Cash,"33,717.62",00.00,"33,912.09",
31-May-23,Transportellaneous,00.00,"4,239.01","29,673.08",
31-May-23,Reversal,00.00,"4,945.51","24,727.57",
31-May-23,Debit Card,05.29,00.00,"24,732.86",
31-May-23,Bill,00.00,"24,732.86",00.00,
31-May-23,Tax,"21,068.00",00.00,"21,068.00",
31-May-23,Purchase,00.00,"10,534.00","10,534.00",
31-May-23,Bill,"12,004.00",00.00,"22,538.00",
31-May-23,Commission,25.76,00.00,"22,563.76",
31-May-23,Commission,861,00.00,"23,424.76",
31-May-23,Purchase,00.00,"5,856.19","17,568.57",
31-May-23,ATM,"80,653.53",00.00,"98,222.10",
31-May-23,Interest,00.00,"98,222.10",00.00,
31-May-23,Purchase,18,00.00,18,
31-May-23,Transportellaneous,07.56,00.00,25.56,
31-May-23,ATM,00.00,02.84,22.72,
31-May-23,Bill,00.00,03.25,19.47,
01-Jun-23,Bill,00.00,06.49,12.98,
01-Jun-23,Tax,00.00,12.98,00.00,
01-Jun-23,ATM,487,00.00,487,
01-Jun-23,Transportellaneous,00.00,97.4,389.6,
01-Jun-23,Interest,"1,884.47",00.00,"2,274.07",
01-Jun-23,NEFT,00.00,568.52,"1,705.55",
01-Jun-23,Bill,00.00,243.65,"1,461.90",
01-Jun-23,Transfer,00.00,208.84,"1,253.06",
01-Jun-23,Cash,"20,79,267.00",00.00,"20,80,520.06",
01-Jun-23,Transportellaneous,00.00,"2,60,065.01","18,20,455.05",
01-Jun-23,Cheque,30.7,00.00,"18,20,485.75",
01-Jun-23,ATM,00.00,"2,02,276.19","16,18,209.56",
01-Jun-23,Transportellaneous,00.00,"4,04,552.39","12,13,657.17",
01-Jun-23,Commission,07.19,00.00,"12,13,664.36",
01-Jun-23,ATM,00.00,"6,06,832.18","6,06,832.18",
01-Jun-23,Interest,00.00,"1,21,366.44","4,85,465.74",
01-Jun-23,Purchase,"23,322.00",00.00,"5,08,787.74",
01-Jun-23,IMPS,"3,194.00",00.00,"5,11,981.74",
01-Jun-23,Transfer,00.00,"5,11,981.74",00.00,
01-Jun-23,Reversal,"1,78,794.00",00.00,"1,78,794.00",
01-Jun-23,ATM,"26,021.93",00.00,"2,04,815.93",
01-Jun-23,Cheque,00.00,"25,601.99","1,79,213.94",
01-Jun-23,Transfer,00.00,"44,803.49","1,34,410.46",
01-Jun-23,Bill,00.00,"33,602.62","1,00,807.84",
01-Jun-23,Interest,00.00,"1,00,807.84",00.00,
01-Jun-23,Transportellaneous,"15,09,068.50",00.00,"15,09,068.50",
01-Jun-23,Cash,00.00,"1,50,906.85","13,58,161.65",
01-Jun-23,NEFT,00.00,"13,58,161.65",00.00,
01-Jun-23,Commission,00.80,00.00,00.80,
01-Jun-23,Reversal,"2,59,940.94",00.00,"2,59,941.74",
01-Jun-23,Transfer,00.00,"2,59,941.74",00.00,
01-Jun-23,Interest,488.15,00.00,488.15,
01-Jun-23,Reversal,00.00,69.74,418.41,
01-Jun-23,ATM,228.4,00.00,646.81,
01-Jun-23,Transfer,00.00,64.68,582.13,
01-Jun-23,Debit Card,00.00,582.13,00.00,
01-Jun-23,ATM,"22,160.12",00.00,"22,160.12",
01-Jun-23,NEFT,00.00,"11,080.06","11,080.06",
01-Jun-23,Purchase,35,00.00,"11,115.06",
01-Jun-23,RTGS,00.00,"1,111.51","10,003.55",
01-Jun-23,Transfer,53.2,00.00,"10,056.75",
01-Jun-23,Commission,"1,36,696.50",00.00,"1,46,753.25",
01-Jun-23,Commission,00.00,"14,675.33","1,32,077.92",
01-Jun-23,Bill,00.00,"1,32,077.92",00.00,
01-Jun-23,NEFT,"59,553.70",00.00,"59,553.70",
01-Jun-23,Purchase,"1,43,571.50",00.00,"2,03,125.20",
01-Jun-23,Debit Card,00.00,"40,625.04","1,62,500.16",
01-Jun-23,Cash,"1,12,043.62",00.00,"2,74,543.78",
01-Jun-23,Bill,"16,18,049.00",00.00,"18,92,592.78",
01-Jun-23,Tax,00.00,"1,89,259.28","17,03,333.50",
01-Jun-23,Transportellaneous,00.00,"1,70,333.35","15,33,000.15",
01-Jun-23,Interest,"16,33,320.00",00.00,"31,66,320.15",
01-Jun-23,Reversal,05.60,00.00,"31,66,325.75",
01-Jun-23,NEFT,"2,389.00",00.00,"31,68,714.75",
01-Jun-23,Tax,00.00,"7,92,178.69","23,76,536.06",
01-Jun-23,Cash,"22,162.30",00.00,"23,98,698.36",
01-Jun-23,NEFT,00.00,"23,98,698.36",00.00,
01-Jun-23,Transportellaneous,41.7,00.00,41.7,
01-Jun-23,Transportellaneous,00.00,10.43,31.28,
01-Jun-23,Debit Card,10.52,00.00,41.8,
01-Jun-23,IMPS,00.00,13.93,27.87,
01-Jun-23,ATM,00.00,02.79,25.08,
01-Jun-23,ATM,00.00,05.02,20.06,
01-Jun-23,Bill,00.00,06.69,13.37,
01-Jun-23,Transportellaneous,"2,346.27",00.00,"2,359.64",
01-Jun-23,Transfer,05.00,00.00,"2,364.64",
01-Jun-23,IMPS,07.32,00.00,"2,371.96",
01-Jun-23,RTGS,"7,45,364.00",00.00,"7,47,735.96",
01-Jun-23,Debit Card,00.00,"1,49,547.19","5,98,188.77",
01-Jun-23,IMPS,"23,512.34",00.00,"6,21,701.11",
01-Jun-23,Cheque,00.00,"62,170.11","5,59,531.00",
01-Jun-23,NEFT,"3,739.20",00.00,"5,63,270.20",
01-Jun-23,Tax,"6,96,914.75",00.00,"12,60,184.95",
01-Jun-23,Bill,00.00,"3,15,046.24","9,45,138.71",
01-Jun-23,NEFT,03.50,00.00,"9,45,142.21",
01-Jun-23,Interest,"25,228.16",00.00,"9,70,370.37",
02-Jun-23,Debit Card,"2,34,564.72",00.00,"12,04,935.09",
02-Jun-23,Debit Card,00.00,"2,00,822.52","10,04,112.58",
02-Jun-23,Commission,00.00,"2,51,028.15","7,53,084.44",
02-Jun-23,Debit Card,"24,132.80",00.00,"7,77,217.24",
02-Jun-23,Reversal,00.00,"1,11,031.03","6,66,186.21",
02-Jun-23,Tax,00.00,"83,273.28","5,82,912.93",
02-Jun-23,Commission,"1,56,110.25",00.00,"7,39,023.18",
02-Jun-23,Debit Card,00.00,"7,39,023.18",00.00,
02-Jun-23,NEFT,"1,43,861.50",00.00,"1,43,861.50",
02-Jun-23,Transportellaneous,00.00,"28,772.30","1,15,089.20",
02-Jun-23,NEFT,"1,312.85",00.00,"1,16,402.05",
02-Jun-23,Transportellaneous,"8,811.00",00.00,"1,25,213.05",
02-Jun-23,ATM,97.3,00.00,"1,25,310.35",
02-Jun-23,NEFT,00.00,"12,531.04","1,12,779.32",
02-Jun-23,RTGS,109,00.00,"1,12,888.32",
02-Jun-23,Debit Card,00.00,"56,444.16","56,444.16",
02-Jun-23,Commission,00.00,"8,063.45","48,380.71",
02-Jun-23,Tax,00.00,"6,911.53","41,469.18",
02-Jun-23,Purchase,00.00,"4,146.92","37,322.26",
02-Jun-23,Reversal,00.00,"12,440.75","24,881.51",
02-Jun-23,Bill,352,00.00,"25,233.51",
02-Jun-23,Reversal,00.00,"3,154.19","22,079.32",
02-Jun-23,Transportellaneous,"1,28,291.30",00.00,"1,50,370.62",
02-Jun-23,Purchase,00.00,"50,123.54","1,00,247.08",
02-Jun-23,NEFT,00.00,"16,707.85","83,539.23",
02-Jun-23,IMPS,"2,494.71",00.00,"86,033.94",
02-Jun-23,Transportellaneous,38.1,00.00,"86,072.04",
02-Jun-23,NEFT,00.00,"28,690.68","57,381.36",
02-Jun-23,Cheque,00.00,"19,127.12","38,254.24",
02-Jun-23,Debit Card,00.00,"12,751.41","25,502.83",
02-Jun-23,Debit Card,50.6,00.00,"25,553.43",
02-Jun-23,IMPS,395,00.00,"25,948.43",
02-Jun-23,Cash,"1,41,117.80",00.00,"1,67,066.23",
02-Jun-23,ATM,00.00,"1,67,066.23",00.00,
02-Jun-23,Transfer,324,00.00,324,
02-Jun-23,Interest,"3,18,733.00",00.00,"3,19,057.00",
02-Jun-23,Debit Card,95.8,00.00,"3,19,152.80",
02-Jun-23,Transfer,08.00,00.00,"3,19,160.80",
02-Jun-23,IMPS,00.00,"1,06,386.93","2,12,773.87",
02-Jun-23,Tax,00.00,"53,193.47","1,59,580.40",
03-Jun-23,ATM,00.00,"1,59,580.40",00.00,
03-Jun-23,Reversal,220.05,00.00,220.05,
03-Jun-23,Bill,06.94,00.00,226.99,
03-Jun-23,Cheque,00.00,113.5,113.5,
03-Jun-23,IMPS,00.00,113.5,00.00,
03-Jun-23,Bill,18.6,00.00,18.6,
03-Jun-23,Reversal,"1,081.00",00.00,"1,099.60",
03-Jun-23,Cheque,"17,94,126.00",00.00,"17,95,225.60",
03-Jun-23,Transfer,"2,16,857.22",00.00,"20,12,082.82",
03-Jun-23,Cheque,"1,93,637.94",00.00,"22,05,720.76",
03-Jun-23,Commission,00.00,"5,51,430.19","16,54,290.57",
03-Jun-23,Cash,"24,871.89",00.00,"16,79,162.46",
03-Jun-23,Bill,06.20,00.00,"16,79,168.66",
03-Jun-23,RTGS,763.1,00.00,"16,79,931.76",
03-Jun-23,Purchase,29.4,00.00,"16,79,961.16",
03-Jun-23,ATM,04.00,00.00,"16,79,965.16",
03-Jun-23,NEFT,"1,91,146.00",00.00,"18,71,111.16",
03-Jun-23,Reversal,"1,63,224.70",00.00,"20,34,335.86",
03-Jun-23,Transportellaneous,"4,82,581.00",00.00,"25,16,916.86",
03-Jun-23,Debit Card,06.75,00.00,"25,16,923.61",
03-Jun-23,Transfer,"10,410.04",00.00,"25,27,333.65",
03-Jun-23,Cheque,"15,53,152.00",00.00,"40,80,485.65",
03-Jun-23,NEFT,00.00,"5,10,060.71","35,70,424.94",
03-Jun-23,ATM,00.00,"4,46,303.12","31,24,121.82",
03-Jun-23,Interest,00.00,"6,24,824.36","24,99,297.46",
03-Jun-23,Bill,00.00,"4,99,859.49","19,99,437.97",
03-Jun-23,Purchase,00.00,"9,99,718.99","9,99,718.98",
03-Jun-23,Reversal,03.40,00.00,"9,99,722.38",
03-Jun-23,Cheque,00.00,"9,99,722.38",00.00,
03-Jun-23,Purchase,"80,843.00",00.00,"80,843.00",
03-Jun-23,ATM,"4,24,702.20",00.00,"5,05,545.20",
03-Jun-23,Debit Card,00.00,"1,68,515.07","3,37,030.13",
03-Jun-23,RTGS,04.67,00.00,"3,37,034.80",
03-Jun-23,Commission,81.7,00.00,"3,37,116.50",
04-Jun-23,RTGS,"2,03,932.00",00.00,"5,41,048.50",
04-Jun-23,RTGS,"3,243.00",00.00,"5,44,291.50",
04-Jun-23,NEFT,04.00,00.00,"5,44,295.50",
04-Jun-23,Reversal,254,00.00,"5,44,549.50",
04-Jun-23,Reversal,00.00,"1,81,516.50","3,63,033.00",
04-Jun-23,Purchase,"29,741.00",00.00,"3,92,774.00",
04-Jun-23,Interest,339.6,00.00,"3,93,113.60",
04-Jun-23,Debit Card,00.00,"3,93,113.60",00.00,
04-Jun-23,Interest,"5,954.10",00.00,"5,954.10",
04-Jun-23,Transportellaneous,00.00,"1,190.82","4,763.28",
04-Jun-23,Tax,00.00,793.88,"3,969.40",
04-Jun-23,Purchase,"5,122.04",00.00,"9,091.44",
04-Jun-23,Reversal,00.00,"1,515.24","7,576.20",
04-Jun-23,ATM,00.00,841.8,"6,734.40",
04-Jun-23,Transfer,366,00.00,"7,100.40",
04-Jun-23,Commission,00.00,"1,183.40","5,917.00",
04-Jun-23,Commission,"19,802.70",00.00,"25,719.70",
04-Jun-23,Interest,00.00,"6,429.93","19,289.78",
04-Jun-23,ATM,00.00,"4,822.45","14,467.34",
04-Jun-23,NEFT,25.4,00.00,"14,492.74",
04-Jun-23,NEFT,00.00,"1,449.27","13,043.47",
04-Jun-23,Transfer,00.00,"2,173.91","10,869.56",
04-Jun-23,Transfer,00.00,"1,086.96","9,782.60",
04-Jun-23,Cheque,02.80,00.00,"9,785.40",
04-Jun-23,Cheque,285.5,00.00,"10,070.90",
04-Jun-23,Cash,00.00,"2,517.73","7,553.17",
04-Jun-23,RTGS,00.00,755.32,"6,797.85",
04-Jun-23,Transportellaneous,"18,802.73",00.00,"25,600.58",
04-Jun-23,ATM,"22,030.00",00.00,"47,630.58",
04-Jun-23,NEFT,05.34,00.00,"47,635.92",
04-Jun-23,Commission,00.00,"15,878.64","31,757.28",
04-Jun-23,Cash,00.00,"5,292.88","26,464.40",
04-Jun-23,RTGS,00.00,"2,940.49","23,523.91",
04-Jun-23,Reversal,00.00,"2,940.49","20,583.42",
04-Jun-23,Transportellaneous,00.00,"6,861.14","13,722.28",
04-Jun-23,Tax,00.00,"4,574.09","9,148.19",
04-Jun-23,Debit Card,507,00.00,"9,655.19",
04-Jun-23,RTGS,00.00,"9,655.19",00.00,
04-Jun-23,Tax,450,00.00,450,
04-Jun-23,Tax,124,00.00,574,
04-Jun-23,Cheque,"7,39,359.25",00.00,"7,39,933.25",
04-Jun-23,Debit Card,00.00,"2,46,644.42","4,93,288.83",
04-Jun-23,Purchase,00.00,"54,809.87","4,38,478.96",
04-Jun-23,Transportellaneous,00.00,"87,695.79","3,50,783.17",
04-Jun-23,Interest,00.00,"58,463.86","2,92,319.31",
04-Jun-23,ATM,651.81,00.00,"2,92,971.12",
04-Jun-23,Debit Card,137,00.00,"2,93,108.12",
04-Jun-23,Reversal,66,00.00,"2,93,174.12",
04-Jun-23,ATM,00.00,"58,634.82","2,34,539.30",
04-Jun-23,Tax,03.60,00.00,"2,34,542.90",
05-Jun-23,RTGS,00.00,"23,454.29","2,11,088.61",
05-Jun-23,Cash,"5,238.00",00.00,"2,16,326.61",
06-Jun-23,Transfer,"1,428.00",00.00,"2,17,754.61",
06-Jun-23,Bill,00.00,"24,194.96","1,93,559.65",
06-Jun-23,Reversal,00.00,"96,779.83","96,779.82",
06-Jun-23,NEFT,00.00,"16,129.97","80,649.85",
06-Jun-23,Cash,00.00,"11,521.41","69,128.44",
06-Jun-23,Transfer,00.00,"11,521.41","57,607.03",
06-Jun-23,Cheque,06.00,00.00,"57,613.03",
06-Jun-23,Transportellaneous,00.00,"11,522.61","46,090.42",
06-Jun-23,Cheque,00.00,"9,218.08","36,872.34",
06-Jun-23,Reversal,00.00,"12,290.78","24,581.56",
06-Jun-23,Transportellaneous,23,00.00,"24,604.56",
06-Jun-23,Purchase,00.00,"2,733.84","21,870.72",
06-Jun-23,Purchase,00.00,"3,124.39","18,746.33",
06-Jun-23,Transfer,00.00,"2,343.29","16,403.04",
06-Jun-23,Transportellaneous,"5,566.75",00.00,"21,969.79",
06-Jun-23,Commission,03.00,00.00,"21,972.79",
06-Jun-23,RTGS,00.00,"10,986.40","10,986.40",
06-Jun-23,RTGS,"3,66,806.00",00.00,"3,77,792.40",
06-Jun-23,Bill,00.00,"1,25,930.80","2,51,861.60",
06-Jun-23,IMPS,00.00,"1,25,930.80","1,25,930.80",
06-Jun-23,Bill,04.60,00.00,"1,25,935.40",
06-Jun-23,Commission,00.00,"17,990.77","1,07,944.63",
06-Jun-23,Cheque,00.00,"26,986.16","80,958.47",
06-Jun-23,NEFT,00.00,"11,565.50","69,392.97",
06-Jun-23,Reversal,00.00,"23,130.99","46,261.98",
07-Jun-23,Cheque,47.94,00.00,"46,309.92",
08-Jun-23,Cash,00.00,"23,154.96","23,154.96",
08-Jun-23,Interest,00.00,"2,572.77","20,582.19",
08-Jun-23,Transfer,00.00,"3,430.37","17,151.82",
08-Jun-23,Commission,31.86,00.00,"17,183.68",
09-Jun-23,RTGS,00.00,"17,183.68",00.00,
09-Jun-23,ATM,"1,468.00",00.00,"1,468.00",
10-Jun-23,Debit Card,00.00,244.67,"1,223.33",
10-Jun-23,Interest,"13,301.00",00.00,"14,524.33",
10-Jun-23,Cheque,00.00,"1,613.81","12,910.52",
10-Jun-23,Cheque,00.00,"1,434.50","11,476.02",
10-Jun-23,NEFT,00.00,"5,738.01","5,738.01",
10-Jun-23,RTGS,00.00,637.56,"5,100.45",
10-Jun-23,Bill,00.00,"1,700.15","3,400.30",
10-Jun-23,IMPS,00.00,377.81,"3,022.49",
10-Jun-23,Bill,"3,63,718.25",00.00,"3,66,740.74",
10-Jun-23,Tax,"2,13,287.00",00.00,"5,80,027.74",
10-Jun-23,Bill,"3,71,491.75",00.00,"9,51,519.49",
10-Jun-23,Reversal,"3,930.74",00.00,"9,55,450.23",
10-Jun-23,NEFT,"51,381.16",00.00,"10,06,831.39",
10-Jun-23,Interest,00.00,"1,67,805.23","8,39,026.16",
10-Jun-23,Debit Card,35,00.00,"8,39,061.16",
10-Jun-23,Transportellaneous,00.00,"1,19,865.88","7,19,195.28",
10-Jun-23,Tax,04.00,00.00,"7,19,199.28",
11-Jun-23,IMPS,00.00,"79,911.03","6,39,288.25",
11-Jun-23,NEFT,00.00,"1,27,857.65","5,11,430.60",
11-Jun-23,Transportellaneous,00.00,"1,02,286.12","4,09,144.48",
11-Jun-23,Transfer,"2,455.65",00.00,"4,11,600.13",
11-Jun-23,Interest,293.58,00.00,"4,11,893.71",
11-Jun-23,Reversal,441.07,00.00,"4,12,334.78",
11-Jun-23,RTGS,00.00,"51,541.85","3,60,792.93",
11-Jun-23,Transportellaneous,"6,20,562.20",00.00,"9,81,355.13",
11-Jun-23,RTGS,00.00,"1,09,039.46","8,72,315.67",
11-Jun-23,Tax,00.00,"8,72,315.67",00.00,
11-Jun-23,NEFT,"29,416.60",00.00,"29,416.60",
11-Jun-23,Reversal,"13,89,429.25",00.00,"14,18,845.85",
11-Jun-23,Commission,"3,004.80",00.00,"14,21,850.65",
11-Jun-23,Transfer,"7,276.00",00.00,"14,29,126.65",
12-Jun-23,RTGS,"3,41,088.50",00.00,"17,70,215.15",
12-Jun-23,Purchase,"6,34,232.25",00.00,"24,04,447.40",
12-Jun-23,Cheque,"3,978.00",00.00,"24,08,425.40",
12-Jun-23,Cash,"1,97,399.00",00.00,"26,05,824.40",
13-Jun-23,Debit Card,00.00,"2,60,582.44","23,45,241.96",
13-Jun-23,Cash,00.00,"2,60,582.44","20,84,659.52",
14-Jun-23,RTGS,"2,497.10",00.00,"20,87,156.62",
14-Jun-23,Reversal,"31,196.60",00.00,"21,18,353.22",
14-Jun-23,Transportellaneous,00.00,"7,06,117.74","14,12,235.48",
14-Jun-23,Purchase,00.00,"1,76,529.44","12,35,706.04",
14-Jun-23,IMPS,253.03,00.00,"12,35,959.07",
14-Jun-23,Bill,"14,088.90",00.00,"12,50,047.97",
14-Jun-23,ATM,00.00,"2,08,341.33","10,41,706.64",
14-Jun-23,RTGS,"16,744.20",00.00,"10,58,450.84",
14-Jun-23,Interest,"3,663.00",00.00,"10,62,113.84",
14-Jun-23,ATM,00.00,"1,51,730.55","9,10,383.29",
14-Jun-23,Transfer,00.00,"1,13,797.91","7,96,585.38",
14-Jun-23,Cash,00.00,"88,509.49","7,08,075.89",
14-Jun-23,Commission,00.00,"70,807.59","6,37,268.30",
14-Jun-23,RTGS,19.61,00.00,"6,37,287.91",
15-Jun-23,ATM,00.00,"6,37,287.91",00.00,
15-Jun-23,Cheque,01.41,00.00,01.41,
15-Jun-23,Bill,"2,992.60",00.00,"2,994.01",
15-Jun-23,Commission,34.5,00.00,"3,028.51",
15-Jun-23,Cheque,00.00,757.13,"2,271.38",
15-Jun-23,Commission,03.95,00.00,"2,275.33",
15-Jun-23,ATM,"19,56,220.00",00.00,"19,58,495.33",
15-Jun-23,Purchase,"2,18,009.00",00.00,"21,76,504.33",
15-Jun-23,Cheque,"3,160.75",00.00,"21,79,665.08",
15-Jun-23,Bill,"2,022.50",00.00,"21,81,687.58",
15-Jun-23,RTGS,"7,93,447.00",00.00,"29,75,134.58",
15-Jun-23,Commission,00.00,"7,43,783.65","22,31,350.94",
15-Jun-23,Transportellaneous,01.50,00.00,"22,31,352.44",
15-Jun-23,Commission,25.84,00.00,"22,31,378.28",
15-Jun-23,Cash,153,00.00,"22,31,531.28",
15-Jun-23,Bill,"1,84,762.00",00.00,"24,16,293.28",
15-Jun-23,NEFT,37,00.00,"24,16,330.28",
15-Jun-23,Bill,00.00,"4,02,721.71","20,13,608.57",
15-Jun-23,Reversal,451,00.00,"20,14,059.57",
15-Jun-23,Bill,06.40,00.00,"20,14,065.97",
15-Jun-23,IMPS,"14,02,382.50",00.00,"34,16,448.47",
15-Jun-23,Purchase,00.00,"4,27,056.06","29,89,392.41",
15-Jun-23,Interest,"24,907.62",00.00,"30,14,300.03",
15-Jun-23,Bill,"2,29,418.00",00.00,"32,43,718.03",
15-Jun-23,NEFT,00.00,"8,10,929.51","24,32,788.52",
15-Jun-23,Transportellaneous,"96,473.00",00.00,"25,29,261.52",
15-Jun-23,Interest,"1,38,858.00",00.00,"26,68,119.52",
15-Jun-23,Reversal,00.00,"2,66,811.95","24,01,307.57",
15-Jun-23,Bill,"1,568.90",00.00,"24,02,876.47",
15-Jun-23,Cash,00.00,"2,40,287.65","21,62,588.82",
15-Jun-23,Tax,00.00,"7,20,862.94","14,41,725.88",
15-Jun-23,Reversal,"11,36,473.80",00.00,"25,78,199.68",
15-Jun-23,Reversal,"1,909.60",00.00,"25,80,109.28",
15-Jun-23,Bill,"1,754.00",00.00,"25,81,863.28",
15-Jun-23,ATM,00.00,"2,86,873.70","22,94,989.58",
15-Jun-23,Purchase,00.00,"2,86,873.70","20,08,115.88",
15-Jun-23,Transfer,93,00.00,"20,08,208.88",
15-Jun-23,ATM,"2,404.63",00.00,"20,10,613.51",
15-Jun-23,Transportellaneous,00.00,"2,23,401.50","17,87,212.01",
15-Jun-23,Reversal,00.00,"8,93,606.01","8,93,606.00",
15-Jun-23,Cheque,137.05,00.00,"8,93,743.05",
15-Jun-23,Transportellaneous,00.00,"99,304.78","7,94,438.27",
15-Jun-23,Purchase,354.3,00.00,"7,94,792.57",
15-Jun-23,Bill,"36,962.30",00.00,"8,31,754.87",
15-Jun-23,IMPS,00.00,"4,15,877.44","4,15,877.44",
15-Jun-23,Commission,"19,274.60",00.00,"4,35,152.04",
15-Jun-23,Purchase,00.00,"2,17,576.02","2,17,576.02",
15-Jun-23,Cash,00.00,"43,515.20","1,74,060.82",
15-Jun-23,ATM,00.00,"29,010.14","1,45,050.68",
15-Jun-23,Bill,430.1,00.00,"1,45,480.78",
15-Jun-23,IMPS,00.00,"1,45,480.78",00.00,
15-Jun-23,Purchase,"1,30,667.10",00.00,"1,30,667.10",
15-Jun-23,RTGS,00.00,"16,333.39","1,14,333.71",
15-Jun-23,Cash,00.00,"1,14,333.71",00.00,
15-Jun-23,Bill,05.30,00.00,05.30,
15-Jun-23,RTGS,134.5,00.00,139.8,
15-Jun-23,Commission,00.00,46.6,93.2,
15-Jun-23,IMPS,00.00,10.36,82.84,
15-Jun-23,Purchase,"4,38,571.00",00.00,"4,38,653.84",
15-Jun-23,Transfer,"1,03,107.84",00.00,"5,41,761.68",
15-Jun-23,Purchase,"1,00,423.60",00.00,"6,42,185.28",
15-Jun-23,Purchase,00.00,"1,28,437.06","5,13,748.22",
15-Jun-23,Tax,00.00,"1,28,437.06","3,85,311.16",
15-Jun-23,NEFT,"2,37,838.20",00.00,"6,23,149.36",
15-Jun-23,Tax,"1,59,507.00",00.00,"7,82,656.36",
16-Jun-23,ATM,"2,57,730.90",00.00,"10,40,387.26",
16-Jun-23,ATM,00.00,"1,30,048.41","9,10,338.85",
16-Jun-23,Reversal,00.00,"1,30,048.41","7,80,290.44",
16-Jun-23,Transportellaneous,00.00,"7,80,290.44",00.00,
16-Jun-23,Commission,02.61,00.00,02.61,
16-Jun-23,Purchase,00.00,00.52,02.09,
16-Jun-23,Cash,"2,08,223.00",00.00,"2,08,225.09",
16-Jun-23,Reversal,00.00,"1,04,112.55","1,04,112.54",
16-Jun-23,Bill,00.00,"26,028.14","78,084.40",
16-Jun-23,Interest,"1,11,331.00",00.00,"1,89,415.40",
16-Jun-23,ATM,00.00,"47,353.85","1,42,061.55",
16-Jun-23,RTGS,00.00,"15,784.62","1,26,276.93",
16-Jun-23,NEFT,00.00,"18,039.56","1,08,237.37",
16-Jun-23,Cheque,00.00,"36,079.12","72,158.25",
16-Jun-23,Bill,00.00,"10,308.32","61,849.93",
16-Jun-23,Tax,00.00,"10,308.32","51,541.61",
16-Jun-23,Cheque,"1,51,196.00",00.00,"2,02,737.61",
16-Jun-23,Tax,19.7,00.00,"2,02,757.31",
16-Jun-23,RTGS,"26,038.00",00.00,"2,28,795.31",
16-Jun-23,Transportellaneous,"2,85,374.50",00.00,"5,14,169.81",
16-Jun-23,Transfer,03.00,00.00,"5,14,172.81",
16-Jun-23,Bill,00.00,"85,695.47","4,28,477.34",
16-Jun-23,Commission,"7,18,723.80",00.00,"11,47,201.14",
16-Jun-23,Bill,00.00,"1,27,466.79","10,19,734.35",
17-Jun-23,RTGS,"92,545.16",00.00,"11,12,279.51",
17-Jun-23,Reversal,"14,31,299.00",00.00,"25,43,578.51",
17-Jun-23,NEFT,00.00,"4,23,929.75","21,19,648.76",
17-Jun-23,Purchase,04.00,00.00,"21,19,652.76",
17-Jun-23,RTGS,660,00.00,"21,20,312.76",
17-Jun-23,Purchase,00.00,"10,60,156.38","10,60,156.38",
17-Jun-23,Cash,00.00,"5,30,078.19","5,30,078.19",
17-Jun-23,RTGS,00.00,"2,65,039.10","2,65,039.09",
17-Jun-23,Commission,00.00,"33,129.89","2,31,909.20",
17-Jun-23,RTGS,00.00,"2,31,909.20",00.00,
17-Jun-23,RTGS,"17,253.90",00.00,"17,253.90",
17-Jun-23,Tax,47.3,00.00,"17,301.20",
17-Jun-23,RTGS,00.00,"3,460.24","13,840.96",
17-Jun-23,Tax,00.00,"4,613.65","9,227.31",
17-Jun-23,Commission,00.00,"1,537.89","7,689.42",
17-Jun-23,NEFT,00.00,"3,844.71","3,844.71",
17-Jun-23,Cash,00.00,384.47,"3,460.24",
17-Jun-23,Reversal,00.00,865.06,"2,595.18",
17-Jun-23,NEFT,"23,085.04",00.00,"25,680.22",
17-Jun-23,Transfer,00.00,"25,680.22",00.00,
17-Jun-23,Reversal,"6,751.00",00.00,"6,751.00",
17-Jun-23,Transportellaneous,"94,191.00",00.00,"1,00,942.00",
17-Jun-23,Reversal,00.00,"1,00,942.00",00.00,
17-Jun-23,Cash,"1,519.80",00.00,"1,519.80",
17-Jun-23,Reversal,251.03,00.00,"1,770.83",
17-Jun-23,Purchase,00.00,354.17,"1,416.66",
17-Jun-23,Cheque,00.00,283.33,"1,133.33",
17-Jun-23,Purchase,00.00,141.67,991.66,
17-Jun-23,Reversal,00.00,165.28,826.38,
17-Jun-23,Purchase,"1,846.00",00.00,"2,672.38",
17-Jun-23,Purchase,"3,543.30",00.00,"6,215.68",
17-Jun-23,IMPS,00.00,621.57,"5,594.11",
17-Jun-23,Cheque,11,00.00,"5,605.11",
17-Jun-23,RTGS,358.3,00.00,"5,963.41",
17-Jun-23,Cash,00.00,"1,490.85","4,472.56",
17-Jun-23,IMPS,03.20,00.00,"4,475.76",
17-Jun-23,Transfer,"27,336.60",00.00,"31,812.36",
17-Jun-23,Cheque,00.00,"10,604.12","21,208.24",
17-Jun-23,Transfer,906.5,00.00,"22,114.74",
17-Jun-23,Reversal,"31,021.12",00.00,"53,135.86",
17-Jun-23,Transfer,00.00,"5,313.59","47,822.27",
17-Jun-23,Interest,43,00.00,"47,865.27",
17-Jun-23,ATM,00.00,"23,932.64","23,932.64",
17-Jun-23,Reversal,00.00,"2,393.26","21,539.38",
17-Jun-23,Reversal,"24,252.00",00.00,"45,791.38",
17-Jun-23,Debit Card,00.00,"15,263.79","30,527.59",
17-Jun-23,Transportellaneous,00.00,"30,527.59",00.00,
17-Jun-23,Cheque,505.9,00.00,505.9,
17-Jun-23,Transfer,00.00,168.63,337.27,
17-Jun-23,Bill,00.00,168.64,168.64,
17-Jun-23,Tax,"2,56,363.00",00.00,"2,56,531.64",
17-Jun-23,Commission,"1,725.00",00.00,"2,58,256.64",
17-Jun-23,Cash,00.00,"1,29,128.32","1,29,128.32",
17-Jun-23,Interest,975.2,00.00,"1,30,103.52",
17-Jun-23,Transfer,00.00,"21,683.92","1,08,419.60",
17-Jun-23,ATM,"3,096.50",00.00,"1,11,516.10",
17-Jun-23,Interest,02.60,00.00,"1,11,518.70",
17-Jun-23,Commission,00.00,"55,759.35","55,759.35",
18-Jun-23,Debit Card,00.00,"27,879.68","27,879.68",
18-Jun-23,Transfer,"4,54,510.50",00.00,"4,82,390.18",
18-Jun-23,Transportellaneous,00.00,"2,41,195.09","2,41,195.09",
18-Jun-23,ATM,28,00.00,"2,41,223.09",
18-Jun-23,NEFT,00.00,"40,203.85","2,01,019.24",
18-Jun-23,Commission,00.00,"67,006.41","1,34,012.83",
18-Jun-23,Reversal,"3,837.00",00.00,"1,37,849.83",
18-Jun-23,Debit Card,00.00,"1,37,849.83",00.00,
18-Jun-23,ATM,"6,62,118.80",00.00,"6,62,118.80",
18-Jun-23,Interest,00.00,"66,211.88","5,95,906.92",
18-Jun-23,Commission,00.00,"1,98,635.64","3,97,271.28",
18-Jun-23,Transportellaneous,"18,771.00",00.00,"4,16,042.28",
18-Jun-23,Reversal,00.00,"1,38,680.76","2,77,361.52",
18-Jun-23,Interest,"1,68,467.90",00.00,"4,45,829.42",
18-Jun-23,Bill,"19,091.00",00.00,"4,64,920.42",
18-Jun-23,Tax,15.25,00.00,"4,64,935.67",
18-Jun-23,Commission,00.00,"1,54,978.56","3,09,957.11",
18-Jun-23,IMPS,00.00,"61,991.42","2,47,965.69",
18-Jun-23,Interest,07.32,00.00,"2,47,973.01",
18-Jun-23,Bill,"2,51,190.50",00.00,"4,99,163.51",
18-Jun-23,RTGS,"3,889.00",00.00,"5,03,052.51",
18-Jun-23,Transportellaneous,30.24,00.00,"5,03,082.75",
18-Jun-23,NEFT,08.00,00.00,"5,03,090.75",
19-Jun-23,Commission,00.00,"71,870.11","4,31,220.64",
19-Jun-23,Cheque,467.2,00.00,"4,31,687.84",
19-Jun-23,RTGS,"2,01,934.10",00.00,"6,33,621.94",
19-Jun-23,Tax,00.00,"3,16,810.97","3,16,810.97",
19-Jun-23,IMPS,00.00,"45,258.71","2,71,552.26",
19-Jun-23,Commission,"25,789.09",00.00,"2,97,341.35",
19-Jun-23,Commission,00.00,"59,468.27","2,37,873.08",
19-Jun-23,IMPS,00.00,"26,430.34","2,11,442.74",
19-Jun-23,Debit Card,15.87,00.00,"2,11,458.61",
19-Jun-23,Cash,"25,390.89",00.00,"2,36,849.50",
19-Jun-23,Debit Card,00.00,"59,212.38","1,77,637.12",
19-Jun-23,Reversal,00.00,"1,77,637.12",00.00,
19-Jun-23,NEFT,130,00.00,130,
19-Jun-23,Commission,02.00,00.00,132,
19-Jun-23,Commission,"2,282.40",00.00,"2,414.40",
19-Jun-23,Interest,00.00,241.44,"2,172.96",
19-Jun-23,Purchase,"12,002.00",00.00,"14,174.96",
19-Jun-23,Cash,"11,866.00",00.00,"26,040.96",
19-Jun-23,RTGS,00.00,"3,255.12","22,785.84",
19-Jun-23,Tax,00.00,"22,785.84",00.00,
19-Jun-23,Reversal,"1,97,106.75",00.00,"1,97,106.75",
19-Jun-23,Interest,"21,875.30",00.00,"2,18,982.05",
19-Jun-23,Interest,00.00,"2,18,982.05",00.00,
19-Jun-23,Cash,"57,486.90",00.00,"57,486.90",
19-Jun-23,Cheque,00.00,"9,581.15","47,905.75",
19-Jun-23,Transportellaneous,"1,30,680.59",00.00,"1,78,586.34",
19-Jun-23,Commission,"29,951.80",00.00,"2,08,538.14",
19-Jun-23,Reversal,"24,128.90",00.00,"2,32,667.04",
19-Jun-23,Transportellaneous,00.00,"77,555.68","1,55,111.36",
19-Jun-23,ATM,00.00,"25,851.89","1,29,259.47",
19-Jun-23,Tax,03.00,00.00,"1,29,262.47",
19-Jun-23,Commission,00.00,"1,29,262.47",00.00,
19-Jun-23,Debit Card,"1,42,799.00",00.00,"1,42,799.00",
19-Jun-23,NEFT,00.00,"47,599.67","95,199.33",
19-Jun-23,Transportellaneous,00.00,"10,577.70","84,621.63",
19-Jun-23,Cash,00.00,00.00,"84,621.63",
19-Jun-23,Cash,02.00,00.00,"84,623.63",
19-Jun-23,Transportellaneous,265,00.00,"84,888.63",
19-Jun-23,Transportellaneous,"4,28,964.00",00.00,"5,13,852.63",
19-Jun-23,RTGS,00.00,"64,231.58","4,49,621.05",
19-Jun-23,IMPS,"1,805.59",00.00,"4,51,426.64",
20-Jun-23,Bill,"3,955.00",00.00,"4,55,381.64",
20-Jun-23,Tax,00.00,"45,538.16","4,09,843.48",
20-Jun-23,Cash,63.9,00.00,"4,09,907.38",
20-Jun-23,Purchase,00.00,"81,981.48","3,27,925.90",
20-Jun-23,Reversal,00.00,"54,654.32","2,73,271.58",
20-Jun-23,Transfer,"2,584.11",00.00,"2,75,855.69",
20-Jun-23,ATM,00.00,"68,963.92","2,06,891.77",
20-Jun-23,RTGS,"10,80,931.00",00.00,"12,87,822.77",
20-Jun-23,Interest,00.00,"6,43,911.39","6,43,911.38",
20-Jun-23,NEFT,"1,95,454.56",00.00,"8,39,365.94",
20-Jun-23,Cash,00.00,"4,19,682.97","4,19,682.97",
20-Jun-23,Interest,00.00,"69,947.16","3,49,735.81",
20-Jun-23,IMPS,00.00,"34,973.58","3,14,762.23",
20-Jun-23,Tax,00.00,"34,973.58","2,79,788.65",
20-Jun-23,Debit Card,"2,694.00",00.00,"2,82,482.65",
21-Jun-23,Tax,19.9,00.00,"2,82,502.55",
21-Jun-23,RTGS,00.00,"35,312.82","2,47,189.73",
21-Jun-23,Cheque,"4,10,186.00",00.00,"6,57,375.73",
21-Jun-23,Transfer,07.60,00.00,"6,57,383.33",
21-Jun-23,Commission,00.00,"65,738.33","5,91,645.00",
21-Jun-23,Reversal,169.7,00.00,"5,91,814.70",
21-Jun-23,Cheque,"1,258.40",00.00,"5,93,073.10",
21-Jun-23,Purchase,00.00,00.00,"5,93,073.10",
21-Jun-23,IMPS,"20,385.23",00.00,"6,13,458.33",
21-Jun-23,Transportellaneous,00.00,"76,682.29","5,36,776.04",
21-Jun-23,Commission,00.00,"1,34,194.01","4,02,582.03",
21-Jun-23,NEFT,00.00,"80,516.41","3,22,065.62",
21-Jun-23,Interest,"3,893.00",00.00,"3,25,958.62",
21-Jun-23,Debit Card,04.00,00.00,"3,25,962.62",
21-Jun-23,IMPS,"16,11,003.50",00.00,"19,36,966.12",
21-Jun-23,Transportellaneous,00.00,"1,93,696.61","17,43,269.51",
21-Jun-23,Cheque,"10,27,845.00",00.00,"27,71,114.51",
21-Jun-23,Purchase,258,00.00,"27,71,372.51",
21-Jun-23,IMPS,00.00,"3,95,910.36","23,75,462.15",
21-Jun-23,IMPS,00.00,"3,39,351.74","20,36,110.41",
21-Jun-23,Interest,02.03,00.00,"20,36,112.44",
21-Jun-23,NEFT,03.03,00.00,"20,36,115.47",
21-Jun-23,ATM,00.00,"6,78,705.16","13,57,410.31",
21-Jun-23,NEFT,00.96,00.00,"13,57,411.27",
21-Jun-23,Tax,"54,663.38",00.00,"14,12,074.65",
21-Jun-23,Transportellaneous,05.00,00.00,"14,12,079.65",
21-Jun-23,Reversal,00.00,"2,35,346.61","11,76,733.04",
21-Jun-23,Tax,06.85,00.00,"11,76,739.89",
21-Jun-23,ATM,06.20,00.00,"11,76,746.09",
21-Jun-23,Cash,00.00,"1,30,749.57","10,45,996.52",
21-Jun-23,NEFT,"27,458.60",00.00,"10,73,455.12",
21-Jun-23,RTGS,41.47,00.00,"10,73,496.59",
21-Jun-23,NEFT,"83,966.12",00.00,"11,57,462.71",
21-Jun-23,Transfer,00.00,"1,44,682.84","10,12,779.87",
21-Jun-23,Commission,03.00,00.00,"10,12,782.87",
21-Jun-23,Transportellaneous,03.00,00.00,"10,12,785.87",
21-Jun-23,Transfer,00.00,"1,44,683.70","8,68,102.17",
21-Jun-23,ATM,153,00.00,"8,68,255.17",
21-Jun-23,Interest,00.00,"4,34,127.59","4,34,127.58",
21-Jun-23,Transfer,00.00,"54,265.95","3,79,861.63",
21-Jun-23,NEFT,00.00,"54,265.95","3,25,595.68",
21-Jun-23,Reversal,00.00,"1,62,797.84","1,62,797.84",
21-Jun-23,Reversal,57.72,00.00,"1,62,855.56",
21-Jun-23,Debit Card,00.00,"54,285.19","1,08,570.37",
21-Jun-23,Cheque,03.04,00.00,"1,08,573.41",
21-Jun-23,NEFT,00.00,"21,714.68","86,858.73",
21-Jun-23,Commission,"2,33,674.00",00.00,"3,20,532.73",
21-Jun-23,Cash,00.00,"32,053.27","2,88,479.46",
21-Jun-23,ATM,"3,05,885.00",00.00,"5,94,364.46",
21-Jun-23,Transportellaneous,00.00,"2,97,182.23","2,97,182.23",
21-Jun-23,Reversal,00.00,"99,060.74","1,98,121.49",
21-Jun-23,Cash,00.00,"19,812.15","1,78,309.34",
21-Jun-23,Bill,00.00,"29,718.22","1,48,591.12",
21-Jun-23,Tax,00.00,"37,147.78","1,11,443.34",
21-Jun-23,Cheque,00.00,"1,11,443.34",00.00,
21-Jun-23,RTGS,"34,201.20",00.00,"34,201.20",
21-Jun-23,Transportellaneous,"4,10,131.00",00.00,"4,44,332.20",
21-Jun-23,Commission,13.96,00.00,"4,44,346.16",
21-Jun-23,Cheque,"19,42,692.50",00.00,"23,87,038.66",
21-Jun-23,NEFT,00.00,"2,65,226.52","21,21,812.14",
21-Jun-23,Cheque,"30,212.00",00.00,"21,52,024.14",
21-Jun-23,Interest,00.00,"10,76,012.07","10,76,012.07",
21-Jun-23,IMPS,"16,19,455.50",00.00,"26,95,467.57",
21-Jun-23,NEFT,00.00,"2,69,546.76","24,25,920.81",
21-Jun-23,Bill,"6,51,209.00",00.00,"30,77,129.81",
21-Jun-23,Cash,"4,88,973.00",00.00,"35,66,102.81",
21-Jun-23,Reversal,"3,067.90",00.00,"35,69,170.71",
21-Jun-23,IMPS,00.00,"5,94,861.79","29,74,308.92",
21-Jun-23,NEFT,00.00,"9,91,436.31","19,82,872.61",
22-Jun-23,Transportellaneous,00.00,"9,91,436.31","9,91,436.30",
22-Jun-23,Purchase,40,00.00,"9,91,476.30",
22-Jun-23,Debit Card,00.00,"99,147.63","8,92,328.67",
22-Jun-23,Purchase,18.2,00.00,"8,92,346.87",
22-Jun-23,Reversal,00.00,"2,97,448.96","5,94,897.91",
22-Jun-23,Reversal,00.00,"66,099.77","5,28,798.14",
22-Jun-23,Tax,"1,08,392.25",00.00,"6,37,190.39",
22-Jun-23,Debit Card,00.00,"1,59,297.60","4,77,892.79",
22-Jun-23,Transfer,"5,04,741.80",00.00,"9,82,634.59",
22-Jun-23,Cheque,02.60,00.00,"9,82,637.19",
22-Jun-23,Tax,00.00,"1,40,376.74","8,42,260.45",
22-Jun-23,Cash,"5,178.80",00.00,"8,47,439.25",
22-Jun-23,Purchase,00.00,"1,21,062.75","7,26,376.50",
22-Jun-23,Cheque,"1,24,900.80",00.00,"8,51,277.30",
22-Jun-23,IMPS,00.00,"2,12,819.33","6,38,457.98",
22-Jun-23,Reversal,00.00,"6,38,457.98",00.00,
22-Jun-23,Transportellaneous,"1,185.00",00.00,"1,185.00",
22-Jun-23,RTGS,00.00,131.67,"1,053.33",
22-Jun-23,Tax,398,00.00,"1,451.33",
22-Jun-23,Transportellaneous,01.80,00.00,"1,453.13",
22-Jun-23,Cheque,00.00,145.31,"1,307.82",
22-Jun-23,Bill,00.00,186.83,"1,120.99",
22-Jun-23,Transportellaneous,08.00,00.00,"1,128.99",
22-Jun-23,Cheque,00.00,282.25,846.74,
22-Jun-23,Cheque,00.00,141.12,705.62,
22-Jun-23,Purchase,"1,02,506.90",00.00,"1,03,212.52",
22-Jun-23,ATM,145.18,00.00,"1,03,357.70",
22-Jun-23,IMPS,00.00,"1,03,357.70",00.00,
22-Jun-23,Cash,"19,40,516.80",00.00,"19,40,516.80",
22-Jun-23,Reversal,"6,885.00",00.00,"19,47,401.80",
22-Jun-23,Transfer,04.00,00.00,"19,47,405.80",
22-Jun-23,IMPS,02.90,00.00,"19,47,408.70",
22-Jun-23,Reversal,02.70,00.00,"19,47,411.40",
22-Jun-23,ATM,"9,96,077.50",00.00,"29,43,488.90",
22-Jun-23,Bill,29.8,00.00,"29,43,518.70",
22-Jun-23,Transfer,"1,507.00",00.00,"29,45,025.70",
22-Jun-23,Bill,00.00,"3,68,128.21","25,76,897.49",
22-Jun-23,Bill,00.00,"8,58,965.83","17,17,931.66",
22-Jun-23,Bill,"15,37,536.20",00.00,"32,55,467.86",
22-Jun-23,Tax,00.00,"5,42,577.98","27,12,889.88",
22-Jun-23,Cheque,"1,28,792.00",00.00,"28,41,681.88",
22-Jun-23,Transportellaneous,"2,14,048.44",00.00,"30,55,730.32",
22-Jun-23,RTGS,00.00,"3,39,525.59","27,16,204.73",
22-Jun-23,Cash,00.00,"9,05,401.58","18,10,803.15",
22-Jun-23,Debit Card,00.00,"2,26,350.39","15,84,452.76",
22-Jun-23,Bill,"36,271.81",00.00,"16,20,724.57",
22-Jun-23,Transportellaneous,58,00.00,"16,20,782.57",
22-Jun-23,Cash,00.00,"2,70,130.43","13,50,652.14",
22-Jun-23,Interest,00.00,"1,35,065.21","12,15,586.93",
22-Jun-23,Debit Card,"1,622.80",00.00,"12,17,209.73",
22-Jun-23,Bill,09.70,00.00,"12,17,219.43",
22-Jun-23,RTGS,"13,496.38",00.00,"12,30,715.81",
22-Jun-23,Purchase,197.69,00.00,"12,30,913.50",
22-Jun-23,ATM,00.00,"2,46,182.70","9,84,730.80",
22-Jun-23,Cash,03.00,00.00,"9,84,733.80",
22-Jun-23,Reversal,00.00,"3,28,244.60","6,56,489.20",
22-Jun-23,Debit Card,00.00,"82,061.15","5,74,428.05",
22-Jun-23,Bill,"1,16,501.90",00.00,"6,90,929.95",
22-Jun-23,Cheque,03.43,00.00,"6,90,933.38",
22-Jun-23,IMPS,00.00,"2,30,311.13","4,60,622.25",
22-Jun-23,Interest,00.00,"76,770.38","3,83,851.88",
22-Jun-23,Tax,00.80,00.00,"3,83,852.68",
22-Jun-23,Tax,00.00,"47,981.59","3,35,871.10",
22-Jun-23,Transportellaneous,00.00,"37,319.01","2,98,552.09",
22-Jun-23,Tax,"2,403.41",00.00,"3,00,955.50",
22-Jun-23,RTGS,226.14,00.00,"3,01,181.64",
22-Jun-23,ATM,00.00,"30,118.16","2,71,063.48",
23-Jun-23,IMPS,318,00.00,"2,71,381.48",
23-Jun-23,Reversal,00.00,"54,276.30","2,17,105.18",
23-Jun-23,Interest,00.00,"1,08,552.59","1,08,552.59",
23-Jun-23,Commission,"32,690.00",00.00,"1,41,242.59",
23-Jun-23,RTGS,"3,051.00",00.00,"1,44,293.59",
23-Jun-23,NEFT,"32,663.00",00.00,"1,76,956.59",
23-Jun-23,Transfer,485.18,00.00,"1,77,441.77",
23-Jun-23,Purchase,00.00,"88,720.89","88,720.88",
23-Jun-23,Transfer,"8,249.58",00.00,"96,970.46",
23-Jun-23,Cash,76,00.00,"97,046.46",
23-Jun-23,IMPS,00.00,"9,704.65","87,341.81",
23-Jun-23,Reversal,738.2,00.00,"88,080.01",
23-Jun-23,Commission,"13,73,232.00",00.00,"14,61,312.01",
23-Jun-23,Commission,496.46,00.00,"14,61,808.47",
23-Jun-23,Interest,00.00,"2,92,361.69","11,69,446.78",
23-Jun-23,Transfer,00.00,"1,29,938.53","10,39,508.25",
23-Jun-23,IMPS,27,00.00,"10,39,535.25",
23-Jun-23,Commission,00.00,"2,59,883.81","7,79,651.44",
23-Jun-23,Bill,00.00,"3,89,825.72","3,89,825.72",
23-Jun-23,Cash,"1,85,565.00",00.00,"5,75,390.72",
23-Jun-23,IMPS,00.00,"1,15,078.14","4,60,312.58",
23-Jun-23,Tax,"23,085.50",00.00,"4,83,398.08",
23-Jun-23,Cash,00.00,"69,056.87","4,14,341.21",
23-Jun-23,Purchase,00.00,"2,07,170.61","2,07,170.60",
23-Jun-23,IMPS,"14,04,753.00",00.00,"16,11,923.60",
23-Jun-23,Debit Card,"4,016.17",00.00,"16,15,939.77",
23-Jun-23,Transfer,00.00,"2,69,323.30","13,46,616.48",
23-Jun-23,Debit Card,890,00.00,"13,47,506.48",
23-Jun-23,Reversal,00.00,"3,36,876.62","10,10,629.86",
23-Jun-23,ATM,00.00,"1,44,375.69","8,66,254.17",
23-Jun-23,Debit Card,17.95,00.00,"8,66,272.12",
23-Jun-23,Bill,00.00,"4,33,136.06","4,33,136.06",
23-Jun-23,IMPS,00.00,"54,142.01","3,78,994.05",
24-Jun-23,Cash,08.00,00.00,"3,79,002.05",
24-Jun-23,Debit Card,"67,483.00",00.00,"4,46,485.05",
25-Jun-23,Reversal,00.00,"74,414.18","3,72,070.88",
25-Jun-23,NEFT,00.00,"46,508.86","3,25,562.02",
25-Jun-23,IMPS,00.00,"54,260.34","2,71,301.68",
25-Jun-23,Debit Card,00.00,"27,130.17","2,44,171.51",
25-Jun-23,Tax,00.00,"48,834.30","1,95,337.21",
25-Jun-23,Transfer,00.00,"21,704.13","1,73,633.08",
25-Jun-23,Cheque,"1,78,508.00",00.00,"3,52,141.08",
25-Jun-23,Transportellaneous,00.00,"50,305.87","3,01,835.21",
25-Jun-23,Transportellaneous,62.6,00.00,"3,01,897.81",
25-Jun-23,Transportellaneous,"66,977.00",00.00,"3,68,874.81",
25-Jun-23,Transfer,00.00,"1,22,958.27","2,45,916.54",
25-Jun-23,Cheque,"3,118.00",00.00,"2,49,034.54",
25-Jun-23,Bill,00.00,"31,129.32","2,17,905.22",
25-Jun-23,ATM,"2,725.80",00.00,"2,20,631.02",
25-Jun-23,Commission,"22,893.00",00.00,"2,43,524.02",
25-Jun-23,Bill,00.00,"60,881.01","1,82,643.02",
26-Jun-23,Commission,00.00,"22,830.38","1,59,812.64",
26-Jun-23,ATM,06.90,00.00,"1,59,819.54",
26-Jun-23,Cash,63.91,00.00,"1,59,883.45",
26-Jun-23,Bill,00.00,"17,764.83","1,42,118.62",
26-Jun-23,RTGS,"32,820.00",00.00,"1,74,938.62",
26-Jun-23,Transfer,43.95,00.00,"1,74,982.57",
26-Jun-23,Cash,"27,641.70",00.00,"2,02,624.27",
26-Jun-23,Purchase,01.84,00.00,"2,02,626.11",
26-Jun-23,Cheque,00.00,"33,771.02","1,68,855.09",
26-Jun-23,Commission,"14,86,964.00",00.00,"16,55,819.09",
26-Jun-23,ATM,144.3,00.00,"16,55,963.39",
26-Jun-23,Reversal,05.93,00.00,"16,55,969.32",
26-Jun-23,Bill,00.00,"1,83,996.59","14,71,972.73",
26-Jun-23,Interest,00.00,"2,10,281.82","12,61,690.91",
26-Jun-23,Transfer,12,00.00,"12,61,702.91",
26-Jun-23,Cash,"87,334.06",00.00,"13,49,036.97",
26-Jun-23,Tax,"72,249.00",00.00,"14,21,285.97",
26-Jun-23,Reversal,00.00,"4,73,761.99","9,47,523.98",
26-Jun-23,Transfer,"16,19,973.80",00.00,"25,67,497.78",
26-Jun-23,Cheque,01.20,00.00,"25,67,498.98",
26-Jun-23,Bill,00.00,"6,41,874.75","19,25,624.24",
26-Jun-23,Cheque,"2,02,178.60",00.00,"21,27,802.84",
26-Jun-23,Transfer,00.00,"21,27,802.84",00.00,
26-Jun-23,Debit Card,23,00.00,23,
26-Jun-23,Transportellaneous,03.00,00.00,26,
26-Jun-23,RTGS,00.00,26,00.00,
26-Jun-23,Transportellaneous,"1,718.77",00.00,"1,718.77",
26-Jun-23,Reversal,"2,111.00",00.00,"3,829.77",
26-Jun-23,ATM,00.00,765.95,"3,063.82",
26-Jun-23,Commission,50.56,00.00,"3,114.38",
26-Jun-23,Debit Card,00.00,"3,114.38",00.00,
26-Jun-23,Transportellaneous,495,00.00,495,
26-Jun-23,ATM,00.00,165,330,
26-Jun-23,Debit Card,00.00,165,165,
26-Jun-23,ATM,27.04,00.00,192.04,
26-Jun-23,Transfer,45.57,00.00,237.61,
26-Jun-23,Purchase,00.00,118.81,118.8,
26-Jun-23,Debit Card,00.00,39.6,79.2,
26-Jun-23,ATM,00.00,07.92,71.28,
26-Jun-23,Debit Card,00.00,07.13,64.15,
26-Jun-23,ATM,00.00,10.69,53.46,
26-Jun-23,Bill,"1,68,105.50",00.00,"1,68,158.96",
27-Jun-23,IMPS,14.8,00.00,"1,68,173.76",
27-Jun-23,RTGS,"12,04,301.50",00.00,"13,72,475.26",
27-Jun-23,Transfer,"15,79,869.25",00.00,"29,52,344.51",
27-Jun-23,NEFT,07.20,00.00,"29,52,351.71",
27-Jun-23,IMPS,"3,378.00",00.00,"29,55,729.71",
27-Jun-23,RTGS,00.00,"14,77,864.86","14,77,864.86",
27-Jun-23,Transportellaneous,"3,232.20",00.00,"14,81,097.06",
27-Jun-23,Reversal,00.00,"1,48,109.71","13,32,987.35",
27-Jun-23,Cheque,00.00,"2,22,164.56","11,10,822.79",
27-Jun-23,Bill,00.00,"2,77,705.70","8,33,117.09",
27-Jun-23,Transfer,00.00,"1,04,139.64","7,28,977.45",
27-Jun-23,Transportellaneous,00.00,"80,997.49","6,47,979.96",
27-Jun-23,Transportellaneous,"1,370.30",00.00,"6,49,350.26",
27-Jun-23,Commission,00.00,"72,150.03","5,77,200.23",
27-Jun-23,Purchase,00.00,"2,88,600.12","2,88,600.12",
27-Jun-23,ATM,"16,93,368.00",00.00,"19,81,968.12",
27-Jun-23,Cash,"6,46,308.00",00.00,"26,28,276.12",
27-Jun-23,Transportellaneous,00.00,"13,14,138.06","13,14,138.06",
27-Jun-23,Purchase,"3,248.00",00.00,"13,17,386.06",
27-Jun-23,Transfer,00.00,"4,39,128.69","8,78,257.37",
27-Jun-23,Tax,00.00,"4,39,128.69","4,39,128.68",
27-Jun-23,IMPS,00.00,"62,732.67","3,76,396.01",
27-Jun-23,RTGS,61.9,00.00,"3,76,457.91",
27-Jun-23,Transfer,00.00,"3,76,457.91",00.00,
27-Jun-23,Tax,46.5,00.00,46.5,
27-Jun-23,NEFT,15,00.00,61.5,
27-Jun-23,Purchase,00.00,61.5,00.00,
28-Jun-23,RTGS,06.90,00.00,06.90,
28-Jun-23,IMPS,00.00,00.69,06.21,
28-Jun-23,RTGS,"15,316.16",00.00,"15,322.37",
28-Jun-23,Cash,00.00,"1,532.24","13,790.13",
28-Jun-23,Transfer,"29,449.00",00.00,"43,239.13",
28-Jun-23,Cash,00.00,"14,413.04","28,826.09",
28-Jun-23,Tax,00.00,"4,804.35","24,021.74",
28-Jun-23,RTGS,00.00,"3,431.68","20,590.06",
28-Jun-23,Interest,00.00,"5,147.52","15,442.55",
28-Jun-23,ATM,00.00,"2,206.08","13,236.47",
29-Jun-23,Transportellaneous,00.00,"3,309.12","9,927.35",
29-Jun-23,IMPS,00.00,"1,103.04","8,824.31",
29-Jun-23,ATM,00.00,"1,103.04","7,721.27",
29-Jun-23,ATM,"1,48,806.70",00.00,"1,56,527.97",
29-Jun-23,IMPS,00.00,"31,305.59","1,25,222.38",
29-Jun-23,Interest,"7,854.00",00.00,"1,33,076.38",
29-Jun-23,RTGS,00.00,"16,634.55","1,16,441.83",
29-Jun-23,Purchase,00.00,"29,110.46","87,331.37",
29-Jun-23,Purchase,"15,68,054.00",00.00,"16,55,385.37",
29-Jun-23,RTGS,00.00,"1,65,538.54","14,89,846.83",
29-Jun-23,Reversal,00.00,"4,96,615.61","9,93,231.22",
29-Jun-23,ATM,00.00,"1,41,890.17","8,51,341.05",
29-Jun-23,Transportellaneous,00.00,"1,21,620.15","7,29,720.90",
29-Jun-23,IMPS,00.00,"1,45,944.18","5,83,776.72",
29-Jun-23,Cash,00.00,"1,45,944.18","4,37,832.54",
29-Jun-23,Transfer,"3,332.00",00.00,"4,41,164.54",
29-Jun-23,Purchase,00.00,"2,20,582.27","2,20,582.27",
29-Jun-23,NEFT,05.09,00.00,"2,20,587.36",
29-Jun-23,Cash,00.00,"55,146.84","1,65,440.52",
29-Jun-23,Tax,00.00,"23,634.36","1,41,806.16",
29-Jun-23,ATM,"15,725.62",00.00,"1,57,531.78",
29-Jun-23,ATM,00.00,"31,506.36","1,26,025.42",
29-Jun-23,Commission,00.00,"15,753.18","1,10,272.24",
29-Jun-23,Bill,00.00,"13,784.03","96,488.21",
30-Jun-23,IMPS,00.00,"16,081.37","80,406.84",
30-Jun-23,IMPS,00.00,"16,081.37","64,325.47",
30-Jun-23,Tax,00.00,"21,441.82","42,883.65",
30-Jun-23,Debit Card,00.00,"42,883.65",00.00,
30-Jun-23,ATM,02.90,00.00,02.90,
30-Jun-23,Interest,"87,249.70",00.00,"87,252.60",
30-Jun-23,Reversal,00.00,"12,464.66","74,787.94",
30-Jun-23,NEFT,00.00,"18,696.99","56,090.96",
30-Jun-23,Bill,"28,025.00",00.00,"84,115.96",
30-Jun-23,Interest,00.00,"21,028.99","63,086.97",
30-Jun-23,RTGS,00.00,"21,028.99","42,057.98",
30-Jun-23,ATM,00.00,"7,009.66","35,048.32",
30-Jun-23,ATM,01.40,00.00,"35,049.72",
30-Jun-23,Purchase,05.60,00.00,"35,055.32",
30-Jun-23,NEFT,00.00,"11,685.11","23,370.21",
30-Jun-23,Bill,00.00,"2,921.28","20,448.93",
30-Jun-23,ATM,"1,51,922.00",00.00,"1,72,370.93",
30-Jun-23,Bill,00.00,"43,092.73","1,29,278.20",
30-Jun-23,ATM,00.00,"64,639.10","64,639.10",
30-Jun-23,Cheque,00.00,"32,319.55","32,319.55",
30-Jun-23,Interest,"1,869.00",00.00,"34,188.55",
30-Jun-23,IMPS,153.15,00.00,"34,341.70",
30-Jun-23,Reversal,43,00.00,"34,384.70",
30-Jun-23,Cheque,00.00,"4,298.09","30,086.61",
30-Jun-23,IMPS,00.00,"10,028.87","20,057.74",
30-Jun-23,Cash,00.00,"20,057.74",00.00,
30-Jun-23,NEFT,"3,315.43",00.00,"3,315.43",
30-Jun-23,Transportellaneous,499,00.00,"3,814.43",
30-Jun-23,Bill,00.00,423.83,"3,390.60",
30-Jun-23,NEFT,"2,90,815.20",00.00,"2,94,205.80",
30-Jun-23,Commission,"2,311.27",00.00,"2,96,517.07",
30-Jun-23,Tax,00.00,"2,96,517.07",00.00,
30-Jun-23,RTGS,"17,16,666.00",00.00,"17,16,666.00",
30-Jun-23,Commission,00.00,"1,90,740.67","15,25,925.33",
30-Jun-23,IMPS,"8,16,084.00",00.00,"23,42,009.33",
30-Jun-23,NEFT,00.00,"4,68,401.87","18,73,607.46",
30-Jun-23,Reversal,00.00,"2,08,178.61","16,65,428.85",
30-Jun-23,Tax,00.00,"3,33,085.77","13,32,343.08",
30-Jun-23,Cash,00.00,"1,90,334.73","11,42,008.35",
30-Jun-23,RTGS,45,00.00,"11,42,053.35",
30-Jun-23,ATM,00.00,"3,80,684.45","7,61,368.90",
30-Jun-23,Commission,"27,120.60",00.00,"7,88,489.50",
30-Jun-23,Purchase,"83,177.25",00.00,"8,71,666.75",
30-Jun-23,Reversal,195.77,00.00,"8,71,862.52",
30-Jun-23,Commission,00.00,"87,186.25","7,84,676.27",
30-Jun-23,Cheque,00.00,"87,186.25","6,97,490.02",
30-Jun-23,ATM,00.00,"6,97,490.02",00.00,
30-Jun-23,Reversal,"1,52,793.00",00.00,"1,52,793.00",
30-Jun-23,RTGS,265,00.00,"1,53,058.00",
01-Jul-23,Bill,00.00,"1,53,058.00",00.00,
01-Jul-23,Transfer,"5,49,184.00",00.00,"5,49,184.00",
01-Jul-23,Interest,00.00,"78,454.86","4,70,729.14",
01-Jul-23,Transfer,00.00,"1,56,909.71","3,13,819.43",
01-Jul-23,IMPS,"31,903.80",00.00,"3,45,723.23",
01-Jul-23,Debit Card,04.00,00.00,"3,45,727.23",
01-Jul-23,Purchase,00.00,"43,215.90","3,02,511.33",
01-Jul-23,RTGS,47,00.00,"3,02,558.33",
01-Jul-23,Bill,00.00,"33,617.59","2,68,940.74",
01-Jul-23,ATM,"4,615.00",00.00,"2,73,555.74",
01-Jul-23,Debit Card,00.00,"54,711.15","2,18,844.59",
02-Jul-23,Debit Card,00.00,"21,884.46","1,96,960.13",
02-Jul-23,RTGS,00.00,"21,884.46","1,75,075.67",
02-Jul-23,IMPS,00.00,"87,537.84","87,537.84",
02-Jul-23,NEFT,"2,102.00",00.00,"89,639.84",
02-Jul-23,Bill,00.00,"44,819.92","44,819.92",
02-Jul-23,Purchase,"3,836.00",00.00,"48,655.92",
02-Jul-23,Reversal,"32,021.50",00.00,"80,677.42",
02-Jul-23,Bill,00.00,"40,338.71","40,338.71",
02-Jul-23,Cash,"1,64,278.00",00.00,"2,04,616.71",
02-Jul-23,Transportellaneous,07.00,00.00,"2,04,623.71",
02-Jul-23,Cheque,00.00,"1,02,311.86","1,02,311.86",
03-Jul-23,IMPS,"9,96,523.00",00.00,"10,98,834.86",
03-Jul-23,Purchase,"14,716.00",00.00,"11,13,550.86",
03-Jul-23,IMPS,00.00,"5,56,775.43","5,56,775.43",
03-Jul-23,Cheque,00.00,"79,539.35","4,77,236.08",
03-Jul-23,Reversal,"22,022.00",00.00,"4,99,258.08",
03-Jul-23,Transfer,460.7,00.00,"4,99,718.78",
03-Jul-23,Debit Card,03.23,00.00,"4,99,722.01",
03-Jul-23,Transfer,00.00,"4,99,722.01",00.00,
03-Jul-23,Cheque,"19,86,288.80",00.00,"19,86,288.80",
03-Jul-23,Debit Card,00.00,"1,98,628.88","17,87,659.92",
03-Jul-23,ATM,00.00,"2,55,379.99","15,32,279.93",
03-Jul-23,Transportellaneous,00.00,"3,83,069.98","11,49,209.95",
03-Jul-23,Transportellaneous,"3,220.50",00.00,"11,52,430.45",
03-Jul-23,RTGS,00.00,"1,44,053.81","10,08,376.64",
03-Jul-23,Cheque,00.00,"3,36,125.55","6,72,251.09",
03-Jul-23,Transportellaneous,00.00,"2,24,083.70","4,48,167.39",
03-Jul-23,Cheque,00.00,"74,694.57","3,73,472.82",
03-Jul-23,Tax,00.00,"1,24,490.94","2,48,981.88",
03-Jul-23,Bill,57,00.00,"2,49,038.88",
03-Jul-23,Transfer,00.00,"1,24,519.44","1,24,519.44",
03-Jul-23,Debit Card,"24,268.00",00.00,"1,48,787.44",
03-Jul-23,Bill,00.00,"24,797.91","1,23,989.53",
03-Jul-23,Tax,233.4,00.00,"1,24,222.93",
03-Jul-23,Transfer,00.00,"62,111.47","62,111.46",
03-Jul-23,NEFT,"3,965.00",00.00,"66,076.46",
03-Jul-23,RTGS,"5,93,514.50",00.00,"6,59,590.96",
03-Jul-23,ATM,00.00,"1,64,897.74","4,94,693.22",
03-Jul-23,Transfer,"5,910.06",00.00,"5,00,603.28",
03-Jul-23,Reversal,00.00,"50,060.33","4,50,542.95",
03-Jul-23,Purchase,00.00,"75,090.49","3,75,452.46",
03-Jul-23,NEFT,"64,618.70",00.00,"4,40,071.16",
03-Jul-23,Bill,05.80,00.00,"4,40,076.96",
03-Jul-23,Commission,"1,702.00",00.00,"4,41,778.96",
03-Jul-23,NEFT,00.00,"4,41,778.96",00.00,
03-Jul-23,Transfer,52.1,00.00,52.1,
03-Jul-23,Reversal,07.50,00.00,59.6,
03-Jul-23,Transfer,"7,098.00",00.00,"7,157.60",
03-Jul-23,Cash,"2,778.60",00.00,"9,936.20",
03-Jul-23,Purchase,01.20,00.00,"9,937.40",
04-Jul-23,IMPS,"3,622.60",00.00,"13,560.00",
04-Jul-23,Transfer,"44,577.00",00.00,"58,137.00",
04-Jul-23,Transportellaneous,509.41,00.00,"58,646.41",
04-Jul-23,ATM,08.82,00.00,"58,655.23",
04-Jul-23,Reversal,04.20,00.00,"58,659.43",
04-Jul-23,RTGS,"12,672.43",00.00,"71,331.86",
04-Jul-23,Transportellaneous,00.00,"7,925.76","63,406.10",
04-Jul-23,ATM,00.00,"6,340.61","57,065.49",
04-Jul-23,Transfer,07.63,00.00,"57,073.12",
04-Jul-23,Purchase,00.00,"6,341.46","50,731.66",
04-Jul-23,Tax,00.00,"7,247.38","43,484.28",
04-Jul-23,ATM,00.00,"4,831.59","38,652.69",
04-Jul-23,RTGS,"1,22,349.00",00.00,"1,61,001.69",
04-Jul-23,Bill,00.00,"23,000.24","1,38,001.45",
04-Jul-23,Interest,"7,555.10",00.00,"1,45,556.55",
04-Jul-23,Cash,00.00,"24,259.43","1,21,297.12",
04-Jul-23,Interest,00.00,"24,259.42","97,037.70",
04-Jul-23,IMPS,00.00,"48,518.85","48,518.85",
04-Jul-23,Transportellaneous,"30,563.04",00.00,"79,081.89",
04-Jul-23,Tax,00.00,"79,081.89",00.00,
04-Jul-23,Cash,20.08,00.00,20.08,
04-Jul-23,Commission,38,00.00,58.08,
04-Jul-23,Transfer,03.10,00.00,61.18,
04-Jul-23,RTGS,00.00,15.3,45.88,
04-Jul-23,Reversal,00.00,15.29,30.59,
04-Jul-23,RTGS,00.00,10.2,20.39,
04-Jul-23,NEFT,07.20,00.00,27.59,
04-Jul-23,Tax,23.2,00.00,50.79,
04-Jul-23,Tax,00.00,50.79,00.00,
04-Jul-23,Transportellaneous,392,00.00,392,
05-Jul-23,Transportellaneous,00.00,392,00.00,
05-Jul-23,Transportellaneous,52.1,00.00,52.1,
05-Jul-23,Transfer,00.00,13.03,39.08,
05-Jul-23,Cash,252,00.00,291.08,
05-Jul-23,Tax,"2,46,429.80",00.00,"2,46,720.88",
05-Jul-23,IMPS,00.00,"2,46,720.88",00.00,
05-Jul-23,RTGS,02.00,00.00,02.00,
05-Jul-23,Transfer,00.00,01.00,01.00,
05-Jul-23,Cheque,00.00,00.50,00.50,
05-Jul-23,Tax,"1,78,967.16",00.00,"1,78,967.66",
05-Jul-23,Cheque,00.00,"17,896.77","1,61,070.89",
05-Jul-23,Tax,00.00,"40,267.72","1,20,803.17",
05-Jul-23,IMPS,00.00,"17,257.60","1,03,545.57",
05-Jul-23,Cheque,"1,58,151.50",00.00,"2,61,697.07",
05-Jul-23,NEFT,00.00,"26,169.71","2,35,527.36",
05-Jul-23,NEFT,00.00,"2,35,527.36",00.00,
05-Jul-23,IMPS,"2,30,595.90",00.00,"2,30,595.90",
05-Jul-23,Tax,502,00.00,"2,31,097.90",
05-Jul-23,Debit Card,00.00,"28,887.24","2,02,210.66",
05-Jul-23,NEFT,00.00,"25,276.33","1,76,934.33",
05-Jul-23,Bill,00.00,"19,659.37","1,57,274.96",
05-Jul-23,Tax,00.00,"26,212.49","1,31,062.47",
05-Jul-23,Reversal,02.20,00.00,"1,31,064.67",
05-Jul-23,ATM,"24,823.00",00.00,"1,55,887.67",
05-Jul-23,Bill,"17,25,365.50",00.00,"18,81,253.17",
05-Jul-23,NEFT,00.00,"1,88,125.32","16,93,127.85",
05-Jul-23,RTGS,227.6,00.00,"16,93,355.45",
05-Jul-23,ATM,00.00,"2,11,669.43","14,81,686.02",
05-Jul-23,ATM,"14,85,808.50",00.00,"29,67,494.52",
05-Jul-23,Transfer,00.00,"3,70,936.82","25,96,557.70",
05-Jul-23,ATM,00.00,"3,70,936.81","22,25,620.89",
05-Jul-23,Purchase,00.00,"22,25,620.89",00.00,
05-Jul-23,ATM,42.5,00.00,42.5,
05-Jul-23,Debit Card,00.00,21.25,21.25,
05-Jul-23,Commission,00.00,10.63,10.62,
05-Jul-23,Transfer,00.00,01.52,09.10,
05-Jul-23,Transfer,00.00,01.52,07.58,
05-Jul-23,IMPS,00.00,01.90,05.68,
05-Jul-23,RTGS,343.29,00.00,348.97,
05-Jul-23,Cash,"3,747.10",00.00,"4,096.07",
05-Jul-23,Commission,"1,00,684.00",00.00,"1,04,780.07",
05-Jul-23,Transfer,00.00,"26,195.02","78,585.05",
05-Jul-23,Transportellaneous,00.00,"78,585.05",00.00,
05-Jul-23,ATM,"4,863.80",00.00,"4,863.80",
05-Jul-23,ATM,"3,916.56",00.00,"8,780.36",
05-Jul-23,Cheque,00.00,"1,097.55","7,682.82",
05-Jul-23,ATM,"90,018.80",00.00,"97,701.62",
05-Jul-23,Transportellaneous,00.00,"19,540.32","78,161.30",
05-Jul-23,Transfer,00.00,"26,053.77","52,107.53",
05-Jul-23,Transfer,03.56,00.00,"52,111.09",
05-Jul-23,Transfer,00.00,"6,513.89","45,597.20",
05-Jul-23,Interest,05.40,00.00,"45,602.60",
05-Jul-23,NEFT,00.00,"5,066.96","40,535.64",
05-Jul-23,Reversal,00.00,"5,790.81","34,744.83",
06-Jul-23,Debit Card,00.00,"3,860.54","30,884.29",
06-Jul-23,Interest,125.55,00.00,"31,009.84",
06-Jul-23,Transfer,00.00,"4,429.98","26,579.86",
06-Jul-23,RTGS,"26,656.50",00.00,"53,236.36",
06-Jul-23,NEFT,29,00.00,"53,265.36",
06-Jul-23,Interest,360,00.00,"53,625.36",
06-Jul-23,Commission,00.00,"17,875.12","35,750.24",
06-Jul-23,Commission,"3,626.60",00.00,"39,376.84",
07-Jul-23,ATM,00.00,"7,875.37","31,501.47",
07-Jul-23,Purchase,00.00,"3,500.16","28,001.31",
07-Jul-23,Cheque,00.00,"7,000.33","21,000.98",
07-Jul-23,Reversal,00.00,"2,100.10","18,900.88",
07-Jul-23,RTGS,12.34,00.00,"18,913.22",
08-Jul-23,Purchase,220.5,00.00,"19,133.72",
08-Jul-23,Interest,04.30,00.00,"19,138.02",
08-Jul-23,Transportellaneous,00.00,"3,189.67","15,948.35",
08-Jul-23,Tax,00.00,"15,948.35",00.00,
08-Jul-23,IMPS,"89,772.50",00.00,"89,772.50",
08-Jul-23,Tax,00.00,"17,954.50","71,818.00",
08-Jul-23,Debit Card,35.84,00.00,"71,853.84",
08-Jul-23,IMPS,07.03,00.00,"71,860.87",
08-Jul-23,Reversal,"14,064.00",00.00,"85,924.87",
08-Jul-23,ATM,"11,909.82",00.00,"97,834.69",
08-Jul-23,Commission,00.00,"48,917.35","48,917.34",
08-Jul-23,Transfer,"1,487.96",00.00,"50,405.30",
08-Jul-23,IMPS,00.00,"5,600.59","44,804.71",
08-Jul-23,Tax,07.85,00.00,"44,812.56",
08-Jul-23,NEFT,05.70,00.00,"44,818.26",
08-Jul-23,Cheque,00.00,"14,939.42","29,878.84",
08-Jul-23,Purchase,"2,145.70",00.00,"32,024.54",
08-Jul-23,Interest,00.00,"5,337.42","26,687.12",
08-Jul-23,Debit Card,"4,27,602.00",00.00,"4,54,289.12",
08-Jul-23,Transportellaneous,00.00,"64,898.45","3,89,390.67",
08-Jul-23,ATM,06.40,00.00,"3,89,397.07",
08-Jul-23,Cheque,00.00,"64,899.51","3,24,497.56",
08-Jul-23,Tax,00.00,"46,356.79","2,78,140.77",
08-Jul-23,Transportellaneous,07.00,00.00,"2,78,147.77",
08-Jul-23,Interest,50,00.00,"2,78,197.77",
08-Jul-23,Reversal,"6,899.00",00.00,"2,85,096.77",
08-Jul-23,Interest,"2,645.90",00.00,"2,87,742.67",
08-Jul-23,RTGS,00.00,"71,935.67","2,15,807.00",
08-Jul-23,Bill,60.4,00.00,"2,15,867.40",
08-Jul-23,ATM,00.00,"23,985.27","1,91,882.13",
08-Jul-23,Reversal,07.04,00.00,"1,91,889.17",
08-Jul-23,Tax,"24,754.08",00.00,"2,16,643.25",
08-Jul-23,Commission,00.00,"36,107.21","1,80,536.04",
08-Jul-23,Bill,00.00,"25,790.86","1,54,745.18",
08-Jul-23,Transportellaneous,311.73,00.00,"1,55,056.91",
08-Jul-23,Commission,00.00,"1,55,056.91",00.00,
08-Jul-23,Purchase,"55,695.00",00.00,"55,695.00",
08-Jul-23,Purchase,07.00,00.00,"55,702.00",
08-Jul-23,Interest,87.09,00.00,"55,789.09",
08-Jul-23,Transfer,"8,998.90",00.00,"64,787.99",
08-Jul-23,Cash,"1,540.00",00.00,"66,327.99",
08-Jul-23,Cheque,00.00,"9,475.43","56,852.56",
08-Jul-23,ATM,00.00,"11,370.51","45,482.05",
08-Jul-23,RTGS,"3,157.40",00.00,"48,639.45",
08-Jul-23,NEFT,"2,11,216.20",00.00,"2,59,855.65",
08-Jul-23,Transfer,"2,44,932.90",00.00,"5,04,788.55",
08-Jul-23,NEFT,33.9,00.00,"5,04,822.45",
08-Jul-23,Cheque,480,00.00,"5,05,302.45",
08-Jul-23,RTGS,"25,390.59",00.00,"5,30,693.04",
08-Jul-23,Tax,"3,337.07",00.00,"5,34,030.11",
08-Jul-23,Cheque,"18,74,666.20",00.00,"24,08,696.31",
08-Jul-23,Cheque,"19,638.90",00.00,"24,28,335.21",
08-Jul-23,IMPS,707.52,00.00,"24,29,042.73",
08-Jul-23,RTGS,"7,70,493.50",00.00,"31,99,536.23",
08-Jul-23,Commission,00.00,"10,66,512.08","21,33,024.15",
08-Jul-23,NEFT,04.29,00.00,"21,33,028.44",
08-Jul-23,Transfer,"2,05,735.34",00.00,"23,38,763.78",
08-Jul-23,Debit Card,00.00,"4,67,752.76","18,71,011.02",
08-Jul-23,Tax,05.92,00.00,"18,71,016.94",
08-Jul-23,Interest,00.00,"1,87,101.69","16,83,915.25",
08-Jul-23,Purchase,00.00,"16,83,915.25",00.00,
08-Jul-23,IMPS,"20,22,355.50",00.00,"20,22,355.50",
08-Jul-23,Transportellaneous,"1,98,014.40",00.00,"22,20,369.90",
08-Jul-23,ATM,468.18,00.00,"22,20,838.08",
08-Jul-23,Purchase,00.00,"2,77,604.76","19,43,233.32",
08-Jul-23,IMPS,385.9,00.00,"19,43,619.22",
08-Jul-23,Debit Card,00.00,"9,71,809.61","9,71,809.61",
08-Jul-23,Tax,37.1,00.00,"9,71,846.71",
08-Jul-23,Commission,00.00,"3,23,948.90","6,47,897.81",
08-Jul-23,ATM,"23,122.00",00.00,"6,71,019.81",
08-Jul-23,Purchase,"3,663.55",00.00,"6,74,683.36",
08-Jul-23,Tax,00.00,"67,468.34","6,07,215.02",
08-Jul-23,Bill,"1,59,624.84",00.00,"7,66,839.86",
08-Jul-23,RTGS,00.00,"1,53,367.97","6,13,471.89",
08-Jul-23,Reversal,33.3,00.00,"6,13,505.19",
08-Jul-23,NEFT,"1,294.80",00.00,"6,14,799.99",
08-Jul-23,Cash,00.00,"3,07,400.00","3,07,400.00",
08-Jul-23,Interest,00.00,"34,155.56","2,73,244.44",
08-Jul-23,Bill,332.8,00.00,"2,73,577.24",
09-Jul-23,Reversal,40,00.00,"2,73,617.24",
09-Jul-23,ATM,"4,702.20",00.00,"2,78,319.44",
09-Jul-23,Transportellaneous,00.00,"69,579.86","2,08,739.58",
09-Jul-23,Bill,30.7,00.00,"2,08,770.28",
09-Jul-23,NEFT,"11,754.31",00.00,"2,20,524.59",
09-Jul-23,Transportellaneous,00.00,"1,10,262.30","1,10,262.30",
10-Jul-23,Transfer,00.00,"13,782.79","96,479.51",
10-Jul-23,RTGS,00.00,"32,159.84","64,319.67",
10-Jul-23,Cheque,58,00.00,"64,377.67",
10-Jul-23,IMPS,00.00,"12,875.53","51,502.14",
11-Jul-23,IMPS,00.00,"8,583.69","42,918.45",
11-Jul-23,NEFT,"19,21,256.00",00.00,"19,64,174.45",
11-Jul-23,Commission,07.98,00.00,"19,64,182.43",
11-Jul-23,Cheque,00.00,"2,18,242.49","17,45,939.94",
11-Jul-23,IMPS,22.4,00.00,"17,45,962.34",
11-Jul-23,Commission,19.7,00.00,"17,45,982.04",
11-Jul-23,Reversal,00.00,"1,93,998.00","15,51,984.04",
11-Jul-23,RTGS,"2,17,267.00",00.00,"17,69,251.04",
11-Jul-23,Interest,00.00,"3,53,850.21","14,15,400.83",
11-Jul-23,Debit Card,00.00,"1,41,540.08","12,73,860.75",
11-Jul-23,Reversal,00.00,"4,24,620.25","8,49,240.50",
11-Jul-23,Reversal,"1,145.30",00.00,"8,50,385.80",
11-Jul-23,NEFT,242.5,00.00,"8,50,628.30",
11-Jul-23,NEFT,00.00,"1,70,125.66","6,80,502.64",
11-Jul-23,ATM,357.8,00.00,"6,80,860.44",
11-Jul-23,ATM,00.00,"75,651.16","6,05,209.28",
11-Jul-23,ATM,"2,581.20",00.00,"6,07,790.48",
11-Jul-23,Bill,00.00,00.00,"6,07,790.48",
11-Jul-23,ATM,05.99,00.00,"6,07,796.47",
11-Jul-23,Purchase,00.00,"86,828.07","5,20,968.40",
11-Jul-23,Bill,00.00,"1,30,242.10","3,90,726.30",
11-Jul-23,Debit Card,00.00,"43,414.03","3,47,312.27",
11-Jul-23,Cheque,"1,813.00",00.00,"3,49,125.27",
11-Jul-23,RTGS,00.00,"69,825.05","2,79,300.22",
11-Jul-23,Debit Card,"19,41,202.50",00.00,"22,20,502.72",
11-Jul-23,IMPS,"23,280.41",00.00,"22,43,783.13",
11-Jul-23,IMPS,00.00,"3,20,540.45","19,23,242.68",
11-Jul-23,Tax,00.00,"4,80,810.67","14,42,432.01",
11-Jul-23,IMPS,00.00,"2,40,405.34","12,02,026.68",
11-Jul-23,Purchase,00.00,"2,00,337.78","10,01,688.90",
11-Jul-23,Transportellaneous,00.00,"1,43,098.41","8,58,590.49",
11-Jul-23,Cash,04.00,00.00,"8,58,594.49",
11-Jul-23,NEFT,00.00,"1,71,718.90","6,86,875.59",
11-Jul-23,IMPS,"2,42,672.03",00.00,"9,29,547.62",
11-Jul-23,NEFT,00.00,"1,54,924.60","7,74,623.02",
11-Jul-23,Transfer,00.00,"3,87,311.51","3,87,311.51",
11-Jul-23,Reversal,"16,68,740.00",00.00,"20,56,051.51",
11-Jul-23,Debit Card,00.00,"6,85,350.50","13,70,701.01",
11-Jul-23,IMPS,00.00,"1,95,814.43","11,74,886.58",
11-Jul-23,IMPS,"10,32,112.80",00.00,"22,06,999.38",
11-Jul-23,RTGS,"1,52,159.80",00.00,"23,59,159.18",
11-Jul-23,Commission,00.00,"2,62,128.80","20,97,030.38",
11-Jul-23,IMPS,"19,62,200.00",00.00,"40,59,230.38",
11-Jul-23,RTGS,00.00,"4,05,923.04","36,53,307.34",
11-Jul-23,Bill,00.00,"3,65,330.73","32,87,976.61",
12-Jul-23,Commission,00.00,"4,69,710.94","28,18,265.67",
12-Jul-23,ATM,00.00,"9,39,421.89","18,78,843.78",
12-Jul-23,Transfer,07.47,00.00,"18,78,851.25",
12-Jul-23,Transfer,"18,88,980.50",00.00,"37,67,831.75",
12-Jul-23,Debit Card,"15,25,196.00",00.00,"52,93,027.75",
12-Jul-23,Transportellaneous,00.00,"5,88,114.19","47,04,913.56",
12-Jul-23,RTGS,01.70,00.00,"47,04,915.26",
12-Jul-23,Cash,00.00,"9,40,983.05","37,63,932.21",
12-Jul-23,Purchase,50.91,00.00,"37,63,983.12",
12-Jul-23,Purchase,62,00.00,"37,64,045.12",
12-Jul-23,Debit Card,00.00,"5,37,720.73","32,26,324.39",
12-Jul-23,Debit Card,00.00,"10,75,441.46","21,50,882.93",
12-Jul-23,Cheque,00.00,"5,37,720.73","16,13,162.20",
12-Jul-23,Reversal,00.00,"4,03,290.55","12,09,871.65",
12-Jul-23,IMPS,"2,844.16",00.00,"12,12,715.81",
12-Jul-23,IMPS,33,00.00,"12,12,748.81",
12-Jul-23,Tax,00.00,"1,34,749.87","10,77,998.94",
12-Jul-23,Interest,00.00,"1,53,999.85","9,23,999.09",
12-Jul-23,Transfer,00.00,"1,15,499.89","8,08,499.20",
13-Jul-23,Tax,00.00,"89,833.24","7,18,665.96",
13-Jul-23,Bill,"2,123.05",00.00,"7,20,789.01",
13-Jul-23,Cheque,"19,99,802.00",00.00,"27,20,591.01",
13-Jul-23,Transfer,383.46,00.00,"27,20,974.47",
13-Jul-23,Tax,00.00,"27,20,974.47",00.00,
13-Jul-23,Commission,226.4,00.00,226.4,
13-Jul-23,Cash,00.00,56.6,169.8,
13-Jul-23,Transportellaneous,00.00,28.3,141.5,
13-Jul-23,Cash,"27,813.35",00.00,"27,954.85",
13-Jul-23,Commission,00.00,"5,590.97","22,363.88",
13-Jul-23,Interest,"1,184.80",00.00,"23,548.68",
14-Jul-23,Cash,00.00,"11,774.34","11,774.34",
14-Jul-23,Transportellaneous,25.8,00.00,"11,800.14",
14-Jul-23,Commission,00.00,"3,933.38","7,866.76",
14-Jul-23,RTGS,00.00,"2,622.25","5,244.51",
14-Jul-23,Bill,00.00,874.09,"4,370.42",
15-Jul-23,Bill,00.77,00.00,"4,371.19",
15-Jul-23,NEFT,00.00,"1,092.80","3,278.39",
15-Jul-23,Cash,"1,139.10",00.00,"4,417.49",
15-Jul-23,Commission,63.73,00.00,"4,481.22",
16-Jul-23,Transportellaneous,"1,54,992.94",00.00,"1,59,474.16",
16-Jul-23,Bill,00.00,"39,868.54","1,19,605.62",
16-Jul-23,Transportellaneous,00.00,"1,19,605.62",00.00,
16-Jul-23,Reversal,"20,487.30",00.00,"20,487.30",
16-Jul-23,Tax,"3,14,242.50",00.00,"3,34,729.80",
16-Jul-23,Bill,00.00,"1,67,364.90","1,67,364.90",
16-Jul-23,Interest,00.00,"1,67,364.90",00.00,
16-Jul-23,Interest,428.21,00.00,428.21,
16-Jul-23,Tax,"6,34,653.50",00.00,"6,35,081.71",
16-Jul-23,Tax,00.00,"63,508.17","5,71,573.54",
16-Jul-23,ATM,00.00,"95,262.26","4,76,311.28",
16-Jul-23,Reversal,00.00,"52,923.48","4,23,387.80",
16-Jul-23,ATM,00.00,"1,05,846.95","3,17,540.85",
16-Jul-23,Interest,00.00,"63,508.17","2,54,032.68",
16-Jul-23,Commission,00.00,"1,27,016.34","1,27,016.34",
16-Jul-23,Transportellaneous,173,00.00,"1,27,189.34",
16-Jul-23,Purchase,55,00.00,"1,27,244.34",
16-Jul-23,Purchase,00.00,"21,207.39","1,06,036.95",
16-Jul-23,Reversal,00.00,"15,148.14","90,888.81",
16-Jul-23,Transfer,00.00,"12,984.12","77,904.69",
16-Jul-23,ATM,00.00,"77,904.69",00.00,
16-Jul-23,Transfer,04.27,00.00,04.27,
16-Jul-23,Commission,"3,050.00",00.00,"3,054.27",
16-Jul-23,Cash,00.00,610.85,"2,443.42",
16-Jul-23,Transportellaneous,"68,153.00",00.00,"70,596.42",
16-Jul-23,Transfer,00.00,"7,059.64","63,536.78",
16-Jul-23,Commission,340.4,00.00,"63,877.18",
16-Jul-23,Reversal,"1,05,365.00",00.00,"1,69,242.18",
16-Jul-23,Commission,00.00,"21,155.27","1,48,086.91",
16-Jul-23,Tax,"3,137.50",00.00,"1,51,224.41",
16-Jul-23,ATM,"2,29,151.80",00.00,"3,80,376.21",
16-Jul-23,Cash,"1,507.00",00.00,"3,81,883.21",
16-Jul-23,Commission,00.00,"47,735.40","3,34,147.81",
16-Jul-23,Debit Card,"4,844.49",00.00,"3,38,992.30",
16-Jul-23,Cheque,00.00,"1,12,997.43","2,25,994.87",
16-Jul-23,RTGS,"1,39,245.00",00.00,"3,65,239.87",
16-Jul-23,Cash,"79,803.31",00.00,"4,45,043.18",
16-Jul-23,Bill,06.21,00.00,"4,45,049.39",
16-Jul-23,Tax,331.87,00.00,"4,45,381.26",
16-Jul-23,Purchase,00.00,"74,230.21","3,71,151.05",
17-Jul-23,Debit Card,"15,02,838.00",00.00,"18,73,989.05",
17-Jul-23,NEFT,"1,11,976.70",00.00,"19,85,965.75",
17-Jul-23,Cheque,"17,691.90",00.00,"20,03,657.65",
17-Jul-23,Interest,349,00.00,"20,04,006.65",
17-Jul-23,Interest,00.00,"2,22,667.41","17,81,339.24",
17-Jul-23,Bill,00.00,"3,56,267.85","14,25,071.39",
17-Jul-23,IMPS,"2,18,413.20",00.00,"16,43,484.59",
17-Jul-23,Cash,"14,27,845.75",00.00,"30,71,330.34",
17-Jul-23,Debit Card,00.00,"3,07,133.03","27,64,197.31",
17-Jul-23,Transfer,00.00,"9,21,399.10","18,42,798.21",
17-Jul-23,IMPS,00.00,"6,14,266.07","12,28,532.14",
17-Jul-23,NEFT,"2,350.99",00.00,"12,30,883.13",
17-Jul-23,Tax,"17,73,062.50",00.00,"30,03,945.63",
17-Jul-23,Transfer,"19,51,534.25",00.00,"49,55,479.88",
17-Jul-23,NEFT,00.00,"49,55,479.88",00.00,
17-Jul-23,ATM,06.00,00.00,06.00,
17-Jul-23,RTGS,"10,82,657.50",00.00,"10,82,663.50",
18-Jul-23,Debit Card,"10,06,353.25",00.00,"20,89,016.75",
18-Jul-23,Reversal,00.00,"20,89,016.75",00.00,
18-Jul-23,Bill,20,00.00,20,
18-Jul-23,IMPS,"1,98,523.56",00.00,"1,98,543.56",
18-Jul-23,ATM,00.00,"33,090.59","1,65,452.97",
18-Jul-23,Cheque,00.00,"41,363.24","1,24,089.73",
18-Jul-23,Transfer,00.00,"13,787.75","1,10,301.98",
18-Jul-23,Reversal,"2,159.11",00.00,"1,12,461.09",
18-Jul-23,Commission,109,00.00,"1,12,570.09",
18-Jul-23,Tax,00.00,"1,12,570.09",00.00,
18-Jul-23,Bill,"2,995.01",00.00,"2,995.01",
18-Jul-23,ATM,"1,996.00",00.00,"4,991.01",
19-Jul-23,Reversal,367.24,00.00,"5,358.25",
19-Jul-23,Cash,00.00,669.78,"4,688.47",
19-Jul-23,RTGS,04.58,00.00,"4,693.05",
19-Jul-23,Cash,"16,471.00",00.00,"21,164.05",
19-Jul-23,ATM,00.00,"10,582.03","10,582.02",
19-Jul-23,Cheque,00.00,"10,582.02",00.00,
19-Jul-23,Cash,"2,34,681.00",00.00,"2,34,681.00",
19-Jul-23,Transportellaneous,00.00,"1,17,340.50","1,17,340.50",
20-Jul-23,Transportellaneous,00.00,"39,113.50","78,227.00",
20-Jul-23,IMPS,"2,07,624.00",00.00,"2,85,851.00",
20-Jul-23,NEFT,"2,167.31",00.00,"2,88,018.31",
20-Jul-23,IMPS,"45,436.40",00.00,"3,33,454.71",
20-Jul-23,Transfer,00.00,"66,690.94","2,66,763.77",
20-Jul-23,Interest,94,00.00,"2,66,857.77",
20-Jul-23,RTGS,00.00,"1,33,428.89","1,33,428.88",
20-Jul-23,RTGS,00.00,"1,33,428.88",00.00,
21-Jul-23,Tax,"91,129.00",00.00,"91,129.00",
21-Jul-23,Transfer,00.00,"91,129.00",00.00,
21-Jul-23,RTGS,05.50,00.00,05.50,
21-Jul-23,ATM,"10,89,657.50",00.00,"10,89,663.00",
21-Jul-23,Cheque,"2,620.30",00.00,"10,92,283.30",
21-Jul-23,RTGS,00.00,"3,64,094.43","7,28,188.87",
21-Jul-23,Cash,00.00,"7,28,188.87",00.00,
21-Jul-23,Transportellaneous,"2,33,607.00",00.00,"2,33,607.00",
21-Jul-23,Purchase,"20,864.69",00.00,"2,54,471.69",
21-Jul-23,Reversal,00.00,"50,894.34","2,03,577.35",
21-Jul-23,IMPS,00.00,"67,859.12","1,35,718.23",
21-Jul-23,Reversal,"2,02,353.90",00.00,"3,38,072.13",
21-Jul-23,IMPS,00.00,"42,259.02","2,95,813.11",
21-Jul-23,RTGS,03.00,00.00,"2,95,816.11",
21-Jul-23,Cheque,00.00,"73,954.03","2,21,862.08",
21-Jul-23,Interest,00.00,"44,372.42","1,77,489.66",
21-Jul-23,Debit Card,00.00,"22,186.21","1,55,303.45",
21-Jul-23,Interest,"7,999.00",00.00,"1,63,302.45",
21-Jul-23,IMPS,00.00,"23,328.92","1,39,973.53",
21-Jul-23,IMPS,26.29,00.00,"1,39,999.82",
21-Jul-23,NEFT,00.00,"13,999.98","1,25,999.84",
21-Jul-23,Transfer,00.00,"62,999.92","62,999.92",
21-Jul-23,Bill,00.00,"20,999.97","41,999.95",
21-Jul-23,Bill,435.96,00.00,"42,435.91",
21-Jul-23,RTGS,00.00,"5,304.49","37,131.42",
21-Jul-23,Bill,48.9,00.00,"37,180.32",
21-Jul-23,NEFT,05.06,00.00,"37,185.38",
21-Jul-23,Commission,00.00,"18,592.69","18,592.69",
21-Jul-23,IMPS,07.00,00.00,"18,599.69",
21-Jul-23,Tax,04.85,00.00,"18,604.54",
21-Jul-23,Cash,"1,257.00",00.00,"19,861.54",
21-Jul-23,RTGS,"1,865.00",00.00,"21,726.54",
21-Jul-23,Interest,274,00.00,"22,000.54",
21-Jul-23,Bill,"2,890.50",00.00,"24,891.04",
21-Jul-23,Debit Card,"2,06,140.00",00.00,"2,31,031.04",
22-Jul-23,Transfer,00.00,"2,31,031.04",00.00,
22-Jul-23,Cash,83.89,00.00,83.89,
22-Jul-23,Cash,00.00,83.89,00.00,
22-Jul-23,Debit Card,"5,26,574.75",00.00,"5,26,574.75",
22-Jul-23,IMPS,443.3,00.00,"5,27,018.05",
22-Jul-23,Cash,00.00,"75,288.29","4,51,729.76",
22-Jul-23,NEFT,00.00,"45,172.98","4,06,556.78",
22-Jul-23,ATM,00.00,"1,35,518.93","2,71,037.85",
22-Jul-23,Purchase,00.00,"90,345.95","1,80,691.90",
22-Jul-23,Bill,00.00,"18,069.19","1,62,622.71",
22-Jul-23,ATM,00.00,"16,262.27","1,46,360.44",
22-Jul-23,Bill,"2,997.00",00.00,"1,49,357.44",
22-Jul-23,Commission,"2,45,916.00",00.00,"3,95,273.44",
22-Jul-23,Debit Card,"21,374.70",00.00,"4,16,648.14",
22-Jul-23,IMPS,399.28,00.00,"4,17,047.42",
22-Jul-23,Transportellaneous,"1,51,545.00",00.00,"5,68,592.42",
22-Jul-23,Purchase,"4,00,509.50",00.00,"9,69,101.92",
23-Jul-23,Debit Card,"1,728.03",00.00,"9,70,829.95",
23-Jul-23,Purchase,00.00,"3,23,609.98","6,47,219.97",
23-Jul-23,Cheque,283.9,00.00,"6,47,503.87",
23-Jul-23,RTGS,"3,185.90",00.00,"6,50,689.77",
23-Jul-23,Transportellaneous,"1,951.50",00.00,"6,52,641.27",
23-Jul-23,Commission,"2,039.00",00.00,"6,54,680.27",
23-Jul-23,Debit Card,379.05,00.00,"6,55,059.32",
24-Jul-23,IMPS,00.00,"81,882.42","5,73,176.90",
24-Jul-23,Tax,00.00,"2,86,588.45","2,86,588.45",
24-Jul-23,Transportellaneous,00.00,"31,843.16","2,54,745.29",
24-Jul-23,Commission,03.00,00.00,"2,54,748.29",
24-Jul-23,NEFT,00.00,"31,843.54","2,22,904.75",
24-Jul-23,Transportellaneous,00.00,"74,301.58","1,48,603.17",
25-Jul-23,Reversal,51.86,00.00,"1,48,655.03",
25-Jul-23,Commission,00.00,"21,236.43","1,27,418.60",
25-Jul-23,RTGS,00.00,"15,927.33","1,11,491.28",
25-Jul-23,Transfer,00.00,"12,387.92","99,103.36",
25-Jul-23,IMPS,00.00,"99,103.36",00.00,
25-Jul-23,RTGS,"16,21,255.00",00.00,"16,21,255.00",
25-Jul-23,Cash,"1,766.40",00.00,"16,23,021.40",
25-Jul-23,Bill,00.00,"4,05,755.35","12,17,266.05",
25-Jul-23,Cheque,00.00,"1,73,895.15","10,43,370.90",
25-Jul-23,NEFT,00.00,"1,49,052.99","8,94,317.91",
25-Jul-23,Bill,"1,48,168.00",00.00,"10,42,485.91",
25-Jul-23,ATM,00.00,"2,08,497.18","8,33,988.73",
25-Jul-23,Interest,04.10,00.00,"8,33,992.83",
26-Jul-23,Transfer,00.00,"1,38,998.81","6,94,994.02",
26-Jul-23,Debit Card,"1,85,063.00",00.00,"8,80,057.02",
26-Jul-23,Tax,"8,42,818.25",00.00,"17,22,875.27",
26-Jul-23,Transfer,00.00,"8,61,437.64","8,61,437.64",
26-Jul-23,Transportellaneous,00.00,"8,61,437.64",00.00,
26-Jul-23,Transportellaneous,"12,44,117.50",00.00,"12,44,117.50",
26-Jul-23,Bill,00.00,"3,11,029.38","9,33,088.12",
26-Jul-23,Purchase,00.00,"93,308.81","8,39,779.31",
26-Jul-23,Purchase,"10,50,130.75",00.00,"18,89,910.06",
26-Jul-23,IMPS,"14,04,944.50",00.00,"32,94,854.56",
26-Jul-23,Cheque,00.00,"8,23,713.64","24,71,140.92",
26-Jul-23,Commission,"1,95,225.20",00.00,"26,66,366.12",
26-Jul-23,Bill,"12,65,126.00",00.00,"39,31,492.12",
26-Jul-23,Tax,00.00,"6,55,248.69","32,76,243.43",
26-Jul-23,Commission,00.00,"32,76,243.43",00.00,
26-Jul-23,IMPS,03.00,00.00,03.00,
26-Jul-23,Cash,00.00,00.33,02.67,
26-Jul-23,Commission,00.00,00.38,02.29,
26-Jul-23,Transfer,00.00,00.76,01.53,
26-Jul-23,Bill,07.37,00.00,08.90,
26-Jul-23,NEFT,124.71,00.00,133.61,
26-Jul-23,Cash,"16,778.00",00.00,"16,911.61",
26-Jul-23,Bill,00.00,"4,227.90","12,683.71",
26-Jul-23,Transfer,"5,040.67",00.00,"17,724.38",
26-Jul-23,NEFT,00.00,"4,431.10","13,293.28",
26-Jul-23,Tax,"88,488.00",00.00,"1,01,781.28",
26-Jul-23,Reversal,"10,54,708.20",00.00,"11,56,489.48",
26-Jul-23,Transportellaneous,00.00,"5,78,244.74","5,78,244.74",
26-Jul-23,NEFT,00.00,"2,89,122.37","2,89,122.37",
26-Jul-23,Reversal,04.90,00.00,"2,89,127.27",
26-Jul-23,Transfer,30.6,00.00,"2,89,157.87",
26-Jul-23,Tax,00.00,"36,144.73","2,53,013.14",
26-Jul-23,Transfer,"2,567.00",00.00,"2,55,580.14",
26-Jul-23,RTGS,00.00,"42,596.69","2,12,983.45",
26-Jul-23,RTGS,00.00,"26,622.93","1,86,360.52",
26-Jul-23,Purchase,00.00,"1,86,360.52",00.00,
26-Jul-23,Cheque,436.87,00.00,436.87,
26-Jul-23,Debit Card,"12,044.71",00.00,"12,481.58",
26-Jul-23,RTGS,00.00,"1,783.08","10,698.50",
26-Jul-23,Tax,00.00,"10,698.50",00.00,
26-Jul-23,Commission,"2,24,965.34",00.00,"2,24,965.34",
26-Jul-23,Reversal,"1,138.20",00.00,"2,26,103.54",
26-Jul-23,Tax,00.00,"22,610.35","2,03,493.19",
26-Jul-23,IMPS,"1,041.80",00.00,"2,04,534.99",
26-Jul-23,Cash,00.00,"20,453.50","1,84,081.49",
26-Jul-23,Purchase,"2,064.60",00.00,"1,86,146.09",
26-Jul-23,RTGS,"1,26,204.40",00.00,"3,12,350.49",
26-Jul-23,Purchase,00.00,"3,12,350.49",00.00,
26-Jul-23,Transportellaneous,179,00.00,179,
26-Jul-23,Tax,"42,430.50",00.00,"42,609.50",
26-Jul-23,Tax,00.00,"14,203.17","28,406.33",
26-Jul-23,Purchase,00.00,"7,101.58","21,304.75",
26-Jul-23,IMPS,30.71,00.00,"21,335.46",
26-Jul-23,Purchase,"7,641.50",00.00,"28,976.96",
26-Jul-23,Reversal,"1,10,561.00",00.00,"1,39,537.96",
26-Jul-23,NEFT,00.30,00.00,"1,39,538.26",
26-Jul-23,Debit Card,00.00,"19,934.04","1,19,604.22",
26-Jul-23,Cheque,02.70,00.00,"1,19,606.92",
26-Jul-23,Transfer,56,00.00,"1,19,662.92",
26-Jul-23,Interest,00.00,"29,915.73","89,747.19",
26-Jul-23,Cheque,"18,962.20",00.00,"1,08,709.39",
26-Jul-23,Transfer,"3,172.00",00.00,"1,11,881.39",
26-Jul-23,Interest,"14,659.00",00.00,"1,26,540.39",
26-Jul-23,Commission,"1,42,455.12",00.00,"2,68,995.51",
26-Jul-23,IMPS,"21,617.90",00.00,"2,90,613.41",
26-Jul-23,Bill,00.00,"2,90,613.41",00.00,
26-Jul-23,NEFT,"2,407.00",00.00,"2,407.00",
26-Jul-23,Purchase,"88,672.50",00.00,"91,079.50",
26-Jul-23,ATM,00.00,"11,384.94","79,694.56",
26-Jul-23,Transfer,00.00,"26,564.85","53,129.71",
26-Jul-23,Cash,00.00,"5,903.30","47,226.41",
26-Jul-23,Tax,00.00,"11,806.60","35,419.81",
26-Jul-23,Purchase,"1,543.10",00.00,"36,962.91",
26-Jul-23,Commission,00.00,"9,240.73","27,722.18",
26-Jul-23,Cash,16,00.00,"27,738.18",
26-Jul-23,Cheque,"25,450.00",00.00,"53,188.18",
26-Jul-23,IMPS,"2,432.00",00.00,"55,620.18",
26-Jul-23,Tax,"61,779.44",00.00,"1,17,399.62",
26-Jul-23,Cash,00.00,"1,17,399.62",00.00,
26-Jul-23,IMPS,300.7,00.00,300.7,
26-Jul-23,ATM,00.00,150.35,150.35,
26-Jul-23,Tax,00.00,25.06,125.29,
26-Jul-23,Interest,00.00,12.53,112.76,
26-Jul-23,Cash,"6,82,096.00",00.00,"6,82,208.76",
26-Jul-23,Tax,00.00,"3,41,104.38","3,41,104.38",
26-Jul-23,Interest,00.00,"34,110.44","3,06,993.94",
26-Jul-23,Tax,00.00,"30,699.39","2,76,294.55",
26-Jul-23,Interest,00.00,"55,258.91","2,21,035.64",
26-Jul-23,Transfer,00.00,"36,839.27","1,84,196.37",
26-Jul-23,IMPS,01.00,00.00,"1,84,197.37",
26-Jul-23,Bill,13,00.00,"1,84,210.37",
26-Jul-23,Debit Card,00.00,"18,421.04","1,65,789.33",
26-Jul-23,IMPS,00.00,"23,684.19","1,42,105.14",
26-Jul-23,Reversal,06.10,00.00,"1,42,111.24",
26-Jul-23,Debit Card,24.75,00.00,"1,42,135.99",
26-Jul-23,Transportellaneous,00.00,"23,689.33","1,18,446.66",
26-Jul-23,Interest,00.00,"23,689.33","94,757.33",
26-Jul-23,ATM,01.40,00.00,"94,758.73",
26-Jul-23,Commission,00.00,"15,793.12","78,965.61",
26-Jul-23,Transportellaneous,00.00,"11,280.80","67,684.81",
26-Jul-23,Transportellaneous,00.00,"16,921.20","50,763.61",
26-Jul-23,Debit Card,"68,062.00",00.00,"1,18,825.61",
26-Jul-23,ATM,00.00,"14,853.20","1,03,972.41",
26-Jul-23,IMPS,"2,486.90",00.00,"1,06,459.31",
26-Jul-23,Purchase,00.00,"11,828.81","94,630.50",
26-Jul-23,Transfer,00.00,"13,518.64","81,111.86",
26-Jul-23,Debit Card,00.00,"9,012.43","72,099.43",
26-Jul-23,Commission,00.00,"72,099.43",00.00,
26-Jul-23,ATM,"4,64,173.75",00.00,"4,64,173.75",
26-Jul-23,Reversal,00.00,"77,362.29","3,86,811.46",
26-Jul-23,Cash,"17,948.30",00.00,"4,04,759.76",
26-Jul-23,RTGS,00.00,"50,594.97","3,54,164.79",
26-Jul-23,Transportellaneous,00.00,"3,54,164.79",00.00,
26-Jul-23,Bill,"19,15,502.50",00.00,"19,15,502.50",
26-Jul-23,Transportellaneous,"73,578.78",00.00,"19,89,081.28",
26-Jul-23,Transportellaneous,00.00,"2,48,635.16","17,40,446.12",
26-Jul-23,Cheque,00.00,"17,40,446.12",00.00,
26-Jul-23,Bill,02.00,00.00,02.00,
26-Jul-23,Bill,31.9,00.00,33.9,
26-Jul-23,NEFT,00.00,16.95,16.95,
26-Jul-23,Cash,00.00,02.12,14.83,
26-Jul-23,Debit Card,"2,463.00",00.00,"2,477.83",
26-Jul-23,Bill,00.00,825.94,"1,651.89",
26-Jul-23,Reversal,00.00,275.32,"1,376.58",
26-Jul-23,Reversal,11,00.00,"1,387.58",
26-Jul-23,Debit Card,02.93,00.00,"1,390.51",
26-Jul-23,Reversal,00.00,198.64,"1,191.87",
26-Jul-23,Commission,04.00,00.00,"1,195.87",
26-Jul-23,Transportellaneous,00.00,170.84,"1,025.03",
26-Jul-23,Cheque,00.00,170.84,854.19,
26-Jul-23,Commission,"1,455.30",00.00,"2,309.49",
26-Jul-23,IMPS,"2,19,286.50",00.00,"2,21,595.99",
26-Jul-23,Debit Card,00.00,"31,656.57","1,89,939.42",
26-Jul-23,RTGS,"8,87,094.00",00.00,"10,77,033.42",
26-Jul-23,Purchase,00.00,"5,38,516.71","5,38,516.71",
26-Jul-23,Cash,"2,059.81",00.00,"5,40,576.52",
26-Jul-23,Bill,00.00,"60,064.06","4,80,512.46",
26-Jul-23,Debit Card,459.1,00.00,"4,80,971.56",
26-Jul-23,Bill,04.10,00.00,"4,80,975.66",
26-Jul-23,NEFT,"18,02,282.00",00.00,"22,83,257.66",
26-Jul-23,Bill,"1,58,280.72",00.00,"24,41,538.38",
26-Jul-23,Reversal,00.00,"12,20,769.19","12,20,769.19",
26-Jul-23,ATM,00.00,"1,52,596.15","10,68,173.04",
26-Jul-23,Interest,00.00,"3,56,057.68","7,12,115.36",
26-Jul-23,Reversal,51.1,00.00,"7,12,166.46",
26-Jul-23,Debit Card,"2,52,952.80",00.00,"9,65,119.26",
26-Jul-23,Transfer,00.00,"1,07,235.47","8,57,883.79",
26-Jul-23,Transportellaneous,00.00,"2,14,470.95","6,43,412.84",
26-Jul-23,NEFT,00.00,"71,490.32","5,71,922.52",
26-Jul-23,Transfer,29,00.00,"5,71,951.52",
27-Jul-23,Bill,08.00,00.00,"5,71,959.52",
27-Jul-23,Bill,479.2,00.00,"5,72,438.72",
27-Jul-23,NEFT,00.00,"57,243.87","5,15,194.85",
27-Jul-23,NEFT,00.00,"1,28,798.71","3,86,396.14",
27-Jul-23,Tax,47.1,00.00,"3,86,443.24",
27-Jul-23,Commission,"3,87,734.00",00.00,"7,74,177.24",
27-Jul-23,Cash,00.00,"1,29,029.54","6,45,147.70",
27-Jul-23,Purchase,00.00,"92,163.96","5,52,983.74",
27-Jul-23,Reversal,00.00,"55,298.37","4,97,685.37",
27-Jul-23,Debit Card,02.00,00.00,"4,97,687.37",
28-Jul-23,Interest,411.38,00.00,"4,98,098.75",
28-Jul-23,Transfer,62.09,00.00,"4,98,160.84",
28-Jul-23,Debit Card,00.00,"55,351.20","4,42,809.64",
28-Jul-23,Purchase,04.59,00.00,"4,42,814.23",
28-Jul-23,Purchase,108.6,00.00,"4,42,922.83",
28-Jul-23,Bill,00.00,"2,21,461.42","2,21,461.42",
28-Jul-23,NEFT,00.00,"24,606.82","1,96,854.60",
28-Jul-23,Tax,00.00,"21,872.73","1,74,981.87",
28-Jul-23,RTGS,"1,04,657.30",00.00,"2,79,639.17",
28-Jul-23,Transportellaneous,"2,27,513.06",00.00,"5,07,152.23",
28-Jul-23,Cash,00.00,"5,07,152.23",00.00,
28-Jul-23,NEFT,"3,767.50",00.00,"3,767.50",
28-Jul-23,Cash,"16,093.00",00.00,"19,860.50",
28-Jul-23,RTGS,403.4,00.00,"20,263.90",
28-Jul-23,RTGS,"10,521.05",00.00,"30,784.95",
28-Jul-23,Commission,00.00,"3,420.55","27,364.40",
28-Jul-23,Interest,75,00.00,"27,439.40",
28-Jul-23,Cheque,27,00.00,"27,466.40",
28-Jul-23,Interest,00.00,"5,493.28","21,973.12",
28-Jul-23,Cheque,57.1,00.00,"22,030.22",
28-Jul-23,Transfer,00.00,"5,507.56","16,522.66",
28-Jul-23,Bill,00.00,"3,304.53","13,218.13",
28-Jul-23,NEFT,00.00,"13,218.13",00.00,
28-Jul-23,RTGS,251.59,00.00,251.59,
28-Jul-23,NEFT,58.5,00.00,310.09,
28-Jul-23,RTGS,"4,85,108.50",00.00,"4,85,418.59",
28-Jul-23,Purchase,00.00,"97,083.72","3,88,334.87",
28-Jul-23,Purchase,00.00,"77,666.97","3,10,667.90",
28-Jul-23,Tax,503.6,00.00,"3,11,171.50",
28-Jul-23,Reversal,"1,535.16",00.00,"3,12,706.66",
28-Jul-23,Interest,"32,527.00",00.00,"3,45,233.66",
28-Jul-23,Tax,00.00,"86,308.42","2,58,925.24",
28-Jul-23,Reversal,00.00,"43,154.21","2,15,771.03",
28-Jul-23,Bill,00.00,"1,07,885.52","1,07,885.52",
28-Jul-23,RTGS,00.00,"13,485.69","94,399.83",
28-Jul-23,IMPS,40.7,00.00,"94,440.53",
28-Jul-23,Commission,"27,702.00",00.00,"1,22,142.53",
28-Jul-23,IMPS,04.00,00.00,"1,22,146.53",
28-Jul-23,Debit Card,00.00,"20,357.76","1,01,788.78",
29-Jul-23,Commission,"9,869.20",00.00,"1,11,657.98",
29-Jul-23,Commission,"16,340.30",00.00,"1,27,998.28",
29-Jul-23,ATM,00.00,"31,999.57","95,998.71",
29-Jul-23,RTGS,"2,18,424.25",00.00,"3,14,422.96",
29-Jul-23,RTGS,"4,066.90",00.00,"3,18,489.86",
29-Jul-23,NEFT,"20,753.80",00.00,"3,39,243.66",
29-Jul-23,NEFT,00.00,"1,13,081.22","2,26,162.44",
29-Jul-23,Cheque,00.00,"2,26,162.44",00.00,
29-Jul-23,RTGS,"1,109.00",00.00,"1,109.00",
29-Jul-23,IMPS,00.00,123.22,985.78,
29-Jul-23,Cheque,00.00,985.78,00.00,
29-Jul-23,Commission,"16,23,326.20",00.00,"16,23,326.20",
29-Jul-23,ATM,605.91,00.00,"16,23,932.11",
29-Jul-23,Cheque,"77,759.47",00.00,"17,01,691.58",
30-Jul-23,ATM,"3,759.28",00.00,"17,05,450.86",
30-Jul-23,Cash,"9,85,857.00",00.00,"26,91,307.86",
30-Jul-23,Bill,"19,356.90",00.00,"27,10,664.76",
30-Jul-23,Debit Card,03.50,00.00,"27,10,668.26",
30-Jul-23,RTGS,59.68,00.00,"27,10,727.94",
30-Jul-23,Transportellaneous,00.00,"13,55,363.97","13,55,363.97",
30-Jul-23,Transportellaneous,00.00,"13,55,363.97",00.00,
30-Jul-23,Cash,00.00,00.00,00.00,
30-Jul-23,Transportellaneous,02.25,00.00,02.25,
31-Jul-23,ATM,"2,711.00",00.00,"2,713.25",
31-Jul-23,Debit Card,00.00,301.47,"2,411.78",
31-Jul-23,Debit Card,00.00,344.54,"2,067.24",
31-Jul-23,Commission,"18,32,866.50",00.00,"18,34,933.74",
31-Jul-23,Purchase,00.00,"2,29,366.72","16,05,567.02",
31-Jul-23,Cash,00.00,"2,00,695.88","14,04,871.14",
31-Jul-23,Commission,00.00,"4,68,290.38","9,36,580.76",
31-Jul-23,RTGS,"17,34,461.50",00.00,"26,71,042.26",
31-Jul-23,Commission,00.00,"2,67,104.23","24,03,938.03",
31-Jul-23,Bill,"2,882.60",00.00,"24,06,820.63",
31-Jul-23,Cash,00.00,"3,43,831.52","20,62,989.11",
31-Jul-23,Tax,00.00,"2,06,298.91","18,56,690.20",
31-Jul-23,RTGS,269.24,00.00,"18,56,959.44",
31-Jul-23,Interest,"3,394.30",00.00,"18,60,353.74",
31-Jul-23,Cheque,00.00,"2,32,544.22","16,27,809.52",
31-Jul-23,Debit Card,18.39,00.00,"16,27,827.91",
31-Jul-23,Interest,"26,261.80",00.00,"16,54,089.71",
31-Jul-23,Purchase,00.00,"4,13,522.43","12,40,567.28",
31-Jul-23,Cash,00.00,"1,77,223.90","10,63,343.38",
31-Jul-23,Cheque,00.00,"1,77,223.90","8,86,119.48",
31-Jul-23,Cheque,00.00,"1,26,588.50","7,59,530.98",
31-Jul-23,Transportellaneous,00.00,"84,392.33","6,75,138.65",
31-Jul-23,Debit Card,00.00,"1,35,027.73","5,40,110.92",
31-Jul-23,Purchase,00.00,"77,158.70","4,62,952.22",
31-Jul-23,Commission,00.00,"4,62,952.22",00.00,
31-Jul-23,Interest,503.8,00.00,503.8,
31-Jul-23,Tax,"1,023.00",00.00,"1,526.80",
31-Jul-23,Cheque,01.80,00.00,"1,528.60",
31-Jul-23,Tax,00.00,305.72,"1,222.88",
31-Jul-23,Tax,00.00,152.86,"1,070.02",
31-Jul-23,IMPS,238,00.00,"1,308.02",
31-Jul-23,IMPS,496.5,00.00,"1,804.52",
31-Jul-23,Debit Card,00.00,257.79,"1,546.73",
31-Jul-23,Cash,"4,20,553.00",00.00,"4,22,099.73",
31-Jul-23,ATM,"9,956.20",00.00,"4,32,055.93",
31-Jul-23,ATM,444.62,00.00,"4,32,500.55",
31-Jul-23,Cheque,00.00,"61,785.79","3,70,714.76",
31-Jul-23,Bill,00.00,"46,339.35","3,24,375.42",
31-Jul-23,ATM,20.09,00.00,"3,24,395.51",
31-Jul-23,Tax,"4,31,766.00",00.00,"7,56,161.51",
31-Jul-23,Cheque,"3,383.20",00.00,"7,59,544.71",
31-Jul-23,Commission,00.00,"94,943.09","6,64,601.62",
31-Jul-23,Cheque,00.00,"73,844.62","5,90,757.00",
31-Jul-23,Cheque,36.9,00.00,"5,90,793.90",
31-Jul-23,Debit Card,02.00,00.00,"5,90,795.90",
31-Jul-23,Tax,91,00.00,"5,90,886.90",
31-Jul-23,Cash,05.00,00.00,"5,90,891.90",
31-Jul-23,Commission,00.00,"84,413.13","5,06,478.77",
31-Jul-23,Debit Card,00.00,"2,53,239.39","2,53,239.38",
31-Jul-23,Bill,00.00,"31,654.92","2,21,584.46",
31-Jul-23,Bill,17.8,00.00,"2,21,602.26",
31-Jul-23,Tax,00.00,"27,700.28","1,93,901.98",
31-Jul-23,Debit Card,00.00,"24,237.75","1,69,664.23",
31-Jul-23,ATM,389.3,00.00,"1,70,053.53",
31-Jul-23,Cheque,"17,041.00",00.00,"1,87,094.53",
01-Aug-23,IMPS,00.00,"46,773.63","1,40,320.90",
01-Aug-23,ATM,"1,15,142.20",00.00,"2,55,463.10",
02-Aug-23,Tax,"8,83,435.00",00.00,"11,38,898.10",
02-Aug-23,Bill,00.00,"11,38,898.10",00.00,
02-Aug-23,Transfer,54.87,00.00,54.87,
02-Aug-23,RTGS,00.00,18.29,36.58,
03-Aug-23,Purchase,00.00,07.32,29.26,
03-Aug-23,IMPS,00.00,29.26,00.00,
03-Aug-23,Transportellaneous,331,00.00,331,
03-Aug-23,NEFT,39,00.00,370,
03-Aug-23,Cheque,02.63,00.00,372.63,
03-Aug-23,Commission,"39,909.00",00.00,"40,281.63",
03-Aug-23,Tax,456.27,00.00,"40,737.90",
03-Aug-23,Reversal,00.00,"20,368.95","20,368.95",
03-Aug-23,Purchase,00.00,"6,789.65","13,579.30",
03-Aug-23,Commission,00.00,"1,939.90","11,639.40",
03-Aug-23,Interest,"2,50,814.00",00.00,"2,62,453.40",
03-Aug-23,Interest,07.65,00.00,"2,62,461.05",
03-Aug-23,Debit Card,17,00.00,"2,62,478.05",
03-Aug-23,RTGS,"10,87,210.80",00.00,"13,49,688.85",
03-Aug-23,ATM,"29,852.60",00.00,"13,79,541.45",
03-Aug-23,NEFT,"7,72,352.00",00.00,"21,51,893.45",
03-Aug-23,Debit Card,00.00,"2,68,986.68","18,82,906.77",
03-Aug-23,Debit Card,05.72,00.00,"18,82,912.49",
03-Aug-23,Cheque,12.75,00.00,"18,82,925.24",
03-Aug-23,Cheque,"20,73,763.20",00.00,"39,56,688.44",
03-Aug-23,Purchase,00.00,"13,18,896.15","26,37,792.29",
03-Aug-23,Reversal,00.00,"4,39,632.05","21,98,160.24",
03-Aug-23,Bill,00.00,"7,32,720.08","14,65,440.16",
03-Aug-23,Reversal,00.00,"1,46,544.02","13,18,896.14",
04-Aug-23,Purchase,"2,527.20",00.00,"13,21,423.34",
04-Aug-23,RTGS,00.00,"4,40,474.45","8,80,948.89",
04-Aug-23,IMPS,425.5,00.00,"8,81,374.39",
04-Aug-23,NEFT,00.00,"1,76,274.88","7,05,099.51",
04-Aug-23,Debit Card,00.00,"1,00,728.50","6,04,371.01",
04-Aug-23,Tax,47,00.00,"6,04,418.01",
04-Aug-23,Transfer,00.00,"1,00,736.34","5,03,681.68",
04-Aug-23,Debit Card,03.00,00.00,"5,03,684.68",
04-Aug-23,NEFT,00.00,"71,954.95","4,31,729.73",
04-Aug-23,Transfer,00.00,"86,345.95","3,45,383.78",
04-Aug-23,RTGS,310.23,00.00,"3,45,694.01",
04-Aug-23,NEFT,"13,493.70",00.00,"3,59,187.71",
04-Aug-23,Transportellaneous,00.00,"35,918.77","3,23,268.94",
04-Aug-23,Commission,00.00,"32,326.89","2,90,942.05",
04-Aug-23,Reversal,"1,81,461.00",00.00,"4,72,403.05",
04-Aug-23,Interest,"4,936.79",00.00,"4,77,339.84",
04-Aug-23,Cheque,00.00,"2,38,669.92","2,38,669.92",
04-Aug-23,NEFT,00.00,"2,38,669.92",00.00,
05-Aug-23,Cash,53.1,00.00,53.1,
06-Aug-23,Cash,"1,58,101.00",00.00,"1,58,154.10",
06-Aug-23,Cash,"3,789.30",00.00,"1,61,943.40",
06-Aug-23,Cash,00.00,"40,485.85","1,21,457.55",
06-Aug-23,Commission,"1,86,480.00",00.00,"3,07,937.55",
06-Aug-23,Bill,"1,184.00",00.00,"3,09,121.55",
06-Aug-23,Reversal,00.00,"61,824.31","2,47,297.24",
06-Aug-23,Transfer,00.00,"30,912.16","2,16,385.08",
06-Aug-23,Purchase,00.00,"72,128.36","1,44,256.72",
06-Aug-23,IMPS,00.00,"14,425.67","1,29,831.05",
06-Aug-23,Cheque,00.00,"18,547.29","1,11,283.76",
06-Aug-23,Commission,"3,597.10",00.00,"1,14,880.86",
06-Aug-23,Interest,508.93,00.00,"1,15,389.79",
06-Aug-23,Transfer,"3,628.00",00.00,"1,19,017.79",
06-Aug-23,Reversal,88.95,00.00,"1,19,106.74",
06-Aug-23,NEFT,04.00,00.00,"1,19,110.74",
06-Aug-23,IMPS,51,00.00,"1,19,161.74",
06-Aug-23,Commission,00.00,"13,240.19","1,05,921.55",
07-Aug-23,Reversal,03.40,00.00,"1,05,924.95",
08-Aug-23,Tax,00.00,"11,769.44","94,155.51",
08-Aug-23,Reversal,"3,05,324.50",00.00,"3,99,480.01",
08-Aug-23,IMPS,00.00,"99,870.00","2,99,610.01",
08-Aug-23,Tax,00.00,"74,902.50","2,24,707.51",
08-Aug-23,ATM,"11,25,985.80",00.00,"13,50,693.31",
08-Aug-23,Tax,48,00.00,"13,50,741.31",
09-Aug-23,Transportellaneous,391.81,00.00,"13,51,133.12",
09-Aug-23,Commission,00.00,"1,68,891.64","11,82,241.48",
09-Aug-23,Reversal,"10,90,389.00",00.00,"22,72,630.48",
09-Aug-23,Bill,11.06,00.00,"22,72,641.54",
09-Aug-23,IMPS,00.00,"7,57,547.18","15,15,094.36",
09-Aug-23,Reversal,00.00,"15,15,094.36",00.00,
10-Aug-23,RTGS,02.20,00.00,02.20,
10-Aug-23,RTGS,00.00,00.37,01.83,
10-Aug-23,Transfer,00.00,00.18,01.65,
10-Aug-23,IMPS,00.00,00.28,01.38,
10-Aug-23,Bill,02.90,00.00,04.28,
10-Aug-23,Bill,"2,979.92",00.00,"2,984.20",
10-Aug-23,Reversal,"1,42,278.00",00.00,"1,45,262.20",
10-Aug-23,Bill,409,00.00,"1,45,671.20",
10-Aug-23,Interest,03.30,00.00,"1,45,674.50",
10-Aug-23,Debit Card,26.8,00.00,"1,45,701.30",
10-Aug-23,Bill,56.53,00.00,"1,45,757.83",
10-Aug-23,Transportellaneous,"1,69,128.00",00.00,"3,14,885.83",
10-Aug-23,Debit Card,408.8,00.00,"3,15,294.63",
10-Aug-23,Interest,00.00,"45,042.09","2,70,252.54",
10-Aug-23,NEFT,00.00,"67,563.14","2,02,689.40",
10-Aug-23,Transportellaneous,"5,920.00",00.00,"2,08,609.40",
10-Aug-23,Cheque,00.00,"20,860.94","1,87,748.46",
10-Aug-23,Debit Card,00.00,"1,87,748.46",00.00,
10-Aug-23,Bill,23.99,00.00,23.99,
10-Aug-23,Bill,00.00,04.80,19.19,
10-Aug-23,NEFT,03.00,00.00,22.19,
10-Aug-23,NEFT,00.00,05.55,16.64,
10-Aug-23,Reversal,00.00,16.64,00.00,
10-Aug-23,Cash,"2,88,382.00",00.00,"2,88,382.00",
10-Aug-23,Tax,00.00,"28,838.20","2,59,543.80",
10-Aug-23,NEFT,"17,38,335.50",00.00,"19,97,879.30",
10-Aug-23,Transfer,00.00,"3,99,575.86","15,98,303.44",
10-Aug-23,Cash,"2,461.00",00.00,"16,00,764.44",
10-Aug-23,Interest,00.00,"2,66,794.07","13,33,970.37",
11-Aug-23,Purchase,00.00,"1,90,567.20","11,43,403.17",
11-Aug-23,Cash,"8,077.54",00.00,"11,51,480.71",
11-Aug-23,Commission,00.00,"1,27,942.30","10,23,538.41",
11-Aug-23,Cheque,00.00,"10,23,538.41",00.00,
11-Aug-23,Bill,"19,75,285.50",00.00,"19,75,285.50",
11-Aug-23,ATM,00.00,"6,58,428.50","13,16,857.00",
11-Aug-23,Bill,06.00,00.00,"13,16,863.00",
11-Aug-23,Commission,"13,917.00",00.00,"13,30,780.00",
11-Aug-23,NEFT,00.00,"1,66,347.50","11,64,432.50",
12-Aug-23,Commission,56,00.00,"11,64,488.50",
12-Aug-23,Transfer,00.00,"1,66,355.50","9,98,133.00",
12-Aug-23,Cheque,00.00,"1,10,903.67","8,87,229.33",
12-Aug-23,RTGS,"20,481.40",00.00,"9,07,710.73",
12-Aug-23,Tax,00.00,"1,81,542.15","7,26,168.58",
12-Aug-23,Transportellaneous,00.00,"72,616.86","6,53,551.72",
12-Aug-23,Interest,00.00,"1,63,387.93","4,90,163.79",
12-Aug-23,Cash,00.00,"54,462.64","4,35,701.15",
12-Aug-23,IMPS,"16,917.80",00.00,"4,52,618.95",
12-Aug-23,Cash,198.55,00.00,"4,52,817.50",
12-Aug-23,Tax,00.00,"1,50,939.17","3,01,878.33",
13-Aug-23,IMPS,893.32,00.00,"3,02,771.65",
13-Aug-23,IMPS,00.00,"37,846.46","2,64,925.19",
13-Aug-23,Debit Card,00.00,"37,846.46","2,27,078.73",
13-Aug-23,NEFT,00.00,"25,230.97","2,01,847.76",
13-Aug-23,Transfer,00.00,"25,230.97","1,76,616.79",
13-Aug-23,Cash,96.44,00.00,"1,76,713.23",
13-Aug-23,NEFT,00.00,"19,634.80","1,57,078.43",
13-Aug-23,Cheque,00.00,"26,179.74","1,30,898.69",
13-Aug-23,Transfer,00.00,"21,816.45","1,09,082.24",
13-Aug-23,NEFT,01.00,00.00,"1,09,083.24",
13-Aug-23,Cash,"40,512.10",00.00,"1,49,595.34",
13-Aug-23,ATM,00.00,"18,699.42","1,30,895.92",
13-Aug-23,Purchase,00.00,"43,631.97","87,263.95",
13-Aug-23,Interest,00.00,"9,695.99","77,567.96",
13-Aug-23,RTGS,"5,761.00",00.00,"83,328.96",
13-Aug-23,Reversal,11,00.00,"83,339.96",
13-Aug-23,Bill,"1,78,537.69",00.00,"2,61,877.65",
13-Aug-23,Tax,"18,22,301.00",00.00,"20,84,178.65",
13-Aug-23,Cheque,"1,09,318.90",00.00,"21,93,497.55",
13-Aug-23,Commission,110,00.00,"21,93,607.55",
13-Aug-23,Interest,"8,54,152.50",00.00,"30,47,760.05",
13-Aug-23,ATM,00.00,"30,47,760.05",00.00,
13-Aug-23,Transfer,440,00.00,440,
13-Aug-23,Commission,"3,136.00",00.00,"3,576.00",
13-Aug-23,IMPS,00.00,"1,192.00","2,384.00",
13-Aug-23,NEFT,"1,985.50",00.00,"4,369.50",
13-Aug-23,Interest,"9,22,861.00",00.00,"9,27,230.50",
13-Aug-23,NEFT,"1,23,698.10",00.00,"10,50,928.60",
13-Aug-23,Cash,296.1,00.00,"10,51,224.70",
13-Aug-23,Debit Card,"26,533.10",00.00,"10,77,757.80",
13-Aug-23,Transfer,04.36,00.00,"10,77,762.16",
13-Aug-23,Commission,"1,311.80",00.00,"10,79,073.96",
13-Aug-23,Commission,715,00.00,"10,79,788.96",
13-Aug-23,Commission,00.00,"1,34,973.62","9,44,815.34",
13-Aug-23,ATM,04.13,00.00,"9,44,819.47",
13-Aug-23,Cash,00.00,"4,72,409.74","4,72,409.74",
13-Aug-23,Commission,03.10,00.00,"4,72,412.84",
13-Aug-23,Commission,284.6,00.00,"4,72,697.44",
13-Aug-23,Transfer,00.00,"2,36,348.72","2,36,348.72",
13-Aug-23,NEFT,113,00.00,"2,36,461.72",
13-Aug-23,Interest,51,00.00,"2,36,512.72",
13-Aug-23,Cash,00.00,"33,787.53","2,02,725.19",
13-Aug-23,Tax,97,00.00,"2,02,822.19",
13-Aug-23,Cheque,"20,94,493.00",00.00,"22,97,315.19",
14-Aug-23,IMPS,00.00,"3,28,187.88","19,69,127.31",
14-Aug-23,Cheque,07.00,00.00,"19,69,134.31",
15-Aug-23,Interest,"17,60,548.00",00.00,"37,29,682.31",
15-Aug-23,Bill,172.4,00.00,"37,29,854.71",
15-Aug-23,ATM,34.71,00.00,"37,29,889.42",
15-Aug-23,IMPS,00.00,"7,45,977.88","29,83,911.54",
15-Aug-23,RTGS,02.00,00.00,"29,83,913.54",
16-Aug-23,NEFT,00.00,"14,91,956.77","14,91,956.77",
16-Aug-23,Bill,00.00,"2,48,659.46","12,43,297.31",
16-Aug-23,Commission,00.00,"1,38,144.15","11,05,153.16",
16-Aug-23,ATM,00.00,"11,05,153.16",00.00,
16-Aug-23,Bill,"31,028.84",00.00,"31,028.84",
16-Aug-23,Purchase,00.00,"15,514.42","15,514.42",
16-Aug-23,Debit Card,"1,77,107.40",00.00,"1,92,621.82",
16-Aug-23,Debit Card,47.82,00.00,"1,92,669.64",
16-Aug-23,Purchase,00.00,"19,266.96","1,73,402.68",
16-Aug-23,Bill,00.00,"34,680.54","1,38,722.14",
16-Aug-23,NEFT,00.00,"34,680.54","1,04,041.61",
16-Aug-23,Bill,00.00,"20,808.32","83,233.29",
16-Aug-23,NEFT,00.00,"9,248.14","73,985.15",
16-Aug-23,ATM,00.00,"10,569.31","63,415.84",
16-Aug-23,Interest,00.00,"63,415.84",00.00,
16-Aug-23,Bill,495.4,00.00,495.4,
16-Aug-23,RTGS,"2,46,093.84",00.00,"2,46,589.24",
16-Aug-23,Cash,00.00,"27,398.80","2,19,190.44",
16-Aug-23,Commission,00.00,"24,354.49","1,94,835.95",
16-Aug-23,Cash,"28,220.09",00.00,"2,23,056.04",
16-Aug-23,Transportellaneous,00.00,"1,11,528.02","1,11,528.02",
16-Aug-23,Cheque,00.00,"55,764.01","55,764.01",
16-Aug-23,ATM,"2,853.70",00.00,"58,617.71",
16-Aug-23,Transportellaneous,00.00,"11,723.54","46,894.17",
16-Aug-23,Transportellaneous,480.7,00.00,"47,374.87",
16-Aug-23,Bill,318.6,00.00,"47,693.47",
16-Aug-23,ATM,00.00,"23,846.74","23,846.74",
16-Aug-23,IMPS,"12,12,924.00",00.00,"12,36,770.74",
16-Aug-23,Transfer,20.9,00.00,"12,36,791.64",
16-Aug-23,ATM,02.00,00.00,"12,36,793.64",
16-Aug-23,Commission,389.6,00.00,"12,37,183.24",
16-Aug-23,RTGS,"1,661.00",00.00,"12,38,844.24",
16-Aug-23,Cheque,00.00,"12,38,844.24",00.00,
16-Aug-23,Tax,"31,140.88",00.00,"31,140.88",
16-Aug-23,IMPS,"18,61,776.00",00.00,"18,92,916.88",
16-Aug-23,Cash,"3,981.70",00.00,"18,96,898.58",
16-Aug-23,NEFT,00.00,"9,48,449.29","9,48,449.29",
17-Aug-23,Interest,05.00,00.00,"9,48,454.29",
17-Aug-23,Cheque,00.00,"1,18,556.79","8,29,897.50",
17-Aug-23,Reversal,00.00,"1,18,556.79","7,11,340.71",
17-Aug-23,NEFT,"17,687.00",00.00,"7,29,027.71",
17-Aug-23,Bill,09.68,00.00,"7,29,037.39",
17-Aug-23,RTGS,02.90,00.00,"7,29,040.29",
17-Aug-23,Commission,364,00.00,"7,29,404.29",
17-Aug-23,Commission,31.2,00.00,"7,29,435.49",
17-Aug-23,Cash,"1,346.00",00.00,"7,30,781.49",
17-Aug-23,Transportellaneous,00.00,"1,21,796.92","6,08,984.57",
17-Aug-23,Transportellaneous,"1,86,746.40",00.00,"7,95,730.97",
18-Aug-23,Debit Card,00.00,"7,95,730.97",00.00,
18-Aug-23,Tax,"2,17,676.60",00.00,"2,17,676.60",
18-Aug-23,Cheque,07.32,00.00,"2,17,683.92",
18-Aug-23,Debit Card,"2,913.00",00.00,"2,20,596.92",
18-Aug-23,Commission,04.70,00.00,"2,20,601.62",
18-Aug-23,Reversal,31.3,00.00,"2,20,632.92",
18-Aug-23,Cash,03.80,00.00,"2,20,636.72",
18-Aug-23,Reversal,00.00,"27,579.59","1,93,057.13",
18-Aug-23,Tax,00.00,"48,264.28","1,44,792.85",
18-Aug-23,Cheque,"17,68,634.50",00.00,"19,13,427.35",
18-Aug-23,Commission,"3,86,498.20",00.00,"22,99,925.55",
18-Aug-23,Transportellaneous,00.00,"11,49,962.78","11,49,962.77",
19-Aug-23,Commission,"3,618.19",00.00,"11,53,580.96",
19-Aug-23,NEFT,00.00,"1,64,797.28","9,88,783.68",
19-Aug-23,Reversal,"11,86,597.25",00.00,"21,75,380.93",
19-Aug-23,Reversal,"14,071.00",00.00,"21,89,451.93",
19-Aug-23,Reversal,"11,65,202.80",00.00,"33,54,654.73",
19-Aug-23,Tax,00.00,"11,18,218.24","22,36,436.49",
19-Aug-23,Bill,00.00,00.00,"22,36,436.49",
19-Aug-23,IMPS,03.38,00.00,"22,36,439.87",
19-Aug-23,Purchase,00.00,"22,36,439.87",00.00,
19-Aug-23,Commission,"10,13,099.50",00.00,"10,13,099.50",
19-Aug-23,Commission,04.70,00.00,"10,13,104.20",
19-Aug-23,Tax,00.00,"1,01,310.42","9,11,793.78",
20-Aug-23,ATM,00.00,"91,179.38","8,20,614.40",
20-Aug-23,IMPS,04.30,00.00,"8,20,618.70",
20-Aug-23,Tax,00.00,"1,17,231.24","7,03,387.46",
20-Aug-23,Purchase,"7,153.00",00.00,"7,10,540.46",
20-Aug-23,Debit Card,"3,572.00",00.00,"7,14,112.46",
20-Aug-23,Cheque,00.00,"7,14,112.46",00.00,
20-Aug-23,Cheque,57,00.00,57,
20-Aug-23,Debit Card,00.00,09.50,47.5,
20-Aug-23,NEFT,00.00,23.75,23.75,
20-Aug-23,Debit Card,"6,219.00",00.00,"6,242.75",
20-Aug-23,Cash,00.00,"1,248.55","4,994.20",
20-Aug-23,Transportellaneous,03.59,00.00,"4,997.79",
20-Aug-23,Tax,00.00,"2,498.90","2,498.90",
20-Aug-23,Commission,00.00,499.78,"1,999.12",
20-Aug-23,Commission,"1,937.30",00.00,"3,936.42",
20-Aug-23,NEFT,00.00,562.35,"3,374.07",
20-Aug-23,Transportellaneous,00.00,337.41,"3,036.66",
20-Aug-23,Tax,00.00,"3,036.66",00.00,
20-Aug-23,Tax,58.08,00.00,58.08,
20-Aug-23,Cash,"73,845.50",00.00,"73,903.58",
20-Aug-23,Commission,00.00,"9,237.95","64,665.63",
20-Aug-23,Debit Card,"7,51,789.50",00.00,"8,16,455.13",
20-Aug-23,NEFT,04.90,00.00,"8,16,460.03",
20-Aug-23,RTGS,00.00,"2,72,153.34","5,44,306.69",
20-Aug-23,RTGS,00.00,"1,08,861.34","4,35,445.35",
20-Aug-23,Cash,"11,688.00",00.00,"4,47,133.35",
20-Aug-23,NEFT,30,00.00,"4,47,163.35",
20-Aug-23,Commission,00.00,"2,23,581.68","2,23,581.68",
20-Aug-23,ATM,33.29,00.00,"2,23,614.97",
20-Aug-23,IMPS,00.00,"55,903.74","1,67,711.23",
20-Aug-23,Transfer,00.00,"18,634.58","1,49,076.65",
21-Aug-23,IMPS,"10,065.20",00.00,"1,59,141.85",
21-Aug-23,Cheque,00.00,00.00,"1,59,141.85",
21-Aug-23,Cash,00.00,"39,785.46","1,19,356.39",
21-Aug-23,Cash,00.00,"11,935.64","1,07,420.75",
21-Aug-23,Cash,00.00,"15,345.82","92,074.93",
21-Aug-23,Transportellaneous,27.1,00.00,"92,102.03",
21-Aug-23,Transportellaneous,00.00,"18,420.41","73,681.62",
21-Aug-23,Transportellaneous,"27,234.14",00.00,"1,00,915.76",
21-Aug-23,Commission,343.8,00.00,"1,01,259.56",
21-Aug-23,RTGS,00.00,"1,01,259.56",00.00,
21-Aug-23,Commission,"2,621.50",00.00,"2,621.50",
21-Aug-23,Bill,434.02,00.00,"3,055.52",
21-Aug-23,Tax,07.00,00.00,"3,062.52",
21-Aug-23,NEFT,00.00,437.5,"2,625.02",
21-Aug-23,Tax,00.00,262.5,"2,362.52",
21-Aug-23,Cheque,44,00.00,"2,406.52",
21-Aug-23,Reversal,00.00,"1,203.26","1,203.26",
21-Aug-23,Bill,00.00,171.89,"1,031.37",
22-Aug-23,Transportellaneous,"2,52,266.50",00.00,"2,53,297.87",
22-Aug-23,Purchase,13,00.00,"2,53,310.87",
22-Aug-23,Cash,00.00,"31,663.86","2,21,647.01",
22-Aug-23,Interest,"22,922.00",00.00,"2,44,569.01",
22-Aug-23,Tax,107,00.00,"2,44,676.01",
22-Aug-23,Interest,"21,081.33",00.00,"2,65,757.34",
22-Aug-23,Transportellaneous,00.00,"88,585.78","1,77,171.56",
22-Aug-23,Purchase,"19,263.00",00.00,"1,96,434.56",
22-Aug-23,Bill,"28,953.00",00.00,"2,25,387.56",
22-Aug-23,Cheque,"2,634.00",00.00,"2,28,021.56",
22-Aug-23,RTGS,00.00,"25,335.73","2,02,685.83",
22-Aug-23,Transfer,00.00,"67,561.94","1,35,123.89",
22-Aug-23,ATM,22,00.00,"1,35,145.89",
22-Aug-23,Purchase,00.00,"45,048.63","90,097.26",
22-Aug-23,Bill,00.00,"15,016.21","75,081.05",
23-Aug-23,Tax,00.00,"18,770.26","56,310.79",
23-Aug-23,Bill,00.00,"18,770.26","37,540.53",
23-Aug-23,Purchase,382.12,00.00,"37,922.65",
23-Aug-23,ATM,"2,18,814.00",00.00,"2,56,736.65",
23-Aug-23,Debit Card,00.00,"1,28,368.33","1,28,368.32",
23-Aug-23,Commission,"13,531.00",00.00,"1,41,899.32",
23-Aug-23,NEFT,00.00,"70,949.66","70,949.66",
23-Aug-23,Interest,13.48,00.00,"70,963.14",
24-Aug-23,Bill,00.00,"11,827.19","59,135.95",
24-Aug-23,ATM,"19,52,620.50",00.00,"20,11,756.45",
24-Aug-23,IMPS,00.00,"2,51,469.56","17,60,286.89",
24-Aug-23,Transfer,00.00,"2,93,381.15","14,66,905.74",
24-Aug-23,Cash,00.00,"1,83,363.22","12,83,542.52",
24-Aug-23,NEFT,"2,245.89",00.00,"12,85,788.41",
24-Aug-23,Cheque,04.00,00.00,"12,85,792.41",
24-Aug-23,RTGS,00.00,"1,42,865.82","11,42,926.59",
24-Aug-23,IMPS,"19,63,028.75",00.00,"31,05,955.34",
24-Aug-23,Interest,"1,77,272.00",00.00,"32,83,227.34",
24-Aug-23,Debit Card,00.00,"10,94,409.11","21,88,818.23",
24-Aug-23,Tax,18,00.00,"21,88,836.23",
24-Aug-23,IMPS,"9,61,959.80",00.00,"31,50,796.03",
24-Aug-23,Bill,00.00,"3,15,079.60","28,35,716.43",
24-Aug-23,Debit Card,26.62,00.00,"28,35,743.05",
24-Aug-23,Cheque,00.00,"9,45,247.68","18,90,495.37",
24-Aug-23,Reversal,38.1,00.00,"18,90,533.47",
24-Aug-23,Transportellaneous,00.00,"2,70,076.21","16,20,457.26",
24-Aug-23,Reversal,00.00,"2,70,076.21","13,50,381.05",
24-Aug-23,ATM,"7,30,834.00",00.00,"20,81,215.05",
24-Aug-23,Bill,"30,362.71",00.00,"21,11,577.76",
24-Aug-23,Debit Card,00.00,"7,03,859.25","14,07,718.51",
24-Aug-23,Debit Card,00.00,"2,34,619.75","11,73,098.76",
24-Aug-23,ATM,194.2,00.00,"11,73,292.96",
24-Aug-23,Interest,00.00,"1,30,365.88","10,42,927.08",
24-Aug-23,Interest,70,00.00,"10,42,997.08",
24-Aug-23,Commission,00.00,"1,30,374.64","9,12,622.44",
24-Aug-23,Tax,00.00,"1,82,524.49","7,30,097.95",
24-Aug-23,IMPS,00.00,"3,65,048.98","3,65,048.98",
24-Aug-23,Cash,"1,57,761.19",00.00,"5,22,810.17",
24-Aug-23,Reversal,00.00,"87,135.03","4,35,675.14",
24-Aug-23,Interest,00.00,"62,239.31","3,73,435.83",
24-Aug-23,Cash,"9,851.61",00.00,"3,83,287.44",
24-Aug-23,ATM,"17,04,900.50",00.00,"20,88,187.94",
24-Aug-23,Cash,00.00,"10,44,093.97","10,44,093.97",
24-Aug-23,Interest,00.00,"2,08,818.79","8,35,275.18",
24-Aug-23,Interest,00.00,"2,78,425.06","5,56,850.12",
24-Aug-23,ATM,00.00,"2,78,425.06","2,78,425.06",
24-Aug-23,Cash,"11,02,175.25",00.00,"13,80,600.31",
24-Aug-23,Interest,00.00,"2,30,100.05","11,50,500.26",
24-Aug-23,Reversal,"3,049.00",00.00,"11,53,549.26",
24-Aug-23,Reversal,"2,091.00",00.00,"11,55,640.26",
24-Aug-23,NEFT,29,00.00,"11,55,669.26",
24-Aug-23,Cheque,00.00,"1,65,095.61","9,90,573.65",
24-Aug-23,IMPS,"25,731.00",00.00,"10,16,304.65",
24-Aug-23,Bill,00.00,"3,38,768.22","6,77,536.43",
24-Aug-23,Cheque,"1,77,713.00",00.00,"8,55,249.43",
24-Aug-23,Bill,"2,12,643.90",00.00,"10,67,893.33",
24-Aug-23,NEFT,16.94,00.00,"10,67,910.27",
24-Aug-23,NEFT,03.00,00.00,"10,67,913.27",
24-Aug-23,Cash,"11,77,992.25",00.00,"22,45,905.52",
24-Aug-23,Bill,00.00,"5,61,476.38","16,84,429.14",
24-Aug-23,Reversal,03.10,00.00,"16,84,432.24",
24-Aug-23,Commission,00.00,"1,87,159.14","14,97,273.10",
24-Aug-23,RTGS,00.00,"2,49,545.52","12,47,727.58",
25-Aug-23,Transportellaneous,00.00,"2,07,954.60","10,39,772.98",
25-Aug-23,Transportellaneous,95,00.00,"10,39,867.98",
25-Aug-23,RTGS,00.00,"1,48,552.57","8,91,315.41",
25-Aug-23,Transfer,"19,669.72",00.00,"9,10,985.13",
25-Aug-23,Bill,02.00,00.00,"9,10,987.13",
25-Aug-23,Cash,00.00,"9,10,987.13",00.00,
25-Aug-23,RTGS,"16,52,066.00",00.00,"16,52,066.00",
25-Aug-23,Cash,07.00,00.00,"16,52,073.00",
25-Aug-23,Purchase,00.77,00.00,"16,52,073.77",
25-Aug-23,Bill,"2,668.00",00.00,"16,54,741.77",
25-Aug-23,Purchase,00.00,"16,54,741.77",00.00,
25-Aug-23,Purchase,08.00,00.00,08.00,
25-Aug-23,Bill,00.00,02.67,05.33,
25-Aug-23,Cheque,00.00,00.59,04.74,
25-Aug-23,IMPS,22,00.00,26.74,
25-Aug-23,Transportellaneous,00.00,03.82,22.92,
25-Aug-23,Purchase,00.00,02.29,20.63,
25-Aug-23,Transfer,00.00,02.58,18.05,
25-Aug-23,Transportellaneous,"7,82,450.00",00.00,"7,82,468.05",
25-Aug-23,Tax,00.00,"2,60,822.68","5,21,645.37",
25-Aug-23,NEFT,00.00,"86,940.90","4,34,704.48",
25-Aug-23,Purchase,"14,063.37",00.00,"4,48,767.85",
25-Aug-23,Cash,"20,74,126.00",00.00,"25,22,893.85",
25-Aug-23,Cash,00.00,"12,61,446.93","12,61,446.92",
25-Aug-23,IMPS,424.4,00.00,"12,61,871.32",
25-Aug-23,Cash,00.00,"3,15,467.83","9,46,403.49",
25-Aug-23,IMPS,00.00,"1,18,300.44","8,28,103.05",
25-Aug-23,IMPS,"8,29,472.00",00.00,"16,57,575.05",
25-Aug-23,Purchase,00.00,"2,36,796.44","14,20,778.61",
25-Aug-23,RTGS,"92,444.00",00.00,"15,13,222.61",
25-Aug-23,Cheque,03.64,00.00,"15,13,226.25",
25-Aug-23,IMPS,00.00,"1,51,322.63","13,61,903.62",
25-Aug-23,RTGS,00.00,"1,51,322.62","12,10,581.00",
25-Aug-23,ATM,00.00,"6,05,290.50","6,05,290.50",
25-Aug-23,Bill,"18,002.00",00.00,"6,23,292.50",
25-Aug-23,Commission,00.00,"1,03,882.08","5,19,410.42",
25-Aug-23,Interest,"22,648.00",00.00,"5,42,058.42",
25-Aug-23,Transportellaneous,00.00,"77,436.92","4,64,621.50",
25-Aug-23,Commission,00.00,"58,077.69","4,06,543.81",
25-Aug-23,Tax,00.00,"50,817.98","3,55,725.83",
25-Aug-23,Commission,"92,892.00",00.00,"4,48,617.83",
25-Aug-23,Reversal,00.00,"64,088.26","3,84,529.57",
25-Aug-23,Transportellaneous,178.78,00.00,"3,84,708.35",
25-Aug-23,RTGS,"4,031.20",00.00,"3,88,739.55",
25-Aug-23,IMPS,00.00,"48,592.44","3,40,147.11",
25-Aug-23,ATM,00.00,"85,036.78","2,55,110.33",
25-Aug-23,Cash,00.00,"2,55,110.33",00.00,
25-Aug-23,Cash,05.00,00.00,05.00,
25-Aug-23,Purchase,00.00,00.56,04.44,
25-Aug-23,RTGS,00.00,00.56,03.88,
25-Aug-23,Commission,00.00,03.88,00.00,
25-Aug-23,Transfer,"1,869.00",00.00,"1,869.00",
25-Aug-23,Transfer,"28,047.56",00.00,"29,916.56",
25-Aug-23,Tax,575.5,00.00,"30,492.06",
25-Aug-23,Reversal,00.00,"3,388.01","27,104.05",
25-Aug-23,Commission,00.00,"3,872.01","23,232.04",
25-Aug-23,Transportellaneous,00.00,"23,232.04",00.00,
25-Aug-23,Cheque,"19,201.00",00.00,"19,201.00",
25-Aug-23,Commission,00.00,"2,743.00","16,458.00",
26-Aug-23,RTGS,00.00,"1,828.67","14,629.33",
26-Aug-23,Interest,455.2,00.00,"15,084.53",
26-Aug-23,ATM,00.00,"2,514.09","12,570.44",
26-Aug-23,Bill,00.00,"1,396.72","11,173.72",
26-Aug-23,Purchase,00.00,"1,862.29","9,311.43",
26-Aug-23,Bill,00.00,"9,311.43",00.00,
26-Aug-23,Cheque,"8,05,992.80",00.00,"8,05,992.80",
26-Aug-23,Reversal,"1,60,094.81",00.00,"9,66,087.61",
26-Aug-23,Transportellaneous,"49,619.80",00.00,"10,15,707.41",
26-Aug-23,Commission,"1,925.00",00.00,"10,17,632.41",
26-Aug-23,Commission,"13,22,875.80",00.00,"23,40,508.21",
26-Aug-23,Cheque,09.70,00.00,"23,40,517.91",
26-Aug-23,Cash,"5,264.16",00.00,"23,45,782.07",
26-Aug-23,Cash,"3,28,891.00",00.00,"26,74,673.07",
26-Aug-23,Debit Card,"15,75,727.00",00.00,"42,50,400.07",
26-Aug-23,ATM,00.00,"7,08,400.01","35,42,000.06",
26-Aug-23,Transportellaneous,00.00,"3,54,200.01","31,87,800.05",
26-Aug-23,Tax,33,00.00,"31,87,833.05",
26-Aug-23,Interest,"2,102.00",00.00,"31,89,935.05",
26-Aug-23,Cheque,"2,29,924.90",00.00,"34,19,859.95",
26-Aug-23,RTGS,00.00,"34,19,859.95",00.00,
26-Aug-23,RTGS,472,00.00,472,
26-Aug-23,Cheque,"16,754.00",00.00,"17,226.00",
26-Aug-23,Debit Card,"6,004.54",00.00,"23,230.54",
26-Aug-23,Debit Card,51.36,00.00,"23,281.90",
27-Aug-23,Transfer,00.00,"11,640.95","11,640.95",
27-Aug-23,RTGS,42.8,00.00,"11,683.75",
27-Aug-23,Tax,34.35,00.00,"11,718.10",
27-Aug-23,Cheque,"29,465.20",00.00,"41,183.30",
27-Aug-23,Debit Card,08.00,00.00,"41,191.30",
27-Aug-23,Cheque,00.00,"5,148.91","36,042.39",
27-Aug-23,RTGS,48.34,00.00,"36,090.73",
27-Aug-23,Purchase,04.00,00.00,"36,094.73",
27-Aug-23,Transportellaneous,00.00,"3,609.47","32,485.26",
27-Aug-23,Commission,"3,270.00",00.00,"35,755.26",
27-Aug-23,ATM,"18,03,988.00",00.00,"18,39,743.26",
27-Aug-23,Interest,"2,04,531.25",00.00,"20,44,274.51",
27-Aug-23,Cheque,00.00,"2,27,141.61","18,17,132.90",
27-Aug-23,RTGS,00.00,"2,27,141.61","15,89,991.29",
27-Aug-23,Transfer,00.00,"2,64,998.55","13,24,992.74",
27-Aug-23,NEFT,00.00,"3,31,248.19","9,93,744.56",
27-Aug-23,Purchase,00.00,"2,48,436.14","7,45,308.42",
27-Aug-23,Interest,"17,81,395.80",00.00,"25,26,704.22",
27-Aug-23,Cheque,00.00,"2,80,744.91","22,45,959.31",
27-Aug-23,IMPS,"13,128.40",00.00,"22,59,087.71",
27-Aug-23,Transfer,129.66,00.00,"22,59,217.37",
27-Aug-23,Transfer,575.64,00.00,"22,59,793.01",
27-Aug-23,Transfer,"8,148.57",00.00,"22,67,941.58",
27-Aug-23,Commission,00.00,"3,23,991.65","19,43,949.93",
27-Aug-23,IMPS,"15,330.00",00.00,"19,59,279.93",
27-Aug-23,Purchase,00.00,"19,59,279.93",00.00,
27-Aug-23,ATM,05.40,00.00,05.40,
27-Aug-23,Transfer,"17,20,255.00",00.00,"17,20,260.40",
27-Aug-23,Debit Card,00.00,"17,20,260.40",00.00,
27-Aug-23,RTGS,"1,87,218.00",00.00,"1,87,218.00",
27-Aug-23,Commission,"20,669.91",00.00,"2,07,887.91",
27-Aug-23,Commission,00.00,"2,07,887.91",00.00,
27-Aug-23,Debit Card,23,00.00,23,
27-Aug-23,Interest,00.00,02.88,20.12,
27-Aug-23,Bill,55.6,00.00,75.72,
27-Aug-23,Transportellaneous,00.00,10.82,64.9,
27-Aug-23,Commission,00.00,07.21,57.69,
27-Aug-23,Transfer,00.00,09.62,48.08,
27-Aug-23,Cheque,00.00,05.34,42.74,
27-Aug-23,NEFT,00.00,10.69,32.06,
27-Aug-23,Commission,00.00,06.41,25.65,
27-Aug-23,Transfer,06.20,00.00,31.85,
27-Aug-23,Purchase,09.80,00.00,41.65,
27-Aug-23,Interest,00.00,10.41,31.24,
27-Aug-23,Bill,00.00,03.12,28.12,
27-Aug-23,Cheque,08.00,00.00,36.12,
27-Aug-23,Commission,00.00,18.06,18.06,
27-Aug-23,Cash,"18,04,238.25",00.00,"18,04,256.31",
27-Aug-23,Tax,00.00,"3,60,851.26","14,43,405.05",
27-Aug-23,RTGS,00.67,00.00,"14,43,405.72",
27-Aug-23,Bill,00.00,"2,40,567.62","12,02,838.10",
28-Aug-23,IMPS,330.5,00.00,"12,03,168.60",
28-Aug-23,Cash,00.00,"3,00,792.15","9,02,376.45",
28-Aug-23,ATM,"2,318.00",00.00,"9,04,694.45",
28-Aug-23,Debit Card,00.00,"2,26,173.61","6,78,520.84",
28-Aug-23,Tax,"2,16,774.53",00.00,"8,95,295.37",
28-Aug-23,ATM,"6,43,958.00",00.00,"15,39,253.37",
28-Aug-23,IMPS,00.00,"2,19,893.34","13,19,360.03",
28-Aug-23,Purchase,"3,12,279.50",00.00,"16,31,639.53",
28-Aug-23,Tax,"2,655.70",00.00,"16,34,295.23",
28-Aug-23,NEFT,"27,904.50",00.00,"16,62,199.73",
28-Aug-23,Cash,01.00,00.00,"16,62,200.73",
28-Aug-23,Cash,00.00,"8,31,100.37","8,31,100.36",
28-Aug-23,Interest,00.00,"83,110.04","7,47,990.32",
28-Aug-23,Cheque,00.00,"3,73,995.16","3,73,995.16",
28-Aug-23,Debit Card,00.00,"1,86,997.58","1,86,997.58",
28-Aug-23,Cash,00.00,"31,166.26","1,55,831.32",
28-Aug-23,Debit Card,"1,51,087.70",00.00,"3,06,919.02",
28-Aug-23,Bill,45.9,00.00,"3,06,964.92",
28-Aug-23,Interest,00.00,"38,370.62","2,68,594.30",
28-Aug-23,Cash,"1,61,173.06",00.00,"4,29,767.36",
28-Aug-23,RTGS,31,00.00,"4,29,798.36",
28-Aug-23,NEFT,150.49,00.00,"4,29,948.85",
28-Aug-23,Bill,"69,031.70",00.00,"4,98,980.55",
28-Aug-23,RTGS,00.00,"83,163.43","4,15,817.12",
28-Aug-23,NEFT,00.00,"41,581.71","3,74,235.41",
28-Aug-23,Transfer,00.00,"1,87,117.71","1,87,117.70",
28-Aug-23,Bill,00.00,"23,389.71","1,63,727.99",
28-Aug-23,Transfer,879,00.00,"1,64,606.99",
29-Aug-23,NEFT,00.00,"41,151.75","1,23,455.24",
30-Aug-23,Cheque,00.00,"20,575.87","1,02,879.37",
30-Aug-23,Interest,"28,307.06",00.00,"1,31,186.43",
30-Aug-23,IMPS,00.00,"13,118.64","1,18,067.79",
30-Aug-23,Transportellaneous,00.00,"19,677.97","98,389.82",
30-Aug-23,NEFT,00.00,"24,597.46","73,792.37",
30-Aug-23,Bill,"3,183.70",00.00,"76,976.07",
30-Aug-23,IMPS,"1,34,075.00",00.00,"2,11,051.07",
30-Aug-23,Cash,00.00,"1,05,525.54","1,05,525.54",
30-Aug-23,Reversal,00.00,"13,190.69","92,334.85",
30-Aug-23,Reversal,"3,76,522.00",00.00,"4,68,856.85",
30-Aug-23,Interest,"1,29,327.50",00.00,"5,98,184.35",
30-Aug-23,ATM,142,00.00,"5,98,326.35",
30-Aug-23,Bill,"43,007.12",00.00,"6,41,333.47",
30-Aug-23,Interest,"2,215.40",00.00,"6,43,548.87",
30-Aug-23,Reversal,00.00,"1,60,887.22","4,82,661.65",
30-Aug-23,Bill,00.00,"1,60,887.22","3,21,774.43",
30-Aug-23,Purchase,86,00.00,"3,21,860.43",
30-Aug-23,RTGS,05.30,00.00,"3,21,865.73",
30-Aug-23,Commission,00.00,"80,466.43","2,41,399.30",
30-Aug-23,Cash,00.00,"40,233.22","2,01,166.08",
30-Aug-23,IMPS,"1,852.10",00.00,"2,03,018.18",
30-Aug-23,Transfer,00.00,"1,01,509.09","1,01,509.09",
30-Aug-23,ATM,00.00,"11,278.79","90,230.30",
30-Aug-23,Reversal,00.00,"22,557.58","67,672.73",
30-Aug-23,Transportellaneous,495.36,00.00,"68,168.09",
30-Aug-23,NEFT,00.00,"68,168.09",00.00,
30-Aug-23,Tax,"1,74,427.40",00.00,"1,74,427.40",
30-Aug-23,Cheque,00.00,"21,803.43","1,52,623.98",
30-Aug-23,Transfer,00.00,"50,874.66","1,01,749.32",
30-Aug-23,Reversal,"31,635.00",00.00,"1,33,384.32",
30-Aug-23,IMPS,199.27,00.00,"1,33,583.59",
30-Aug-23,Cash,"12,86,398.25",00.00,"14,19,981.84",
30-Aug-23,IMPS,00.00,"3,54,995.46","10,64,986.38",
30-Aug-23,IMPS,"41,851.47",00.00,"11,06,837.85",
30-Aug-23,Cheque,06.70,00.00,"11,06,844.55",
30-Aug-23,Cheque,"23,851.50",00.00,"11,30,696.05",
30-Aug-23,RTGS,00.00,"1,25,632.89","10,05,063.16",
30-Aug-23,Transportellaneous,34,00.00,"10,05,097.16",
30-Aug-23,IMPS,"11,09,548.50",00.00,"21,14,645.66",
30-Aug-23,Tax,"1,34,252.53",00.00,"22,48,898.19",
30-Aug-23,ATM,00.00,"3,21,271.17","19,27,627.02",
30-Aug-23,Reversal,02.60,00.00,"19,27,629.62",
30-Aug-23,Tax,"3,33,447.50",00.00,"22,61,077.12",
30-Aug-23,RTGS,00.00,"4,52,215.42","18,08,861.70",
30-Aug-23,Transportellaneous,"1,85,594.12",00.00,"19,94,455.82",
30-Aug-23,Cheque,00.00,"2,84,922.26","17,09,533.56",
30-Aug-23,Interest,09.00,00.00,"17,09,542.56",
30-Aug-23,NEFT,41,00.00,"17,09,583.56",
30-Aug-23,IMPS,"10,160.44",00.00,"17,19,744.00",
30-Aug-23,RTGS,00.00,"1,71,974.40","15,47,769.60",
30-Aug-23,Purchase,49.63,00.00,"15,47,819.23",
30-Aug-23,Bill,108,00.00,"15,47,927.23",
30-Aug-23,Tax,00.00,"1,93,490.90","13,54,436.33",
30-Aug-23,Purchase,"1,20,339.34",00.00,"14,74,775.67",
30-Aug-23,ATM,"88,491.00",00.00,"15,63,266.67",
30-Aug-23,NEFT,"18,69,744.25",00.00,"34,33,010.92",
30-Aug-23,Bill,00.00,"4,29,126.37","30,03,884.56",
30-Aug-23,Commission,00.00,"3,75,485.57","26,28,398.99",
30-Aug-23,Transportellaneous,197.76,00.00,"26,28,596.75",
30-Aug-23,Transportellaneous,00.00,"5,25,719.35","21,02,877.40",
30-Aug-23,IMPS,"19,42,205.00",00.00,"40,45,082.40",
30-Aug-23,Purchase,951.44,00.00,"40,46,033.84",
30-Aug-23,Purchase,29.9,00.00,"40,46,063.74",
30-Aug-23,Interest,202.6,00.00,"40,46,266.34",
30-Aug-23,NEFT,04.10,00.00,"40,46,270.44",
30-Aug-23,Transportellaneous,"21,228.00",00.00,"40,67,498.44",
30-Aug-23,RTGS,00.47,00.00,"40,67,498.91",
30-Aug-23,RTGS,00.00,"40,67,498.91",00.00,
30-Aug-23,Interest,296.12,00.00,296.12,
30-Aug-23,Reversal,00.00,49.35,246.77,
30-Aug-23,Transfer,00.00,123.39,123.38,
30-Aug-23,NEFT,00.00,20.56,102.82,
30-Aug-23,Transportellaneous,41.66,00.00,144.48,
30-Aug-23,Debit Card,00.00,16.05,128.43,
30-Aug-23,Transportellaneous,00.00,64.22,64.22,
30-Aug-23,Debit Card,00.00,06.42,57.8,
30-Aug-23,Transportellaneous,119,00.00,176.8,
30-Aug-23,IMPS,16.77,00.00,193.57,
31-Aug-23,Transportellaneous,13,00.00,206.57,
31-Aug-23,RTGS,495,00.00,701.57,
31-Aug-23,Debit Card,02.21,00.00,703.78,
31-Aug-23,Transportellaneous,00.00,78.2,625.58,
31-Aug-23,IMPS,00.00,125.12,500.46,
31-Aug-23,IMPS,"1,583.14",00.00,"2,083.60",
31-Aug-23,Cash,00.00,297.66,"1,785.94",
31-Aug-23,Cheque,00.00,357.19,"1,428.75",
31-Aug-23,Cheque,"3,164.80",00.00,"4,593.55",
31-Aug-23,NEFT,285,00.00,"4,878.55",
31-Aug-23,Transfer,00.00,542.06,"4,336.49",
31-Aug-23,Transfer,"8,114.09",00.00,"12,450.58",
31-Aug-23,Transfer,"1,707.00",00.00,"14,157.58",
31-Aug-23,Bill,"2,37,853.41",00.00,"2,52,010.99",
31-Aug-23,Interest,"3,987.29",00.00,"2,55,998.28",
31-Aug-23,RTGS,00.00,"63,999.57","1,91,998.71",
31-Aug-23,IMPS,"52,000.81",00.00,"2,43,999.52",
31-Aug-23,Transportellaneous,00.00,"48,799.90","1,95,199.62",
31-Aug-23,Tax,00.00,"19,519.96","1,75,679.66",
31-Aug-23,Cash,00.00,"1,75,679.66",00.00,
31-Aug-23,Cash,87.01,00.00,87.01,
31-Aug-23,Commission,"5,60,657.00",00.00,"5,60,744.01",
31-Aug-23,Tax,00.00,"1,40,186.00","4,20,558.01",
31-Aug-23,ATM,321.7,00.00,"4,20,879.71",
31-Aug-23,Transportellaneous,00.00,"4,20,879.71",00.00,
31-Aug-23,Transportellaneous,15,00.00,15,
31-Aug-23,Interest,"17,723.34",00.00,"17,738.34",
31-Aug-23,Cash,"2,109.00",00.00,"19,847.34",
31-Aug-23,RTGS,"29,732.90",00.00,"49,580.24",
31-Aug-23,Transportellaneous,"10,02,935.20",00.00,"10,52,515.44",
31-Aug-23,RTGS,00.00,"2,10,503.09","8,42,012.35",
31-Aug-23,Debit Card,00.70,00.00,"8,42,013.05",
31-Aug-23,Debit Card,00.00,"2,80,671.02","5,61,342.03",
31-Aug-23,Reversal,00.00,"56,134.20","5,05,207.83",
31-Aug-23,Commission,"2,14,457.50",00.00,"7,19,665.33",
31-Aug-23,Purchase,26,00.00,"7,19,691.33",
31-Aug-23,Cheque,00.88,00.00,"7,19,692.21",
31-Aug-23,Cash,51.3,00.00,"7,19,743.51",
31-Aug-23,IMPS,00.43,00.00,"7,19,743.94",
31-Aug-23,Cash,00.00,"89,967.99","6,29,775.95",
31-Aug-23,Interest,00.00,"62,977.60","5,66,798.36",
31-Aug-23,Interest,00.00,"5,66,798.36",00.00,
31-Aug-23,Transportellaneous,"3,73,570.00",00.00,"3,73,570.00",
01-Sep-23,Purchase,"8,262.46",00.00,"3,81,832.46",
01-Sep-23,Bill,00.00,"63,638.74","3,18,193.72",
01-Sep-23,Commission,06.00,00.00,"3,18,199.72",
01-Sep-23,Transfer,00.00,"1,59,099.86","1,59,099.86",
01-Sep-23,IMPS,03.96,00.00,"1,59,103.82",
01-Sep-23,Bill,00.00,"39,775.96","1,19,327.86",
01-Sep-23,Commission,"17,099.10",00.00,"1,36,426.96",
01-Sep-23,NEFT,"6,06,008.00",00.00,"7,42,434.96",
02-Sep-23,Cash,00.00,"2,47,478.32","4,94,956.64",
02-Sep-23,Bill,00.00,"4,94,956.64",00.00,
02-Sep-23,Commission,42.7,00.00,42.7,
02-Sep-23,ATM,00.00,42.7,00.00,
02-Sep-23,Tax,03.87,00.00,03.87,
02-Sep-23,Transportellaneous,00.00,01.94,01.94,
02-Sep-23,Cash,00.00,00.24,01.70,
02-Sep-23,Cash,"2,247.00",00.00,"2,248.70",
02-Sep-23,Cash,27.2,00.00,"2,275.90",
02-Sep-23,Commission,00.00,"2,275.90",00.00,
02-Sep-23,Tax,07.00,00.00,07.00,
02-Sep-23,Debit Card,00.00,02.33,04.67,
02-Sep-23,NEFT,00.00,00.52,04.15,
02-Sep-23,Cheque,"3,37,290.50",00.00,"3,37,294.65",
02-Sep-23,NEFT,00.00,"84,323.66","2,52,970.99",
02-Sep-23,Transfer,"2,805.00",00.00,"2,55,775.99",
02-Sep-23,Cheque,00.00,"85,258.66","1,70,517.33",
02-Sep-23,Cash,"30,273.00",00.00,"2,00,790.33",
02-Sep-23,Bill,00.00,"66,930.11","1,33,860.22",
02-Sep-23,ATM,00.00,"22,310.04","1,11,550.18",
02-Sep-23,ATM,"82,972.34",00.00,"1,94,522.52",
02-Sep-23,Commission,"1,41,644.00",00.00,"3,36,166.52",
02-Sep-23,Cash,"2,83,512.20",00.00,"6,19,678.72",
02-Sep-23,Cheque,"1,45,731.20",00.00,"7,65,409.92",
02-Sep-23,Debit Card,00.00,"1,27,568.32","6,37,841.60",
02-Sep-23,RTGS,208.01,00.00,"6,38,049.61",
02-Sep-23,NEFT,"25,184.00",00.00,"6,63,233.61",
02-Sep-23,Reversal,00.00,"3,31,616.81","3,31,616.80",
02-Sep-23,Transportellaneous,00.00,"1,65,808.40","1,65,808.40",
02-Sep-23,Transportellaneous,317.9,00.00,"1,66,126.30",
02-Sep-23,Transfer,00.00,"41,531.58","1,24,594.72",
03-Sep-23,Commission,00.00,"31,148.68","93,446.04",
03-Sep-23,Tax,00.00,"11,680.76","81,765.28",
03-Sep-23,Interest,00.00,"16,353.06","65,412.22",
03-Sep-23,IMPS,02.11,00.00,"65,414.33",
03-Sep-23,Transfer,"5,197.90",00.00,"70,612.23",
03-Sep-23,Cheque,00.00,"7,845.80","62,766.43",
03-Sep-23,Interest,03.97,00.00,"62,770.40",
03-Sep-23,Cash,"99,256.53",00.00,"1,62,026.93",
03-Sep-23,Interest,00.00,"16,202.69","1,45,824.24",
03-Sep-23,Reversal,00.00,"48,608.08","97,216.16",
04-Sep-23,Transportellaneous,03.20,00.00,"97,219.36",
04-Sep-23,Cheque,00.00,"12,152.42","85,066.94",
04-Sep-23,Reversal,"4,15,537.00",00.00,"5,00,603.94",
04-Sep-23,RTGS,00.00,"1,25,150.99","3,75,452.96",
04-Sep-23,Purchase,35.6,00.00,"3,75,488.56",
04-Sep-23,RTGS,00.00,"41,720.95","3,33,767.61",
04-Sep-23,Purchase,"20,542.00",00.00,"3,54,309.61",
04-Sep-23,NEFT,00.00,"88,577.40","2,65,732.21",
05-Sep-23,Transfer,"2,499.70",00.00,"2,68,231.91",
05-Sep-23,Tax,00.00,"67,057.98","2,01,173.93",
05-Sep-23,Tax,00.00,"2,01,173.93",00.00,
05-Sep-23,IMPS,48.51,00.00,48.51,
05-Sep-23,Cheque,00.00,12.13,36.38,
05-Sep-23,Transfer,"17,992.00",00.00,"18,028.38",
06-Sep-23,ATM,"1,82,558.25",00.00,"2,00,586.63",
07-Sep-23,Tax,00.00,"25,073.33","1,75,513.30",
07-Sep-23,Cash,00.00,"19,501.48","1,56,011.82",
07-Sep-23,Interest,366,00.00,"1,56,377.82",
07-Sep-23,Transfer,00.00,"19,547.23","1,36,830.59",
07-Sep-23,Transfer,"1,171.60",00.00,"1,38,002.19",
07-Sep-23,ATM,"17,02,926.00",00.00,"18,40,928.19",
07-Sep-23,IMPS,00.00,"2,30,116.02","16,10,812.17",
07-Sep-23,Transfer,"2,25,565.00",00.00,"18,36,377.17",
07-Sep-23,Transfer,00.00,"3,06,062.86","15,30,314.31",
07-Sep-23,Bill,573.08,00.00,"15,30,887.39",
07-Sep-23,Debit Card,00.00,"2,55,147.90","12,75,739.49",
07-Sep-23,Reversal,"12,72,147.00",00.00,"25,47,886.49",
08-Sep-23,Cheque,"11,63,271.00",00.00,"37,11,157.49",
08-Sep-23,Debit Card,245,00.00,"37,11,402.49",
08-Sep-23,Commission,"1,94,060.00",00.00,"39,05,462.49",
08-Sep-23,Cash,"77,662.00",00.00,"39,83,124.49",
08-Sep-23,Bill,00.00,"4,97,890.56","34,85,233.93",
08-Sep-23,Cash,05.00,00.00,"34,85,238.93",
08-Sep-23,Reversal,57.2,00.00,"34,85,296.13",
08-Sep-23,NEFT,"39,137.00",00.00,"35,24,433.13",
08-Sep-23,Purchase,"12,717.20",00.00,"35,37,150.33",
08-Sep-23,NEFT,15,00.00,"35,37,165.33",
08-Sep-23,Debit Card,13.87,00.00,"35,37,179.20",
08-Sep-23,Debit Card,00.00,"8,84,294.80","26,52,884.40",
08-Sep-23,Transportellaneous,"2,51,579.97",00.00,"29,04,464.37",
08-Sep-23,Commission,00.00,"2,90,446.44","26,14,017.93",
08-Sep-23,IMPS,"4,026.32",00.00,"26,18,044.25",
08-Sep-23,Purchase,01.00,00.00,"26,18,045.25",
08-Sep-23,RTGS,00.00,"2,90,893.92","23,27,151.33",
08-Sep-23,IMPS,00.00,"11,63,575.67","11,63,575.66",
08-Sep-23,IMPS,"12,053.03",00.00,"11,75,628.69",
08-Sep-23,Debit Card,00.00,"2,93,907.17","8,81,721.52",
08-Sep-23,Commission,"16,67,301.75",00.00,"25,49,023.27",
08-Sep-23,Debit Card,00.00,"3,64,146.18","21,84,877.09",
09-Sep-23,Transfer,00.00,"5,46,219.27","16,38,657.82",
09-Sep-23,IMPS,"23,831.83",00.00,"16,62,489.65",
09-Sep-23,ATM,00.00,"5,54,163.22","11,08,326.43",
09-Sep-23,Debit Card,05.30,00.00,"11,08,331.73",
09-Sep-23,Purchase,03.00,00.00,"11,08,334.73",
09-Sep-23,Tax,292.61,00.00,"11,08,627.34",
09-Sep-23,Debit Card,14.4,00.00,"11,08,641.74",
09-Sep-23,Transportellaneous,00.00,"1,38,580.22","9,70,061.52",
09-Sep-23,Reversal,"15,04,369.25",00.00,"24,74,430.77",
09-Sep-23,RTGS,06.31,00.00,"24,74,437.08",
09-Sep-23,Purchase,138,00.00,"24,74,575.08",
09-Sep-23,Reversal,"76,551.60",00.00,"25,51,126.68",
09-Sep-23,ATM,"11,74,260.00",00.00,"37,25,386.68",
09-Sep-23,ATM,"2,56,326.75",00.00,"39,81,713.43",
09-Sep-23,IMPS,00.00,"7,96,342.69","31,85,370.74",
09-Sep-23,Cheque,00.00,"4,55,052.96","27,30,317.78",
09-Sep-23,Commission,"2,85,719.20",00.00,"30,16,036.98",
09-Sep-23,Cheque,00.00,"3,35,115.22","26,80,921.76",
09-Sep-23,ATM,04.80,00.00,"26,80,926.56",
09-Sep-23,Cheque,07.00,00.00,"26,80,933.56",
09-Sep-23,Cheque,137.24,00.00,"26,81,070.80",
09-Sep-23,Purchase,05.89,00.00,"26,81,076.69",
09-Sep-23,Interest,07.30,00.00,"26,81,083.99",
09-Sep-23,Cash,38,00.00,"26,81,121.99",
09-Sep-23,NEFT,06.80,00.00,"26,81,128.79",
09-Sep-23,Purchase,"2,950.54",00.00,"26,84,079.33",
09-Sep-23,IMPS,00.00,"6,71,019.83","20,13,059.50",
09-Sep-23,NEFT,05.00,00.00,"20,13,064.50",
09-Sep-23,Cheque,00.00,"5,03,266.13","15,09,798.38",
09-Sep-23,Purchase,"69,588.20",00.00,"15,79,386.58",
09-Sep-23,NEFT,"6,69,182.00",00.00,"22,48,568.58",
09-Sep-23,Cash,"9,69,796.00",00.00,"32,18,364.58",
09-Sep-23,Reversal,00.00,"8,04,591.15","24,13,773.44",
09-Sep-23,RTGS,00.00,"2,68,197.05","21,45,576.39",
09-Sep-23,RTGS,57.9,00.00,"21,45,634.29",
09-Sep-23,Cash,"18,96,638.00",00.00,"40,42,272.29",
09-Sep-23,Cash,00.00,"40,42,272.29",00.00,
09-Sep-23,RTGS,"61,011.00",00.00,"61,011.00",
09-Sep-23,Reversal,00.00,"8,715.86","52,295.14",
09-Sep-23,Purchase,772,00.00,"53,067.14",
09-Sep-23,NEFT,"1,28,577.16",00.00,"1,81,644.30",
09-Sep-23,Bill,00.00,"45,411.08","1,36,233.22",
10-Sep-23,Cheque,"16,13,879.00",00.00,"17,50,112.22",
10-Sep-23,Tax,00.00,"8,75,056.11","8,75,056.11",
10-Sep-23,RTGS,00.00,"1,45,842.69","7,29,213.42",
10-Sep-23,Reversal,04.45,00.00,"7,29,217.87",
10-Sep-23,Interest,00.00,"7,29,217.87",00.00,
10-Sep-23,Bill,"17,392.00",00.00,"17,392.00",
10-Sep-23,Tax,00.00,"8,696.00","8,696.00",
10-Sep-23,ATM,"4,079.36",00.00,"12,775.36",
10-Sep-23,Debit Card,"3,247.70",00.00,"16,023.06",
10-Sep-23,Purchase,26.49,00.00,"16,049.55",
10-Sep-23,Transfer,00.00,"2,006.19","14,043.36",
10-Sep-23,RTGS,"1,05,920.50",00.00,"1,19,963.86",
10-Sep-23,Purchase,59.7,00.00,"1,20,023.56",
10-Sep-23,Tax,"1,05,392.69",00.00,"2,25,416.25",
10-Sep-23,Cash,"15,03,189.00",00.00,"17,28,605.25",
10-Sep-23,RTGS,00.00,"3,45,721.05","13,82,884.20",
10-Sep-23,Commission,00.00,"13,82,884.20",00.00,
10-Sep-23,Bill,"2,725.90",00.00,"2,725.90",
10-Sep-23,Transfer,00.00,908.63,"1,817.27",
10-Sep-23,ATM,795,00.00,"2,612.27",
10-Sep-23,Reversal,"2,05,589.75",00.00,"2,08,202.02",
11-Sep-23,Transfer,00.00,"1,04,101.01","1,04,101.01",
11-Sep-23,Transportellaneous,00.00,"14,871.57","89,229.44",
11-Sep-23,Debit Card,00.00,"11,153.68","78,075.76",
11-Sep-23,IMPS,00.00,"8,675.08","69,400.68",
11-Sep-23,Commission,00.00,"17,350.17","52,050.51",
11-Sep-23,Bill,04.00,00.00,"52,054.51",
11-Sep-23,NEFT,00.00,"8,675.75","43,378.76",
11-Sep-23,Reversal,00.00,"8,675.75","34,703.01",
11-Sep-23,Debit Card,342.1,00.00,"35,045.11",
11-Sep-23,ATM,"20,574.52",00.00,"55,619.63",
12-Sep-23,Transfer,"56,155.38",00.00,"1,11,775.01",
12-Sep-23,Purchase,413,00.00,"1,12,188.01",
12-Sep-23,IMPS,00.00,"11,218.80","1,00,969.21",
12-Sep-23,NEFT,00.00,"16,828.20","84,141.01",
12-Sep-23,ATM,00.00,"14,023.50","70,117.51",
12-Sep-23,Tax,00.00,"35,058.76","35,058.75",
12-Sep-23,Reversal,00.00,"5,843.13","29,215.62",
12-Sep-23,ATM,397.2,00.00,"29,612.82",
12-Sep-23,ATM,"8,20,881.00",00.00,"8,50,493.82",
12-Sep-23,ATM,00.00,"1,06,311.73","7,44,182.09",
12-Sep-23,Purchase,"13,861.00",00.00,"7,58,043.09",
12-Sep-23,Interest,02.46,00.00,"7,58,045.55",
12-Sep-23,Interest,00.00,"3,79,022.78","3,79,022.78",
12-Sep-23,Transportellaneous,06.16,00.00,"3,79,028.94",
12-Sep-23,NEFT,"2,515.50",00.00,"3,81,544.44",
12-Sep-23,IMPS,00.00,"95,386.11","2,86,158.33",
12-Sep-23,Cheque,"1,41,511.00",00.00,"4,27,669.33",
12-Sep-23,RTGS,00.00,"61,095.62","3,66,573.71",
12-Sep-23,ATM,00.00,"40,730.41","3,25,843.30",
12-Sep-23,Reversal,274,00.00,"3,26,117.30",
12-Sep-23,Commission,56.66,00.00,"3,26,173.96",
12-Sep-23,IMPS,00.00,"36,241.55","2,89,932.41",
12-Sep-23,Bill,00.00,"96,644.14","1,93,288.27",
12-Sep-23,Cheque,00.00,"24,161.03","1,69,127.24",
12-Sep-23,ATM,"1,169.00",00.00,"1,70,296.24",
12-Sep-23,Interest,00.00,"17,029.62","1,53,266.62",
12-Sep-23,Debit Card,00.00,"21,895.23","1,31,371.39",
12-Sep-23,Transfer,200.9,00.00,"1,31,572.29",
13-Sep-23,Interest,00.00,"26,314.46","1,05,257.83",
13-Sep-23,Reversal,00.00,"21,051.57","84,206.26",
13-Sep-23,Cash,00.00,"28,068.75","56,137.51",
13-Sep-23,IMPS,00.00,"6,237.50","49,900.01",
13-Sep-23,RTGS,00.00,"12,475.00","37,425.01",
13-Sep-23,Tax,00.00,"18,712.51","18,712.50",
13-Sep-23,Purchase,"8,997.10",00.00,"27,709.60",
13-Sep-23,Cash,00.00,"9,236.53","18,473.07",
13-Sep-23,Reversal,"13,13,470.00",00.00,"13,31,943.07",
13-Sep-23,Reversal,00.00,"1,66,492.88","11,65,450.19",
13-Sep-23,Purchase,00.00,"11,65,450.19",00.00,
13-Sep-23,Debit Card,"2,757.40",00.00,"2,757.40",
13-Sep-23,Transfer,00.00,344.68,"2,412.72",
13-Sep-23,Cheque,00.00,"2,412.72",00.00,
13-Sep-23,Reversal,"14,89,818.00",00.00,"14,89,818.00",
13-Sep-23,Transportellaneous,06.00,00.00,"14,89,824.00",
13-Sep-23,Cheque,00.00,"1,86,228.00","13,03,596.00",
13-Sep-23,Commission,713,00.00,"13,04,309.00",
13-Sep-23,Transportellaneous,"1,530.10",00.00,"13,05,839.10",
13-Sep-23,Reversal,"1,06,849.00",00.00,"14,12,688.10",
13-Sep-23,Cheque,"1,513.30",00.00,"14,14,201.40",
13-Sep-23,ATM,00.00,"1,57,133.49","12,57,067.91",
13-Sep-23,Interest,00.00,"12,57,067.91",00.00,
13-Sep-23,RTGS,55,00.00,55,
13-Sep-23,ATM,00.00,55,00.00,
13-Sep-23,Cash,"1,10,249.00",00.00,"1,10,249.00",
13-Sep-23,Transfer,00.00,"12,249.89","97,999.11",
13-Sep-23,Transfer,38,00.00,"98,037.11",
14-Sep-23,IMPS,754.7,00.00,"98,791.81",
14-Sep-23,IMPS,"2,15,607.10",00.00,"3,14,398.91",
14-Sep-23,Cheque,00.00,"52,399.82","2,61,999.09",
14-Sep-23,ATM,00.00,"37,428.44","2,24,570.65",
14-Sep-23,Bill,"8,75,808.00",00.00,"11,00,378.65",
14-Sep-23,Interest,00.00,"2,20,075.73","8,80,302.92",
14-Sep-23,ATM,00.00,"2,20,075.73","6,60,227.19",
14-Sep-23,RTGS,509.68,00.00,"6,60,736.87",
14-Sep-23,Tax,00.00,"1,10,122.81","5,50,614.06",
14-Sep-23,Debit Card,00.00,"1,10,122.81","4,40,491.25",
15-Sep-23,Cheque,00.00,"44,049.13","3,96,442.12",
15-Sep-23,Bill,00.00,"79,288.42","3,17,153.70",
15-Sep-23,Tax,04.90,00.00,"3,17,158.60",
15-Sep-23,Cheque,"9,59,185.80",00.00,"12,76,344.40",
15-Sep-23,IMPS,00.00,"4,25,448.13","8,50,896.27",
15-Sep-23,NEFT,00.00,"1,21,556.61","7,29,339.66",
15-Sep-23,ATM,"3,591.10",00.00,"7,32,930.76",
15-Sep-23,Purchase,359.6,00.00,"7,33,290.36",
16-Sep-23,Debit Card,"6,846.00",00.00,"7,40,136.36",
16-Sep-23,Cash,00.00,"74,013.64","6,66,122.72",
16-Sep-23,ATM,00.00,"74,013.64","5,92,109.08",
16-Sep-23,Commission,07.00,00.00,"5,92,116.08",
16-Sep-23,Purchase,21.72,00.00,"5,92,137.80",
16-Sep-23,Interest,00.00,"74,017.23","5,18,120.58",
16-Sep-23,ATM,"23,695.00",00.00,"5,41,815.58",
16-Sep-23,Tax,277,00.00,"5,42,092.58",
16-Sep-23,Transportellaneous,"3,688.39",00.00,"5,45,780.97",
16-Sep-23,RTGS,00.00,"5,45,780.97",00.00,
16-Sep-23,Cheque,"11,65,826.00",00.00,"11,65,826.00",
16-Sep-23,Reversal,"9,73,406.00",00.00,"21,39,232.00",
16-Sep-23,Transportellaneous,"7,78,659.50",00.00,"29,17,891.50",
16-Sep-23,RTGS,"2,23,016.40",00.00,"31,40,907.90",
16-Sep-23,IMPS,00.00,"15,70,453.95","15,70,453.95",
16-Sep-23,Reversal,166.74,00.00,"15,70,620.69",
16-Sep-23,Cash,476,00.00,"15,71,096.69",
16-Sep-23,Cheque,"3,467.76",00.00,"15,74,564.45",
16-Sep-23,Tax,"7,96,152.00",00.00,"23,70,716.45",
16-Sep-23,Debit Card,00.00,"11,85,358.23","11,85,358.23",
16-Sep-23,ATM,"65,735.00",00.00,"12,51,093.23",
16-Sep-23,IMPS,"2,972.00",00.00,"12,54,065.23",
16-Sep-23,RTGS,"15,313.50",00.00,"12,69,378.73",
16-Sep-23,Commission,"13,27,255.00",00.00,"25,96,633.73",
17-Sep-23,Tax,00.00,"3,24,579.22","22,72,054.51",
17-Sep-23,Bill,00.00,"2,84,006.81","19,88,047.70",
17-Sep-23,IMPS,00.00,"6,62,682.57","13,25,365.13",
17-Sep-23,Transportellaneous,00.00,"13,25,365.13",00.00,
17-Sep-23,Debit Card,"19,11,119.50",00.00,"19,11,119.50",
17-Sep-23,NEFT,00.00,"4,77,779.88","14,33,339.62",
17-Sep-23,Bill,00.00,"2,86,667.92","11,46,671.70",
18-Sep-23,IMPS,00.00,"3,82,223.90","7,64,447.80",
18-Sep-23,ATM,07.69,00.00,"7,64,455.49",
18-Sep-23,Reversal,00.00,"1,52,891.10","6,11,564.39",
18-Sep-23,Reversal,167.09,00.00,"6,11,731.48",
18-Sep-23,Commission,00.00,"87,390.21","5,24,341.27",
18-Sep-23,Tax,00.00,"58,260.14","4,66,081.13",
18-Sep-23,Interest,"1,16,277.20",00.00,"5,82,358.33",
18-Sep-23,NEFT,"2,56,969.90",00.00,"8,39,328.23",
18-Sep-23,Tax,"11,783.00",00.00,"8,51,111.23",
18-Sep-23,Bill,00.00,"2,83,703.74","5,67,407.49",
18-Sep-23,Tax,"25,248.90",00.00,"5,92,656.39",
18-Sep-23,ATM,18.05,00.00,"5,92,674.44",
18-Sep-23,Cash,48.8,00.00,"5,92,723.24",
18-Sep-23,ATM,00.00,"74,090.41","5,18,632.84",
18-Sep-23,NEFT,00.00,"1,72,877.61","3,45,755.23",
18-Sep-23,Transportellaneous,03.29,00.00,"3,45,758.52",
18-Sep-23,Debit Card,00.00,"1,72,879.26","1,72,879.26",
19-Sep-23,Reversal,00.00,"34,575.85","1,38,303.41",
19-Sep-23,IMPS,"17,92,030.25",00.00,"19,30,333.66",
19-Sep-23,Tax,"10,970.00",00.00,"19,41,303.66",
19-Sep-23,Reversal,110.1,00.00,"19,41,413.76",
19-Sep-23,ATM,00.00,"2,77,344.82","16,64,068.94",
19-Sep-23,Bill,00.00,"1,84,896.55","14,79,172.39",
19-Sep-23,RTGS,00.00,"1,47,917.24","13,31,255.15",
19-Sep-23,IMPS,00.00,"3,32,813.79","9,98,441.36",
19-Sep-23,Debit Card,00.00,"2,49,610.34","7,48,831.02",
19-Sep-23,ATM,393.3,00.00,"7,49,224.32",
19-Sep-23,Bill,"1,081.64",00.00,"7,50,305.96",
19-Sep-23,IMPS,00.00,"2,50,101.99","5,00,203.97",
19-Sep-23,Purchase,00.00,"62,525.50","4,37,678.47",
19-Sep-23,Transportellaneous,00.00,"62,525.50","3,75,152.97",
19-Sep-23,Transfer,00.00,"1,25,050.99","2,50,101.98",
19-Sep-23,ATM,00.00,"41,683.66","2,08,418.32",
19-Sep-23,Commission,00.00,"26,052.29","1,82,366.03",
19-Sep-23,Cheque,00.00,"91,183.02","91,183.02",
19-Sep-23,Reversal,00.00,"10,131.45","81,051.57",
19-Sep-23,Cash,"6,13,255.75",00.00,"6,94,307.32",
19-Sep-23,ATM,"1,30,119.69",00.00,"8,24,427.01",
19-Sep-23,Bill,00.00,"4,12,213.51","4,12,213.50",
19-Sep-23,Transportellaneous,00.00,"51,526.69","3,60,686.81",
19-Sep-23,Transportellaneous,"2,950.90",00.00,"3,63,637.71",
19-Sep-23,Purchase,00.00,"40,404.19","3,23,233.52",
19-Sep-23,Commission,00.00,"35,914.84","2,87,318.68",
19-Sep-23,IMPS,00.00,"95,772.89","1,91,545.79",
19-Sep-23,Commission,00.00,"1,91,545.79",00.00,
19-Sep-23,RTGS,"1,79,082.40",00.00,"1,79,082.40",
19-Sep-23,Transfer,00.00,"25,583.20","1,53,499.20",
20-Sep-23,Commission,"2,128.00",00.00,"1,55,627.20",
20-Sep-23,Commission,00.00,"77,813.60","77,813.60",
20-Sep-23,NEFT,00.00,"8,645.96","69,167.64",
20-Sep-23,Tax,"12,546.80",00.00,"81,714.44",
20-Sep-23,IMPS,01.20,00.00,"81,715.64",
20-Sep-23,Bill,00.00,"13,619.27","68,096.37",
20-Sep-23,Transportellaneous,00.00,"22,698.79","45,397.58",
20-Sep-23,ATM,00.20,00.00,"45,397.78",
20-Sep-23,Purchase,"25,312.30",00.00,"70,710.08",
20-Sep-23,Purchase,00.00,"23,570.03","47,140.05",
20-Sep-23,Debit Card,00.00,"7,856.68","39,283.38",
20-Sep-23,Debit Card,00.00,"19,641.69","19,641.69",
20-Sep-23,NEFT,26.8,00.00,"19,668.49",
20-Sep-23,Transfer,00.00,"2,185.39","17,483.10",
20-Sep-23,IMPS,00.00,"3,496.62","13,986.48",
20-Sep-23,Cheque,02.24,00.00,"13,988.72",
20-Sep-23,Debit Card,"1,89,897.00",00.00,"2,03,885.72",
20-Sep-23,Transportellaneous,24,00.00,"2,03,909.72",
20-Sep-23,Bill,00.00,"29,129.96","1,74,779.76",
20-Sep-23,Commission,"1,83,936.00",00.00,"3,58,715.76",
21-Sep-23,Transportellaneous,978,00.00,"3,59,693.76",
21-Sep-23,RTGS,00.00,"71,938.75","2,87,755.01",
21-Sep-23,Commission,"25,606.00",00.00,"3,13,361.01",
21-Sep-23,Transfer,00.00,"44,765.86","2,68,595.15",
21-Sep-23,Cheque,"1,093.00",00.00,"2,69,688.15",
21-Sep-23,ATM,04.00,00.00,"2,69,692.15",
21-Sep-23,IMPS,00.00,"67,423.04","2,02,269.11",
21-Sep-23,Tax,00.00,"2,02,269.11",00.00,
21-Sep-23,ATM,16.41,00.00,16.41,
21-Sep-23,Reversal,07.95,00.00,24.36,
21-Sep-23,Purchase,00.00,02.44,21.92,
21-Sep-23,Bill,"14,26,443.20",00.00,"14,26,465.12",
21-Sep-23,Reversal,00.00,"3,56,616.28","10,69,848.84",
21-Sep-23,Interest,07.42,00.00,"10,69,856.26",
21-Sep-23,ATM,59.7,00.00,"10,69,915.96",
21-Sep-23,Transportellaneous,00.00,"5,34,957.98","5,34,957.98",
21-Sep-23,RTGS,00.00,"1,06,991.60","4,27,966.38",
21-Sep-23,Debit Card,"15,74,699.75",00.00,"20,02,666.13",
21-Sep-23,Debit Card,00.00,"2,22,518.46","17,80,147.67",
21-Sep-23,Tax,00.81,00.00,"17,80,148.48",
21-Sep-23,IMPS,"1,61,469.38",00.00,"19,41,617.86",
21-Sep-23,Debit Card,00.00,"6,47,205.95","12,94,411.91",
21-Sep-23,RTGS,00.00,"12,94,411.91",00.00,
21-Sep-23,Cheque,"2,479.90",00.00,"2,479.90",
21-Sep-23,Cheque,"15,107.80",00.00,"17,587.70",
21-Sep-23,Bill,"17,885.00",00.00,"35,472.70",
21-Sep-23,Cash,"2,36,330.94",00.00,"2,71,803.64",
21-Sep-23,NEFT,00.00,"27,180.36","2,44,623.28",
21-Sep-23,Interest,00.00,"34,946.18","2,09,677.10",
21-Sep-23,NEFT,"12,424.60",00.00,"2,22,101.70",
21-Sep-23,RTGS,04.58,00.00,"2,22,106.28",
21-Sep-23,Commission,00.00,"22,210.63","1,99,895.65",
21-Sep-23,Commission,93,00.00,"1,99,988.65",
21-Sep-23,Interest,"2,51,190.97",00.00,"4,51,179.62",
21-Sep-23,NEFT,00.00,"90,235.92","3,60,943.70",
21-Sep-23,Commission,00.00,"72,188.74","2,88,754.96",
21-Sep-23,IMPS,00.00,"1,44,377.48","1,44,377.48",
21-Sep-23,NEFT,"9,319.70",00.00,"1,53,697.18",
22-Sep-23,Reversal,00.00,"25,616.20","1,28,080.98",
22-Sep-23,Transportellaneous,00.00,"1,28,080.98",00.00,
22-Sep-23,Bill,25,00.00,25,
22-Sep-23,NEFT,00.00,03.57,21.43,
22-Sep-23,ATM,"4,89,219.50",00.00,"4,89,240.93",
22-Sep-23,Interest,00.00,"2,44,620.47","2,44,620.46",
22-Sep-23,Tax,00.00,"81,540.15","1,63,080.31",
22-Sep-23,Bill,00.00,"40,770.08","1,22,310.23",
22-Sep-23,Bill,00.00,"24,462.05","97,848.18",
22-Sep-23,Reversal,317,00.00,"98,165.18",
22-Sep-23,Interest,373.58,00.00,"98,538.76",
22-Sep-23,NEFT,00.00,"14,076.97","84,461.79",
22-Sep-23,Bill,00.00,"28,153.93","56,307.86",
22-Sep-23,Transportellaneous,"25,851.14",00.00,"82,159.00",
22-Sep-23,Interest,"8,303.00",00.00,"90,462.00",
22-Sep-23,Commission,"1,55,895.00",00.00,"2,46,357.00",
22-Sep-23,Reversal,"2,834.00",00.00,"2,49,191.00",
22-Sep-23,Reversal,02.40,00.00,"2,49,193.40",
22-Sep-23,Interest,00.00,"1,24,596.70","1,24,596.70",
22-Sep-23,Transportellaneous,"4,673.15",00.00,"1,29,269.85",
22-Sep-23,NEFT,"16,09,392.00",00.00,"17,38,661.85",
22-Sep-23,RTGS,00.00,"4,34,665.46","13,03,996.39",
22-Sep-23,Purchase,328,00.00,"13,04,324.39",
22-Sep-23,Reversal,02.86,00.00,"13,04,327.25",
22-Sep-23,Cheque,00.00,"4,34,775.75","8,69,551.50",
22-Sep-23,Interest,"1,38,406.28",00.00,"10,07,957.78",
22-Sep-23,ATM,00.00,"2,01,591.56","8,06,366.22",
22-Sep-23,Reversal,"1,35,578.00",00.00,"9,41,944.22",
23-Sep-23,IMPS,02.00,00.00,"9,41,946.22",
23-Sep-23,Tax,910,00.00,"9,42,856.22",
23-Sep-23,RTGS,00.00,"3,14,285.41","6,28,570.81",
23-Sep-23,Reversal,00.00,"2,09,523.60","4,19,047.21",
23-Sep-23,Reversal,"1,127.30",00.00,"4,20,174.51",
23-Sep-23,Cash,"2,377.30",00.00,"4,22,551.81",
23-Sep-23,ATM,00.00,"4,22,551.81",00.00,
23-Sep-23,Commission,"10,59,797.80",00.00,"10,59,797.80",
23-Sep-23,Cheque,00.00,"2,64,949.45","7,94,848.35",
23-Sep-23,Debit Card,00.00,"99,356.04","6,95,492.31",
23-Sep-23,Debit Card,00.00,"6,95,492.31",00.00,
23-Sep-23,ATM,"1,49,064.75",00.00,"1,49,064.75",
23-Sep-23,Debit Card,"1,127.00",00.00,"1,50,191.75",
23-Sep-23,Debit Card,"19,370.00",00.00,"1,69,561.75",
23-Sep-23,Transfer,"1,81,574.00",00.00,"3,51,135.75",
23-Sep-23,Tax,"14,763.47",00.00,"3,65,899.22",
23-Sep-23,Transfer,00.00,"1,82,949.61","1,82,949.61",
23-Sep-23,Bill,00.00,"20,327.73","1,62,621.88",
23-Sep-23,Cash,00.00,"32,524.38","1,30,097.50",
23-Sep-23,RTGS,00.00,"26,019.50","1,04,078.00",
23-Sep-23,Debit Card,00.00,"52,039.00","52,039.00",
23-Sep-23,ATM,00.00,"5,203.90","46,835.10",
23-Sep-23,Transfer,"6,842.60",00.00,"53,677.70",
23-Sep-23,Commission,00.00,"13,419.43","40,258.27",
23-Sep-23,Reversal,"2,14,400.90",00.00,"2,54,659.17",
23-Sep-23,NEFT,"1,05,984.91",00.00,"3,60,644.08",
23-Sep-23,IMPS,00.00,"40,071.56","3,20,572.52",
23-Sep-23,Bill,00.00,"3,20,572.52",00.00,
23-Sep-23,ATM,32.97,00.00,32.97,
23-Sep-23,RTGS,00.00,10.99,21.98,
23-Sep-23,Transportellaneous,"3,260.80",00.00,"3,282.78",
23-Sep-23,Interest,"3,660.00",00.00,"6,942.78",
23-Sep-23,Commission,"18,22,621.50",00.00,"18,29,564.28",
23-Sep-23,Cash,05.90,00.00,"18,29,570.18",
23-Sep-23,NEFT,"4,48,391.00",00.00,"22,77,961.18",
23-Sep-23,Interest,00.00,"11,38,980.59","11,38,980.59",
23-Sep-23,Transfer,101.18,00.00,"11,39,081.77",
23-Sep-23,Reversal,00.00,"2,27,816.35","9,11,265.42",
23-Sep-23,Reversal,00.00,"1,01,251.71","8,10,013.71",
24-Sep-23,Debit Card,"6,88,365.75",00.00,"14,98,379.46",
24-Sep-23,Cheque,00.00,"14,98,379.46",00.00,
24-Sep-23,Purchase,"7,34,931.25",00.00,"7,34,931.25",
24-Sep-23,Transportellaneous,00.00,"1,46,986.25","5,87,945.00",
24-Sep-23,ATM,00.00,"58,794.50","5,29,150.50",
24-Sep-23,Purchase,00.00,"88,191.75","4,40,958.75",
24-Sep-23,Purchase,"14,71,254.00",00.00,"19,12,212.75",
24-Sep-23,Transportellaneous,00.00,"9,56,106.38","9,56,106.38",
24-Sep-23,Debit Card,00.00,"1,36,586.63","8,19,519.75",
24-Sep-23,Debit Card,00.00,"2,73,173.25","5,46,346.50",
25-Sep-23,Purchase,00.00,"5,46,346.50",00.00,
25-Sep-23,Cheque,"29,821.80",00.00,"29,821.80",
25-Sep-23,Interest,49,00.00,"29,870.80",
25-Sep-23,Transportellaneous,918,00.00,"30,788.80",
25-Sep-23,Reversal,00.00,"7,697.20","23,091.60",
25-Sep-23,Tax,00.00,"4,618.32","18,473.28",
25-Sep-23,Transportellaneous,00.00,"1,847.33","16,625.95",
25-Sep-23,Transportellaneous,00.00,"1,847.33","14,778.62",
25-Sep-23,Purchase,00.00,"1,847.33","12,931.29",
25-Sep-23,Commission,"3,796.60",00.00,"16,727.89",
25-Sep-23,Debit Card,00.00,"5,575.96","11,151.93",
25-Sep-23,Bill,00.00,"11,151.93",00.00,
25-Sep-23,Interest,479.4,00.00,479.4,
25-Sep-23,Interest,494,00.00,973.4,
25-Sep-23,Transfer,00.00,108.16,865.24,
25-Sep-23,IMPS,"2,98,741.50",00.00,"2,99,606.74",
25-Sep-23,Interest,"24,287.10",00.00,"3,23,893.84",
25-Sep-23,RTGS,444,00.00,"3,24,337.84",
25-Sep-23,Bill,42,00.00,"3,24,379.84",
25-Sep-23,Debit Card,00.00,"3,24,379.84",00.00,
25-Sep-23,Transportellaneous,"15,839.00",00.00,"15,839.00",
25-Sep-23,ATM,00.00,"7,919.50","7,919.50",
25-Sep-23,Debit Card,00.00,791.95,"7,127.55",
25-Sep-23,Commission,00.00,"7,127.55",00.00,
25-Sep-23,Commission,38,00.00,38,
25-Sep-23,Commission,00.00,12.67,25.33,
25-Sep-23,RTGS,312,00.00,337.33,
25-Sep-23,Bill,06.00,00.00,343.33,
25-Sep-23,Commission,00.00,343.33,00.00,
25-Sep-23,NEFT,"15,08,320.00",00.00,"15,08,320.00",
25-Sep-23,Cash,08.40,00.00,"15,08,328.40",
25-Sep-23,Commission,"1,522.82",00.00,"15,09,851.22",
25-Sep-23,RTGS,00.00,"15,09,851.22",00.00,
25-Sep-23,RTGS,27,00.00,27,
25-Sep-23,Cash,00.00,03.86,23.14,
25-Sep-23,Cheque,05.01,00.00,28.15,
25-Sep-23,Tax,"3,944.30",00.00,"3,972.45",
25-Sep-23,Cash,00.00,662.08,"3,310.38",
25-Sep-23,Transfer,05.70,00.00,"3,316.08",
25-Sep-23,Cheque,00.00,663.22,"2,652.86",
25-Sep-23,Transportellaneous,00.63,00.00,"2,653.49",
25-Sep-23,Interest,00.00,"2,653.49",00.00,
25-Sep-23,NEFT,40.6,00.00,40.6,
25-Sep-23,Transportellaneous,"11,98,258.50",00.00,"11,98,299.10",
25-Sep-23,ATM,00.00,"3,99,433.03","7,98,866.07",
25-Sep-23,IMPS,363.71,00.00,"7,99,229.78",
25-Sep-23,Cash,00.00,"7,99,229.78",00.00,
25-Sep-23,Interest,"2,06,538.00",00.00,"2,06,538.00",
25-Sep-23,Cash,00.00,"20,653.80","1,85,884.20",
26-Sep-23,Reversal,"30,797.00",00.00,"2,16,681.20",
26-Sep-23,ATM,38.83,00.00,"2,16,720.03",
26-Sep-23,Transfer,00.00,"30,960.00","1,85,760.03",
26-Sep-23,Purchase,"6,48,800.00",00.00,"8,34,560.03",
26-Sep-23,Cheque,00.00,"1,04,320.00","7,30,240.03",
26-Sep-23,Purchase,"20,73,373.80",00.00,"28,03,613.83",
26-Sep-23,Cheque,"1,01,476.00",00.00,"29,05,089.83",
26-Sep-23,Purchase,00.00,"9,68,363.28","19,36,726.55",
26-Sep-23,RTGS,33,00.00,"19,36,759.55",
26-Sep-23,Tax,00.00,"1,93,675.96","17,43,083.60",
26-Sep-23,Transfer,00.00,"4,35,770.90","13,07,312.70",
26-Sep-23,Tax,00.00,"2,61,462.54","10,45,850.16",
26-Sep-23,Commission,02.26,00.00,"10,45,852.42",
26-Sep-23,ATM,21.3,00.00,"10,45,873.72",
26-Sep-23,Tax,120,00.00,"10,45,993.72",
26-Sep-23,Debit Card,05.44,00.00,"10,45,999.16",
26-Sep-23,RTGS,00.00,"1,30,749.90","9,15,249.26",
26-Sep-23,ATM,00.00,"9,15,249.26",00.00,
26-Sep-23,NEFT,490.4,00.00,490.4,
26-Sep-23,ATM,00.00,245.2,245.2,
26-Sep-23,Cheque,"62,437.75",00.00,"62,682.95",
27-Sep-23,Commission,"10,771.00",00.00,"73,453.95",
27-Sep-23,ATM,"12,09,360.00",00.00,"12,82,813.95",
27-Sep-23,ATM,00.00,"4,27,604.65","8,55,209.30",
27-Sep-23,Transportellaneous,00.00,"1,42,534.88","7,12,674.42",
27-Sep-23,Interest,00.00,00.00,"7,12,674.42",
27-Sep-23,Debit Card,00.00,"79,186.05","6,33,488.37",
27-Sep-23,Interest,00.00,"63,348.84","5,70,139.53",
27-Sep-23,Purchase,49.94,00.00,"5,70,189.47",
27-Sep-23,Commission,00.00,"1,14,037.89","4,56,151.58",
27-Sep-23,Commission,00.00,"76,025.26","3,80,126.32",
27-Sep-23,ATM,14,00.00,"3,80,140.32",
27-Sep-23,Debit Card,00.00,"1,90,070.16","1,90,070.16",
27-Sep-23,Cash,00.00,"23,758.77","1,66,311.39",
27-Sep-23,NEFT,"1,99,164.00",00.00,"3,65,475.39",
27-Sep-23,NEFT,06.00,00.00,"3,65,481.39",
27-Sep-23,ATM,02.60,00.00,"3,65,483.99",
27-Sep-23,Transfer,00.00,"91,371.00","2,74,112.99",
27-Sep-23,Tax,461.4,00.00,"2,74,574.39",
27-Sep-23,Purchase,"2,33,883.00",00.00,"5,08,457.39",
27-Sep-23,Commission,00.00,"63,557.17","4,44,900.22",
28-Sep-23,Bill,278,00.00,"4,45,178.22",
28-Sep-23,Bill,00.00,"4,45,178.22",00.00,
28-Sep-23,Transfer,42,00.00,42,
28-Sep-23,NEFT,04.40,00.00,46.4,
28-Sep-23,IMPS,00.00,04.64,41.76,
28-Sep-23,RTGS,"1,55,786.00",00.00,"1,55,827.76",
28-Sep-23,ATM,00.00,"22,261.11","1,33,566.65",
28-Sep-23,Interest,00.00,"22,261.11","1,11,305.54",
28-Sep-23,Transportellaneous,"1,34,510.80",00.00,"2,45,816.34",
28-Sep-23,IMPS,"14,868.20",00.00,"2,60,684.54",
28-Sep-23,IMPS,00.00,"1,30,342.27","1,30,342.27",
28-Sep-23,IMPS,00.00,"32,585.57","97,756.70",
28-Sep-23,Debit Card,"12,05,697.75",00.00,"13,03,454.45",
28-Sep-23,Transportellaneous,00.00,"1,44,828.27","11,58,626.18",
28-Sep-23,ATM,00.00,"1,15,862.62","10,42,763.56",
28-Sep-23,Transfer,00.00,"5,21,381.78","5,21,381.78",
28-Sep-23,NEFT,00.00,"2,60,690.89","2,60,690.89",
28-Sep-23,Commission,47.4,00.00,"2,60,738.29",
28-Sep-23,Transfer,"2,00,581.28",00.00,"4,61,319.57",
28-Sep-23,Transfer,"2,42,591.50",00.00,"7,03,911.07",
28-Sep-23,Reversal,"1,50,153.00",00.00,"8,54,064.07",
28-Sep-23,Debit Card,00.00,"4,27,032.04","4,27,032.04",
28-Sep-23,Commission,00.00,"2,13,516.02","2,13,516.02",
28-Sep-23,Cheque,00.00,"53,379.01","1,60,137.01",
28-Sep-23,Commission,00.00,"20,017.13","1,40,119.88",
28-Sep-23,Interest,186,00.00,"1,40,305.88",
28-Sep-23,Transportellaneous,00.00,"28,061.18","1,12,244.70",
28-Sep-23,NEFT,00.00,"16,034.96","96,209.74",
28-Sep-23,IMPS,"21,909.00",00.00,"1,18,118.74",
28-Sep-23,IMPS,00.00,"29,529.69","88,589.06",
28-Sep-23,Tax,00.00,"9,843.23","78,745.83",
28-Sep-23,RTGS,"3,198.50",00.00,"81,944.33",
28-Sep-23,Transportellaneous,144.55,00.00,"82,088.88",
28-Sep-23,Cheque,"23,686.20",00.00,"1,05,775.08",
28-Sep-23,Cash,00.00,"26,443.77","79,331.31",
28-Sep-23,RTGS,00.00,"26,443.77","52,887.54",
28-Sep-23,RTGS,415.6,00.00,"53,303.14",
28-Sep-23,Cheque,00.00,"17,767.71","35,535.43",
28-Sep-23,Purchase,52,00.00,"35,587.43",
28-Sep-23,Transfer,00.00,"4,448.43","31,139.00",
28-Sep-23,NEFT,00.00,"7,784.75","23,354.25",
28-Sep-23,Transportellaneous,00.00,"5,838.56","17,515.69",
28-Sep-23,Interest,00.00,"1,946.19","15,569.50",
28-Sep-23,Transportellaneous,"2,510.40",00.00,"18,079.90",
28-Sep-23,Tax,00.00,"6,026.63","12,053.27",
28-Sep-23,Debit Card,00.00,"12,053.27",00.00,
28-Sep-23,Purchase,"4,011.00",00.00,"4,011.00",
28-Sep-23,Reversal,06.75,00.00,"4,017.75",
28-Sep-23,Tax,43.1,00.00,"4,060.85",
28-Sep-23,Interest,00.00,451.21,"3,609.64",
28-Sep-23,Interest,00.00,721.93,"2,887.71",
28-Sep-23,Purchase,"29,351.30",00.00,"32,239.01",
28-Sep-23,IMPS,146,00.00,"32,385.01",
28-Sep-23,Bill,04.00,00.00,"32,389.01",
28-Sep-23,Transfer,42,00.00,"32,431.01",
28-Sep-23,Cash,"3,58,591.00",00.00,"3,91,022.01",
28-Sep-23,NEFT,"13,610.00",00.00,"4,04,632.01",
28-Sep-23,ATM,00.00,"1,34,877.34","2,69,754.67",
28-Sep-23,IMPS,"9,352.63",00.00,"2,79,107.30",
28-Sep-23,Debit Card,34,00.00,"2,79,141.30",
28-Sep-23,NEFT,49.02,00.00,"2,79,190.32",
28-Sep-23,Interest,00.00,"2,79,190.32",00.00,
28-Sep-23,Purchase,"88,089.00",00.00,"88,089.00",
28-Sep-23,ATM,"2,02,862.60",00.00,"2,90,951.60",
28-Sep-23,Purchase,00.00,"32,327.96","2,58,623.64",
28-Sep-23,Debit Card,00.00,"2,58,623.64",00.00,
28-Sep-23,Tax,02.50,00.00,02.50,
28-Sep-23,Cheque,00.00,01.25,01.25,
28-Sep-23,RTGS,04.72,00.00,05.97,
28-Sep-23,Debit Card,51.52,00.00,57.49,
28-Sep-23,Reversal,"16,74,737.25",00.00,"16,74,794.74",
28-Sep-23,Cheque,"3,874.00",00.00,"16,78,668.74",
28-Sep-23,Transfer,"12,85,534.80",00.00,"29,64,203.54",
29-Sep-23,Reversal,00.00,"4,23,457.65","25,40,745.89",
29-Sep-23,NEFT,"31,569.80",00.00,"25,72,315.69",
29-Sep-23,Interest,"24,799.00",00.00,"25,97,114.69",
29-Sep-23,ATM,08.00,00.00,"25,97,122.69",
29-Sep-23,Purchase,510.26,00.00,"25,97,632.95",
29-Sep-23,Cheque,00.00,"25,97,632.95",00.00,
29-Sep-23,ATM,01.84,00.00,01.84,
29-Sep-23,Bill,"1,22,460.60",00.00,"1,22,462.44",
29-Sep-23,Tax,01.52,00.00,"1,22,463.96",
29-Sep-23,Commission,"2,30,315.28",00.00,"3,52,779.24",
29-Sep-23,Reversal,00.00,"70,555.85","2,82,223.39",
29-Sep-23,Transfer,00.00,"70,555.85","2,11,667.54",
29-Sep-23,Transportellaneous,"1,89,357.50",00.00,"4,01,025.04",
29-Sep-23,Bill,00.00,"1,00,256.26","3,00,768.78",
29-Sep-23,Reversal,03.35,00.00,"3,00,772.13",
29-Sep-23,Purchase,00.00,"50,128.69","2,50,643.44",
29-Sep-23,IMPS,00.00,"83,547.81","1,67,095.63",
29-Sep-23,Debit Card,00.00,"16,709.56","1,50,386.07",
29-Sep-23,Purchase,00.00,"21,483.72","1,28,902.35",
29-Sep-23,Bill,00.00,"32,225.59","96,676.76",
29-Sep-23,Interest,00.00,"10,741.86","85,934.90",
29-Sep-23,Transportellaneous,00.00,"28,644.97","57,289.93",
29-Sep-23,Interest,35.62,00.00,"57,325.55",
29-Sep-23,Cheque,00.00,"57,325.55",00.00,
29-Sep-23,Tax,"1,89,127.80",00.00,"1,89,127.80",
29-Sep-23,Bill,02.40,00.00,"1,89,130.20",
29-Sep-23,Reversal,00.00,"1,89,130.20",00.00,
29-Sep-23,Transfer,"1,26,723.80",00.00,"1,26,723.80",
29-Sep-23,Cash,00.00,"63,361.90","63,361.90",
29-Sep-23,Reversal,00.00,"15,840.48","47,521.42",
29-Sep-23,Tax,59.83,00.00,"47,581.25",
29-Sep-23,Transportellaneous,00.00,"6,797.32","40,783.93",
29-Sep-23,Reversal,00.00,"40,783.93",00.00,
29-Sep-23,Bill,"10,460.20",00.00,"10,460.20",
29-Sep-23,IMPS,00.00,"1,743.37","8,716.83",
29-Sep-23,RTGS,00.00,"1,452.81","7,264.02",
29-Sep-23,Commission,"7,11,023.50",00.00,"7,18,287.52",
29-Sep-23,Purchase,07.00,00.00,"7,18,294.52",
29-Sep-23,Interest,49.8,00.00,"7,18,344.32",
29-Sep-23,Transportellaneous,00.00,"2,39,448.11","4,78,896.21",
29-Sep-23,Cash,"20,08,170.50",00.00,"24,87,066.71",
29-Sep-23,Commission,00.00,"3,55,295.24","21,31,771.47",
29-Sep-23,Commission,00.00,"5,32,942.87","15,98,828.60",
29-Sep-23,Purchase,03.30,00.00,"15,98,831.90",
29-Sep-23,Reversal,433.2,00.00,"15,99,265.10",
29-Sep-23,NEFT,00.00,"15,99,265.10",00.00,
29-Sep-23,NEFT,"17,54,223.00",00.00,"17,54,223.00",
29-Sep-23,NEFT,"15,94,050.75",00.00,"33,48,273.75",
29-Sep-23,Reversal,00.00,"4,78,324.82","28,69,948.93",
29-Sep-23,ATM,00.00,"14,34,974.47","14,34,974.46",
29-Sep-23,Debit Card,"2,03,871.00",00.00,"16,38,845.46",
29-Sep-23,Transfer,"7,378.34",00.00,"16,46,223.80",
29-Sep-23,Transfer,26,00.00,"16,46,249.80",
29-Sep-23,Bill,"8,767.90",00.00,"16,55,017.70",
29-Sep-23,Transportellaneous,"6,413.00",00.00,"16,61,430.70",
29-Sep-23,IMPS,"12,42,888.80",00.00,"29,04,319.50",
29-Sep-23,NEFT,295,00.00,"29,04,614.50",
29-Sep-23,Transportellaneous,00.00,"29,04,614.50",00.00,
29-Sep-23,Purchase,"2,472.50",00.00,"2,472.50",
29-Sep-23,Commission,"31,896.40",00.00,"34,368.90",
29-Sep-23,Tax,134.77,00.00,"34,503.67",
29-Sep-23,IMPS,"1,497.00",00.00,"36,000.67",
29-Sep-23,Purchase,"1,916.20",00.00,"37,916.87",
29-Sep-23,Tax,02.50,00.00,"37,919.37",
29-Sep-23,Interest,811,00.00,"38,730.37",
29-Sep-23,RTGS,324.1,00.00,"39,054.47",
29-Sep-23,Bill,"14,84,134.00",00.00,"15,23,188.47",
29-Sep-23,NEFT,00.00,"1,69,243.16","13,53,945.31",
29-Sep-23,Interest,00.00,"1,50,438.37","12,03,506.94",
29-Sep-23,Tax,00.00,"3,00,876.74","9,02,630.20",
29-Sep-23,ATM,00.00,"4,51,315.10","4,51,315.10",
29-Sep-23,IMPS,00.00,"56,414.39","3,94,900.71",
29-Sep-23,Bill,00.00,"78,980.14","3,15,920.57",
29-Sep-23,Bill,37,00.00,"3,15,957.57",
30-Sep-23,Transfer,00.00,"1,05,319.19","2,10,638.38",
30-Sep-23,Commission,00.00,"52,659.60","1,57,978.78",
30-Sep-23,ATM,30.33,00.00,"1,58,009.11",
30-Sep-23,Commission,00.00,"31,601.82","1,26,407.29",
30-Sep-23,IMPS,01.38,00.00,"1,26,408.67",
30-Sep-23,NEFT,"2,42,267.34",00.00,"3,68,676.01",
30-Sep-23,Tax,00.00,"92,169.00","2,76,507.01",
30-Sep-23,Debit Card,00.00,"34,563.38","2,41,943.63",
30-Sep-23,Interest,"1,76,186.20",00.00,"4,18,129.83",
30-Sep-23,NEFT,00.00,"4,18,129.83",00.00,
30-Sep-23,IMPS,285.78,00.00,285.78,
30-Sep-23,IMPS,127,00.00,412.78,
30-Sep-23,Cash,"9,25,437.00",00.00,"9,25,849.78",
30-Sep-23,Transfer,02.00,00.00,"9,25,851.78",
30-Sep-23,Commission,"6,99,118.00",00.00,"16,24,969.78",
30-Sep-23,IMPS,03.00,00.00,"16,24,972.78",
30-Sep-23,Transportellaneous,00.00,"2,32,138.97","13,92,833.81",
30-Sep-23,Tax,00.63,00.00,"13,92,834.44",
30-Sep-23,Tax,00.00,"13,92,834.44",00.00,
30-Sep-23,Cheque,"1,16,695.20",00.00,"1,16,695.20",
30-Sep-23,Cash,"6,18,035.00",00.00,"7,34,730.20",
30-Sep-23,Debit Card,13,00.00,"7,34,743.20",
30-Sep-23,Debit Card,"4,039.38",00.00,"7,38,782.58",
30-Sep-23,Tax,335.3,00.00,"7,39,117.88",
30-Sep-23,ATM,00.00,"7,39,117.88",00.00,
30-Sep-23,NEFT,"1,32,199.00",00.00,"1,32,199.00",
30-Sep-23,Cheque,00.00,"33,049.75","99,149.25",
30-Sep-23,ATM,36.3,00.00,"99,185.55",
30-Sep-23,Cash,18,00.00,"99,203.55",
30-Sep-23,Purchase,00.00,"14,171.94","85,031.61",
30-Sep-23,Debit Card,00.00,"42,515.81","42,515.80",
30-Sep-23,Reversal,00.00,"10,628.95","31,886.85",
30-Sep-23,NEFT,00.00,"31,886.85",00.00,
30-Sep-23,RTGS,"26,639.00",00.00,"26,639.00",
30-Sep-23,Bill,46.33,00.00,"26,685.33",
30-Sep-23,Reversal,03.00,00.00,"26,688.33",
30-Sep-23,Interest,91,00.00,"26,779.33",
30-Sep-23,IMPS,06.00,00.00,"26,785.33",
30-Sep-23,Cash,07.69,00.00,"26,793.02",
30-Sep-23,Commission,"13,618.00",00.00,"40,411.02",
30-Sep-23,Cheque,00.00,"40,411.02",00.00,
30-Sep-23,ATM,"23,067.09",00.00,"23,067.09",
30-Sep-23,Cash,"38,347.50",00.00,"61,414.59",
30-Sep-23,Commission,"2,37,541.00",00.00,"2,98,955.59",
30-Sep-23,Transfer,00.00,"2,98,955.59",00.00,
30-Sep-23,Transportellaneous,"2,905.61",00.00,"2,905.61",
30-Sep-23,Transportellaneous,00.00,363.2,"2,542.41",
30-Sep-23,Tax,"3,556.20",00.00,"6,098.61",
30-Sep-23,Commission,"17,47,616.00",00.00,"17,53,714.61",
30-Sep-23,IMPS,"4,145.18",00.00,"17,57,859.79",
30-Sep-23,ATM,00.00,"8,78,929.90","8,78,929.90",
30-Sep-23,Commission,"1,02,026.20",00.00,"9,80,956.10",
30-Sep-23,Debit Card,84.75,00.00,"9,81,040.85",
30-Sep-23,Transportellaneous,"4,728.00",00.00,"9,85,768.85",
30-Sep-23,Reversal,00.00,"4,92,884.43","4,92,884.42",
30-Sep-23,Transfer,00.00,"2,46,442.21","2,46,442.21",
01-Oct-23,Transfer,00.00,"82,147.40","1,64,294.81",
01-Oct-23,NEFT,00.00,"54,764.94","1,09,529.87",
01-Oct-23,Bill,00.00,"21,905.97","87,623.90",
01-Oct-23,Reversal,"3,473.98",00.00,"91,097.88",
01-Oct-23,Cheque,357.9,00.00,"91,455.78",
01-Oct-23,IMPS,"3,597.60",00.00,"95,053.38",
01-Oct-23,Bill,00.00,"9,505.34","85,548.04",
01-Oct-23,Cash,00.00,"9,505.34","76,042.70",
01-Oct-23,IMPS,00.00,"19,010.68","57,032.02",
01-Oct-23,IMPS,"1,60,730.97",00.00,"2,17,762.99",
01-Oct-23,Commission,02.77,00.00,"2,17,765.76",
01-Oct-23,IMPS,"11,42,301.00",00.00,"13,60,066.76",
01-Oct-23,IMPS,00.00,"1,94,295.25","11,65,771.51",
02-Oct-23,Debit Card,00.00,"1,16,577.15","10,49,194.36",
02-Oct-23,Commission,02.30,00.00,"10,49,196.66",
02-Oct-23,Reversal,00.00,"1,04,919.67","9,44,276.99",
02-Oct-23,Reversal,05.99,00.00,"9,44,282.98",
02-Oct-23,RTGS,00.00,"1,04,920.33","8,39,362.65",
02-Oct-23,Cheque,"11,28,227.50",00.00,"19,67,590.15",
03-Oct-23,Reversal,00.00,"1,96,759.02","17,70,831.14",
03-Oct-23,RTGS,"1,97,077.60",00.00,"19,67,908.74",
03-Oct-23,Commission,06.00,00.00,"19,67,914.74",
03-Oct-23,RTGS,00.00,"3,27,985.79","16,39,928.95",
03-Oct-23,Bill,00.00,"3,27,985.79","13,11,943.16",
03-Oct-23,Commission,63.9,00.00,"13,12,007.06",
03-Oct-23,Bill,"3,549.70",00.00,"13,15,556.76",
03-Oct-23,Reversal,00.00,"13,15,556.76",00.00,
03-Oct-23,ATM,485,00.00,485,
03-Oct-23,IMPS,"27,208.00",00.00,"27,693.00",
03-Oct-23,Transportellaneous,00.00,"3,077.00","24,616.00",
03-Oct-23,Tax,00.00,"6,154.00","18,462.00",
03-Oct-23,Cheque,00.00,"2,051.33","16,410.67",
03-Oct-23,Bill,"87,534.00",00.00,"1,03,944.67",
03-Oct-23,Transfer,00.00,"10,394.47","93,550.20",
03-Oct-23,Cheque,00.00,"93,550.20",00.00,
03-Oct-23,RTGS,03.40,00.00,03.40,
03-Oct-23,Transfer,00.00,00.85,02.55,
03-Oct-23,RTGS,"1,317.45",00.00,"1,320.00",
03-Oct-23,Reversal,"9,98,858.50",00.00,"10,00,178.50",
03-Oct-23,Transportellaneous,00.00,"1,25,022.31","8,75,156.19",
03-Oct-23,Transfer,00.00,"8,75,156.19",00.00,
03-Oct-23,Debit Card,03.80,00.00,03.80,
04-Oct-23,Tax,"2,945.59",00.00,"2,949.39",
04-Oct-23,Transportellaneous,00.00,421.34,"2,528.05",
04-Oct-23,Reversal,12.5,00.00,"2,540.55",
04-Oct-23,RTGS,00.00,635.14,"1,905.41",
04-Oct-23,Interest,"1,84,992.00",00.00,"1,86,897.41",
04-Oct-23,Debit Card,00.00,"18,689.74","1,68,207.67",
04-Oct-23,Transfer,00.00,"33,641.53","1,34,566.14",
04-Oct-23,Reversal,104,00.00,"1,34,670.14",
04-Oct-23,Transfer,00.00,"14,963.35","1,19,706.79",
04-Oct-23,ATM,"65,995.00",00.00,"1,85,701.79",
05-Oct-23,RTGS,"6,64,197.00",00.00,"8,49,898.79",
05-Oct-23,IMPS,00.00,"2,83,299.60","5,66,599.19",
05-Oct-23,Debit Card,00.00,"94,433.20","4,72,165.99",
05-Oct-23,Transportellaneous,00.00,"59,020.75","4,13,145.24",
05-Oct-23,Interest,442.27,00.00,"4,13,587.51",
05-Oct-23,Debit Card,00.00,"4,13,587.51",00.00,
05-Oct-23,Bill,"1,503.53",00.00,"1,503.53",
05-Oct-23,Debit Card,00.00,167.06,"1,336.47",
06-Oct-23,Commission,20,00.00,"1,356.47",
06-Oct-23,Commission,00.00,678.24,678.24,
06-Oct-23,IMPS,00.00,169.56,508.68,
07-Oct-23,Interest,00.00,101.74,406.94,
07-Oct-23,Reversal,"5,49,062.00",00.00,"5,49,468.94",
07-Oct-23,ATM,14,00.00,"5,49,482.94",
07-Oct-23,ATM,"26,865.00",00.00,"5,76,347.94",
07-Oct-23,Interest,00.00,"96,057.99","4,80,289.95",
07-Oct-23,Reversal,00.00,"48,029.00","4,32,260.96",
07-Oct-23,Tax,00.00,"43,226.10","3,89,034.86",
07-Oct-23,Tax,"11,57,154.50",00.00,"15,46,189.36",
07-Oct-23,ATM,"2,912.00",00.00,"15,49,101.36",
07-Oct-23,Transportellaneous,"2,07,991.50",00.00,"17,57,092.86",
07-Oct-23,Bill,01.30,00.00,"17,57,094.16",
07-Oct-23,Transportellaneous,00.00,"2,19,636.77","15,37,457.39",
07-Oct-23,IMPS,00.00,"2,56,242.90","12,81,214.49",
07-Oct-23,Transfer,45.2,00.00,"12,81,259.69",
08-Oct-23,Cheque,05.50,00.00,"12,81,265.19",
08-Oct-23,Commission,00.00,"6,40,632.60","6,40,632.60",
09-Oct-23,Cash,03.10,00.00,"6,40,635.70",
09-Oct-23,Cheque,"28,725.00",00.00,"6,69,360.70",
09-Oct-23,Cheque,00.00,"1,11,560.12","5,57,800.58",
09-Oct-23,Transfer,00.00,"69,725.07","4,88,075.51",
09-Oct-23,Purchase,03.52,00.00,"4,88,079.03",
09-Oct-23,Reversal,00.00,"97,615.81","3,90,463.22",
09-Oct-23,Cash,"1,96,400.10",00.00,"5,86,863.32",
09-Oct-23,Interest,00.00,"1,46,715.83","4,40,147.49",
09-Oct-23,Cash,00.00,"62,878.21","3,77,269.28",
09-Oct-23,Cash,00.00,"1,88,634.64","1,88,634.64",
09-Oct-23,Tax,00.00,"37,726.93","1,50,907.71",
10-Oct-23,Transfer,61,00.00,"1,50,968.71",
10-Oct-23,ATM,"2,37,731.16",00.00,"3,88,699.87",
10-Oct-23,IMPS,00.00,"64,783.31","3,23,916.56",
10-Oct-23,IMPS,00.00,"46,273.79","2,77,642.77",
10-Oct-23,Purchase,03.00,00.00,"2,77,645.77",
10-Oct-23,Interest,06.58,00.00,"2,77,652.35",
10-Oct-23,RTGS,00.00,"39,664.62","2,37,987.73",
10-Oct-23,Tax,00.00,"26,443.08","2,11,544.65",
10-Oct-23,Interest,04.00,00.00,"2,11,548.65",
10-Oct-23,Cash,00.00,"21,154.87","1,90,393.78",
10-Oct-23,Cash,26.3,00.00,"1,90,420.08",
10-Oct-23,Tax,"74,674.00",00.00,"2,65,094.08",
10-Oct-23,Tax,"2,37,391.30",00.00,"5,02,485.38",
10-Oct-23,Transfer,00.00,"71,783.63","4,30,701.75",
10-Oct-23,Transportellaneous,00.00,"1,07,675.44","3,23,026.31",
10-Oct-23,RTGS,00.00,"64,605.26","2,58,421.05",
10-Oct-23,NEFT,00.00,"25,842.11","2,32,578.94",
11-Oct-23,IMPS,00.00,"23,257.89","2,09,321.05",
11-Oct-23,Purchase,00.00,"23,257.89","1,86,063.16",
11-Oct-23,Tax,"21,677.00",00.00,"2,07,740.16",
11-Oct-23,Commission,05.03,00.00,"2,07,745.19",
11-Oct-23,IMPS,"3,579.45",00.00,"2,11,324.64",
11-Oct-23,Reversal,00.00,"23,480.52","1,87,844.12",
11-Oct-23,Transportellaneous,"23,596.60",00.00,"2,11,440.72",
11-Oct-23,Commission,00.00,"21,144.07","1,90,296.65",
11-Oct-23,Interest,02.40,00.00,"1,90,299.05",
11-Oct-23,IMPS,00.00,"1,90,299.05",00.00,
11-Oct-23,Tax,08.00,00.00,08.00,
11-Oct-23,Transportellaneous,"2,41,492.80",00.00,"2,41,500.80",
11-Oct-23,Interest,00.00,"30,187.60","2,11,313.20",
11-Oct-23,RTGS,00.00,"30,187.60","1,81,125.60",
11-Oct-23,Cheque,00.00,"22,640.70","1,58,484.90",
11-Oct-23,Transportellaneous,00.00,"26,414.15","1,32,070.75",
11-Oct-23,IMPS,51.7,00.00,"1,32,122.45",
11-Oct-23,Bill,00.70,00.00,"1,32,123.15",
11-Oct-23,ATM,"1,039.19",00.00,"1,33,162.34",
11-Oct-23,Cheque,00.00,"1,33,162.34",00.00,
11-Oct-23,Interest,"2,597.00",00.00,"2,597.00",
11-Oct-23,ATM,00.00,288.56,"2,308.44",
11-Oct-23,Debit Card,00.00,329.78,"1,978.66",
11-Oct-23,RTGS,00.00,197.87,"1,780.79",
11-Oct-23,ATM,"1,24,491.00",00.00,"1,26,271.79",
11-Oct-23,RTGS,"21,229.00",00.00,"1,47,500.79",
11-Oct-23,IMPS,"3,554.00",00.00,"1,51,054.79",
11-Oct-23,Interest,147,00.00,"1,51,201.79",
11-Oct-23,Cheque,00.00,"75,600.90","75,600.90",
11-Oct-23,Commission,04.00,00.00,"75,604.90",
11-Oct-23,Purchase,00.00,"7,560.49","68,044.41",
11-Oct-23,Cash,283.9,00.00,"68,328.31",
11-Oct-23,Interest,04.50,00.00,"68,332.81",
11-Oct-23,NEFT,00.00,"13,666.56","54,666.25",
12-Oct-23,Cheque,21.7,00.00,"54,687.95",
12-Oct-23,Purchase,06.00,00.00,"54,693.95",
12-Oct-23,Tax,00.00,"27,346.98","27,346.98",
12-Oct-23,ATM,00.00,"27,346.98",00.00,
12-Oct-23,ATM,"94,727.72",00.00,"94,727.72",
12-Oct-23,Debit Card,02.00,00.00,"94,729.72",
12-Oct-23,Cash,00.00,"15,788.29","78,941.43",
12-Oct-23,Tax,41.6,00.00,"78,983.03",
12-Oct-23,Reversal,"2,14,448.80",00.00,"2,93,431.83",
13-Oct-23,RTGS,434.56,00.00,"2,93,866.39",
13-Oct-23,Tax,00.00,"29,386.64","2,64,479.75",
13-Oct-23,Interest,00.00,"1,32,239.88","1,32,239.88",
13-Oct-23,Transfer,00.00,"16,529.99","1,15,709.90",
13-Oct-23,Cheque,00.00,"12,856.66","1,02,853.24",
13-Oct-23,Debit Card,00.00,"25,713.31","77,139.93",
13-Oct-23,Cash,00.00,"15,427.99","61,711.94",
13-Oct-23,NEFT,00.00,"8,815.99","52,895.95",
13-Oct-23,Tax,00.00,"26,447.98","26,447.98",
13-Oct-23,Bill,"13,71,084.00",00.00,"13,97,531.98",
13-Oct-23,Commission,"1,96,137.75",00.00,"15,93,669.73",
14-Oct-23,NEFT,"1,456.90",00.00,"15,95,126.63",
14-Oct-23,Cheque,00.00,"1,99,390.83","13,95,735.80",
14-Oct-23,Transportellaneous,00.00,"1,74,466.98","12,21,268.82",
14-Oct-23,Interest,187.7,00.00,"12,21,456.52",
14-Oct-23,NEFT,00.00,"2,44,291.30","9,77,165.22",
14-Oct-23,Purchase,229.45,00.00,"9,77,394.67",
14-Oct-23,Debit Card,06.00,00.00,"9,77,400.67",
14-Oct-23,Debit Card,00.00,"97,740.07","8,79,660.60",
14-Oct-23,Purchase,"1,63,786.00",00.00,"10,43,446.60",
14-Oct-23,ATM,00.00,"3,47,815.53","6,95,631.07",
14-Oct-23,Debit Card,00.00,"3,47,815.54","3,47,815.54",
14-Oct-23,Reversal,16.4,00.00,"3,47,831.94",
14-Oct-23,Transfer,04.68,00.00,"3,47,836.62",
14-Oct-23,Interest,"2,44,352.10",00.00,"5,92,188.72",
14-Oct-23,ATM,06.00,00.00,"5,92,194.72",
14-Oct-23,Commission,00.00,"1,97,398.24","3,94,796.48",
14-Oct-23,Purchase,00.00,"1,31,598.83","2,63,197.65",
14-Oct-23,Interest,"73,403.40",00.00,"3,36,601.05",
14-Oct-23,Cash,33,00.00,"3,36,634.05",
14-Oct-23,Purchase,01.13,00.00,"3,36,635.18",
14-Oct-23,Interest,00.00,"67,327.04","2,69,308.14",
14-Oct-23,ATM,00.00,"26,930.81","2,42,377.33",
14-Oct-23,Cheque,00.00,"26,930.81","2,15,446.52",
14-Oct-23,Transportellaneous,167.5,00.00,"2,15,614.02",
14-Oct-23,NEFT,00.00,"71,871.34","1,43,742.68",
14-Oct-23,ATM,349.8,00.00,"1,44,092.48",
14-Oct-23,Cash,00.00,"48,030.83","96,061.65",
14-Oct-23,Purchase,"6,57,179.00",00.00,"7,53,240.65",
14-Oct-23,NEFT,"11,01,454.75",00.00,"18,54,695.40",
14-Oct-23,Debit Card,"12,069.56",00.00,"18,66,764.96",
14-Oct-23,Cheque,"13,24,644.00",00.00,"31,91,408.96",
14-Oct-23,Transfer,00.00,"31,91,408.96",00.00,
14-Oct-23,Transfer,"1,73,148.22",00.00,"1,73,148.22",
14-Oct-23,Cash,05.81,00.00,"1,73,154.03",
14-Oct-23,IMPS,307,00.00,"1,73,461.03",
14-Oct-23,Transportellaneous,00.00,"43,365.26","1,30,095.77",
14-Oct-23,IMPS,00.00,"16,261.97","1,13,833.80",
14-Oct-23,Reversal,00.00,"56,916.90","56,916.90",
14-Oct-23,Transportellaneous,"5,773.00",00.00,"62,689.90",
14-Oct-23,Reversal,"1,39,491.50",00.00,"2,02,181.40",
14-Oct-23,ATM,00.00,"2,02,181.40",00.00,
14-Oct-23,IMPS,"29,204.50",00.00,"29,204.50",
14-Oct-23,RTGS,33,00.00,"29,237.50",
14-Oct-23,Debit Card,00.00,"2,923.75","26,313.75",
14-Oct-23,Debit Card,00.00,"26,313.75",00.00,
14-Oct-23,Debit Card,02.50,00.00,02.50,
14-Oct-23,Interest,02.71,00.00,05.21,
14-Oct-23,IMPS,00.00,01.74,03.47,
14-Oct-23,Interest,00.00,01.74,01.74,
14-Oct-23,Cash,464.5,00.00,466.24,
14-Oct-23,Cash,00.00,93.25,372.99,
14-Oct-23,Interest,"62,391.62",00.00,"62,764.61",
14-Oct-23,Debit Card,"27,847.51",00.00,"90,612.12",
14-Oct-23,Commission,00.00,"9,061.21","81,550.91",
14-Oct-23,Purchase,"67,475.00",00.00,"1,49,025.91",
14-Oct-23,Commission,00.00,"14,902.59","1,34,123.32",
14-Oct-23,Purchase,00.00,"14,902.59","1,19,220.73",
14-Oct-23,Cheque,00.00,"14,902.59","1,04,318.14",
14-Oct-23,Transportellaneous,00.00,"52,159.07","52,159.07",
14-Oct-23,Tax,00.00,"10,431.81","41,727.26",
14-Oct-23,Reversal,"2,929.00",00.00,"44,656.26",
14-Oct-23,Debit Card,"2,296.76",00.00,"46,953.02",
14-Oct-23,Commission,"1,300.49",00.00,"48,253.51",
14-Oct-23,Tax,"1,751.00",00.00,"50,004.51",
14-Oct-23,Reversal,00.00,"12,501.13","37,503.38",
14-Oct-23,Debit Card,00.00,"5,357.63","32,145.75",
14-Oct-23,Debit Card,05.90,00.00,"32,151.65",
14-Oct-23,Reversal,00.00,"10,717.22","21,434.43",
14-Oct-23,ATM,00.00,"4,286.89","17,147.54",
14-Oct-23,RTGS,425.9,00.00,"17,573.44",
14-Oct-23,NEFT,639.9,00.00,"18,213.34",
14-Oct-23,Bill,"18,97,460.00",00.00,"19,15,673.34",
14-Oct-23,IMPS,00.00,"9,57,836.67","9,57,836.67",
14-Oct-23,Bill,"3,858.00",00.00,"9,61,694.67",
14-Oct-23,Cash,00.00,"2,40,423.67","7,21,271.00",
14-Oct-23,Commission,00.00,"1,80,317.75","5,40,953.25",
14-Oct-23,IMPS,78,00.00,"5,41,031.25",
14-Oct-23,RTGS,"1,70,134.10",00.00,"7,11,165.35",
14-Oct-23,Transportellaneous,00.00,"1,01,595.05","6,09,570.30",
14-Oct-23,Tax,00.00,"76,196.29","5,33,374.01",
14-Oct-23,Purchase,00.00,"59,263.78","4,74,110.23",
14-Oct-23,Reversal,"27,650.18",00.00,"5,01,760.41",
14-Oct-23,ATM,00.00,"83,626.74","4,18,133.68",
14-Oct-23,Cheque,00.00,"59,733.38","3,58,400.30",
14-Oct-23,Tax,00.00,"1,79,200.15","1,79,200.15",
14-Oct-23,Cheque,00.00,"29,866.69","1,49,333.46",
14-Oct-23,Reversal,61.85,00.00,"1,49,395.31",
14-Oct-23,Debit Card,06.00,00.00,"1,49,401.31",
14-Oct-23,Bill,"1,13,825.47",00.00,"2,63,226.78",
14-Oct-23,Cash,"2,15,908.00",00.00,"4,79,134.78",
14-Oct-23,Cash,00.00,"4,79,134.78",00.00,
14-Oct-23,Purchase,"23,403.20",00.00,"23,403.20",
14-Oct-23,Commission,00.00,"2,340.32","21,062.88",
14-Oct-23,RTGS,"1,704.90",00.00,"22,767.78",
14-Oct-23,Bill,30,00.00,"22,797.78",
14-Oct-23,IMPS,00.00,"2,849.72","19,948.06",
14-Oct-23,Commission,"3,35,121.75",00.00,"3,55,069.81",
14-Oct-23,Transfer,00.00,"1,18,356.60","2,36,713.21",
14-Oct-23,Debit Card,"3,808.36",00.00,"2,40,521.57",
14-Oct-23,NEFT,00.00,"24,052.16","2,16,469.41",
14-Oct-23,Tax,"1,782.00",00.00,"2,18,251.41",
14-Oct-23,Cheque,00.00,"2,18,251.41",00.00,
14-Oct-23,Reversal,"3,202.00",00.00,"3,202.00",
14-Oct-23,Debit Card,06.82,00.00,"3,208.82",
14-Oct-23,Bill,03.50,00.00,"3,212.32",
14-Oct-23,Interest,00.00,401.54,"2,810.78",
14-Oct-23,Bill,"13,675.00",00.00,"16,485.78",
14-Oct-23,Tax,00.00,"16,485.78",00.00,
14-Oct-23,IMPS,"2,773.90",00.00,"2,773.90",
14-Oct-23,RTGS,00.00,346.74,"2,427.16",
14-Oct-23,Purchase,00.00,269.68,"2,157.48",
14-Oct-23,Purchase,36.1,00.00,"2,193.58",
14-Oct-23,Interest,00.00,219.36,"1,974.22",
14-Oct-23,Reversal,06.72,00.00,"1,980.94",
14-Oct-23,Purchase,"61,315.00",00.00,"63,295.94",
14-Oct-23,NEFT,00.00,"21,098.65","42,197.29",
14-Oct-23,ATM,"20,80,272.80",00.00,"21,22,470.09",
14-Oct-23,Interest,00.00,"3,53,745.02","17,68,725.08",
14-Oct-23,Reversal,00.00,"2,52,675.01","15,16,050.07",
14-Oct-23,Bill,00.00,"2,52,675.01","12,63,375.06",
14-Oct-23,NEFT,365,00.00,"12,63,740.06",
14-Oct-23,Transportellaneous,00.00,"1,80,534.29","10,83,205.77",
14-Oct-23,Bill,34,00.00,"10,83,239.77",
14-Oct-23,Transfer,"1,91,508.00",00.00,"12,74,747.77",
14-Oct-23,Transfer,00.00,"1,27,474.78","11,47,272.99",
14-Oct-23,Reversal,"1,485.00",00.00,"11,48,757.99",
14-Oct-23,NEFT,00.00,"1,27,639.78","10,21,118.21",
14-Oct-23,Transportellaneous,05.26,00.00,"10,21,123.47",
14-Oct-23,RTGS,06.83,00.00,"10,21,130.30",
14-Oct-23,Commission,02.80,00.00,"10,21,133.10",
14-Oct-23,Transfer,59.06,00.00,"10,21,192.16",
14-Oct-23,Reversal,00.00,"10,21,192.16",00.00,
14-Oct-23,RTGS,"12,648.40",00.00,"12,648.40",
14-Oct-23,Cash,00.00,"1,405.38","11,243.02",
14-Oct-23,RTGS,00.00,"1,249.22","9,993.80",
14-Oct-23,NEFT,00.00,"4,996.90","4,996.90",
15-Oct-23,Commission,06.78,00.00,"5,003.68",
15-Oct-23,Cash,00.00,"1,000.74","4,002.94",
15-Oct-23,Transfer,"1,958.00",00.00,"5,960.94",
15-Oct-23,IMPS,00.00,"5,960.94",00.00,
15-Oct-23,Commission,"1,490.00",00.00,"1,490.00",
15-Oct-23,Transfer,00.00,496.67,993.33,
15-Oct-23,IMPS,00.00,165.56,827.78,
15-Oct-23,Purchase,00.00,206.95,620.84,
15-Oct-23,Cheque,00.00,155.21,465.63,
15-Oct-23,Debit Card,00.00,66.52,399.11,
15-Oct-23,Debit Card,00.00,49.89,349.22,
15-Oct-23,Transfer,00.00,49.89,299.33,
16-Oct-23,RTGS,00.00,99.78,199.55,
16-Oct-23,RTGS,403,00.00,602.55,
16-Oct-23,ATM,00.00,301.28,301.27,
16-Oct-23,Cheque,"32,556.00",00.00,"32,857.27",
16-Oct-23,ATM,"1,14,023.50",00.00,"1,46,880.77",
16-Oct-23,RTGS,00.00,"14,688.08","1,32,192.69",
16-Oct-23,IMPS,00.00,"33,048.17","99,144.52",
16-Oct-23,Tax,00.00,"33,048.17","66,096.35",
16-Oct-23,Transfer,"2,055.50",00.00,"68,151.85",
16-Oct-23,Debit Card,00.00,"34,075.93","34,075.93",
16-Oct-23,RTGS,00.99,00.00,"34,076.92",
16-Oct-23,ATM,00.00,"3,407.69","30,669.23",
16-Oct-23,Bill,01.00,00.00,"30,670.23",
16-Oct-23,NEFT,300.43,00.00,"30,970.66",
17-Oct-23,Purchase,00.00,"6,194.13","24,776.53",
17-Oct-23,RTGS,00.00,"4,955.31","19,821.22",
17-Oct-23,IMPS,00.00,"19,821.22",00.00,
17-Oct-23,NEFT,717.44,00.00,717.44,
17-Oct-23,Commission,"2,54,133.30",00.00,"2,54,850.74",
17-Oct-23,Interest,00.00,"50,970.15","2,03,880.59",
18-Oct-23,Tax,00.00,"2,03,880.59",00.00,
18-Oct-23,RTGS,"62,077.50",00.00,"62,077.50",
18-Oct-23,ATM,00.00,"20,692.50","41,385.00",
18-Oct-23,Interest,00.00,"4,598.33","36,786.67",
18-Oct-23,Bill,00.00,"3,678.67","33,108.00",
18-Oct-23,Tax,495.6,00.00,"33,603.60",
18-Oct-23,Debit Card,"13,03,824.25",00.00,"13,37,427.85",
18-Oct-23,Bill,00.00,"1,48,603.09","11,88,824.76",
18-Oct-23,ATM,00.00,"1,32,091.64","10,56,733.12",
18-Oct-23,RTGS,00.00,"10,56,733.12",00.00,
18-Oct-23,Commission,"80,342.00",00.00,"80,342.00",
18-Oct-23,Debit Card,00.00,"11,477.43","68,864.57",
18-Oct-23,Debit Card,00.00,"11,477.43","57,387.14",
18-Oct-23,Debit Card,00.00,"6,376.35","51,010.79",
18-Oct-23,Interest,111,00.00,"51,121.79",
18-Oct-23,Debit Card,"3,730.00",00.00,"54,851.79",
18-Oct-23,ATM,"91,466.47",00.00,"1,46,318.26",
18-Oct-23,Commission,"10,74,474.00",00.00,"12,20,792.26",
18-Oct-23,ATM,00.00,"3,05,198.07","9,15,594.20",
18-Oct-23,Cash,01.20,00.00,"9,15,595.40",
18-Oct-23,Tax,00.00,"2,28,898.85","6,86,696.55",
18-Oct-23,Transportellaneous,270.18,00.00,"6,86,966.73",
18-Oct-23,Transfer,"2,95,772.25",00.00,"9,82,738.98",
18-Oct-23,Interest,224.65,00.00,"9,82,963.63",
18-Oct-23,Transportellaneous,"28,929.40",00.00,"10,11,893.03",
18-Oct-23,Debit Card,390.77,00.00,"10,12,283.80",
18-Oct-23,RTGS,00.00,"2,53,070.95","7,59,212.85",
18-Oct-23,Commission,"3,233.02",00.00,"7,62,445.87",
18-Oct-23,Cheque,01.67,00.00,"7,62,447.54",
18-Oct-23,Cash,"1,98,055.00",00.00,"9,60,502.54",
18-Oct-23,Bill,"1,033.04",00.00,"9,61,535.58",
18-Oct-23,ATM,41.4,00.00,"9,61,576.98",
18-Oct-23,Transfer,06.90,00.00,"9,61,583.88",
18-Oct-23,Tax,00.00,"3,20,527.96","6,41,055.92",
18-Oct-23,Transfer,00.00,"1,06,842.65","5,34,213.27",
18-Oct-23,Purchase,00.00,"1,06,842.65","4,27,370.62",
18-Oct-23,Cash,14.09,00.00,"4,27,384.71",
18-Oct-23,NEFT,"14,10,576.50",00.00,"18,37,961.21",
18-Oct-23,Bill,00.00,"2,29,745.15","16,08,216.06",
18-Oct-23,RTGS,61.1,00.00,"16,08,277.16",
18-Oct-23,Transfer,"2,58,685.00",00.00,"18,66,962.16",
18-Oct-23,Bill,00.00,"2,66,708.88","16,00,253.28",
18-Oct-23,NEFT,"12,27,339.20",00.00,"28,27,592.48",
18-Oct-23,NEFT,00.00,"28,27,592.48",00.00,
18-Oct-23,Cheque,44.5,00.00,44.5,
18-Oct-23,RTGS,00.00,06.36,38.14,
18-Oct-23,Cheque,260,00.00,298.14,
19-Oct-23,Interest,00.00,298.14,00.00,
19-Oct-23,Transfer,13.14,00.00,13.14,
19-Oct-23,Purchase,"2,274.00",00.00,"2,287.14",
19-Oct-23,Cheque,00.00,"1,143.57","1,143.57",
19-Oct-23,Transportellaneous,"90,667.00",00.00,"91,810.57",
19-Oct-23,Interest,00.00,"30,603.52","61,207.05",
19-Oct-23,Cheque,00.00,"20,402.35","40,804.70",
19-Oct-23,Purchase,00.00,"5,829.24","34,975.46",
19-Oct-23,RTGS,00.00,"4,371.93","30,603.53",
19-Oct-23,IMPS,"2,937.00",00.00,"33,540.53",
19-Oct-23,ATM,00.00,"4,791.50","28,749.03",
19-Oct-23,Bill,871.5,00.00,"29,620.53",
19-Oct-23,Purchase,00.00,"3,291.17","26,329.36",
19-Oct-23,IMPS,"1,52,204.59",00.00,"1,78,533.95",
19-Oct-23,Bill,"1,491.79",00.00,"1,80,025.74",
19-Oct-23,Interest,00.00,"22,503.22","1,57,522.52",
19-Oct-23,RTGS,00.00,"39,380.63","1,18,141.89",
19-Oct-23,RTGS,"31,823.87",00.00,"1,49,965.76",
19-Oct-23,Interest,00.00,"16,662.86","1,33,302.90",
19-Oct-23,Debit Card,"3,140.96",00.00,"1,36,443.86",
19-Oct-23,RTGS,00.00,"34,110.97","1,02,332.89",
19-Oct-23,Transportellaneous,00.00,"11,370.32","90,962.57",
19-Oct-23,Bill,00.00,"90,962.57",00.00,
19-Oct-23,RTGS,"1,99,496.00",00.00,"1,99,496.00",
19-Oct-23,Interest,00.00,"66,498.67","1,32,997.33",
19-Oct-23,Debit Card,42.7,00.00,"1,33,040.03",
19-Oct-23,NEFT,00.00,"26,608.01","1,06,432.02",
19-Oct-23,ATM,00.00,"35,477.34","70,954.68",
19-Oct-23,IMPS,284.8,00.00,"71,239.48",
19-Oct-23,Transportellaneous,"9,64,208.80",00.00,"10,35,448.28",
19-Oct-23,Debit Card,"16,53,694.50",00.00,"26,89,142.78",
19-Oct-23,Cheque,52.4,00.00,"26,89,195.18",
19-Oct-23,RTGS,00.00,"26,89,195.18",00.00,
19-Oct-23,IMPS,"1,97,648.47",00.00,"1,97,648.47",
19-Oct-23,Purchase,00.00,"49,412.12","1,48,236.35",
19-Oct-23,Tax,00.00,"24,706.06","1,23,530.29",
19-Oct-23,Transfer,00.00,"15,441.29","1,08,089.00",
19-Oct-23,Transfer,00.00,"12,009.89","96,079.11",
19-Oct-23,NEFT,00.45,00.00,"96,079.56",
19-Oct-23,Transportellaneous,00.00,"24,019.89","72,059.67",
19-Oct-23,Cheque,"3,156.00",00.00,"75,215.67",
19-Oct-23,RTGS,221,00.00,"75,436.67",
19-Oct-23,ATM,00.00,"7,543.67","67,893.00",
19-Oct-23,Tax,467.42,00.00,"68,360.42",
19-Oct-23,Purchase,00.00,"13,672.08","54,688.34",
19-Oct-23,Transportellaneous,474.16,00.00,"55,162.50",
19-Oct-23,RTGS,00.00,"6,895.31","48,267.19",
19-Oct-23,Commission,00.00,"5,363.02","42,904.17",
19-Oct-23,IMPS,00.00,"8,580.83","34,323.34",
19-Oct-23,Reversal,00.00,"17,161.67","17,161.67",
19-Oct-23,IMPS,00.00,"2,860.28","14,301.39",
19-Oct-23,Cash,00.00,"2,043.06","12,258.33",
19-Oct-23,IMPS,00.00,"2,451.67","9,806.66",
19-Oct-23,Transfer,"15,12,514.80",00.00,"15,22,321.46",
19-Oct-23,Cash,00.00,"1,52,232.15","13,70,089.31",
19-Oct-23,Bill,00.00,"3,42,522.33","10,27,566.98",
19-Oct-23,NEFT,313.03,00.00,"10,27,880.01",
19-Oct-23,Cash,"2,467.00",00.00,"10,30,347.01",
19-Oct-23,NEFT,"3,952.30",00.00,"10,34,299.31",
19-Oct-23,RTGS,00.00,"5,17,149.66","5,17,149.66",
19-Oct-23,Transportellaneous,00.00,"57,461.07","4,59,688.59",
20-Oct-23,Purchase,00.00,"76,614.77","3,83,073.82",
20-Oct-23,Transfer,00.00,"3,83,073.82",00.00,
20-Oct-23,RTGS,"2,36,311.80",00.00,"2,36,311.80",
20-Oct-23,Debit Card,00.00,"26,256.87","2,10,054.93",
20-Oct-23,Transfer,00.00,"26,256.87","1,83,798.06",
20-Oct-23,Purchase,01.00,00.00,"1,83,799.06",
20-Oct-23,Commission,180.66,00.00,"1,83,979.72",
20-Oct-23,NEFT,00.00,"18,397.97","1,65,581.75",
20-Oct-23,Cheque,00.00,"1,65,581.75",00.00,
20-Oct-23,IMPS,05.65,00.00,05.65,
20-Oct-23,Transportellaneous,60.3,00.00,65.95,
20-Oct-23,NEFT,"4,683.59",00.00,"4,749.54",
20-Oct-23,Transfer,"16,24,993.75",00.00,"16,29,743.29",
21-Oct-23,Reversal,"13,105.12",00.00,"16,42,848.41",
21-Oct-23,IMPS,675.1,00.00,"16,43,523.51",
21-Oct-23,RTGS,00.00,"5,47,841.17","10,95,682.34",
21-Oct-23,Tax,00.00,"1,09,568.23","9,86,114.11",
21-Oct-23,Transportellaneous,00.00,"1,40,873.44","8,45,240.67",
21-Oct-23,Tax,00.00,"8,45,240.67",00.00,
21-Oct-23,Purchase,"2,534.90",00.00,"2,534.90",
21-Oct-23,Transportellaneous,00.00,"1,267.45","1,267.45",
21-Oct-23,IMPS,08.00,00.00,"1,275.45",
21-Oct-23,RTGS,00.00,141.72,"1,133.73",
21-Oct-23,Commission,270,00.00,"1,403.73",
21-Oct-23,IMPS,"9,71,866.80",00.00,"9,73,270.53",
21-Oct-23,Cash,00.65,00.00,"9,73,271.18",
21-Oct-23,Bill,"60,910.00",00.00,"10,34,181.18",
21-Oct-23,Reversal,"23,229.28",00.00,"10,57,410.46",
21-Oct-23,RTGS,277.7,00.00,"10,57,688.16",
21-Oct-23,NEFT,"2,247.80",00.00,"10,59,935.96",
21-Oct-23,Commission,"2,57,442.40",00.00,"13,17,378.36",
21-Oct-23,Transportellaneous,"27,762.00",00.00,"13,45,140.36",
21-Oct-23,Purchase,00.00,"1,68,142.55","11,76,997.82",
21-Oct-23,Tax,02.00,00.00,"11,76,999.82",
21-Oct-23,Transfer,00.00,"1,96,166.64","9,80,833.18",
21-Oct-23,RTGS,00.00,"9,80,833.18",00.00,
21-Oct-23,Interest,07.00,00.00,07.00,
21-Oct-23,ATM,00.00,02.33,04.67,
21-Oct-23,Cheque,00.00,01.56,03.11,
21-Oct-23,Tax,"16,430.80",00.00,"16,433.91",
21-Oct-23,Reversal,"2,193.70",00.00,"18,627.61",
21-Oct-23,Transportellaneous,"31,057.00",00.00,"49,684.61",
21-Oct-23,ATM,00.00,"16,561.54","33,123.07",
21-Oct-23,Reversal,00.00,"4,731.87","28,391.20",
21-Oct-23,Reversal,00.00,"5,678.24","22,712.96",
21-Oct-23,Transportellaneous,00.00,"2,523.66","20,189.30",
21-Oct-23,Cash,00.00,"2,523.66","17,665.64",
21-Oct-23,Debit Card,00.00,"17,665.64",00.00,
21-Oct-23,ATM,"1,41,013.59",00.00,"1,41,013.59",
21-Oct-23,Bill,00.00,"15,668.18","1,25,345.41",
21-Oct-23,Transfer,962.32,00.00,"1,26,307.73",
21-Oct-23,Interest,00.00,"21,051.29","1,05,256.44",
21-Oct-23,RTGS,00.00,"13,157.06","92,099.38",
21-Oct-23,RTGS,20.7,00.00,"92,120.08",
21-Oct-23,ATM,00.00,"13,160.01","78,960.07",
21-Oct-23,Tax,00.00,"26,320.02","52,640.05",
21-Oct-23,Interest,443.8,00.00,"53,083.85",
21-Oct-23,IMPS,612,00.00,"53,695.85",
21-Oct-23,IMPS,00.00,"17,898.62","35,797.23",
21-Oct-23,Debit Card,"10,457.00",00.00,"46,254.23",
22-Oct-23,ATM,00.00,"15,418.08","30,836.15",
22-Oct-23,Cheque,00.00,"6,167.23","24,668.92",
22-Oct-23,Reversal,"1,916.30",00.00,"26,585.22",
22-Oct-23,Transportellaneous,00.00,"13,292.61","13,292.61",
22-Oct-23,Commission,"3,466.40",00.00,"16,759.01",
22-Oct-23,Cheque,01.40,00.00,"16,760.41",
22-Oct-23,Cash,00.00,"4,190.10","12,570.31",
22-Oct-23,NEFT,32,00.00,"12,602.31",
22-Oct-23,ATM,00.00,"12,602.31",00.00,
22-Oct-23,Cash,"1,099.00",00.00,"1,099.00",
22-Oct-23,IMPS,00.00,"1,099.00",00.00,
22-Oct-23,Commission,"1,58,091.00",00.00,"1,58,091.00",
22-Oct-23,Transfer,"1,06,367.00",00.00,"2,64,458.00",
22-Oct-23,Reversal,00.00,"44,076.33","2,20,381.67",
22-Oct-23,Bill,00.00,"1,10,190.84","1,10,190.84",
22-Oct-23,Purchase,00.00,"1,10,190.84",00.00,
22-Oct-23,Tax,"11,543.00",00.00,"11,543.00",
22-Oct-23,Debit Card,00.00,"1,154.30","10,388.70",
22-Oct-23,Tax,00.00,"2,597.18","7,791.52",
22-Oct-23,NEFT,"1,43,656.12",00.00,"1,51,447.64",
22-Oct-23,IMPS,02.40,00.00,"1,51,450.04",
22-Oct-23,IMPS,336,00.00,"1,51,786.04",
22-Oct-23,Tax,12.58,00.00,"1,51,798.62",
22-Oct-23,Commission,01.10,00.00,"1,51,799.72",
22-Oct-23,Debit Card,00.00,"25,299.95","1,26,499.77",
22-Oct-23,Cash,07.19,00.00,"1,26,506.96",
22-Oct-23,ATM,00.00,"18,072.42","1,08,434.54",
22-Oct-23,Interest,185.97,00.00,"1,08,620.51",
22-Oct-23,Reversal,00.00,"15,517.22","93,103.29",
22-Oct-23,Transfer,00.00,"9,310.33","83,792.96",
22-Oct-23,Purchase,"74,912.20",00.00,"1,58,705.16",
22-Oct-23,Transportellaneous,00.00,"79,352.58","79,352.58",
22-Oct-23,IMPS,224,00.00,"79,576.58",
22-Oct-23,RTGS,489,00.00,"80,065.58",
22-Oct-23,RTGS,00.00,"20,016.40","60,049.18",
22-Oct-23,Reversal,00.00,"10,008.20","50,040.98",
22-Oct-23,Transfer,32.37,00.00,"50,073.35",
22-Oct-23,Commission,00.00,"10,014.67","40,058.68",
22-Oct-23,Cash,00.00,"13,352.89","26,705.79",
22-Oct-23,ATM,00.00,"2,967.31","23,738.48",
23-Oct-23,NEFT,00.00,"2,637.61","21,100.87",
23-Oct-23,Commission,00.00,"21,100.87",00.00,
23-Oct-23,IMPS,"1,718.00",00.00,"1,718.00",
23-Oct-23,RTGS,"9,29,635.00",00.00,"9,31,353.00",
23-Oct-23,IMPS,00.00,"2,32,838.25","6,98,514.75",
23-Oct-23,Transportellaneous,00.00,"2,32,838.25","4,65,676.50",
23-Oct-23,Interest,00.00,"2,32,838.25","2,32,838.25",
23-Oct-23,Debit Card,00.00,"2,32,838.25",00.00,
23-Oct-23,NEFT,05.50,00.00,05.50,
23-Oct-23,IMPS,00.00,01.10,04.40,
23-Oct-23,Reversal,"15,33,199.00",00.00,"15,33,203.40",
23-Oct-23,Bill,04.35,00.00,"15,33,207.75",
23-Oct-23,Commission,00.00,"15,33,207.75",00.00,
23-Oct-23,Commission,"21,609.31",00.00,"21,609.31",
23-Oct-23,NEFT,00.00,"7,203.10","14,406.21",
23-Oct-23,Cash,09.00,00.00,"14,415.21",
23-Oct-23,Interest,"17,229.75",00.00,"31,644.96",
23-Oct-23,Transfer,"19,543.60",00.00,"51,188.56",
24-Oct-23,IMPS,00.00,"8,531.43","42,657.13",
24-Oct-23,Tax,"1,72,842.00",00.00,"2,15,499.13",
24-Oct-23,Purchase,00.00,"30,785.59","1,84,713.54",
24-Oct-23,Cheque,94,00.00,"1,84,807.54",
24-Oct-23,Reversal,00.00,"36,961.51","1,47,846.03",
24-Oct-23,Transfer,00.00,"1,47,846.03",00.00,
24-Oct-23,Purchase,"2,33,807.00",00.00,"2,33,807.00",
24-Oct-23,Cheque,121.37,00.00,"2,33,928.37",
24-Oct-23,Cash,00.00,"46,785.67","1,87,142.70",
24-Oct-23,IMPS,00.00,"20,793.63","1,66,349.07",
24-Oct-23,Reversal,00.00,"27,724.85","1,38,624.22",
24-Oct-23,Tax,00.00,"15,402.69","1,23,221.53",
24-Oct-23,Commission,"2,45,091.78",00.00,"3,68,313.31",
24-Oct-23,Debit Card,07.49,00.00,"3,68,320.80",
24-Oct-23,Tax,01.10,00.00,"3,68,321.90",
24-Oct-23,ATM,00.00,"92,080.48","2,76,241.43",
24-Oct-23,Commission,00.00,"1,38,120.72","1,38,120.72",
24-Oct-23,Cash,182,00.00,"1,38,302.72",
24-Oct-23,Purchase,00.00,"69,151.36","69,151.36",
24-Oct-23,Interest,"23,477.20",00.00,"92,628.56",
24-Oct-23,RTGS,00.00,"92,628.56",00.00,
24-Oct-23,IMPS,"16,697.09",00.00,"16,697.09",
24-Oct-23,NEFT,"1,840.00",00.00,"18,537.09",
24-Oct-23,Debit Card,01.30,00.00,"18,538.39",
24-Oct-23,Tax,00.00,"2,648.34","15,890.05",
24-Oct-23,Transportellaneous,06.17,00.00,"15,896.22",
24-Oct-23,IMPS,00.00,"2,649.37","13,246.85",
24-Oct-23,Interest,312.85,00.00,"13,559.70",
24-Oct-23,Tax,"2,213.21",00.00,"15,772.91",
24-Oct-23,NEFT,61.88,00.00,"15,834.79",
24-Oct-23,Cheque,00.00,"5,278.26","10,556.53",
24-Oct-23,Reversal,679,00.00,"11,235.53",
24-Oct-23,IMPS,00.00,"3,745.18","7,490.35",
24-Oct-23,IMPS,00.00,832.26,"6,658.09",
24-Oct-23,RTGS,"1,42,487.34",00.00,"1,49,145.43",
24-Oct-23,IMPS,00.00,"21,306.49","1,27,838.94",
24-Oct-23,ATM,00.00,"63,919.47","63,919.47",
24-Oct-23,Transfer,"2,973.30",00.00,"66,892.77",
24-Oct-23,Bill,00.00,"16,723.19","50,169.58",
24-Oct-23,Commission,05.00,00.00,"50,174.58",
24-Oct-23,IMPS,03.89,00.00,"50,178.47",
24-Oct-23,Debit Card,00.00,"6,272.31","43,906.16",
24-Oct-23,NEFT,00.00,"6,272.31","37,633.85",
24-Oct-23,Cash,"3,83,438.50",00.00,"4,21,072.35",
24-Oct-23,IMPS,00.00,"2,10,536.18","2,10,536.18",
24-Oct-23,Interest,"9,53,000.00",00.00,"11,63,536.18",
24-Oct-23,Cheque,00.00,"1,93,922.70","9,69,613.48",
24-Oct-23,IMPS,00.00,"1,07,734.83","8,61,878.65",
24-Oct-23,Purchase,"9,171.20",00.00,"8,71,049.85",
24-Oct-23,IMPS,04.50,00.00,"8,71,054.35",
24-Oct-23,IMPS,00.00,"2,17,763.59","6,53,290.76",
24-Oct-23,Debit Card,00.00,"72,587.86","5,80,702.90",
24-Oct-23,Purchase,396,00.00,"5,81,098.90",
24-Oct-23,Reversal,00.00,"5,81,098.90",00.00,
24-Oct-23,Bill,98.57,00.00,98.57,
24-Oct-23,Cash,"3,355.50",00.00,"3,454.07",
24-Oct-23,Transportellaneous,60.8,00.00,"3,514.87",
24-Oct-23,Transportellaneous,"20,56,393.00",00.00,"20,59,907.87",
24-Oct-23,Interest,"1,16,706.00",00.00,"21,76,613.87",
24-Oct-23,Transfer,00.00,"4,35,322.77","17,41,291.10",
25-Oct-23,Purchase,392,00.00,"17,41,683.10",
25-Oct-23,NEFT,00.00,"2,17,710.39","15,23,972.71",
25-Oct-23,Interest,317.1,00.00,"15,24,289.81",
25-Oct-23,Transportellaneous,"1,462.29",00.00,"15,25,752.10",
25-Oct-23,Transportellaneous,"2,026.20",00.00,"15,27,778.30",
25-Oct-23,IMPS,"24,851.98",00.00,"15,52,630.28",
25-Oct-23,Cash,374.4,00.00,"15,53,004.68",
26-Oct-23,Bill,00.00,"15,53,004.68",00.00,
26-Oct-23,ATM,"2,59,085.03",00.00,"2,59,085.03",
26-Oct-23,Commission,00.00,"28,787.23","2,30,297.80",
26-Oct-23,IMPS,289.8,00.00,"2,30,587.60",
26-Oct-23,NEFT,"7,554.70",00.00,"2,38,142.30",
26-Oct-23,Cheque,731.5,00.00,"2,38,873.80",
26-Oct-23,Cheque,"19,66,005.00",00.00,"22,04,878.80",
26-Oct-23,Commission,"1,50,947.10",00.00,"23,55,825.90",
26-Oct-23,Commission,00.00,"11,77,912.95","11,77,912.95",
27-Oct-23,Interest,00.00,"1,96,318.83","9,81,594.12",
27-Oct-23,Interest,01.00,00.00,"9,81,595.12",
27-Oct-23,NEFT,07.90,00.00,"9,81,603.02",
27-Oct-23,Transportellaneous,00.00,"1,96,320.60","7,85,282.42",
27-Oct-23,ATM,"3,130.00",00.00,"7,88,412.42",
27-Oct-23,Cheque,00.00,"87,601.38","7,00,811.04",
27-Oct-23,Bill,00.00,"1,40,162.21","5,60,648.83",
27-Oct-23,Transportellaneous,00.00,"1,86,882.94","3,73,765.89",
27-Oct-23,Tax,00.00,"37,376.59","3,36,389.30",
27-Oct-23,Bill,"10,88,502.00",00.00,"14,24,891.30",
27-Oct-23,Reversal,00.00,"14,24,891.30",00.00,
27-Oct-23,Commission,80.3,00.00,80.3,
27-Oct-23,IMPS,00.00,26.77,53.53,
27-Oct-23,Cash,00.00,05.35,48.18,
27-Oct-23,Tax,"2,483.00",00.00,"2,531.18",
27-Oct-23,NEFT,"66,378.31",00.00,"68,909.49",
27-Oct-23,Tax,41,00.00,"68,950.49",
27-Oct-23,Transfer,"1,93,260.00",00.00,"2,62,210.49",
27-Oct-23,Tax,00.00,"87,403.50","1,74,806.99",
27-Oct-23,Commission,00.00,"17,480.70","1,57,326.29",
27-Oct-23,Reversal,00.00,"15,732.63","1,41,593.66",
27-Oct-23,RTGS,00.00,"1,41,593.66",00.00,
27-Oct-23,Debit Card,25.81,00.00,25.81,
27-Oct-23,Purchase,01.80,00.00,27.61,
27-Oct-23,Bill,05.11,00.00,32.72,
27-Oct-23,Cheque,00.00,08.18,24.54,
27-Oct-23,IMPS,00.00,08.18,16.36,
27-Oct-23,IMPS,226.13,00.00,242.49,
27-Oct-23,IMPS,153,00.00,395.49,
27-Oct-23,Commission,00.00,131.83,263.66,
27-Oct-23,IMPS,531.6,00.00,795.26,
27-Oct-23,Bill,"2,215.25",00.00,"3,010.51",
27-Oct-23,Commission,00.00,"3,010.51",00.00,
27-Oct-23,Transportellaneous,431.3,00.00,431.3,
27-Oct-23,Transfer,00.00,431.3,00.00,
27-Oct-23,Commission,"14,70,106.00",00.00,"14,70,106.00",
27-Oct-23,Bill,00.00,"7,35,053.00","7,35,053.00",
27-Oct-23,IMPS,00.00,"81,672.56","6,53,380.44",
27-Oct-23,Transfer,00.00,"1,30,676.09","5,22,704.35",
27-Oct-23,Interest,"2,10,378.60",00.00,"7,33,082.95",
27-Oct-23,Bill,"5,46,124.00",00.00,"12,79,206.95",
27-Oct-23,Debit Card,00.00,"1,82,743.85","10,96,463.10",
27-Oct-23,Reversal,00.00,"1,21,829.23","9,74,633.87",
27-Oct-23,Debit Card,"3,804.80",00.00,"9,78,438.67",
27-Oct-23,Tax,00.00,"2,44,609.67","7,33,829.00",
27-Oct-23,Debit Card,00.00,"1,83,457.25","5,50,371.75",
27-Oct-23,Transportellaneous,379,00.00,"5,50,750.75",
27-Oct-23,NEFT,00.00,"61,194.53","4,89,556.22",
27-Oct-23,Commission,00.00,"48,955.62","4,40,600.60",
27-Oct-23,IMPS,00.00,"55,075.08","3,85,525.52",
27-Oct-23,RTGS,00.00,"38,552.55","3,46,972.97",
27-Oct-23,IMPS,"12,70,598.00",00.00,"16,17,570.97",
27-Oct-23,Transportellaneous,00.00,"4,04,392.74","12,13,178.23",
27-Oct-23,Purchase,00.00,"2,02,196.37","10,10,981.86",
27-Oct-23,IMPS,10.91,00.00,"10,10,992.77",
27-Oct-23,Reversal,00.00,"1,12,332.53","8,98,660.24",
27-Oct-23,NEFT,446.3,00.00,"8,99,106.54",
27-Oct-23,Bill,"24,476.90",00.00,"9,23,583.44",
27-Oct-23,Purchase,00.00,"3,07,861.15","6,15,722.29",
27-Oct-23,Bill,29.6,00.00,"6,15,751.89",
27-Oct-23,Reversal,00.00,"1,02,625.32","5,13,126.58",
27-Oct-23,ATM,00.00,"1,02,625.32","4,10,501.26",
27-Oct-23,Bill,00.00,"4,10,501.26",00.00,
27-Oct-23,Purchase,"1,56,886.50",00.00,"1,56,886.50",
27-Oct-23,ATM,"9,717.97",00.00,"1,66,604.47",
27-Oct-23,Cheque,00.00,"55,534.82","1,11,069.65",
27-Oct-23,Cheque,00.00,"18,511.61","92,558.04",
27-Oct-23,Tax,"10,04,018.00",00.00,"10,96,576.04",
27-Oct-23,RTGS,00.00,"1,21,841.78","9,74,734.26",
27-Oct-23,Reversal,00.00,"1,94,946.85","7,79,787.41",
27-Oct-23,NEFT,00.00,"77,978.74","7,01,808.67",
27-Oct-23,IMPS,735,00.00,"7,02,543.67",
27-Oct-23,Debit Card,"11,87,812.25",00.00,"18,90,355.92",
27-Oct-23,IMPS,00.00,"18,90,355.92",00.00,
27-Oct-23,Cash,"6,609.50",00.00,"6,609.50",
27-Oct-23,Debit Card,00.00,734.39,"5,875.11",
27-Oct-23,Tax,00.00,"5,875.11",00.00,
27-Oct-23,Commission,"2,61,130.10",00.00,"2,61,130.10",
27-Oct-23,IMPS,00.00,"43,521.68","2,17,608.42",
27-Oct-23,Commission,"18,178.00",00.00,"2,35,786.42",
27-Oct-23,Tax,162.8,00.00,"2,35,949.22",
27-Oct-23,Transfer,33.16,00.00,"2,35,982.38",
27-Oct-23,Transfer,00.00,"39,330.40","1,96,651.98",
27-Oct-23,Debit Card,"42,835.70",00.00,"2,39,487.68",
27-Oct-23,Commission,"2,212.59",00.00,"2,41,700.27",
27-Oct-23,NEFT,00.00,"24,170.03","2,17,530.24",
27-Oct-23,Reversal,00.00,"72,510.08","1,45,020.16",
27-Oct-23,RTGS,42.7,00.00,"1,45,062.86",
27-Oct-23,Commission,03.50,00.00,"1,45,066.36",
27-Oct-23,Debit Card,"31,000.00",00.00,"1,76,066.36",
27-Oct-23,Bill,"5,00,717.80",00.00,"6,76,784.16",
27-Oct-23,Transfer,"11,158.44",00.00,"6,87,942.60",
27-Oct-23,RTGS,00.00,"76,438.07","6,11,504.53",
27-Oct-23,Reversal,"1,101.62",00.00,"6,12,606.15",
27-Oct-23,NEFT,00.00,"6,12,606.15",00.00,
27-Oct-23,IMPS,33,00.00,33,
27-Oct-23,Commission,00.00,33,00.00,
27-Oct-23,Transportellaneous,"1,016.12",00.00,"1,016.12",
27-Oct-23,ATM,165,00.00,"1,181.12",
27-Oct-23,ATM,04.03,00.00,"1,185.15",
27-Oct-23,Purchase,"20,883.89",00.00,"22,069.04",
27-Oct-23,RTGS,00.00,"5,517.26","16,551.78",
27-Oct-23,ATM,"14,01,895.00",00.00,"14,18,446.78",
27-Oct-23,Bill,00.00,"7,09,223.39","7,09,223.39",
27-Oct-23,Transportellaneous,297,00.00,"7,09,520.39",
27-Oct-23,Reversal,"22,642.00",00.00,"7,32,162.39",
27-Oct-23,Debit Card,61.7,00.00,"7,32,224.09",
27-Oct-23,Purchase,50,00.00,"7,32,274.09",
27-Oct-23,Transfer,00.00,"7,32,274.09",00.00,
27-Oct-23,ATM,"20,672.64",00.00,"20,672.64",
27-Oct-23,Purchase,00.00,"2,067.26","18,605.38",
27-Oct-23,Bill,"1,756.70",00.00,"20,362.08",
27-Oct-23,Cheque,00.00,"2,908.87","17,453.21",
27-Oct-23,Interest,00.00,"17,453.21",00.00,
27-Oct-23,Reversal,"2,519.00",00.00,"2,519.00",
27-Oct-23,Debit Card,"89,918.70",00.00,"92,437.70",
27-Oct-23,NEFT,"52,569.00",00.00,"1,45,006.70",
27-Oct-23,Cash,00.00,"14,500.67","1,30,506.03",
27-Oct-23,Cash,"2,34,406.00",00.00,"3,64,912.03",
27-Oct-23,Transfer,237,00.00,"3,65,149.03",
27-Oct-23,Cheque,01.00,00.00,"3,65,150.03",
27-Oct-23,Cash,336.8,00.00,"3,65,486.83",
27-Oct-23,ATM,00.00,"36,548.68","3,28,938.15",
27-Oct-23,Debit Card,07.00,00.00,"3,28,945.15",
27-Oct-23,Reversal,00.00,"41,118.14","2,87,827.01",
27-Oct-23,Tax,00.00,"57,565.40","2,30,261.61",
27-Oct-23,ATM,56.5,00.00,"2,30,318.11",
27-Oct-23,Commission,"2,468.80",00.00,"2,32,786.91",
27-Oct-23,ATM,00.00,"1,16,393.46","1,16,393.46",
27-Oct-23,ATM,00.00,"1,16,393.46",00.00,
27-Oct-23,Debit Card,"4,043.27",00.00,"4,043.27",
27-Oct-23,ATM,269,00.00,"4,312.27",
27-Oct-23,Bill,00.00,"1,078.07","3,234.20",
27-Oct-23,Commission,16,00.00,"3,250.20",
27-Oct-23,Purchase,00.00,650.04,"2,600.16",
28-Oct-23,Debit Card,233.5,00.00,"2,833.66",
28-Oct-23,Reversal,00.00,"2,833.66",00.00,
28-Oct-23,Purchase,"3,99,190.00",00.00,"3,99,190.00",
28-Oct-23,Reversal,"17,97,778.00",00.00,"21,96,968.00",
28-Oct-23,Debit Card,22.6,00.00,"21,96,990.60",
28-Oct-23,Bill,00.00,"21,96,990.60",00.00,
28-Oct-23,Cheque,07.98,00.00,07.98,
28-Oct-23,IMPS,31.11,00.00,39.09,
28-Oct-23,Cash,"2,30,006.31",00.00,"2,30,045.40",
28-Oct-23,Interest,"12,15,994.00",00.00,"14,46,039.40",
28-Oct-23,ATM,00.00,"4,82,013.13","9,64,026.27",
28-Oct-23,Transfer,02.07,00.00,"9,64,028.34",
28-Oct-23,Transportellaneous,00.00,"1,07,114.26","8,56,914.08",
28-Oct-23,Debit Card,00.00,"4,28,457.04","4,28,457.04",
29-Oct-23,Tax,237,00.00,"4,28,694.04",
29-Oct-23,Tax,"20,92,362.75",00.00,"25,21,056.79",
29-Oct-23,NEFT,"31,866.00",00.00,"25,52,922.79",
29-Oct-23,Commission,00.00,"4,25,487.13","21,27,435.66",
29-Oct-23,ATM,00.00,"3,03,919.38","18,23,516.28",
29-Oct-23,ATM,00.00,"6,07,838.76","12,15,677.52",
29-Oct-23,Reversal,"3,611.70",00.00,"12,19,289.22",
29-Oct-23,Commission,00.00,"12,19,289.22",00.00,
29-Oct-23,NEFT,"1,80,573.60",00.00,"1,80,573.60",
29-Oct-23,Transfer,00.00,"45,143.40","1,35,430.20",
29-Oct-23,Tax,06.00,00.00,"1,35,436.20",
29-Oct-23,NEFT,00.00,"67,718.10","67,718.10",
29-Oct-23,Tax,00.00,00.00,"67,718.10",
29-Oct-23,Bill,00.00,"16,929.53","50,788.58",
29-Oct-23,Purchase,150.7,00.00,"50,939.28",
29-Oct-23,Cash,00.00,"7,277.04","43,662.24",
29-Oct-23,Interest,07.75,00.00,"43,669.99",
29-Oct-23,Transfer,00.00,"43,669.99",00.00,
29-Oct-23,Interest,"2,24,246.60",00.00,"2,24,246.60",
29-Oct-23,Purchase,00.00,"28,030.83","1,96,215.78",
29-Oct-23,Debit Card,"10,728.72",00.00,"2,06,944.50",
29-Oct-23,IMPS,00.00,"29,563.50","1,77,381.00",
29-Oct-23,Tax,"11,900.00",00.00,"1,89,281.00",
29-Oct-23,Cheque,55,00.00,"1,89,336.00",
29-Oct-23,Debit Card,00.00,"21,037.33","1,68,298.67",
29-Oct-23,Cash,00.00,"1,68,298.67",00.00,
29-Oct-23,Transportellaneous,53,00.00,53,
29-Oct-23,Cash,"30,442.30",00.00,"30,495.30",
29-Oct-23,NEFT,"2,953.60",00.00,"33,448.90",
29-Oct-23,Transfer,00.00,"5,574.82","27,874.08",
29-Oct-23,IMPS,00.00,"4,645.68","23,228.40",
29-Oct-23,Cheque,"20,74,101.20",00.00,"20,97,329.60",
29-Oct-23,Reversal,00.00,"10,48,664.80","10,48,664.80",
29-Oct-23,Purchase,02.00,00.00,"10,48,666.80",
29-Oct-23,Transportellaneous,00.00,"1,04,866.68","9,43,800.12",
30-Oct-23,Interest,05.08,00.00,"9,43,805.20",
30-Oct-23,ATM,00.00,"1,34,829.31","8,08,975.89",
31-Oct-23,IMPS,00.00,"1,01,121.99","7,07,853.90",
31-Oct-23,Reversal,05.10,00.00,"7,07,859.00",
31-Oct-23,Transfer,04.40,00.00,"7,07,863.40",
31-Oct-23,RTGS,06.50,00.00,"7,07,869.90",
31-Oct-23,Bill,00.00,"3,53,934.95","3,53,934.95",
31-Oct-23,Bill,06.00,00.00,"3,53,940.95",
31-Oct-23,Interest,"4,039.90",00.00,"3,57,980.85",
31-Oct-23,Transfer,"22,626.25",00.00,"3,80,607.10",
31-Oct-23,Cash,"3,02,267.80",00.00,"6,82,874.90",
31-Oct-23,Interest,00.00,"1,13,812.48","5,69,062.42",
01-Nov-23,Tax,00.00,"1,89,687.47","3,79,374.95",
01-Nov-23,Reversal,00.00,"1,26,458.32","2,52,916.63",
02-Nov-23,IMPS,12.1,00.00,"2,52,928.73",
02-Nov-23,ATM,00.80,00.00,"2,52,929.53",
02-Nov-23,Reversal,"12,137.00",00.00,"2,65,066.53",
02-Nov-23,NEFT,"27,924.00",00.00,"2,92,990.53",
02-Nov-23,IMPS,132.4,00.00,"2,93,122.93",
02-Nov-23,Commission,"1,46,316.90",00.00,"4,39,439.83",
02-Nov-23,Debit Card,00.00,"1,46,479.94","2,92,959.89",
02-Nov-23,Debit Card,00.00,"29,295.99","2,63,663.90",
02-Nov-23,Tax,00.00,"87,887.97","1,75,775.93",
02-Nov-23,Transfer,00.00,"19,530.66","1,56,245.27",
02-Nov-23,Commission,"8,88,618.25",00.00,"10,44,863.52",
02-Nov-23,Tax,00.00,"3,48,287.84","6,96,575.68",
02-Nov-23,Interest,00.00,"77,397.30","6,19,178.38",
02-Nov-23,Debit Card,00.91,00.00,"6,19,179.29",
02-Nov-23,Commission,316,00.00,"6,19,495.29",
02-Nov-23,Tax,00.00,"88,499.33","5,30,995.96",
02-Nov-23,Bill,00.00,"1,06,199.19","4,24,796.77",
02-Nov-23,Commission,00.00,"2,12,398.39","2,12,398.38",
02-Nov-23,Purchase,135.3,00.00,"2,12,533.68",
02-Nov-23,ATM,00.00,"53,133.42","1,59,400.26",
02-Nov-23,IMPS,"53,514.00",00.00,"2,12,914.26",
02-Nov-23,Reversal,"3,929.00",00.00,"2,16,843.26",
02-Nov-23,ATM,"20,50,099.25",00.00,"22,66,942.51",
02-Nov-23,Transfer,00.00,"3,77,823.75","18,89,118.76",
03-Nov-23,Bill,00.00,"18,89,118.76",00.00,
03-Nov-23,RTGS,02.00,00.00,02.00,
03-Nov-23,NEFT,00.00,00.50,01.50,
03-Nov-23,Cheque,"26,565.62",00.00,"26,567.12",
03-Nov-23,ATM,00.00,"13,283.56","13,283.56",
03-Nov-23,Interest,301.3,00.00,"13,584.86",
03-Nov-23,Debit Card,00.50,00.00,"13,585.36",
03-Nov-23,Cheque,00.00,"1,698.17","11,887.19",
03-Nov-23,IMPS,00.00,"1,698.17","10,189.02",
03-Nov-23,ATM,"30,370.00",00.00,"40,559.02",
03-Nov-23,RTGS,00.00,"5,069.88","35,489.14",
03-Nov-23,Commission,00.00,"5,914.86","29,574.28",
03-Nov-23,Purchase,00.00,"3,286.03","26,288.25",
03-Nov-23,Cash,"1,80,279.94",00.00,"2,06,568.19",
03-Nov-23,Tax,"2,35,807.91",00.00,"4,42,376.10",
03-Nov-23,Transportellaneous,503.97,00.00,"4,42,880.07",
04-Nov-23,Tax,00.00,"44,288.01","3,98,592.06",
04-Nov-23,Cash,"2,34,071.30",00.00,"6,32,663.36",
04-Nov-23,Interest,"26,671.00",00.00,"6,59,334.36",
04-Nov-23,Debit Card,00.00,"94,190.62","5,65,143.74",
04-Nov-23,Reversal,00.00,"80,734.82","4,84,408.92",
04-Nov-23,Transfer,02.30,00.00,"4,84,411.22",
04-Nov-23,ATM,"3,008.60",00.00,"4,87,419.82",
04-Nov-23,Transportellaneous,467,00.00,"4,87,886.82",
04-Nov-23,Interest,17.61,00.00,"4,87,904.43",
04-Nov-23,Tax,00.00,"1,62,634.81","3,25,269.62",
04-Nov-23,Cheque,00.00,"54,211.60","2,71,058.02",
04-Nov-23,Transportellaneous,"2,588.00",00.00,"2,73,646.02",
04-Nov-23,Transportellaneous,"14,997.59",00.00,"2,88,643.61",
04-Nov-23,Interest,00.00,"48,107.27","2,40,536.34",
04-Nov-23,ATM,00.00,"2,40,536.34",00.00,
04-Nov-23,Tax,"1,61,742.60",00.00,"1,61,742.60",
04-Nov-23,Reversal,"2,01,659.10",00.00,"3,63,401.70",
04-Nov-23,Transfer,00.00,"72,680.34","2,90,721.36",
04-Nov-23,Interest,"2,50,145.78",00.00,"5,40,867.14",
04-Nov-23,Bill,00.00,"2,70,433.57","2,70,433.57",
04-Nov-23,Commission,00.00,"2,70,433.57",00.00,
04-Nov-23,ATM,299,00.00,299,
04-Nov-23,Bill,"2,912.00",00.00,"3,211.00",
04-Nov-23,Cheque,00.00,802.75,"2,408.25",
04-Nov-23,Interest,"13,331.84",00.00,"15,740.09",
04-Nov-23,Purchase,"3,235.00",00.00,"18,975.09",
04-Nov-23,Debit Card,33.31,00.00,"19,008.40",
04-Nov-23,RTGS,04.15,00.00,"19,012.55",
04-Nov-23,Interest,05.80,00.00,"19,018.35",
04-Nov-23,ATM,00.00,"3,169.73","15,848.62",
04-Nov-23,Cash,"20,514.00",00.00,"36,362.62",
05-Nov-23,Debit Card,00.00,"4,545.33","31,817.29",
05-Nov-23,NEFT,"19,79,877.00",00.00,"20,11,694.29",
05-Nov-23,Interest,61.1,00.00,"20,11,755.39",
05-Nov-23,Transportellaneous,"3,480.18",00.00,"20,15,235.57",
05-Nov-23,Cash,00.00,"2,87,890.80","17,27,344.77",
05-Nov-23,Debit Card,448,00.00,"17,27,792.77",
05-Nov-23,Interest,"17,24,077.50",00.00,"34,51,870.27",
05-Nov-23,Transportellaneous,05.83,00.00,"34,51,876.10",
05-Nov-23,NEFT,04.50,00.00,"34,51,880.60",
05-Nov-23,Bill,00.00,"5,75,313.43","28,76,567.17",
05-Nov-23,ATM,00.00,"14,38,283.59","14,38,283.58",
05-Nov-23,Cheque,07.00,00.00,"14,38,290.58",
05-Nov-23,ATM,"5,149.00",00.00,"14,43,439.58",
05-Nov-23,Transportellaneous,"7,081.96",00.00,"14,50,521.54",
05-Nov-23,Debit Card,"9,011.05",00.00,"14,59,532.59",
05-Nov-23,Commission,"2,531.70",00.00,"14,62,064.29",
05-Nov-23,Debit Card,"2,11,273.62",00.00,"16,73,337.91",
05-Nov-23,Cheque,00.00,"8,36,668.96","8,36,668.96",
05-Nov-23,Reversal,00.00,"4,18,334.48","4,18,334.48",
05-Nov-23,Commission,"19,463.00",00.00,"4,37,797.48",
05-Nov-23,NEFT,00.00,"87,559.50","3,50,237.98",
05-Nov-23,Transfer,"1,82,848.00",00.00,"5,33,085.98",
05-Nov-23,Reversal,"2,20,459.00",00.00,"7,53,544.98",
05-Nov-23,Commission,00.00,"75,354.50","6,78,190.48",
05-Nov-23,Purchase,00.00,"84,773.81","5,93,416.67",
05-Nov-23,IMPS,"9,362.86",00.00,"6,02,779.53",
05-Nov-23,Transportellaneous,00.00,"1,50,694.88","4,52,084.65",
05-Nov-23,Bill,"11,16,684.00",00.00,"15,68,768.65",
05-Nov-23,Transfer,16.2,00.00,"15,68,784.85",
05-Nov-23,Tax,00.00,"2,61,464.14","13,07,320.71",
05-Nov-23,Reversal,"1,96,749.94",00.00,"15,04,070.65",
05-Nov-23,Transfer,"3,23,631.25",00.00,"18,27,701.90",
05-Nov-23,Purchase,"1,629.00",00.00,"18,29,330.90",
05-Nov-23,NEFT,"2,27,456.00",00.00,"20,56,786.90",
05-Nov-23,Reversal,"16,66,922.00",00.00,"37,23,708.90",
05-Nov-23,Cheque,02.25,00.00,"37,23,711.15",
05-Nov-23,ATM,00.00,"4,13,745.68","33,09,965.47",
05-Nov-23,Cash,66.54,00.00,"33,10,032.01",
05-Nov-23,Cheque,"1,983.00",00.00,"33,12,015.01",
05-Nov-23,Interest,00.00,"6,62,403.00","26,49,612.01",
05-Nov-23,Bill,200,00.00,"26,49,812.01",
06-Nov-23,Transfer,00.00,"2,64,981.20","23,84,830.81",
06-Nov-23,ATM,"16,753.00",00.00,"24,01,583.81",
06-Nov-23,NEFT,00.00,"3,00,197.98","21,01,385.83",
06-Nov-23,Interest,00.00,"3,00,197.98","18,01,187.85",
06-Nov-23,Transfer,939.8,00.00,"18,02,127.65",
06-Nov-23,Commission,06.00,00.00,"18,02,133.65",
06-Nov-23,Bill,"6,88,891.20",00.00,"24,91,024.85",
06-Nov-23,ATM,00.00,"2,76,780.54","22,14,244.31",
06-Nov-23,Transportellaneous,00.00,"2,46,027.15","19,68,217.16",
06-Nov-23,Transportellaneous,00.00,"2,18,690.80","17,49,526.36",
06-Nov-23,NEFT,00.00,"17,49,526.36",00.00,
06-Nov-23,Transportellaneous,24,00.00,24,
06-Nov-23,RTGS,"2,00,995.00",00.00,"2,01,019.00",
06-Nov-23,Bill,00.00,"33,503.17","1,67,515.83",
06-Nov-23,RTGS,"19,344.50",00.00,"1,86,860.33",
06-Nov-23,IMPS,"23,757.00",00.00,"2,10,617.33",
06-Nov-23,Interest,232.4,00.00,"2,10,849.73",
06-Nov-23,ATM,03.70,00.00,"2,10,853.43",
06-Nov-23,Tax,257.29,00.00,"2,11,110.72",
06-Nov-23,ATM,00.00,"23,456.75","1,87,653.97",
06-Nov-23,Cheque,"19,73,538.00",00.00,"21,61,191.97",
06-Nov-23,ATM,00.00,"10,80,595.99","10,80,595.99",
06-Nov-23,NEFT,119.99,00.00,"10,80,715.98",
06-Nov-23,Transportellaneous,283.94,00.00,"10,80,999.92",
06-Nov-23,NEFT,264,00.00,"10,81,263.92",
06-Nov-23,RTGS,00.00,"5,40,631.96","5,40,631.96",
06-Nov-23,Transfer,"3,512.77",00.00,"5,44,144.73",
06-Nov-23,NEFT,02.00,00.00,"5,44,146.73",
06-Nov-23,IMPS,00.00,"1,81,382.24","3,62,764.49",
06-Nov-23,Commission,00.00,"3,62,764.49",00.00,
06-Nov-23,Cash,"2,139.00",00.00,"2,139.00",
06-Nov-23,Purchase,00.00,"1,069.50","1,069.50",
06-Nov-23,Tax,00.00,356.5,713,
06-Nov-23,Cash,04.30,00.00,717.3,
06-Nov-23,IMPS,"2,50,654.03",00.00,"2,51,371.33",
06-Nov-23,ATM,00.00,"25,137.13","2,26,234.20",
06-Nov-23,Transportellaneous,02.00,00.00,"2,26,236.20",
06-Nov-23,Purchase,53.1,00.00,"2,26,289.30",
06-Nov-23,Purchase,494.41,00.00,"2,26,783.71",
06-Nov-23,Tax,00.00,"37,797.29","1,88,986.42",
06-Nov-23,IMPS,00.00,"31,497.74","1,57,488.68",
06-Nov-23,Reversal,00.00,"26,248.11","1,31,240.57",
06-Nov-23,Reversal,07.50,00.00,"1,31,248.07",
06-Nov-23,ATM,"2,08,025.00",00.00,"3,39,273.07",
06-Nov-23,Transfer,00.00,"3,39,273.07",00.00,
06-Nov-23,Transfer,04.77,00.00,04.77,
06-Nov-23,IMPS,"85,559.00",00.00,"85,563.77",
06-Nov-23,Debit Card,00.00,"8,556.38","77,007.39",
06-Nov-23,Reversal,"2,38,822.80",00.00,"3,15,830.19",
06-Nov-23,Transfer,00.00,"1,57,915.10","1,57,915.10",
06-Nov-23,Transfer,00.00,"78,957.55","78,957.55",
06-Nov-23,Interest,00.00,"13,159.59","65,797.96",
06-Nov-23,Interest,00.00,"8,224.75","57,573.22",
06-Nov-23,Transfer,"2,260.00",00.00,"59,833.22",
06-Nov-23,Transportellaneous,"1,61,516.00",00.00,"2,21,349.22",
06-Nov-23,Cheque,00.00,"2,21,349.22",00.00,
06-Nov-23,Debit Card,"2,604.00",00.00,"2,604.00",
06-Nov-23,IMPS,"26,544.40",00.00,"29,148.40",
06-Nov-23,RTGS,02.60,00.00,"29,151.00",
06-Nov-23,RTGS,"13,345.00",00.00,"42,496.00",
06-Nov-23,Tax,"3,443.40",00.00,"45,939.40",
06-Nov-23,Bill,89.3,00.00,"46,028.70",
06-Nov-23,Tax,396,00.00,"46,424.70",
07-Nov-23,Reversal,"1,42,691.90",00.00,"1,89,116.60",
07-Nov-23,Cash,00.00,"63,038.87","1,26,077.73",
07-Nov-23,Purchase,37.6,00.00,"1,26,115.33",
07-Nov-23,Debit Card,00.00,"42,038.44","84,076.89",
07-Nov-23,RTGS,00.00,"9,341.88","74,735.01",
07-Nov-23,Purchase,01.30,00.00,"74,736.31",
07-Nov-23,Transfer,00.00,"37,368.16","37,368.16",
07-Nov-23,Debit Card,00.00,"12,456.05","24,912.11",
07-Nov-23,Debit Card,00.00,"4,152.02","20,760.09",
07-Nov-23,Reversal,"7,641.00",00.00,"28,401.09",
08-Nov-23,Cash,00.00,"3,155.68","25,245.41",
08-Nov-23,IMPS,00.00,"12,622.71","12,622.70",
08-Nov-23,Transportellaneous,"13,590.50",00.00,"26,213.20",
08-Nov-23,IMPS,00.00,"8,737.73","17,475.47",
08-Nov-23,Reversal,00.00,"2,912.58","14,562.89",
08-Nov-23,ATM,"30,365.27",00.00,"44,928.16",
08-Nov-23,Tax,00.00,"14,976.05","29,952.11",
09-Nov-23,IMPS,00.00,"9,984.04","19,968.07",
09-Nov-23,ATM,99.63,00.00,"20,067.70",
10-Nov-23,RTGS,00.00,"5,016.93","15,050.78",
10-Nov-23,Cash,"4,664.30",00.00,"19,715.08",
10-Nov-23,Cash,00.00,"2,816.44","16,898.64",
10-Nov-23,Transportellaneous,04.80,00.00,"16,903.44",
10-Nov-23,Commission,00.00,"16,903.44",00.00,
10-Nov-23,Tax,132,00.00,132,
10-Nov-23,Bill,00.00,13.2,118.8,
10-Nov-23,NEFT,00.00,23.76,95.04,
10-Nov-23,Debit Card,00.00,19.01,76.03,
10-Nov-23,RTGS,00.00,38.02,38.02,
10-Nov-23,Debit Card,00.00,04.75,33.27,
10-Nov-23,NEFT,45,00.00,78.27,
10-Nov-23,IMPS,00.00,07.83,70.44,
10-Nov-23,Cash,00.00,17.61,52.83,
10-Nov-23,Commission,"20,536.20",00.00,"20,589.03",
10-Nov-23,IMPS,52.76,00.00,"20,641.79",
10-Nov-23,Cash,00.00,"4,128.36","16,513.43",
10-Nov-23,ATM,00.00,"1,834.83","14,678.60",
10-Nov-23,RTGS,153,00.00,"14,831.60",
10-Nov-23,Cheque,00.00,"2,118.80","12,712.80",
10-Nov-23,Cash,01.00,00.00,"12,713.80",
10-Nov-23,RTGS,"2,564.80",00.00,"15,278.60",
10-Nov-23,Cash,00.00,"3,055.72","12,222.88",
10-Nov-23,IMPS,00.00,"2,037.15","10,185.73",
10-Nov-23,RTGS,00.00,"2,546.43","7,639.30",
10-Nov-23,Reversal,"4,039.00",00.00,"11,678.30",
10-Nov-23,ATM,00.00,"5,839.15","5,839.15",
10-Nov-23,Transfer,00.00,"1,459.79","4,379.36",
10-Nov-23,Interest,"2,96,169.25",00.00,"3,00,548.61",
10-Nov-23,Commission,156.8,00.00,"3,00,705.41",
10-Nov-23,Transportellaneous,44.3,00.00,"3,00,749.71",
10-Nov-23,Cash,00.00,"75,187.43","2,25,562.28",
10-Nov-23,Tax,42,00.00,"2,25,604.28",
10-Nov-23,Reversal,00.00,"56,401.07","1,69,203.21",
10-Nov-23,Commission,00.00,"33,840.64","1,35,362.57",
10-Nov-23,Commission,"1,90,928.00",00.00,"3,26,290.57",
10-Nov-23,Purchase,00.00,"1,08,763.52","2,17,527.05",
10-Nov-23,RTGS,00.00,"21,752.71","1,95,774.34",
10-Nov-23,Cash,19,00.00,"1,95,793.34",
10-Nov-23,Transportellaneous,"19,68,330.00",00.00,"21,64,123.34",
10-Nov-23,Reversal,"3,936.00",00.00,"21,68,059.34",
10-Nov-23,Transfer,00.00,"7,22,686.45","14,45,372.89",
10-Nov-23,Bill,"3,362.50",00.00,"14,48,735.39",
10-Nov-23,Purchase,"92,524.69",00.00,"15,41,260.08",
10-Nov-23,Cheque,00.00,"1,92,657.51","13,48,602.57",
10-Nov-23,Commission,00.00,"3,37,150.64","10,11,451.93",
10-Nov-23,Commission,92,00.00,"10,11,543.93",
10-Nov-23,Tax,00.00,"1,68,590.66","8,42,953.28",
10-Nov-23,Reversal,09.30,00.00,"8,42,962.58",
10-Nov-23,ATM,62.3,00.00,"8,43,024.88",
10-Nov-23,RTGS,00.00,"93,669.43","7,49,355.45",
10-Nov-23,Cash,00.00,"83,261.72","6,66,093.73",
10-Nov-23,Reversal,60.01,00.00,"6,66,153.74",
10-Nov-23,Cash,38,00.00,"6,66,191.74",
10-Nov-23,Tax,00.00,"6,66,191.74",00.00,
10-Nov-23,Cash,04.00,00.00,04.00,
10-Nov-23,Transportellaneous,"11,474.47",00.00,"11,478.47",
10-Nov-23,Interest,00.00,"3,826.16","7,652.31",
10-Nov-23,Cash,29.9,00.00,"7,682.21",
10-Nov-23,Debit Card,00.00,"1,280.37","6,401.84",
10-Nov-23,Commission,00.00,800.23,"5,601.61",
10-Nov-23,ATM,00.00,560.16,"5,041.45",
10-Nov-23,RTGS,"10,52,975.00",00.00,"10,58,016.45",
10-Nov-23,RTGS,00.00,"3,52,672.15","7,05,344.30",
10-Nov-23,Purchase,"2,52,384.53",00.00,"9,57,728.83",
10-Nov-23,Cheque,00.00,"9,57,728.83",00.00,
10-Nov-23,Tax,"19,45,986.00",00.00,"19,45,986.00",
10-Nov-23,IMPS,"24,989.00",00.00,"19,70,975.00",
11-Nov-23,Transportellaneous,"2,361.00",00.00,"19,73,336.00",
11-Nov-23,ATM,56.9,00.00,"19,73,392.90",
11-Nov-23,NEFT,174.2,00.00,"19,73,567.10",
11-Nov-23,Debit Card,00.00,"1,97,356.71","17,76,210.39",
11-Nov-23,NEFT,00.00,"2,53,744.34","15,22,466.05",
11-Nov-23,Reversal,00.00,"3,80,616.51","11,41,849.54",
11-Nov-23,Interest,"1,73,569.00",00.00,"13,15,418.54",
11-Nov-23,Debit Card,"28,683.00",00.00,"13,44,101.54",
11-Nov-23,Bill,02.04,00.00,"13,44,103.58",
11-Nov-23,Reversal,00.00,"4,48,034.53","8,96,069.05",
11-Nov-23,Cheque,"1,69,159.30",00.00,"10,65,228.35",
11-Nov-23,Debit Card,"14,599.90",00.00,"10,79,828.25",
11-Nov-23,NEFT,00.00,"3,59,942.75","7,19,885.50",
11-Nov-23,ATM,"3,380.10",00.00,"7,23,265.60",
11-Nov-23,Cash,23.63,00.00,"7,23,289.23",
11-Nov-23,Commission,00.00,"1,03,327.03","6,19,962.20",
11-Nov-23,Cash,50.04,00.00,"6,20,012.24",
11-Nov-23,Tax,00.00,"3,10,006.12","3,10,006.12",
11-Nov-23,IMPS,00.00,"38,750.77","2,71,255.36",
11-Nov-23,Cash,112,00.00,"2,71,367.36",
11-Nov-23,Purchase,55.23,00.00,"2,71,422.59",
11-Nov-23,NEFT,501.5,00.00,"2,71,924.09",
11-Nov-23,Tax,"2,61,778.00",00.00,"5,33,702.09",
11-Nov-23,Transportellaneous,00.00,"5,33,702.09",00.00,
11-Nov-23,Cheque,"8,66,329.00",00.00,"8,66,329.00",
11-Nov-23,Bill,06.64,00.00,"8,66,335.64",
11-Nov-23,Tax,01.60,00.00,"8,66,337.24",
11-Nov-23,Cheque,00.00,"96,259.69","7,70,077.55",
11-Nov-23,Tax,00.00,"77,007.76","6,93,069.80",
11-Nov-23,Purchase,00.00,"86,633.73","6,06,436.08",
11-Nov-23,Commission,"3,069.00",00.00,"6,09,505.08",
11-Nov-23,NEFT,02.90,00.00,"6,09,507.98",
11-Nov-23,Interest,00.00,"3,04,753.99","3,04,753.99",
11-Nov-23,Interest,00.00,"33,861.55","2,70,892.44",
11-Nov-23,Transportellaneous,00.00,"30,099.16","2,40,793.28",
11-Nov-23,Purchase,00.00,"1,20,396.64","1,20,396.64",
11-Nov-23,NEFT,712.25,00.00,"1,21,108.89",
11-Nov-23,Commission,00.00,"30,277.22","90,831.67",
11-Nov-23,NEFT,00.00,"90,831.67",00.00,
11-Nov-23,Reversal,"5,187.00",00.00,"5,187.00",
11-Nov-23,Commission,00.00,"1,729.00","3,458.00",
11-Nov-23,IMPS,00.00,384.22,"3,073.78",
11-Nov-23,IMPS,00.00,384.22,"2,689.56",
11-Nov-23,Purchase,169,00.00,"2,858.56",
11-Nov-23,IMPS,22.58,00.00,"2,881.14",
12-Nov-23,Transportellaneous,"49,633.25",00.00,"52,514.39",
12-Nov-23,Transportellaneous,00.00,"7,502.06","45,012.33",
12-Nov-23,Transfer,00.00,"5,626.54","39,385.79",
12-Nov-23,Tax,00.00,"9,846.45","29,539.34",
12-Nov-23,Cheque,"3,573.00",00.00,"33,112.34",
12-Nov-23,ATM,"1,127.00",00.00,"34,239.34",
12-Nov-23,Transfer,"2,658.83",00.00,"36,898.17",
12-Nov-23,Transfer,"13,55,214.25",00.00,"13,92,112.42",
12-Nov-23,NEFT,00.00,"1,39,211.24","12,52,901.18",
12-Nov-23,Tax,"15,471.00",00.00,"12,68,372.18",
12-Nov-23,NEFT,35.82,00.00,"12,68,408.00",
12-Nov-23,IMPS,00.00,"1,26,840.80","11,41,567.20",
12-Nov-23,Commission,"3,207.00",00.00,"11,44,774.20",
12-Nov-23,ATM,00.00,"1,14,477.42","10,30,296.78",
13-Nov-23,Transfer,"24,366.00",00.00,"10,54,662.78",
13-Nov-23,Reversal,00.00,"2,10,932.56","8,43,730.22",
13-Nov-23,ATM,"1,732.70",00.00,"8,45,462.92",
13-Nov-23,Reversal,00.00,"1,05,682.87","7,39,780.06",
13-Nov-23,Cash,05.30,00.00,"7,39,785.36",
13-Nov-23,Interest,00.00,"1,84,946.34","5,54,839.02",
13-Nov-23,Tax,00.00,"1,10,967.80","4,43,871.22",
13-Nov-23,NEFT,00.00,"73,978.54","3,69,892.68",
13-Nov-23,Transfer,00.00,"73,978.54","2,95,914.14",
13-Nov-23,RTGS,24,00.00,"2,95,938.14",
13-Nov-23,Purchase,59,00.00,"2,95,997.14",
13-Nov-23,Transfer,"3,263.00",00.00,"2,99,260.14",
13-Nov-23,RTGS,"17,573.71",00.00,"3,16,833.85",
13-Nov-23,NEFT,00.00,"52,805.64","2,64,028.21",
13-Nov-23,Transportellaneous,"29,009.36",00.00,"2,93,037.57",
13-Nov-23,Cash,"10,106.00",00.00,"3,03,143.57",
13-Nov-23,Interest,476,00.00,"3,03,619.57",
13-Nov-23,Reversal,00.00,"75,904.89","2,27,714.68",
13-Nov-23,ATM,"3,342.94",00.00,"2,31,057.62",
13-Nov-23,Commission,00.00,"46,211.52","1,84,846.10",
13-Nov-23,Interest,07.40,00.00,"1,84,853.50",
13-Nov-23,Purchase,00.00,"61,617.83","1,23,235.67",
13-Nov-23,NEFT,00.00,"61,617.84","61,617.84",
13-Nov-23,Cheque,00.00,"12,323.57","49,294.27",
13-Nov-23,Transfer,00.00,"9,858.85","39,435.42",
13-Nov-23,Debit Card,00.00,"7,887.08","31,548.34",
13-Nov-23,Cash,06.20,00.00,"31,554.54",
13-Nov-23,NEFT,"20,907.00",00.00,"52,461.54",
13-Nov-23,Commission,"26,000.00",00.00,"78,461.54",
13-Nov-23,NEFT,00.00,"39,230.77","39,230.77",
13-Nov-23,Purchase,00.00,"6,538.46","32,692.31",
13-Nov-23,Transportellaneous,03.72,00.00,"32,696.03",
13-Nov-23,Transfer,47,00.00,"32,743.03",
13-Nov-23,Reversal,00.00,"16,371.52","16,371.52",
13-Nov-23,Interest,00.00,"2,046.44","14,325.08",
13-Nov-23,Interest,04.00,00.00,"14,329.08",
13-Nov-23,Cash,00.00,"3,582.27","10,746.81",
13-Nov-23,Tax,"7,988.00",00.00,"18,734.81",
13-Nov-23,Commission,"1,49,183.00",00.00,"1,67,917.81",
13-Nov-23,Reversal,00.00,"41,979.45","1,25,938.36",
13-Nov-23,NEFT,"17,544.66",00.00,"1,43,483.02",
13-Nov-23,Tax,"20,32,050.25",00.00,"21,75,533.27",
13-Nov-23,Commission,00.00,"2,41,725.92","19,33,807.35",
13-Nov-23,Tax,302.1,00.00,"19,34,109.45",
13-Nov-23,Tax,00.00,"9,67,054.73","9,67,054.72",
13-Nov-23,Transportellaneous,00.00,"1,07,450.52","8,59,604.20",
13-Nov-23,RTGS,00.00,"8,59,604.20",00.00,
13-Nov-23,Transportellaneous,218,00.00,218,
13-Nov-23,NEFT,08.00,00.00,226,
13-Nov-23,Purchase,"29,244.38",00.00,"29,470.38",
13-Nov-23,Tax,00.00,"5,894.08","23,576.30",
13-Nov-23,Commission,"10,73,238.00",00.00,"10,96,814.30",
13-Nov-23,Commission,00.00,"1,21,868.26","9,74,946.04",
13-Nov-23,Tax,00.00,"2,43,736.51","7,31,209.53",
13-Nov-23,Cheque,00.00,"7,31,209.53",00.00,
13-Nov-23,Tax,56.83,00.00,56.83,
13-Nov-23,Debit Card,"9,85,686.50",00.00,"9,85,743.33",
13-Nov-23,Tax,00.20,00.00,"9,85,743.53",
13-Nov-23,Purchase,00.00,"2,46,435.88","7,39,307.65",
13-Nov-23,ATM,126.12,00.00,"7,39,433.77",
13-Nov-23,IMPS,00.00,"1,23,238.96","6,16,194.81",
13-Nov-23,Interest,00.00,"88,027.83","5,28,166.98",
13-Nov-23,Purchase,420,00.00,"5,28,586.98",
13-Nov-23,Purchase,00.00,"88,097.83","4,40,489.15",
13-Nov-23,Reversal,00.00,"73,414.86","3,67,074.29",
13-Nov-23,RTGS,48.1,00.00,"3,67,122.39",
13-Nov-23,Reversal,00.00,"91,780.60","2,75,341.79",
13-Nov-23,Cheque,00.00,"27,534.18","2,47,807.61",
13-Nov-23,Debit Card,02.00,00.00,"2,47,809.61",
13-Nov-23,ATM,47.2,00.00,"2,47,856.81",
13-Nov-23,Transportellaneous,"19,40,945.00",00.00,"21,88,801.81",
13-Nov-23,Purchase,380.68,00.00,"21,89,182.49",
13-Nov-23,Transfer,00.00,"10,94,591.25","10,94,591.25",
13-Nov-23,Tax,00.00,"1,36,823.91","9,57,767.34",
13-Nov-23,Cash,00.00,"1,19,720.92","8,38,046.42",
13-Nov-23,Transfer,00.00,"2,79,348.81","5,58,697.61",
13-Nov-23,ATM,00.00,"79,813.94","4,78,883.67",
13-Nov-23,Cash,00.00,"53,209.30","4,25,674.37",
13-Nov-23,Bill,632,00.00,"4,26,306.37",
13-Nov-23,Commission,315.41,00.00,"4,26,621.78",
13-Nov-23,Cheque,142.21,00.00,"4,26,763.99",
13-Nov-23,ATM,50.36,00.00,"4,26,814.35",
14-Nov-23,Debit Card,00.00,"47,423.82","3,79,390.53",
14-Nov-23,Tax,"1,49,166.00",00.00,"5,28,556.53",
14-Nov-23,Reversal,00.00,"1,05,711.31","4,22,845.22",
14-Nov-23,Commission,00.00,"84,569.04","3,38,276.18",
14-Nov-23,ATM,"18,018.95",00.00,"3,56,295.13",
15-Nov-23,Tax,00.00,"71,259.03","2,85,036.10",
15-Nov-23,Debit Card,"94,485.81",00.00,"3,79,521.91",
15-Nov-23,NEFT,00.00,"1,89,760.96","1,89,760.96",
15-Nov-23,IMPS,00.00,"47,440.24","1,42,320.72",
15-Nov-23,Debit Card,00.00,"1,42,320.72",00.00,
15-Nov-23,Bill,"10,53,386.00",00.00,"10,53,386.00",
15-Nov-23,Cash,00.00,"2,63,346.50","7,90,039.50",
15-Nov-23,Purchase,25.94,00.00,"7,90,065.44",
15-Nov-23,Commission,00.00,"87,785.05","7,02,280.39",
15-Nov-23,NEFT,503.78,00.00,"7,02,784.17",
16-Nov-23,IMPS,381.99,00.00,"7,03,166.16",
16-Nov-23,IMPS,00.00,"2,34,388.72","4,68,777.44",
16-Nov-23,Tax,00.00,"52,086.38","4,16,691.06",
16-Nov-23,NEFT,00.00,"2,08,345.53","2,08,345.53",
16-Nov-23,Debit Card,"1,39,907.90",00.00,"3,48,253.43",
17-Nov-23,Commission,"8,631.00",00.00,"3,56,884.43",
17-Nov-23,Cheque,"21,412.00",00.00,"3,78,296.43",
17-Nov-23,Transportellaneous,00.00,"3,78,296.43",00.00,
17-Nov-23,Debit Card,"90,716.28",00.00,"90,716.28",
17-Nov-23,Cheque,"17,467.80",00.00,"1,08,184.08",
17-Nov-23,Interest,24.2,00.00,"1,08,208.28",
17-Nov-23,Reversal,00.00,"12,023.14","96,185.14",
17-Nov-23,Cash,00.00,"24,046.29","72,138.86",
17-Nov-23,ATM,00.00,"7,213.89","64,924.97",
17-Nov-23,Tax,00.00,"7,213.89","57,711.08",
17-Nov-23,Commission,00.00,"9,618.51","48,092.57",
18-Nov-23,Purchase,06.00,00.00,"48,098.57",
18-Nov-23,Cash,"2,02,573.00",00.00,"2,50,671.57",
18-Nov-23,Debit Card,24.4,00.00,"2,50,695.97",
18-Nov-23,Interest,"71,025.00",00.00,"3,21,720.97",
18-Nov-23,Commission,"3,23,307.00",00.00,"6,45,027.97",
18-Nov-23,RTGS,00.00,"1,29,005.59","5,16,022.38",
18-Nov-23,Transportellaneous,"3,667.49",00.00,"5,19,689.87",
18-Nov-23,Commission,00.00,"51,968.99","4,67,720.88",
18-Nov-23,Commission,31,00.00,"4,67,751.88",
18-Nov-23,Purchase,04.70,00.00,"4,67,756.58",
18-Nov-23,Reversal,"25,888.20",00.00,"4,93,644.78",
18-Nov-23,IMPS,00.00,"98,728.96","3,94,915.82",
18-Nov-23,Cheque,"17,66,417.00",00.00,"21,61,332.82",
18-Nov-23,Cash,02.17,00.00,"21,61,334.99",
18-Nov-23,RTGS,"66,615.80",00.00,"22,27,950.79",
18-Nov-23,Transfer,381.8,00.00,"22,28,332.59",
18-Nov-23,IMPS,00.00,"2,47,592.51","19,80,740.08",
18-Nov-23,Transfer,"3,714.42",00.00,"19,84,454.50",
18-Nov-23,ATM,412,00.00,"19,84,866.50",
18-Nov-23,Purchase,00.00,"2,83,552.36","17,01,314.14",
18-Nov-23,NEFT,00.00,"4,25,328.54","12,75,985.60",
18-Nov-23,Cheque,00.00,"3,18,996.40","9,56,989.20",
18-Nov-23,ATM,00.00,"1,19,623.65","8,37,365.55",
18-Nov-23,Transfer,"3,709.00",00.00,"8,41,074.55",
18-Nov-23,Reversal,"2,572.00",00.00,"8,43,646.55",
18-Nov-23,Purchase,00.00,"93,738.51","7,49,908.04",
18-Nov-23,Tax,00.00,"83,323.12","6,66,584.92",
18-Nov-23,Cash,"6,77,582.00",00.00,"13,44,166.92",
19-Nov-23,Reversal,00.00,"13,44,166.92",00.00,
19-Nov-23,Transportellaneous,"3,246.90",00.00,"3,246.90",
19-Nov-23,NEFT,00.00,541.15,"2,705.75",
19-Nov-23,NEFT,00.00,541.15,"2,164.60",
19-Nov-23,IMPS,00.00,360.77,"1,803.83",
19-Nov-23,Cheque,00.00,180.38,"1,623.45",
19-Nov-23,Transportellaneous,00.00,231.92,"1,391.53",
19-Nov-23,Debit Card,11.1,00.00,"1,402.63",
19-Nov-23,NEFT,"80,976.41",00.00,"82,379.04",
19-Nov-23,Purchase,192.53,00.00,"82,571.57",
19-Nov-23,Cheque,00.00,"8,257.16","74,314.41",
19-Nov-23,Reversal,00.00,"8,257.16","66,057.25",
19-Nov-23,Transportellaneous,00.00,"7,339.69","58,717.56",
19-Nov-23,Transportellaneous,06.10,00.00,"58,723.66",
19-Nov-23,Debit Card,923.57,00.00,"59,647.23",
19-Nov-23,IMPS,12.8,00.00,"59,660.03",
19-Nov-23,Cash,"20,36,137.00",00.00,"20,95,797.03",
19-Nov-23,Interest,"1,19,668.40",00.00,"22,15,465.43",
19-Nov-23,NEFT,03.40,00.00,"22,15,468.83",
19-Nov-23,Reversal,00.00,"3,69,244.81","18,46,224.02",
19-Nov-23,Debit Card,461.6,00.00,"18,46,685.62",
19-Nov-23,RTGS,00.00,"6,15,561.87","12,31,123.75",
19-Nov-23,Purchase,00.00,"1,75,874.82","10,55,248.93",
19-Nov-23,Interest,00.00,"1,50,749.85","9,04,499.08",
19-Nov-23,IMPS,00.00,"9,04,499.08",00.00,
19-Nov-23,Bill,07.07,00.00,07.07,
19-Nov-23,Tax,"3,663.00",00.00,"3,670.07",
19-Nov-23,Interest,"19,182.00",00.00,"22,852.07",
19-Nov-23,Bill,00.00,"5,713.02","17,139.05",
19-Nov-23,Purchase,04.50,00.00,"17,143.55",
19-Nov-23,Purchase,"1,14,614.00",00.00,"1,31,757.55",
19-Nov-23,RTGS,00.00,"13,175.76","1,18,581.79",
19-Nov-23,IMPS,"24,574.00",00.00,"1,43,155.79",
19-Nov-23,Purchase,"1,17,937.88",00.00,"2,61,093.67",
19-Nov-23,RTGS,03.00,00.00,"2,61,096.67",
19-Nov-23,Debit Card,00.00,"26,109.67","2,34,987.00",
19-Nov-23,IMPS,"20,29,944.00",00.00,"22,64,931.00",
19-Nov-23,Cheque,00.00,"11,32,465.50","11,32,465.50",
19-Nov-23,Transportellaneous,02.00,00.00,"11,32,467.50",
19-Nov-23,Commission,"2,32,135.00",00.00,"13,64,602.50",
19-Nov-23,Cheque,05.00,00.00,"13,64,607.50",
19-Nov-23,ATM,00.00,"6,82,303.75","6,82,303.75",
19-Nov-23,Transfer,00.00,"2,27,434.58","4,54,869.17",
19-Nov-23,Transfer,00.00,"45,486.92","4,09,382.25",
19-Nov-23,RTGS,13.59,00.00,"4,09,395.84",
19-Nov-23,NEFT,"1,67,106.00",00.00,"5,76,501.84",
19-Nov-23,Interest,06.61,00.00,"5,76,508.45",
19-Nov-23,NEFT,00.00,"1,15,301.69","4,61,206.76",
19-Nov-23,NEFT,29.7,00.00,"4,61,236.46",
19-Nov-23,IMPS,"8,87,163.00",00.00,"13,48,399.46",
19-Nov-23,Transportellaneous,00.00,"6,74,199.73","6,74,199.73",
19-Nov-23,Purchase,00.00,"2,24,733.24","4,49,466.49",
19-Nov-23,RTGS,00.00,"49,940.72","3,99,525.77",
19-Nov-23,Bill,00.00,"39,952.58","3,59,573.19",
19-Nov-23,NEFT,01.00,00.00,"3,59,574.19",
20-Nov-23,Bill,00.00,"44,946.77","3,14,627.42",
20-Nov-23,Transfer,00.00,"1,04,875.81","2,09,751.61",
20-Nov-23,Cheque,341,00.00,"2,10,092.61",
20-Nov-23,ATM,"23,757.00",00.00,"2,33,849.61",
20-Nov-23,Transfer,00.00,"29,231.20","2,04,618.41",
20-Nov-23,Cheque,00.00,"1,02,309.21","1,02,309.20",
20-Nov-23,Reversal,00.00,"25,577.30","76,731.90",
20-Nov-23,Cheque,"17,14,375.80",00.00,"17,91,107.70",
20-Nov-23,Transfer,229.8,00.00,"17,91,337.50",
20-Nov-23,Interest,00.00,"5,97,112.50","11,94,225.00",
20-Nov-23,Reversal,00.00,"1,49,278.13","10,44,946.88",
20-Nov-23,Reversal,01.00,00.00,"10,44,947.88",
20-Nov-23,NEFT,"1,47,607.10",00.00,"11,92,554.98",
20-Nov-23,NEFT,44.4,00.00,"11,92,599.38",
20-Nov-23,Transfer,00.00,"11,92,599.38",00.00,
20-Nov-23,Interest,54.2,00.00,54.2,
20-Nov-23,Purchase,10.06,00.00,64.26,
20-Nov-23,Reversal,57.5,00.00,121.76,
20-Nov-23,ATM,40.19,00.00,161.95,
20-Nov-23,IMPS,00.00,20.24,141.71,
20-Nov-23,Cheque,"2,50,433.80",00.00,"2,50,575.51",
20-Nov-23,Debit Card,"1,84,382.80",00.00,"4,34,958.31",
20-Nov-23,NEFT,07.70,00.00,"4,34,966.01",
20-Nov-23,Cash,710.7,00.00,"4,35,676.71",
20-Nov-23,Transportellaneous,"3,624.10",00.00,"4,39,300.81",
20-Nov-23,IMPS,00.00,"4,39,300.81",00.00,
20-Nov-23,Transfer,44,00.00,44,
20-Nov-23,NEFT,"2,47,302.80",00.00,"2,47,346.80",
20-Nov-23,Interest,294.87,00.00,"2,47,641.67",
20-Nov-23,Debit Card,04.00,00.00,"2,47,645.67",
20-Nov-23,Debit Card,00.00,"27,516.19","2,20,129.48",
20-Nov-23,IMPS,"20,89,817.75",00.00,"23,09,947.23",
20-Nov-23,Transportellaneous,"3,531.60",00.00,"23,13,478.83",
20-Nov-23,Debit Card,"15,40,735.20",00.00,"38,54,214.03",
20-Nov-23,IMPS,00.00,"7,70,842.81","30,83,371.22",
20-Nov-23,Purchase,15,00.00,"30,83,386.22",
20-Nov-23,Purchase,18,00.00,"30,83,404.22",
20-Nov-23,Cheque,"17,74,914.25",00.00,"48,58,318.47",
20-Nov-23,NEFT,07.21,00.00,"48,58,325.68",
20-Nov-23,Transfer,00.00,"6,07,290.71","42,51,034.97",
20-Nov-23,Purchase,"2,334.00",00.00,"42,53,368.97",
20-Nov-23,Tax,00.00,"21,26,684.49","21,26,684.48",
20-Nov-23,Purchase,00.00,"3,03,812.07","18,22,872.41",
20-Nov-23,NEFT,00.00,"3,03,812.07","15,19,060.34",
20-Nov-23,NEFT,89.1,00.00,"15,19,149.44",
20-Nov-23,Reversal,"10,56,424.00",00.00,"25,75,573.44",
20-Nov-23,Interest,04.47,00.00,"25,75,577.91",
20-Nov-23,ATM,00.00,"12,87,788.96","12,87,788.96",
20-Nov-23,Cheque,00.00,"1,60,973.62","11,26,815.34",
20-Nov-23,RTGS,53,00.00,"11,26,868.34",
20-Nov-23,NEFT,"13,551.83",00.00,"11,40,420.17",
21-Nov-23,Transportellaneous,"24,555.09",00.00,"11,64,975.26",
21-Nov-23,Commission,05.00,00.00,"11,64,980.26",
21-Nov-23,Tax,00.00,"1,66,425.75","9,98,554.51",
21-Nov-23,Interest,00.00,"1,99,710.90","7,98,843.61",
21-Nov-23,Reversal,00.00,"3,99,421.81","3,99,421.80",
21-Nov-23,Debit Card,22.3,00.00,"3,99,444.10",
21-Nov-23,IMPS,34.71,00.00,"3,99,478.81",
21-Nov-23,Cash,"4,046.60",00.00,"4,03,525.41",
21-Nov-23,Transfer,00.00,"2,01,762.71","2,01,762.70",
21-Nov-23,NEFT,00.00,"67,254.23","1,34,508.47",
21-Nov-23,Transportellaneous,"1,76,670.53",00.00,"3,11,179.00",
21-Nov-23,Interest,"1,55,655.00",00.00,"4,66,834.00",
21-Nov-23,IMPS,"20,69,618.00",00.00,"25,36,452.00",
21-Nov-23,Cash,00.00,"3,62,350.29","21,74,101.71",
21-Nov-23,Cash,02.00,00.00,"21,74,103.71",
21-Nov-23,Transfer,00.00,"2,17,410.37","19,56,693.34",
21-Nov-23,Purchase,285,00.00,"19,56,978.34",
21-Nov-23,Debit Card,00.00,"2,44,622.29","17,12,356.05",
21-Nov-23,IMPS,"6,887.40",00.00,"17,19,243.45",
21-Nov-23,RTGS,"1,16,524.00",00.00,"18,35,767.45",
21-Nov-23,Debit Card,00.00,"18,35,767.45",00.00,
21-Nov-23,Transfer,32.26,00.00,32.26,
21-Nov-23,Transfer,03.00,00.00,35.26,
21-Nov-23,Cash,00.00,35.26,00.00,
21-Nov-23,Purchase,03.25,00.00,03.25,
21-Nov-23,Transfer,00.00,00.54,02.71,
21-Nov-23,Transportellaneous,"4,789.00",00.00,"4,791.71",
21-Nov-23,Transportellaneous,00.00,"1,597.24","3,194.47",
21-Nov-23,Transfer,08.00,00.00,"3,202.47",
21-Nov-23,ATM,00.00,800.62,"2,401.85",
21-Nov-23,Bill,"6,403.55",00.00,"8,805.40",
21-Nov-23,ATM,00.00,"2,201.35","6,604.05",
21-Nov-23,Cash,"3,886.09",00.00,"10,490.14",
21-Nov-23,Reversal,00.00,"1,498.59","8,991.55",
21-Nov-23,Commission,39.59,00.00,"9,031.14",
21-Nov-23,Cash,61,00.00,"9,092.14",
21-Nov-23,Reversal,00.00,"1,010.24","8,081.90",
21-Nov-23,Purchase,"18,299.40",00.00,"26,381.30",
21-Nov-23,Debit Card,00.00,"3,768.76","22,612.54",
21-Nov-23,IMPS,"2,828.05",00.00,"25,440.59",
21-Nov-23,Reversal,07.66,00.00,"25,448.25",
22-Nov-23,Reversal,00.00,"2,544.83","22,903.42",
22-Nov-23,RTGS,00.00,"22,903.42",00.00,
22-Nov-23,ATM,07.90,00.00,07.90,
23-Nov-23,Debit Card,07.00,00.00,14.9,
23-Nov-23,Commission,"3,405.00",00.00,"3,419.90",
23-Nov-23,Bill,00.00,488.56,"2,931.34",
24-Nov-23,Reversal,57.7,00.00,"2,989.04",
24-Nov-23,Commission,00.00,"2,989.04",00.00,
24-Nov-23,RTGS,45.3,00.00,45.3,
25-Nov-23,Bill,00.00,04.53,40.77,
25-Nov-23,NEFT,"17,552.10",00.00,"17,592.87",
25-Nov-23,ATM,00.00,"4,398.22","13,194.65",
25-Nov-23,Cheque,00.00,"1,884.95","11,309.70",
25-Nov-23,Cash,"16,727.30",00.00,"28,037.00",
25-Nov-23,Debit Card,00.00,"4,672.83","23,364.17",
25-Nov-23,NEFT,"12,893.00",00.00,"36,257.17",
25-Nov-23,ATM,00.00,"12,085.72","24,171.45",
25-Nov-23,Debit Card,02.97,00.00,"24,174.42",
25-Nov-23,Cash,00.23,00.00,"24,174.65",
25-Nov-23,Reversal,00.00,"12,087.33","12,087.32",
25-Nov-23,Purchase,00.00,"1,343.04","10,744.28",
25-Nov-23,Transfer,"3,006.24",00.00,"13,750.52",
25-Nov-23,Interest,00.00,"13,750.52",00.00,
25-Nov-23,Tax,"9,326.00",00.00,"9,326.00",
25-Nov-23,Debit Card,00.00,"1,036.22","8,289.78",
25-Nov-23,IMPS,00.00,"2,072.45","6,217.34",
25-Nov-23,Transportellaneous,00.00,"3,108.67","3,108.67",
25-Nov-23,ATM,00.00,"3,108.67",00.00,
25-Nov-23,Reversal,"8,712.80",00.00,"8,712.80",
26-Nov-23,IMPS,00.00,"8,712.80",00.00,
26-Nov-23,Bill,05.80,00.00,05.80,
26-Nov-23,Tax,00.00,01.45,04.35,
26-Nov-23,IMPS,00.00,00.87,03.48,
26-Nov-23,Bill,00.00,00.87,02.61,
26-Nov-23,IMPS,"25,016.00",00.00,"25,018.61",
26-Nov-23,IMPS,00.00,"6,254.65","18,763.96",
26-Nov-23,Reversal,00.00,"6,254.65","12,509.31",
26-Nov-23,RTGS,"18,149.00",00.00,"30,658.31",
26-Nov-23,Interest,00.00,"15,329.16","15,329.16",
26-Nov-23,Debit Card,00.00,"5,109.72","10,219.44",
26-Nov-23,NEFT,00.00,"1,021.94","9,197.50",
26-Nov-23,Bill,448,00.00,"9,645.50",
26-Nov-23,IMPS,00.00,"9,645.50",00.00,
26-Nov-23,Transportellaneous,262.3,00.00,262.3,
26-Nov-23,RTGS,00.00,131.15,131.15,
26-Nov-23,Bill,00.00,26.23,104.92,
26-Nov-23,Purchase,00.00,10.49,94.43,
26-Nov-23,NEFT,"6,12,187.00",00.00,"6,12,281.43",
26-Nov-23,Bill,"9,880.40",00.00,"6,22,161.83",
26-Nov-23,IMPS,59.52,00.00,"6,22,221.35",
26-Nov-23,Reversal,00.00,"1,03,703.56","5,18,517.79",
26-Nov-23,Tax,01.60,00.00,"5,18,519.39",
27-Nov-23,Transfer,"17,60,499.50",00.00,"22,79,018.89",
27-Nov-23,RTGS,12.8,00.00,"22,79,031.69",
27-Nov-23,Bill,00.00,"4,55,806.34","18,23,225.35",
27-Nov-23,IMPS,00.00,"2,60,460.76","15,62,764.59",
27-Nov-23,NEFT,00.21,00.00,"15,62,764.80",
27-Nov-23,Transfer,00.00,"2,23,252.11","13,39,512.69",
27-Nov-23,ATM,00.00,"1,67,439.09","11,72,073.60",
27-Nov-23,Purchase,"7,93,011.80",00.00,"19,65,085.40",
27-Nov-23,Transfer,00.00,"6,55,028.47","13,10,056.93",
28-Nov-23,Commission,"21,036.90",00.00,"13,31,093.83",
28-Nov-23,Commission,"13,94,355.00",00.00,"27,25,448.83",
28-Nov-23,Cheque,00.00,"2,72,544.88","24,52,903.95",
28-Nov-23,IMPS,"1,62,792.60",00.00,"26,15,696.55",
28-Nov-23,Transfer,00.00,"6,53,924.14","19,61,772.41",
28-Nov-23,Commission,43.5,00.00,"19,61,815.91",
28-Nov-23,Reversal,972,00.00,"19,62,787.91",
28-Nov-23,IMPS,00.00,"3,27,131.32","16,35,656.59",
28-Nov-23,Tax,391.05,00.00,"16,36,047.64",
28-Nov-23,NEFT,00.00,"5,45,349.21","10,90,698.43",
28-Nov-23,IMPS,00.00,"1,09,069.84","9,81,628.59",
28-Nov-23,Cash,00.00,"9,81,628.59",00.00,
28-Nov-23,Debit Card,"14,15,074.00",00.00,"14,15,074.00",
28-Nov-23,RTGS,"1,23,574.50",00.00,"15,38,648.50",
28-Nov-23,Debit Card,00.00,"5,12,882.83","10,25,765.67",
28-Nov-23,Transportellaneous,00.00,"3,41,921.89","6,83,843.78",
28-Nov-23,RTGS,"27,076.00",00.00,"7,10,919.78",
29-Nov-23,IMPS,420.3,00.00,"7,11,340.08",
29-Nov-23,NEFT,"27,901.80",00.00,"7,39,241.88",
29-Nov-23,Transportellaneous,00.00,"2,46,413.96","4,92,827.92",
29-Nov-23,NEFT,00.00,"82,137.99","4,10,689.93",
29-Nov-23,Cheque,00.00,"68,448.32","3,42,241.61",
29-Nov-23,Cheque,00.00,"3,42,241.61",00.00,
29-Nov-23,ATM,"5,209.20",00.00,"5,209.20",
29-Nov-23,Interest,"89,461.41",00.00,"94,670.61",
29-Nov-23,Bill,"31,594.62",00.00,"1,26,265.23",
29-Nov-23,NEFT,07.00,00.00,"1,26,272.23",
29-Nov-23,Transfer,00.00,"15,784.03","1,10,488.20",
29-Nov-23,Purchase,"4,756.00",00.00,"1,15,244.20",
29-Nov-23,Transportellaneous,00.00,"19,207.37","96,036.83",
29-Nov-23,Interest,00.00,"13,719.55","82,317.28",
29-Nov-23,Bill,11.01,00.00,"82,328.29",
30-Nov-23,NEFT,"1,47,665.00",00.00,"2,29,993.29",
30-Nov-23,Reversal,00.00,"32,856.18","1,97,137.11",
30-Nov-23,Reversal,00.00,"28,162.44","1,68,974.67",
30-Nov-23,Interest,447.8,00.00,"1,69,422.47",
30-Nov-23,Purchase,400.71,00.00,"1,69,823.18",
30-Nov-23,RTGS,00.00,"33,964.64","1,35,858.54",
30-Nov-23,IMPS,126.55,00.00,"1,35,985.09",
30-Nov-23,Transportellaneous,00.00,"22,664.18","1,13,320.91",
30-Nov-23,Debit Card,"6,670.91",00.00,"1,19,991.82",
30-Nov-23,IMPS,00.00,"39,997.27","79,994.55",
30-Nov-23,Debit Card,"2,37,561.00",00.00,"3,17,555.55",
30-Nov-23,RTGS,00.00,"1,58,777.78","1,58,777.78",
30-Nov-23,Reversal,00.00,"79,388.89","79,388.89",
30-Nov-23,Cash,00.00,"15,877.78","63,511.11",
30-Nov-23,RTGS,"1,082.00",00.00,"64,593.11",
30-Nov-23,IMPS,00.00,"8,074.14","56,518.97",
30-Nov-23,Tax,00.00,"11,303.79","45,215.18",
30-Nov-23,NEFT,00.00,"6,459.31","38,755.87",
30-Nov-23,Cheque,00.00,"4,306.21","34,449.66",
30-Nov-23,Transfer,"31,643.10",00.00,"66,092.76",
30-Nov-23,Purchase,"96,160.25",00.00,"1,62,253.01",
30-Nov-23,Commission,00.00,"18,028.11","1,44,224.90",
30-Nov-23,Commission,"13,441.00",00.00,"1,57,665.90",
30-Nov-23,Transportellaneous,00.00,"26,277.65","1,31,388.25",
30-Nov-23,RTGS,"19,08,547.00",00.00,"20,39,935.25",
30-Nov-23,Cash,60,00.00,"20,39,995.25",
01-Dec-23,Cheque,05.50,00.00,"20,40,000.75",
02-Dec-23,Debit Card,00.00,"2,04,000.08","18,36,000.68",
02-Dec-23,Interest,00.00,"2,62,285.81","15,73,714.87",
02-Dec-23,Commission,"1,454.00",00.00,"15,75,168.87",
02-Dec-23,Cash,40.6,00.00,"15,75,209.47",
02-Dec-23,Cash,55.72,00.00,"15,75,265.19",
02-Dec-23,Cash,00.00,"7,87,632.60","7,87,632.60",
02-Dec-23,Cash,00.00,"1,57,526.52","6,30,106.08",
02-Dec-23,Reversal,00.00,"6,30,106.08",00.00,
02-Dec-23,Debit Card,44.06,00.00,44.06,
02-Dec-23,Reversal,00.00,08.81,35.25,
02-Dec-23,Transportellaneous,00.00,03.53,31.72,
02-Dec-23,Purchase,00.00,15.86,15.86,
02-Dec-23,Purchase,00.00,01.59,14.27,
02-Dec-23,RTGS,00.00,14.27,00.00,
02-Dec-23,Bill,"13,03,577.00",00.00,"13,03,577.00",
02-Dec-23,NEFT,00.00,"1,44,841.89","11,58,735.11",
02-Dec-23,IMPS,00.00,"11,58,735.11",00.00,
02-Dec-23,Tax,61.6,00.00,61.6,
02-Dec-23,Transportellaneous,00.00,07.70,53.9,
03-Dec-23,Interest,00.00,13.48,40.42,
03-Dec-23,NEFT,00.00,10.11,30.32,
03-Dec-23,Transfer,"2,07,925.00",00.00,"2,07,955.32",
03-Dec-23,Debit Card,"7,09,711.00",00.00,"9,17,666.32",
03-Dec-23,Cash,00.00,"91,766.63","8,25,899.69",
03-Dec-23,RTGS,00.97,00.00,"8,25,900.66",
04-Dec-23,Cheque,00.00,"4,12,950.33","4,12,950.33",
04-Dec-23,Interest,00.00,"2,06,475.17","2,06,475.16",
04-Dec-23,Tax,11,00.00,"2,06,486.16",
04-Dec-23,Transfer,00.00,"25,810.77","1,80,675.39",
04-Dec-23,Purchase,336,00.00,"1,81,011.39",
04-Dec-23,Interest,00.00,"25,858.77","1,55,152.62",
04-Dec-23,Tax,00.00,"17,239.18","1,37,913.44",
04-Dec-23,Cash,00.00,"45,971.15","91,942.29",
04-Dec-23,NEFT,"4,035.78",00.00,"95,978.07",
04-Dec-23,Bill,"3,398.41",00.00,"99,376.48",
04-Dec-23,Cash,"1,691.90",00.00,"1,01,068.38",
04-Dec-23,NEFT,"2,174.30",00.00,"1,03,242.68",
04-Dec-23,Transfer,00.00,"17,207.11","86,035.57",
04-Dec-23,NEFT,47,00.00,"86,082.57",
04-Dec-23,Interest,00.00,"86,082.57",00.00,
04-Dec-23,Cash,"28,425.56",00.00,"28,425.56",
04-Dec-23,Commission,"22,288.53",00.00,"50,714.09",
04-Dec-23,Transfer,00.00,"6,339.26","44,374.83",
04-Dec-23,NEFT,00.00,"6,339.26","38,035.57",
04-Dec-23,Interest,00.00,"5,433.65","32,601.92",
04-Dec-23,Cash,00.00,"4,075.24","28,526.68",
04-Dec-23,Commission,"8,367.80",00.00,"36,894.48",
04-Dec-23,Cash,00.00,"7,378.90","29,515.58",
04-Dec-23,Interest,00.00,"5,903.12","23,612.46",
04-Dec-23,ATM,485.84,00.00,"24,098.30",
04-Dec-23,Interest,"16,775.50",00.00,"40,873.80",
04-Dec-23,Tax,"9,350.10",00.00,"50,223.90",
04-Dec-23,Bill,00.00,"5,580.43","44,643.47",
04-Dec-23,Debit Card,00.00,"8,928.69","35,714.78",
04-Dec-23,Tax,61,00.00,"35,775.78",
04-Dec-23,Transportellaneous,00.00,"3,577.58","32,198.20",
04-Dec-23,ATM,00.00,"6,439.64","25,758.56",
04-Dec-23,Purchase,"10,35,472.25",00.00,"10,61,230.81",
05-Dec-23,Tax,00.00,"5,30,615.41","5,30,615.40",
05-Dec-23,Cash,00.00,"75,802.20","4,54,813.20",
06-Dec-23,Debit Card,00.00,"90,962.64","3,63,850.56",
06-Dec-23,Tax,00.00,"90,962.64","2,72,887.92",
06-Dec-23,RTGS,00.00,"30,320.88","2,42,567.04",
06-Dec-23,Tax,00.00,"1,21,283.52","1,21,283.52",
06-Dec-23,Bill,04.00,00.00,"1,21,287.52",
06-Dec-23,Transfer,06.85,00.00,"1,21,294.37",
06-Dec-23,Cheque,00.00,"15,161.80","1,06,132.57",
06-Dec-23,RTGS,"1,73,250.47",00.00,"2,79,383.04",
06-Dec-23,Commission,"2,085.46",00.00,"2,81,468.50",
06-Dec-23,Reversal,00.00,"2,81,468.50",00.00,
06-Dec-23,Debit Card,178.9,00.00,178.9,
06-Dec-23,ATM,00.00,44.73,134.18,
06-Dec-23,ATM,"3,907.00",00.00,"4,041.18",
06-Dec-23,Transfer,"1,10,947.53",00.00,"1,14,988.71",
06-Dec-23,RTGS,00.00,"14,373.59","1,00,615.12",
06-Dec-23,ATM,00.00,"16,769.19","83,845.93",
06-Dec-23,Cash,01.30,00.00,"83,847.23",
06-Dec-23,Commission,00.00,"11,978.18","71,869.05",
06-Dec-23,Interest,"18,25,737.00",00.00,"18,97,606.05",
06-Dec-23,RTGS,264.1,00.00,"18,97,870.15",
06-Dec-23,Cash,789.5,00.00,"18,98,659.65",
06-Dec-23,NEFT,"17,43,362.20",00.00,"36,42,021.85",
06-Dec-23,Bill,"8,036.30",00.00,"36,50,058.15",
06-Dec-23,Cheque,00.00,"4,56,257.27","31,93,800.88",
06-Dec-23,Cheque,59.68,00.00,"31,93,860.56",
06-Dec-23,Reversal,00.00,"7,98,465.14","23,95,395.42",
06-Dec-23,Bill,00.00,"7,98,465.14","15,96,930.28",
06-Dec-23,Purchase,"14,70,418.75",00.00,"30,67,349.03",
06-Dec-23,Commission,425,00.00,"30,67,774.03",
06-Dec-23,Tax,00.00,"3,06,777.40","27,60,996.63",
06-Dec-23,IMPS,379.8,00.00,"27,61,376.43",
06-Dec-23,Interest,32,00.00,"27,61,408.43",
06-Dec-23,Transfer,34.09,00.00,"27,61,442.52",
06-Dec-23,Purchase,"14,19,787.20",00.00,"41,81,229.72",
06-Dec-23,IMPS,00.00,"6,96,871.62","34,84,358.10",
06-Dec-23,Reversal,920,00.00,"34,85,278.10",
07-Dec-23,Cash,00.00,"8,71,319.53","26,13,958.58",
07-Dec-23,Purchase,00.00,"2,61,395.86","23,52,562.72",
07-Dec-23,Transfer,00.00,"2,61,395.86","20,91,166.86",
07-Dec-23,IMPS,109,00.00,"20,91,275.86",
07-Dec-23,Commission,60.7,00.00,"20,91,336.56",
07-Dec-23,Tax,00.00,"4,18,267.31","16,73,069.25",
07-Dec-23,Commission,00.00,"16,73,069.25",00.00,
07-Dec-23,Debit Card,"13,85,182.80",00.00,"13,85,182.80",
08-Dec-23,IMPS,00.00,"2,77,036.56","11,08,146.24",
08-Dec-23,NEFT,00.00,"3,69,382.08","7,38,764.16",
08-Dec-23,Cheque,37,00.00,"7,38,801.16",
08-Dec-23,Debit Card,37.5,00.00,"7,38,838.66",
08-Dec-23,ATM,00.00,"1,47,767.73","5,91,070.93",
08-Dec-23,Cash,00.00,"98,511.82","4,92,559.11",
08-Dec-23,Debit Card,"7,118.50",00.00,"4,99,677.61",
08-Dec-23,Cheque,426.5,00.00,"5,00,104.11",
08-Dec-23,Cheque,"3,826.70",00.00,"5,03,930.81",
08-Dec-23,Purchase,"11,770.41",00.00,"5,15,701.22",
08-Dec-23,NEFT,00.00,"5,15,701.22",00.00,
08-Dec-23,Bill,"2,360.00",00.00,"2,360.00",
08-Dec-23,IMPS,25.74,00.00,"2,385.74",
08-Dec-23,Transportellaneous,00.00,477.15,"1,908.59",
08-Dec-23,Tax,00.00,190.86,"1,717.73",
08-Dec-23,Transportellaneous,07.00,00.00,"1,724.73",
08-Dec-23,Debit Card,00.00,191.64,"1,533.09",
08-Dec-23,NEFT,00.00,511.03,"1,022.06",
08-Dec-23,Purchase,00.00,170.34,851.72,
08-Dec-23,RTGS,00.00,94.64,757.08,
08-Dec-23,RTGS,"13,63,203.50",00.00,"13,63,960.58",
08-Dec-23,Transfer,00.00,"2,72,792.12","10,91,168.46",
08-Dec-23,Transfer,"71,890.00",00.00,"11,63,058.46",
08-Dec-23,Cheque,"30,633.00",00.00,"11,93,691.46",
08-Dec-23,Bill,00.00,"1,70,527.35","10,23,164.11",
08-Dec-23,Interest,50.99,00.00,"10,23,215.10",
08-Dec-23,Debit Card,00.00,"1,02,321.51","9,20,893.59",
08-Dec-23,Commission,00.00,"1,84,178.72","7,36,714.87",
08-Dec-23,Cheque,"35,635.00",00.00,"7,72,349.87",
08-Dec-23,NEFT,00.00,"1,54,469.97","6,17,879.90",
08-Dec-23,Transportellaneous,"1,865.00",00.00,"6,19,744.90",
08-Dec-23,Debit Card,00.00,"77,468.11","5,42,276.79",
08-Dec-23,Bill,"19,15,220.50",00.00,"24,57,497.29",
08-Dec-23,IMPS,00.00,"8,19,165.76","16,38,331.53",
08-Dec-23,Purchase,04.00,00.00,"16,38,335.53",
08-Dec-23,Commission,"1,29,737.22",00.00,"17,68,072.75",
08-Dec-23,Transportellaneous,00.00,"17,68,072.75",00.00,
09-Dec-23,Reversal,"1,475.00",00.00,"1,475.00",
09-Dec-23,Interest,186,00.00,"1,661.00",
09-Dec-23,Transfer,507.1,00.00,"2,168.10",
09-Dec-23,RTGS,03.60,00.00,"2,171.70",
09-Dec-23,Commission,00.00,723.9,"1,447.80",
10-Dec-23,Purchase,00.00,"1,447.80",00.00,
10-Dec-23,Cheque,04.00,00.00,04.00,
10-Dec-23,NEFT,00.00,00.40,03.60,
10-Dec-23,Debit Card,"16,906.00",00.00,"16,909.60",
10-Dec-23,Bill,00.00,"1,878.84","15,030.76",
10-Dec-23,Commission,06.00,00.00,"15,036.76",
10-Dec-23,Transportellaneous,00.00,"3,007.35","12,029.41",
10-Dec-23,Cheque,10.44,00.00,"12,039.85",
10-Dec-23,Transfer,"1,08,615.25",00.00,"1,20,655.10",
10-Dec-23,NEFT,00.00,"1,20,655.10",00.00,
10-Dec-23,Debit Card,"1,51,243.00",00.00,"1,51,243.00",
11-Dec-23,Tax,00.00,"30,248.60","1,20,994.40",
11-Dec-23,ATM,"18,33,573.00",00.00,"19,54,567.40",
11-Dec-23,Transfer,00.00,"1,95,456.74","17,59,110.66",
11-Dec-23,Transportellaneous,00.00,"8,79,555.33","8,79,555.33",
12-Dec-23,IMPS,527.8,00.00,"8,80,083.13",
13-Dec-23,ATM,00.00,"1,10,010.39","7,70,072.74",
13-Dec-23,Purchase,00.00,"3,85,036.37","3,85,036.37",
13-Dec-23,NEFT,00.00,"42,781.82","3,42,254.55",
13-Dec-23,NEFT,00.00,"42,781.82","2,99,472.73",
13-Dec-23,Cash,00.00,"59,894.55","2,39,578.18",
13-Dec-23,Cheque,26,00.00,"2,39,604.18",
13-Dec-23,Bill,"51,510.00",00.00,"2,91,114.18",
13-Dec-23,Transfer,00.00,"1,45,557.09","1,45,557.09",
13-Dec-23,Tax,486.29,00.00,"1,46,043.38",
13-Dec-23,Transfer,00.00,"1,46,043.38",00.00,
13-Dec-23,Cash,08.00,00.00,08.00,
13-Dec-23,Transfer,"22,360.10",00.00,"22,368.10",
13-Dec-23,IMPS,00.00,"11,184.05","11,184.05",
13-Dec-23,Cheque,09.00,00.00,"11,193.05",
13-Dec-23,Cash,00.00,"1,865.51","9,327.54",
13-Dec-23,Reversal,22.5,00.00,"9,350.04",
13-Dec-23,Cheque,"5,03,708.00",00.00,"5,13,058.04",
13-Dec-23,ATM,70,00.00,"5,13,128.04",
13-Dec-23,RTGS,00.00,"1,02,625.61","4,10,502.43",
13-Dec-23,ATM,00.00,"1,02,625.61","3,07,876.82",
13-Dec-23,NEFT,324.85,00.00,"3,08,201.67",
13-Dec-23,Transfer,00.00,"1,02,733.89","2,05,467.78",
13-Dec-23,Transportellaneous,"2,88,984.50",00.00,"4,94,452.28",
13-Dec-23,Commission,00.00,"1,23,613.07","3,70,839.21",
13-Dec-23,Cash,00.00,"3,70,839.21",00.00,
13-Dec-23,Transfer,"3,13,069.75",00.00,"3,13,069.75",
13-Dec-23,Transportellaneous,00.00,"3,13,069.75",00.00,
13-Dec-23,Cash,"1,166.40",00.00,"1,166.40",
13-Dec-23,Commission,00.00,"1,166.40",00.00,
13-Dec-23,IMPS,01.00,00.00,01.00,
13-Dec-23,Debit Card,00.00,00.20,00.80,
13-Dec-23,Cheque,"13,924.30",00.00,"13,925.10",
13-Dec-23,Transportellaneous,00.00,"1,392.51","12,532.59",
13-Dec-23,NEFT,89.2,00.00,"12,621.79",
13-Dec-23,NEFT,06.01,00.00,"12,627.80",
13-Dec-23,Purchase,00.00,"4,209.27","8,418.53",
13-Dec-23,Transportellaneous,00.00,"1,052.32","7,366.21",
13-Dec-23,Tax,166,00.00,"7,532.21",
13-Dec-23,NEFT,04.50,00.00,"7,536.71",
13-Dec-23,Transfer,"17,95,452.20",00.00,"18,02,988.91",
13-Dec-23,Debit Card,"3,963.75",00.00,"18,06,952.66",
14-Dec-23,Cash,00.00,"1,80,695.27","16,26,257.39",
14-Dec-23,ATM,00.00,"2,03,282.17","14,22,975.22",
14-Dec-23,Purchase,"1,254.81",00.00,"14,24,230.03",
14-Dec-23,Bill,00.00,"7,12,115.02","7,12,115.02",
14-Dec-23,Transportellaneous,"20,521.70",00.00,"7,32,636.72",
14-Dec-23,Bill,00.00,"81,404.08","6,51,232.64",
14-Dec-23,Cash,"82,828.30",00.00,"7,34,060.94",
14-Dec-23,Tax,"4,66,036.00",00.00,"12,00,096.94",
14-Dec-23,Commission,00.00,"3,00,024.24","9,00,072.70",
14-Dec-23,Reversal,00.00,"1,50,012.12","7,50,060.58",
14-Dec-23,Commission,00.00,"1,07,151.51","6,42,909.07",
14-Dec-23,NEFT,"26,347.88",00.00,"6,69,256.95",
14-Dec-23,ATM,66,00.00,"6,69,322.95",
14-Dec-23,Reversal,53.67,00.00,"6,69,376.62",
14-Dec-23,NEFT,"2,831.00",00.00,"6,72,207.62",
14-Dec-23,Bill,563.96,00.00,"6,72,771.58",
14-Dec-23,NEFT,"82,949.75",00.00,"7,55,721.33",
14-Dec-23,Purchase,"28,164.00",00.00,"7,83,885.33",
14-Dec-23,Transportellaneous,00.00,"87,098.37","6,96,786.96",
14-Dec-23,Purchase,330,00.00,"6,97,116.96",
14-Dec-23,Reversal,00.00,"3,48,558.48","3,48,558.48",
15-Dec-23,Transfer,00.00,"69,711.70","2,78,846.78",
15-Dec-23,Bill,00.00,"1,39,423.39","1,39,423.39",
15-Dec-23,Debit Card,"8,01,248.00",00.00,"9,40,671.39",
15-Dec-23,Reversal,"17,67,819.80",00.00,"27,08,491.19",
15-Dec-23,Tax,43.5,00.00,"27,08,534.69",
15-Dec-23,Interest,00.00,"3,86,933.53","23,21,601.16",
15-Dec-23,ATM,00.00,"23,21,601.16",00.00,
15-Dec-23,Tax,"9,356.98",00.00,"9,356.98",
15-Dec-23,ATM,"9,353.45",00.00,"18,710.43",
15-Dec-23,Cheque,504,00.00,"19,214.43",
15-Dec-23,Tax,00.00,"2,134.94","17,079.49",
15-Dec-23,Commission,00.00,"17,079.49",00.00,
15-Dec-23,ATM,"4,88,631.50",00.00,"4,88,631.50",
15-Dec-23,NEFT,07.90,00.00,"4,88,639.40",
15-Dec-23,IMPS,"2,40,736.10",00.00,"7,29,375.50",
15-Dec-23,IMPS,00.00,"1,82,343.88","5,47,031.62",
15-Dec-23,Commission,"6,010.80",00.00,"5,53,042.42",
15-Dec-23,NEFT,474.1,00.00,"5,53,516.52",
15-Dec-23,Cheque,00.00,"69,189.57","4,84,326.96",
15-Dec-23,Purchase,07.73,00.00,"4,84,334.69",
15-Dec-23,Cheque,00.00,"4,84,334.69",00.00,
15-Dec-23,Commission,"7,069.50",00.00,"7,069.50",
15-Dec-23,RTGS,63.07,00.00,"7,132.57",
15-Dec-23,Debit Card,"1,01,897.30",00.00,"1,09,029.87",
15-Dec-23,Purchase,00.00,"36,343.29","72,686.58",
15-Dec-23,Debit Card,425,00.00,"73,111.58",
15-Dec-23,NEFT,33.18,00.00,"73,144.76",
15-Dec-23,Transportellaneous,00.00,"14,628.95","58,515.81",
15-Dec-23,Bill,46,00.00,"58,561.81",
15-Dec-23,Transfer,"26,992.10",00.00,"85,553.91",
15-Dec-23,Transfer,20,00.00,"85,573.91",
15-Dec-23,Cash,48.77,00.00,"85,622.68",
15-Dec-23,NEFT,00.00,"9,513.63","76,109.05",
15-Dec-23,Reversal,"2,18,184.78",00.00,"2,94,293.83",
15-Dec-23,RTGS,49,00.00,"2,94,342.83",
15-Dec-23,Transfer,00.00,"73,585.71","2,20,757.12",
15-Dec-23,IMPS,00.00,"55,189.28","1,65,567.84",
15-Dec-23,Tax,"1,48,837.20",00.00,"3,14,405.04",
15-Dec-23,Transportellaneous,"6,372.50",00.00,"3,20,777.54",
15-Dec-23,Commission,00.00,"3,20,777.54",00.00,
15-Dec-23,ATM,37.8,00.00,37.8,
15-Dec-23,Transportellaneous,"10,506.69",00.00,"10,544.49",
15-Dec-23,Debit Card,00.00,"2,108.90","8,435.59",
15-Dec-23,Transportellaneous,00.00,843.56,"7,592.03",
15-Dec-23,Debit Card,76.63,00.00,"7,668.66",
15-Dec-23,Reversal,03.70,00.00,"7,672.36",
15-Dec-23,IMPS,"45,147.00",00.00,"52,819.36",
15-Dec-23,Debit Card,"6,100.00",00.00,"58,919.36",
15-Dec-23,Commission,00.00,"14,729.84","44,189.52",
15-Dec-23,Cheque,"19,53,170.00",00.00,"19,97,359.52",
15-Dec-23,Cheque,"1,73,508.00",00.00,"21,70,867.52",
15-Dec-23,NEFT,04.90,00.00,"21,70,872.42",
15-Dec-23,Reversal,05.00,00.00,"21,70,877.42",
15-Dec-23,Transportellaneous,00.00,"2,71,359.68","18,99,517.74",
15-Dec-23,Purchase,00.30,00.00,"18,99,518.04",
15-Dec-23,Bill,51.82,00.00,"18,99,569.86",
15-Dec-23,Bill,"4,503.51",00.00,"19,04,073.37",
15-Dec-23,Debit Card,04.40,00.00,"19,04,077.77",
15-Dec-23,ATM,"3,735.00",00.00,"19,07,812.77",
15-Dec-23,Interest,01.00,00.00,"19,07,813.77",
15-Dec-23,Transfer,"99,703.44",00.00,"20,07,517.21",
16-Dec-23,Cash,00.00,"2,00,751.72","18,06,765.49",
16-Dec-23,Debit Card,"17,59,685.00",00.00,"35,66,450.49",
16-Dec-23,Bill,00.00,"4,45,806.31","31,20,644.18",
16-Dec-23,Tax,00.00,"6,24,128.84","24,96,515.34",
16-Dec-23,RTGS,"10,379.47",00.00,"25,06,894.81",
16-Dec-23,Interest,53,00.00,"25,06,947.81",
16-Dec-23,Cash,"81,911.47",00.00,"25,88,859.28",
16-Dec-23,Transfer,"1,38,058.20",00.00,"27,26,917.48",
16-Dec-23,Cheque,00.00,"3,02,990.83","24,23,926.65",
16-Dec-23,Transfer,00.00,"2,69,325.18","21,54,601.47",
16-Dec-23,Commission,"1,290.00",00.00,"21,55,891.47",
16-Dec-23,Cheque,00.00,"2,69,486.43","18,86,405.04",
16-Dec-23,Cash,"20,149.07",00.00,"19,06,554.11",
16-Dec-23,ATM,00.00,"4,76,638.53","14,29,915.58",
16-Dec-23,Purchase,00.00,"2,85,983.12","11,43,932.46",
16-Dec-23,Tax,"8,222.00",00.00,"11,52,154.46",
16-Dec-23,Debit Card,04.00,00.00,"11,52,158.46",
17-Dec-23,NEFT,00.00,"1,64,594.07","9,87,564.39",
17-Dec-23,Transfer,03.50,00.00,"9,87,567.89",
17-Dec-23,NEFT,00.00,"98,756.79","8,88,811.10",
17-Dec-23,Bill,"1,72,586.25",00.00,"10,61,397.35",
17-Dec-23,IMPS,317,00.00,"10,61,714.35",
17-Dec-23,Bill,00.00,"10,61,714.35",00.00,
17-Dec-23,Cheque,00.30,00.00,00.30,
17-Dec-23,Reversal,"11,857.70",00.00,"11,858.00",
17-Dec-23,NEFT,06.30,00.00,"11,864.30",
17-Dec-23,Cash,00.00,"5,932.15","5,932.15",
17-Dec-23,Transportellaneous,00.00,"1,977.38","3,954.77",
17-Dec-23,Debit Card,00.00,564.97,"3,389.80",
17-Dec-23,Debit Card,"2,226.00",00.00,"5,615.80",
17-Dec-23,Cash,00.00,701.98,"4,913.82",
17-Dec-23,RTGS,38.73,00.00,"4,952.55",
17-Dec-23,Commission,00.00,"4,952.55",00.00,
17-Dec-23,Bill,"31,830.50",00.00,"31,830.50",
17-Dec-23,IMPS,"2,01,176.09",00.00,"2,33,006.59",
17-Dec-23,Transportellaneous,00.00,"25,889.62","2,07,116.97",
17-Dec-23,ATM,"6,74,678.25",00.00,"8,81,795.22",
17-Dec-23,Interest,00.00,"2,20,448.81","6,61,346.42",
17-Dec-23,Reversal,00.00,"1,32,269.28","5,29,077.14",
17-Dec-23,Cash,00.00,"52,907.71","4,76,169.43",
17-Dec-23,Interest,00.00,"1,19,042.36","3,57,127.07",
17-Dec-23,Debit Card,"27,123.30",00.00,"3,84,250.37",
17-Dec-23,RTGS,00.00,"42,694.49","3,41,555.88",
17-Dec-23,RTGS,00.00,"68,311.18","2,73,244.70",
17-Dec-23,Debit Card,"12,94,300.20",00.00,"15,67,544.90",
18-Dec-23,Tax,00.00,"3,13,508.98","12,54,035.92",
18-Dec-23,Cash,219,00.00,"12,54,254.92",
18-Dec-23,Tax,00.00,"4,18,084.97","8,36,169.95",
18-Dec-23,Reversal,52.47,00.00,"8,36,222.42",
18-Dec-23,Transportellaneous,00.00,"4,18,111.21","4,18,111.21",
18-Dec-23,Tax,00.00,"1,04,527.80","3,13,583.41",
18-Dec-23,Transfer,00.00,"31,358.34","2,82,225.07",
18-Dec-23,Interest,00.00,"1,41,112.54","1,41,112.54",
18-Dec-23,Tax,00.00,"28,222.51","1,12,890.03",
18-Dec-23,Cash,00.00,"1,12,890.03",00.00,
18-Dec-23,IMPS,00.90,00.00,00.90,
18-Dec-23,Cash,00.00,00.10,00.80,
18-Dec-23,Cash,00.00,00.11,00.69,
18-Dec-23,Debit Card,00.00,00.35,00.34,
18-Dec-23,Debit Card,00.00,00.11,00.23,
18-Dec-23,Reversal,00.00,00.03,00.20,
18-Dec-23,Commission,"1,93,129.00",00.00,"1,93,129.20",
18-Dec-23,Tax,00.00,"96,564.60","96,564.60",
18-Dec-23,Interest,09.00,00.00,"96,573.60",
18-Dec-23,Transportellaneous,00.00,"10,730.40","85,843.20",
18-Dec-23,Debit Card,"1,20,622.60",00.00,"2,06,465.80",
18-Dec-23,ATM,00.00,"29,495.11","1,76,970.69",
18-Dec-23,Reversal,00.00,"17,697.07","1,59,273.62",
18-Dec-23,Commission,00.00,"26,545.60","1,32,728.02",
18-Dec-23,Debit Card,358.6,00.00,"1,33,086.62",
18-Dec-23,ATM,00.00,"22,181.10","1,10,905.52",
18-Dec-23,NEFT,185.56,00.00,"1,11,091.08",
18-Dec-23,IMPS,39.91,00.00,"1,11,130.99",
18-Dec-23,Transfer,"2,18,965.38",00.00,"3,30,096.37",
18-Dec-23,Purchase,"2,001.80",00.00,"3,32,098.17",
18-Dec-23,NEFT,04.00,00.00,"3,32,102.17",
18-Dec-23,Transportellaneous,"2,538.00",00.00,"3,34,640.17",
18-Dec-23,NEFT,"12,214.80",00.00,"3,46,854.97",
18-Dec-23,NEFT,03.97,00.00,"3,46,858.94",
18-Dec-23,Reversal,00.00,"3,46,858.94",00.00,
19-Dec-23,Tax,"53,106.90",00.00,"53,106.90",
19-Dec-23,Cheque,"10,570.00",00.00,"63,676.90",
19-Dec-23,Transportellaneous,00.00,"12,735.38","50,941.52",
19-Dec-23,Commission,00.00,"5,660.17","45,281.35",
19-Dec-23,Transfer,06.57,00.00,"45,287.92",
20-Dec-23,Reversal,00.00,"5,660.99","39,626.93",
20-Dec-23,IMPS,222.5,00.00,"39,849.43",
20-Dec-23,Purchase,04.00,00.00,"39,853.43",
20-Dec-23,NEFT,53.23,00.00,"39,906.66",
20-Dec-23,Interest,"14,99,287.00",00.00,"15,39,193.66",
20-Dec-23,Tax,00.00,"2,56,532.28","12,82,661.38",
20-Dec-23,Cheque,"2,603.60",00.00,"12,85,264.98",
20-Dec-23,Transfer,365,00.00,"12,85,629.98",
20-Dec-23,Transportellaneous,"2,737.10",00.00,"12,88,367.08",
20-Dec-23,NEFT,04.10,00.00,"12,88,371.18",
20-Dec-23,RTGS,"3,004.00",00.00,"12,91,375.18",
20-Dec-23,Tax,00.00,00.00,"12,91,375.18",
20-Dec-23,Purchase,00.00,"12,91,375.18",00.00,
20-Dec-23,Cheque,"3,50,961.00",00.00,"3,50,961.00",
20-Dec-23,Debit Card,00.00,"70,192.20","2,80,768.80",
20-Dec-23,Transfer,00.00,"31,196.53","2,49,572.27",
20-Dec-23,Interest,00.00,"31,196.53","2,18,375.74",
20-Dec-23,Transfer,"1,371.00",00.00,"2,19,746.74",
20-Dec-23,Cash,"1,37,867.00",00.00,"3,57,613.74",
20-Dec-23,Tax,"11,26,793.25",00.00,"14,84,406.99",
20-Dec-23,Cash,00.00,"2,12,058.14","12,72,348.85",
20-Dec-23,Interest,"2,30,647.00",00.00,"15,02,995.85",
20-Dec-23,Cheque,00.00,"1,87,874.48","13,15,121.37",
20-Dec-23,Bill,00.00,"1,64,390.17","11,50,731.20",
20-Dec-23,Tax,61.9,00.00,"11,50,793.10",
20-Dec-23,Commission,"9,33,641.80",00.00,"20,84,434.90",
20-Dec-23,Transportellaneous,"5,309.70",00.00,"20,89,744.60",
20-Dec-23,RTGS,"8,11,823.25",00.00,"29,01,567.85",
20-Dec-23,Cash,"4,665.00",00.00,"29,06,232.85",
20-Dec-23,Bill,00.00,"4,84,372.14","24,21,860.71",
20-Dec-23,NEFT,"13,25,674.00",00.00,"37,47,534.71",
20-Dec-23,IMPS,00.00,"3,74,753.47","33,72,781.24",
20-Dec-23,Bill,"1,817.00",00.00,"33,74,598.24",
20-Dec-23,NEFT,00.00,"3,74,955.36","29,99,642.88",
20-Dec-23,NEFT,00.00,"14,99,821.44","14,99,821.44",
20-Dec-23,NEFT,00.00,"1,66,646.83","13,33,174.61",
20-Dec-23,Transportellaneous,00.00,"1,33,317.46","11,99,857.15",
20-Dec-23,Interest,00.00,"5,99,928.58","5,99,928.57",
20-Dec-23,RTGS,00.00,"1,49,982.14","4,49,946.43",
20-Dec-23,IMPS,00.00,"1,49,982.14","2,99,964.29",
20-Dec-23,IMPS,314,00.00,"3,00,278.29",
20-Dec-23,Transfer,00.00,"1,00,092.76","2,00,185.53",
20-Dec-23,Bill,"2,87,003.50",00.00,"4,87,189.03",
20-Dec-23,Tax,00.00,"1,21,797.26","3,65,391.77",
20-Dec-23,Purchase,"1,32,901.00",00.00,"4,98,292.77",
20-Dec-23,Bill,00.00,"4,98,292.77",00.00,
20-Dec-23,Bill,80.2,00.00,80.2,
20-Dec-23,Tax,491.33,00.00,571.53,
20-Dec-23,NEFT,"2,96,688.00",00.00,"2,97,259.53",
20-Dec-23,Debit Card,00.00,"49,543.26","2,47,716.28",
20-Dec-23,RTGS,00.00,"1,23,858.14","1,23,858.14",
20-Dec-23,Purchase,"17,09,857.25",00.00,"18,33,715.39",
20-Dec-23,Cheque,"20,59,867.00",00.00,"38,93,582.39",
20-Dec-23,Commission,"16,92,623.00",00.00,"55,86,205.39",
20-Dec-23,Interest,"2,998.21",00.00,"55,89,203.60",
20-Dec-23,Commission,190.48,00.00,"55,89,394.08",
20-Dec-23,Interest,00.00,"5,58,939.41","50,30,454.67",
20-Dec-23,Transportellaneous,96.1,00.00,"50,30,550.77",
20-Dec-23,Interest,00.00,"8,38,425.13","41,92,125.64",
20-Dec-23,Reversal,00.99,00.00,"41,92,126.63",
20-Dec-23,Interest,07.00,00.00,"41,92,133.63",
20-Dec-23,NEFT,02.40,00.00,"41,92,136.03",
20-Dec-23,IMPS,00.00,"4,19,213.60","37,72,922.43",
20-Dec-23,RTGS,"4,626.20",00.00,"37,77,548.63",
20-Dec-23,Bill,00.00,"12,59,182.88","25,18,365.75",
20-Dec-23,Commission,00.00,"25,18,365.75",00.00,
21-Dec-23,IMPS,"2,304.18",00.00,"2,304.18",
21-Dec-23,Cheque,04.60,00.00,"2,308.78",
21-Dec-23,Interest,00.00,"2,308.78",00.00,
21-Dec-23,Cheque,"1,52,347.30",00.00,"1,52,347.30",
21-Dec-23,Cheque,402.72,00.00,"1,52,750.02",
21-Dec-23,Bill,00.00,"76,375.01","76,375.01",
21-Dec-23,Interest,00.00,"19,093.75","57,281.26",
21-Dec-23,Bill,00.00,"11,456.25","45,825.01",
21-Dec-23,Interest,00.00,"45,825.01",00.00,
21-Dec-23,Tax,350,00.00,350,
21-Dec-23,Reversal,00.00,58.33,291.67,
21-Dec-23,Bill,"31,517.00",00.00,"31,808.67",
21-Dec-23,Reversal,00.00,"3,976.08","27,832.59",
21-Dec-23,Cash,00.00,"4,638.77","23,193.82",
21-Dec-23,RTGS,00.00,"2,319.38","20,874.44",
21-Dec-23,IMPS,"32,044.80",00.00,"52,919.24",
21-Dec-23,NEFT,00.00,"52,919.24",00.00,
21-Dec-23,Purchase,"54,423.00",00.00,"54,423.00",
21-Dec-23,Commission,00.00,"7,774.71","46,648.29",
21-Dec-23,Purchase,00.00,"46,648.29",00.00,
21-Dec-23,Transportellaneous,"10,899.10",00.00,"10,899.10",
21-Dec-23,IMPS,"14,81,276.20",00.00,"14,92,175.30",
21-Dec-23,ATM,00.00,"14,92,175.30",00.00,
21-Dec-23,ATM,"32,164.90",00.00,"32,164.90",
21-Dec-23,Reversal,00.00,"4,020.61","28,144.29",
22-Dec-23,Interest,10.33,00.00,"28,154.62",
22-Dec-23,Interest,06.40,00.00,"28,161.02",
22-Dec-23,Commission,00.00,"4,693.50","23,467.52",
22-Dec-23,Bill,00.00,"4,693.50","18,774.02",
23-Dec-23,Cheque,00.00,"6,258.01","12,516.01",
23-Dec-23,Tax,06.28,00.00,"12,522.29",
23-Dec-23,Commission,"3,556.87",00.00,"16,079.16",
23-Dec-23,Bill,00.00,"2,297.02","13,782.14",
23-Dec-23,Purchase,"16,90,245.00",00.00,"17,04,027.14",
23-Dec-23,Transfer,466.4,00.00,"17,04,493.54",
23-Dec-23,Cash,00.00,"2,13,061.69","14,91,431.85",
23-Dec-23,Bill,13.7,00.00,"14,91,445.55",
23-Dec-23,Purchase,00.00,"7,45,722.78","7,45,722.78",
23-Dec-23,Transportellaneous,275.92,00.00,"7,45,998.70",
23-Dec-23,Commission,00.00,"1,86,499.68","5,59,499.02",
23-Dec-23,Bill,"97,657.00",00.00,"6,57,156.02",
23-Dec-23,Purchase,00.00,"93,879.43","5,63,276.59",
23-Dec-23,NEFT,00.00,"56,327.66","5,06,948.93",
23-Dec-23,Reversal,00.00,"63,368.62","4,43,580.31",
23-Dec-23,Reversal,00.00,"44,358.03","3,99,222.28",
23-Dec-23,Transfer,26,00.00,"3,99,248.28",
23-Dec-23,Debit Card,00.00,"39,924.83","3,59,323.45",
23-Dec-23,IMPS,"7,09,195.75",00.00,"10,68,519.20",
23-Dec-23,Bill,511.4,00.00,"10,69,030.60",
23-Dec-23,Purchase,00.00,"2,13,806.12","8,55,224.48",
23-Dec-23,NEFT,"6,39,499.00",00.00,"14,94,723.48",
23-Dec-23,Interest,00.00,"4,98,241.16","9,96,482.32",
23-Dec-23,RTGS,00.00,"3,32,160.77","6,64,321.55",
23-Dec-23,Transportellaneous,00.00,"1,32,864.31","5,31,457.24",
23-Dec-23,Interest,38.6,00.00,"5,31,495.84",
23-Dec-23,Purchase,00.00,"5,31,495.84",00.00,
23-Dec-23,NEFT,06.00,00.00,06.00,
23-Dec-23,Interest,"5,26,839.25",00.00,"5,26,845.25",
23-Dec-23,ATM,00.00,"1,05,369.05","4,21,476.20",
23-Dec-23,Reversal,01.00,00.00,"4,21,477.20",
23-Dec-23,Transportellaneous,02.60,00.00,"4,21,479.80",
24-Dec-23,Reversal,00.00,"4,21,479.80",00.00,
24-Dec-23,Bill,60,00.00,60,
24-Dec-23,Transfer,00.00,06.00,54,
24-Dec-23,Tax,243.5,00.00,297.5,
24-Dec-23,NEFT,18,00.00,315.5,
24-Dec-23,Cash,603.98,00.00,919.48,
24-Dec-23,Purchase,"8,772.20",00.00,"9,691.68",
24-Dec-23,Reversal,182.8,00.00,"9,874.48",
25-Dec-23,Transportellaneous,474,00.00,"10,348.48",
25-Dec-23,Bill,00.00,"10,348.48",00.00,
25-Dec-23,Cash,06.20,00.00,06.20,
25-Dec-23,Cheque,"1,84,740.40",00.00,"1,84,746.60",
25-Dec-23,Reversal,"1,04,643.20",00.00,"2,89,389.80",
25-Dec-23,Purchase,00.00,"48,231.63","2,41,158.17",
26-Dec-23,Transfer,"3,16,240.75",00.00,"5,57,398.92",
26-Dec-23,ATM,"2,362.81",00.00,"5,59,761.73",
26-Dec-23,NEFT,144,00.00,"5,59,905.73",
26-Dec-23,Transportellaneous,00.00,"55,990.57","5,03,915.16",
26-Dec-23,Reversal,25,00.00,"5,03,940.16",
26-Dec-23,Debit Card,00.00,"71,991.45","4,31,948.71",
26-Dec-23,NEFT,"1,372.00",00.00,"4,33,320.71",
26-Dec-23,IMPS,00.00,"54,165.09","3,79,155.62",
26-Dec-23,Transfer,"1,252.00",00.00,"3,80,407.62",
26-Dec-23,Debit Card,00.00,"95,101.91","2,85,305.71",
26-Dec-23,IMPS,00.00,"57,061.14","2,28,244.57",
26-Dec-23,ATM,46.1,00.00,"2,28,290.67",
26-Dec-23,Bill,00.00,"2,28,290.67",00.00,
27-Dec-23,Purchase,"2,67,471.50",00.00,"2,67,471.50",
27-Dec-23,Bill,00.00,"1,33,735.75","1,33,735.75",
27-Dec-23,Transportellaneous,00.00,"22,289.29","1,11,446.46",
27-Dec-23,IMPS,00.00,"18,574.41","92,872.05",
27-Dec-23,Transfer,03.20,00.00,"92,875.25",
27-Dec-23,Interest,00.00,"30,958.42","61,916.83",
27-Dec-23,Cheque,219.31,00.00,"62,136.14",
27-Dec-23,Cheque,01.30,00.00,"62,137.44",
27-Dec-23,IMPS,05.00,00.00,"62,142.44",
28-Dec-23,Debit Card,00.00,"7,767.81","54,374.64",
28-Dec-23,Interest,283,00.00,"54,657.64",
28-Dec-23,ATM,"32,037.00",00.00,"86,694.64",
29-Dec-23,Purchase,00.00,"8,669.46","78,025.18",
29-Dec-23,Purchase,159.5,00.00,"78,184.68",
30-Dec-23,RTGS,"16,913.40",00.00,"95,098.08",
30-Dec-23,Debit Card,"1,887.00",00.00,"96,985.08",
30-Dec-23,Reversal,"17,75,228.00",00.00,"18,72,213.08",
30-Dec-23,Purchase,00.00,"2,67,459.01","16,04,754.07",
30-Dec-23,IMPS,00.00,"1,78,306.01","14,26,448.06",
30-Dec-23,Transportellaneous,"18,73,257.00",00.00,"32,99,705.06",
30-Dec-23,Tax,00.00,"8,24,926.27","24,74,778.80",
30-Dec-23,Transportellaneous,00.00,"2,47,477.88","22,27,300.92",
30-Dec-23,Interest,"13,66,608.00",00.00,"35,93,908.92",
30-Dec-23,Interest,00.00,"3,99,323.21","31,94,585.71",
30-Dec-23,Bill,00.00,"3,99,323.21","27,95,262.50",
30-Dec-23,RTGS,"1,49,424.16",00.00,"29,44,686.66",
30-Dec-23,Bill,00.00,"3,27,187.41","26,17,499.25",
31-Dec-23,ATM,"3,594.00",00.00,"26,21,093.25",
31-Dec-23,Purchase,00.00,"13,10,546.63","13,10,546.62",
31-Dec-23,NEFT,"9,58,980.20",00.00,"22,69,526.82",
31-Dec-23,NEFT,00.00,"2,83,690.85","19,85,835.97",
31-Dec-23,Debit Card,"20,818.03",00.00,"20,06,654.00",
31-Dec-23,RTGS,"23,112.62",00.00,"20,29,766.62",
31-Dec-23,ATM,00.00,"3,38,294.44","16,91,472.18",
31-Dec-23,Bill,55.8,00.00,"16,91,527.98",
31-Dec-23,Reversal,00.00,"2,11,441.00","14,80,086.98",
31-Dec-23,Bill,00.00,"4,93,362.33","9,86,724.65",
31-Dec-23,IMPS,00.00,"1,64,454.11","8,22,270.54",
31-Dec-23,Commission,00.00,"82,227.05","7,40,043.49",
31-Dec-23,Reversal,"5,196.00",00.00,"7,45,239.49",
31-Dec-23,IMPS,"93,629.50",00.00,"8,38,868.99",
31-Dec-23,Reversal,00.00,"83,886.90","7,54,982.09",
31-Dec-23,Interest,00.00,"83,886.90","6,71,095.19",
31-Dec-23,Cheque,00.00,"1,11,849.20","5,59,245.99",
31-Dec-23,RTGS,"2,07,263.00",00.00,"7,66,508.99",
31-Dec-23,Cheque,00.00,"7,66,508.99",00.00,
31-Dec-23,IMPS,"3,169.60",00.00,"3,169.60",
31-Dec-23,Tax,00.00,"1,584.80","1,584.80",
31-Dec-23,Tax,00.00,264.13,"1,320.67",
31-Dec-23,ATM,507.98,00.00,"1,828.65",
31-Dec-23,Purchase,00.00,203.18,"1,625.47",
31-Dec-23,NEFT,"24,062.01",00.00,"25,687.48",
31-Dec-23,Cheque,00.00,00.00,"25,687.48",
31-Dec-23,Tax,51.01,00.00,"25,738.49",
31-Dec-23,Debit Card,"25,549.00",00.00,"51,287.49",
31-Dec-23,Bill,00.00,"8,547.92","42,739.58",
31-Dec-23,Reversal,00.00,"21,369.79","21,369.79",
31-Dec-23,Transportellaneous,00.00,"2,136.98","19,232.81",
31-Dec-23,Transportellaneous,00.00,"9,616.41","9,616.41",
31-Dec-23,Transfer,"15,42,214.80",00.00,"15,51,831.21",
31-Dec-23,Bill,00.00,"2,21,690.17","13,30,141.04",
31-Dec-23,Bill,00.00,"6,65,070.52","6,65,070.52",
31-Dec-23,Tax,00.00,"66,507.05","5,98,563.47",
31-Dec-23,Reversal,"2,511.00",00.00,"6,01,074.47",
31-Dec-23,Commission,00.00,"2,00,358.16","4,00,716.31",
31-Dec-23,Debit Card,00.00,"1,00,179.08","3,00,537.23",
31-Dec-23,Transfer,12,00.00,"3,00,549.23",
31-Dec-23,ATM,03.00,00.00,"3,00,552.23",
31-Dec-23,RTGS,00.00,"60,110.45","2,40,441.78",
31-Dec-23,RTGS,00.00,"30,055.22","2,10,386.56",
31-Dec-23,Bill,00.00,"52,596.64","1,57,789.92",
31-Dec-23,Cheque,00.00,"19,723.74","1,38,066.18",
31-Dec-23,RTGS,00.00,"1,38,066.18",00.00,
31-Dec-23,ATM,"2,544.45",00.00,"2,544.45",
31-Dec-23,Cheque,00.00,282.72,"2,261.73",
31-Dec-23,Transfer,00.00,251.3,"2,010.43",
31-Dec-23,IMPS,"19,045.30",00.00,"21,055.73",
31-Dec-23,IMPS,00.00,"2,339.53","18,716.20",
31-Dec-23,Transfer,35,00.00,"18,751.20",
31-Dec-23,Reversal,"12,65,958.00",00.00,"12,84,709.20",
31-Dec-23,NEFT,286.07,00.00,"12,84,995.27",
31-Dec-23,Tax,"6,31,691.20",00.00,"19,16,686.47",
31-Dec-23,Commission,"4,23,989.00",00.00,"23,40,675.47",
31-Dec-23,Commission,00.00,"4,68,135.09","18,72,540.38",
31-Dec-23,Cheque,24.1,00.00,"18,72,564.48",
31-Dec-23,IMPS,00.00,"3,12,094.08","15,60,470.40",
31-Dec-23,Cheque,00.00,"7,80,235.20","7,80,235.20",
31-Dec-23,NEFT,00.00,"2,60,078.40","5,20,156.80",
31-Dec-23,Bill,00.00,"86,692.80","4,33,464.00",
31-Dec-23,IMPS,01.00,00.00,"4,33,465.00",
31-Dec-23,Transfer,00.00,"86,693.00","3,46,772.00",
31-Dec-23,ATM,"20,625.50",00.00,"3,67,397.50",
31-Dec-23,Transportellaneous,00.00,"73,479.50","2,93,918.00",
31-Dec-23,Transportellaneous,00.00,"97,972.67","1,95,945.33",
31-Dec-23,ATM,63,00.00,"1,96,008.33",
31-Dec-23,Tax,00.00,"24,501.04","1,71,507.29",
31-Dec-23,IMPS,00.00,"34,301.46","1,37,205.83",
31-Dec-23,NEFT,524.2,00.00,"1,37,730.03",
31-Dec-23,Reversal,00.00,"45,910.01","91,820.02",
31-Dec-23,Debit Card,21,00.00,"91,841.02",
31-Dec-23,IMPS,"1,70,330.31",00.00,"2,62,171.33",
31-Dec-23,Reversal,38.1,00.00,"2,62,209.43",
31-Dec-23,NEFT,169.71,00.00,"2,62,379.14",
31-Dec-23,Cash,"1,58,758.97",00.00,"4,21,138.11",
31-Dec-23,RTGS,00.00,"70,189.69","3,50,948.42",
31-Dec-23,Reversal,"17,961.96",00.00,"3,68,910.38",
31-Dec-23,Bill,"74,218.88",00.00,"4,43,129.26",
31-Dec-23,Interest,00.00,"73,854.88","3,69,274.38",
31-Dec-23,Reversal,359,00.00,"3,69,633.38",
31-Dec-23,Transfer,00.00,"73,926.68","2,95,706.70",
31-Dec-23,Debit Card,00.00,"49,284.45","2,46,422.25",
31-Dec-23,Cash,"18,265.00",00.00,"2,64,687.25",
31-Dec-23,Cash,00.00,"37,812.46","2,26,874.79",
31-Dec-23,Tax,00.00,"22,687.48","2,04,187.31",
31-Dec-23,Transportellaneous,"1,70,113.60",00.00,"3,74,300.91",
31-Dec-23,IMPS,00.00,"46,787.61","3,27,513.30",
31-Dec-23,RTGS,00.00,"1,63,756.65","1,63,756.65",
31-Dec-23,Bill,00.00,"16,375.67","1,47,380.98",
31-Dec-23,Debit Card,"1,582.40",00.00,"1,48,963.38",
31-Dec-23,Purchase,00.00,"24,827.23","1,24,136.15",
31-Dec-23,Purchase,05.80,00.00,"1,24,141.95",
31-Dec-23,RTGS,"3,935.00",00.00,"1,28,076.95",
31-Dec-23,Tax,00.00,"18,296.71","1,09,780.24",
31-Dec-23,Bill,00.00,"27,445.06","82,335.18",
31-Dec-23,Cash,"7,20,596.50",00.00,"8,02,931.68",
31-Dec-23,Debit Card,00.00,"1,33,821.95","6,69,109.73",
31-Dec-23,Tax,"2,771.65",00.00,"6,71,881.38",
31-Dec-23,Debit Card,00.00,"83,985.17","5,87,896.21",
31-Dec-23,Interest,03.00,00.00,"5,87,899.21",
31-Dec-23,IMPS,"1,90,462.00",00.00,"7,78,361.21",
31-Dec-23,Transportellaneous,00.00,"97,295.15","6,81,066.06",
31-Dec-23,Cash,97,00.00,"6,81,163.06",
31-Dec-23,Transportellaneous,00.00,"97,309.01","5,83,854.05",
31-Dec-23,ATM,00.00,"64,872.67","5,18,981.38",
31-Dec-23,RTGS,"2,524.13",00.00,"5,21,505.51",
31-Dec-23,Interest,00.00,"86,917.59","4,34,587.92",
31-Dec-23,Cheque,00.00,"4,34,587.92",00.00,
31-Dec-23,Tax,29.7,00.00,29.7,
31-Dec-23,Transfer,"3,541.00",00.00,"3,570.70",
31-Dec-23,Transportellaneous,03.43,00.00,"3,574.13",
31-Dec-23,Reversal,00.00,"3,574.13",00.00,
31-Dec-23,Reversal,"14,34,136.25",00.00,"14,34,136.25",
31-Dec-23,Purchase,39.9,00.00,"14,34,176.15",
31-Dec-23,Cheque,00.00,"1,79,272.02","12,54,904.13",
31-Dec-23,Commission,00.00,"2,09,150.69","10,45,753.44",
31-Dec-23,Transportellaneous,"2,809.40",00.00,"10,48,562.84",
31-Dec-23,Bill,00.00,"1,04,856.28","9,43,706.56",
31-Dec-23,Purchase,02.80,00.00,"9,43,709.36",
31-Dec-23,Transfer,341.4,00.00,"9,44,050.76",
01-Jan-24,NEFT,00.00,"3,14,683.59","6,29,367.17",
01-Jan-24,Debit Card,00.00,"1,57,341.79","4,72,025.38",
01-Jan-24,Cheque,"9,491.43",00.00,"4,81,516.81",
01-Jan-24,RTGS,00.00,"1,20,379.20","3,61,137.61",
01-Jan-24,Cheque,01.00,00.00,"3,61,138.61",
01-Jan-24,Purchase,00.00,"90,284.65","2,70,853.96",
01-Jan-24,Reversal,04.21,00.00,"2,70,858.17",
01-Jan-24,Bill,00.00,"2,70,858.17",00.00,
01-Jan-24,Reversal,"3,566.20",00.00,"3,566.20",
01-Jan-24,Tax,00.00,445.78,"3,120.42",
01-Jan-24,Debit Card,00.00,780.11,"2,340.32",
01-Jan-24,Reversal,00.00,260.04,"2,080.28",
01-Jan-24,Cheque,56,00.00,"2,136.28",
01-Jan-24,Transportellaneous,"11,20,465.00",00.00,"11,22,601.28",
01-Jan-24,Commission,00.00,"1,40,325.16","9,82,276.12",
01-Jan-24,Cheque,00.00,"4,91,138.06","4,91,138.06",
01-Jan-24,IMPS,"7,973.00",00.00,"4,99,111.06",
01-Jan-24,Transportellaneous,62.48,00.00,"4,99,173.54",
01-Jan-24,Interest,"6,75,687.75",00.00,"11,74,861.29",
01-Jan-24,Cheque,00.00,"2,34,972.26","9,39,889.03",
01-Jan-24,NEFT,"2,51,309.25",00.00,"11,91,198.28",
01-Jan-24,Debit Card,"11,948.10",00.00,"12,03,146.38",
01-Jan-24,RTGS,00.00,"6,01,573.19","6,01,573.19",
01-Jan-24,Cheque,00.00,"2,00,524.40","4,01,048.79",
01-Jan-24,Tax,120,00.00,"4,01,168.79",
01-Jan-24,Transportellaneous,"1,13,106.25",00.00,"5,14,275.04",
01-Jan-24,Purchase,00.00,"51,427.50","4,62,847.54",
01-Jan-24,NEFT,00.00,"46,284.75","4,16,562.79",
01-Jan-24,NEFT,00.00,"1,04,140.70","3,12,422.09",
01-Jan-24,Tax,"3,529.90",00.00,"3,15,951.99",
01-Jan-24,ATM,"22,268.00",00.00,"3,38,219.99",
01-Jan-24,RTGS,00.00,"37,580.00","3,00,639.99",
01-Jan-24,Cheque,00.00,"30,064.00","2,70,575.99",
01-Jan-24,Commission,00.00,"33,822.00","2,36,753.99",
01-Jan-24,Tax,126,00.00,"2,36,879.99",
01-Jan-24,Debit Card,127.86,00.00,"2,37,007.85",
01-Jan-24,Reversal,00.00,"47,401.57","1,89,606.28",
01-Jan-24,RTGS,00.00,"47,401.57","1,42,204.71",
01-Jan-24,Commission,15,00.00,"1,42,219.71",
01-Jan-24,RTGS,26,00.00,"1,42,245.71",
01-Jan-24,Transportellaneous,00.00,"15,805.08","1,26,440.63",
01-Jan-24,Cheque,00.00,"12,644.06","1,13,796.57",
01-Jan-24,Cash,"6,76,346.00",00.00,"7,90,142.57",
01-Jan-24,Cash,00.00,"1,12,877.51","6,77,265.06",
01-Jan-24,ATM,00.00,"1,69,316.27","5,07,948.80",
02-Jan-24,Tax,17.82,00.00,"5,07,966.62",
02-Jan-24,Transfer,"2,22,589.59",00.00,"7,30,556.21",
02-Jan-24,RTGS,00.00,"73,055.62","6,57,500.59",
02-Jan-24,Transfer,00.00,"1,09,583.43","5,47,917.16",
02-Jan-24,Purchase,83,00.00,"5,48,000.16",
02-Jan-24,Debit Card,336,00.00,"5,48,336.16",
02-Jan-24,Debit Card,00.00,"91,389.36","4,56,946.80",
02-Jan-24,RTGS,135.5,00.00,"4,57,082.30",
02-Jan-24,Bill,"1,39,931.90",00.00,"5,97,014.20",
02-Jan-24,Transportellaneous,"2,544.85",00.00,"5,99,559.05",
02-Jan-24,ATM,00.00,"1,19,911.81","4,79,647.24",
02-Jan-24,ATM,00.00,"53,294.14","4,26,353.10",
02-Jan-24,Cheque,385,00.00,"4,26,738.10",
02-Jan-24,Tax,"19,87,973.80",00.00,"24,14,711.90",
02-Jan-24,Purchase,00.00,"3,44,958.84","20,69,753.06",
02-Jan-24,Cash,00.00,"2,58,719.13","18,11,033.93",
02-Jan-24,Commission,"4,190.33",00.00,"18,15,224.26",
02-Jan-24,Debit Card,"14,03,384.80",00.00,"32,18,609.06",
02-Jan-24,Purchase,132,00.00,"32,18,741.06",
02-Jan-24,Interest,00.00,"32,18,741.06",00.00,
02-Jan-24,Transportellaneous,03.38,00.00,03.38,
02-Jan-24,Cheque,00.00,01.69,01.69,
02-Jan-24,NEFT,"4,292.52",00.00,"4,294.21",
02-Jan-24,Tax,00.00,613.46,"3,680.75",
02-Jan-24,ATM,"11,587.00",00.00,"15,267.75",
02-Jan-24,Cheque,00.00,"2,544.63","12,723.12",
02-Jan-24,Bill,00.00,"12,723.12",00.00,
02-Jan-24,Cheque,"85,298.53",00.00,"85,298.53",
02-Jan-24,Tax,00.00,"85,298.53",00.00,
02-Jan-24,Bill,"14,732.30",00.00,"14,732.30",
02-Jan-24,Cheque,03.08,00.00,"14,735.38",
02-Jan-24,RTGS,00.00,"1,637.26","13,098.12",
02-Jan-24,Reversal,"15,81,185.00",00.00,"15,94,283.12",
02-Jan-24,Interest,00.00,"7,97,141.56","7,97,141.56",
02-Jan-24,Reversal,00.00,"99,642.70","6,97,498.86",
02-Jan-24,Reversal,00.00,"1,39,499.77","5,57,999.09",
02-Jan-24,Reversal,00.00,"55,799.91","5,02,199.18",
02-Jan-24,Interest,00.00,"1,25,549.80","3,76,649.38",
02-Jan-24,Transfer,00.00,"37,664.94","3,38,984.44",
02-Jan-24,Cheque,00.00,"48,426.35","2,90,558.09",
02-Jan-24,ATM,00.00,"1,45,279.05","1,45,279.05",
02-Jan-24,NEFT,03.70,00.00,"1,45,282.75",
02-Jan-24,Transfer,00.00,"48,427.58","96,855.17",
02-Jan-24,Debit Card,00.00,"24,213.79","72,641.38",
02-Jan-24,Tax,"1,378.10",00.00,"74,019.48",
02-Jan-24,ATM,"1,10,420.00",00.00,"1,84,439.48",
02-Jan-24,Cash,00.00,"30,739.91","1,53,699.57",
02-Jan-24,Transfer,"19,286.00",00.00,"1,72,985.57",
02-Jan-24,Commission,00.00,"28,830.93","1,44,154.64",
02-Jan-24,Transportellaneous,00.00,"16,017.18","1,28,137.46",
02-Jan-24,Transportellaneous,00.00,"64,068.73","64,068.73",
02-Jan-24,Transfer,00.00,"64,068.73",00.00,
02-Jan-24,NEFT,08.00,00.00,08.00,
03-Jan-24,Cheque,00.00,01.00,07.00,
03-Jan-24,Tax,00.00,00.88,06.12,
03-Jan-24,ATM,"1,08,693.16",00.00,"1,08,699.28",
03-Jan-24,RTGS,"47,828.38",00.00,"1,56,527.66",
03-Jan-24,Purchase,00.00,"17,391.96","1,39,135.70",
03-Jan-24,Commission,53,00.00,"1,39,188.70",
03-Jan-24,Transfer,08.00,00.00,"1,39,196.70",
03-Jan-24,Cheque,00.00,"15,466.30","1,23,730.40",
03-Jan-24,Purchase,00.00,"24,746.08","98,984.32",
03-Jan-24,Interest,"3,760.00",00.00,"1,02,744.32",
03-Jan-24,Tax,"36,297.90",00.00,"1,39,042.22",
03-Jan-24,IMPS,"1,86,379.00",00.00,"3,25,421.22",
03-Jan-24,Reversal,25.8,00.00,"3,25,447.02",
03-Jan-24,Cheque,00.00,"1,08,482.34","2,16,964.68",
03-Jan-24,Interest,00.00,"24,107.19","1,92,857.49",
03-Jan-24,Commission,00.00,"1,92,857.49",00.00,
03-Jan-24,ATM,899,00.00,899,
03-Jan-24,Purchase,"9,71,046.00",00.00,"9,71,945.00",
03-Jan-24,Interest,00.00,"9,71,945.00",00.00,
03-Jan-24,Interest,"28,802.00",00.00,"28,802.00",
03-Jan-24,Cheque,00.00,"5,760.40","23,041.60",
03-Jan-24,IMPS,00.00,"3,291.66","19,749.94",
03-Jan-24,NEFT,00.00,"4,937.49","14,812.45",
03-Jan-24,Purchase,00.00,"1,481.25","13,331.20",
03-Jan-24,Commission,76.48,00.00,"13,407.68",
03-Jan-24,RTGS,00.00,"6,703.84","6,703.84",
03-Jan-24,Transportellaneous,"18,884.43",00.00,"25,588.27",
03-Jan-24,IMPS,"1,91,209.00",00.00,"2,16,797.27",
03-Jan-24,Purchase,196,00.00,"2,16,993.27",
03-Jan-24,Purchase,00.00,"1,08,496.64","1,08,496.64",
03-Jan-24,Tax,00.00,"12,055.18","96,441.46",
03-Jan-24,RTGS,00.00,"32,147.15","64,294.31",
03-Jan-24,IMPS,00.00,"8,036.79","56,257.52",
03-Jan-24,Transfer,00.00,"6,250.84","50,006.68",
03-Jan-24,ATM,00.00,"8,334.45","41,672.23",
03-Jan-24,Transfer,"2,274.00",00.00,"43,946.23",
03-Jan-24,Reversal,"15,78,222.75",00.00,"16,22,168.98",
03-Jan-24,Reversal,03.00,00.00,"16,22,171.98",
03-Jan-24,Purchase,00.00,"2,31,738.85","13,90,433.13",
03-Jan-24,Cheque,00.00,"1,39,043.31","12,51,389.82",
03-Jan-24,Transfer,00.00,"12,51,389.82",00.00,
03-Jan-24,Transfer,"2,54,876.94",00.00,"2,54,876.94",
03-Jan-24,Purchase,00.00,"25,487.69","2,29,389.25",
03-Jan-24,Interest,00.00,"25,487.69","2,03,901.56",
03-Jan-24,Cheque,"1,02,086.59",00.00,"3,05,988.15",
03-Jan-24,Interest,00.00,"61,197.63","2,44,790.52",
03-Jan-24,Cash,"6,01,002.25",00.00,"8,45,792.77",
03-Jan-24,Cheque,00.00,"4,22,896.39","4,22,896.38",
03-Jan-24,Cash,"11,82,663.80",00.00,"16,05,560.18",
03-Jan-24,RTGS,"18,20,797.50",00.00,"34,26,357.68",
03-Jan-24,ATM,68.75,00.00,"34,26,426.43",
03-Jan-24,Transportellaneous,00.00,"5,71,071.07","28,55,355.36",
03-Jan-24,Debit Card,00.00,"7,13,838.84","21,41,516.52",
03-Jan-24,Commission,00.00,"10,70,758.26","10,70,758.26",
03-Jan-24,IMPS,00.00,"1,33,844.78","9,36,913.48",
03-Jan-24,RTGS,00.00,"3,12,304.49","6,24,608.99",
03-Jan-24,NEFT,"2,31,322.00",00.00,"8,55,930.99",
03-Jan-24,Bill,"1,241.00",00.00,"8,57,171.99",
03-Jan-24,Transportellaneous,00.00,"1,71,434.40","6,85,737.59",
03-Jan-24,NEFT,36.1,00.00,"6,85,773.69",
04-Jan-24,Purchase,00.00,"6,85,773.69",00.00,
04-Jan-24,Transfer,884.2,00.00,884.2,
04-Jan-24,Purchase,00.00,442.1,442.1,
04-Jan-24,Cash,359.6,00.00,801.7,
04-Jan-24,Bill,00.00,80.17,721.53,
04-Jan-24,Debit Card,"5,39,433.50",00.00,"5,40,155.03",
04-Jan-24,Cash,00.00,"60,017.23","4,80,137.80",
04-Jan-24,Purchase,00.00,"1,60,045.93","3,20,091.87",
04-Jan-24,Reversal,00.00,"35,565.76","2,84,526.11",
04-Jan-24,Purchase,39.9,00.00,"2,84,566.01",
04-Jan-24,IMPS,00.00,"28,456.60","2,56,109.41",
04-Jan-24,RTGS,124,00.00,"2,56,233.41",
04-Jan-24,Tax,00.00,"1,28,116.71","1,28,116.70",
04-Jan-24,Interest,"2,51,976.00",00.00,"3,80,092.70",
04-Jan-24,Commission,00.00,"1,90,046.35","1,90,046.35",
04-Jan-24,Reversal,00.00,"1,90,046.35",00.00,
04-Jan-24,Cheque,"2,22,857.60",00.00,"2,22,857.60",
04-Jan-24,Tax,"26,381.00",00.00,"2,49,238.60",
04-Jan-24,Purchase,42.31,00.00,"2,49,280.91",
04-Jan-24,IMPS,"3,22,900.00",00.00,"5,72,180.91",
04-Jan-24,Transfer,"1,75,067.97",00.00,"7,47,248.88",
04-Jan-24,Cash,"18,77,973.50",00.00,"26,25,222.38",
04-Jan-24,IMPS,"1,92,948.70",00.00,"28,18,171.08",
04-Jan-24,Purchase,"2,35,911.90",00.00,"30,54,082.98",
04-Jan-24,ATM,"30,792.29",00.00,"30,84,875.27",
04-Jan-24,NEFT,00.00,"4,40,696.47","26,44,178.80",
04-Jan-24,Debit Card,"4,87,848.00",00.00,"31,32,026.80",
04-Jan-24,Cheque,00.00,"15,66,013.40","15,66,013.40",
04-Jan-24,IMPS,00.00,"3,91,503.35","11,74,510.05",
04-Jan-24,Bill,00.00,"1,46,813.76","10,27,696.29",
04-Jan-24,Tax,00.00,"10,27,696.29",00.00,
04-Jan-24,NEFT,48.4,00.00,48.4,
04-Jan-24,Interest,31.52,00.00,79.92,
04-Jan-24,Debit Card,04.72,00.00,84.64,
04-Jan-24,ATM,00.00,10.58,74.06,
04-Jan-24,Commission,"2,46,616.00",00.00,"2,46,690.06",
04-Jan-24,Interest,10.68,00.00,"2,46,700.74",
04-Jan-24,Tax,00.00,"35,242.96","2,11,457.78",
04-Jan-24,Bill,00.00,"21,145.78","1,90,312.00",
04-Jan-24,Reversal,59.7,00.00,"1,90,371.70",
04-Jan-24,NEFT,42,00.00,"1,90,413.70",
04-Jan-24,RTGS,"5,092.95",00.00,"1,95,506.65",
04-Jan-24,NEFT,"23,951.80",00.00,"2,19,458.45",
04-Jan-24,Transfer,00.00,"43,891.69","1,75,566.76",
04-Jan-24,Cash,00.00,"58,522.25","1,17,044.51",
04-Jan-24,Bill,40.62,00.00,"1,17,085.13",
04-Jan-24,ATM,"95,907.00",00.00,"2,12,992.13",
04-Jan-24,Cash,00.00,"21,299.21","1,91,692.92",
04-Jan-24,Tax,00.00,"31,948.82","1,59,744.10",
04-Jan-24,Tax,00.00,"53,248.03","1,06,496.07",
04-Jan-24,Transfer,00.00,"15,213.72","91,282.35",
04-Jan-24,RTGS,00.00,"11,410.29","79,872.06",
04-Jan-24,Commission,"23,358.97",00.00,"1,03,231.03",
04-Jan-24,NEFT,00.00,"34,410.34","68,820.69",
04-Jan-24,Commission,"18,909.00",00.00,"87,729.69",
04-Jan-24,NEFT,"1,74,018.88",00.00,"2,61,748.57",
04-Jan-24,Cheque,00.00,"26,174.86","2,35,573.71",
04-Jan-24,Cash,00.00,"23,557.37","2,12,016.34",
04-Jan-24,IMPS,272,00.00,"2,12,288.34",
04-Jan-24,ATM,"9,790.50",00.00,"2,22,078.84",
04-Jan-24,Commission,00.00,"55,519.71","1,66,559.13",
04-Jan-24,Cheque,"88,488.00",00.00,"2,55,047.13",
04-Jan-24,Transfer,"3,279.55",00.00,"2,58,326.68",
04-Jan-24,Debit Card,00.00,"2,58,326.68",00.00,
04-Jan-24,Transportellaneous,"2,334.00",00.00,"2,334.00",
04-Jan-24,Tax,00.00,389,"1,945.00",
04-Jan-24,Purchase,00.00,389,"1,556.00",
05-Jan-24,IMPS,00.00,172.89,"1,383.11",
05-Jan-24,Cash,01.80,00.00,"1,384.91",
05-Jan-24,Purchase,00.00,173.11,"1,211.80",
05-Jan-24,Purchase,00.00,173.11,"1,038.69",
05-Jan-24,Interest,"1,14,624.38",00.00,"1,15,663.07",
05-Jan-24,Commission,"13,606.84",00.00,"1,29,269.91",
05-Jan-24,RTGS,06.22,00.00,"1,29,276.13",
05-Jan-24,Transportellaneous,00.00,"16,159.52","1,13,116.61",
05-Jan-24,Cash,"6,520.22",00.00,"1,19,636.83",
05-Jan-24,Commission,00.00,"39,878.94","79,757.89",
05-Jan-24,Cash,00.00,"9,969.74","69,788.15",
05-Jan-24,Purchase,24.2,00.00,"69,812.35",
05-Jan-24,ATM,"7,41,305.00",00.00,"8,11,117.35",
05-Jan-24,Bill,00.00,"4,05,558.68","4,05,558.68",
05-Jan-24,Cash,00.00,"81,111.74","3,24,446.94",
05-Jan-24,Cash,00.00,"3,24,446.94",00.00,
05-Jan-24,Debit Card,"2,464.00",00.00,"2,464.00",
05-Jan-24,Purchase,"1,51,457.97",00.00,"1,53,921.97",
05-Jan-24,Interest,"3,343.30",00.00,"1,57,265.27",
05-Jan-24,IMPS,00.00,"31,453.05","1,25,812.22",
05-Jan-24,Transportellaneous,305.5,00.00,"1,26,117.72",
05-Jan-24,RTGS,00.00,"1,26,117.72",00.00,
05-Jan-24,Transfer,05.00,00.00,05.00,
06-Jan-24,Interest,00.00,01.00,04.00,
06-Jan-24,Purchase,"9,35,546.00",00.00,"9,35,550.00",
06-Jan-24,Cash,00.00,"1,33,650.00","8,01,900.00",
06-Jan-24,Reversal,44,00.00,"8,01,944.00",
06-Jan-24,Purchase,18.9,00.00,"8,01,962.90",
06-Jan-24,Purchase,00.00,"2,67,320.97","5,34,641.93",
06-Jan-24,Commission,00.00,"53,464.19","4,81,177.74",
06-Jan-24,NEFT,00.00,"68,739.68","4,12,438.06",
06-Jan-24,ATM,00.00,"45,826.45","3,66,611.61",
06-Jan-24,Commission,"13,137.75",00.00,"3,79,749.36",
06-Jan-24,IMPS,21.23,00.00,"3,79,770.59",
06-Jan-24,NEFT,00.00,"94,942.65","2,84,827.94",
06-Jan-24,Transportellaneous,"16,83,617.20",00.00,"19,68,445.14",
06-Jan-24,Reversal,00.00,"3,93,689.03","15,74,756.11",
07-Jan-24,ATM,"11,68,718.80",00.00,"27,43,474.91",
08-Jan-24,IMPS,00.00,"9,14,491.64","18,28,983.27",
08-Jan-24,NEFT,43.63,00.00,"18,29,026.90",
08-Jan-24,Cash,"1,00,636.75",00.00,"19,29,663.65",
08-Jan-24,Tax,60.1,00.00,"19,29,723.75",
08-Jan-24,Reversal,18,00.00,"19,29,741.75",
08-Jan-24,Purchase,"2,47,176.91",00.00,"21,76,918.66",
08-Jan-24,Transportellaneous,"20,29,457.00",00.00,"42,06,375.66",
08-Jan-24,Bill,00.00,"7,01,062.61","35,05,313.05",
08-Jan-24,Bill,10,00.00,"35,05,323.05",
08-Jan-24,Purchase,05.30,00.00,"35,05,328.35",
08-Jan-24,Debit Card,00.00,"5,84,221.39","29,21,106.96",
08-Jan-24,Transportellaneous,"28,961.00",00.00,"29,50,067.96",
08-Jan-24,Purchase,00.00,"9,83,355.99","19,66,711.97",
08-Jan-24,Commission,00.00,"1,96,671.20","17,70,040.77",
08-Jan-24,NEFT,00.00,"3,54,008.15","14,16,032.62",
08-Jan-24,Debit Card,00.00,"7,08,016.31","7,08,016.31",
08-Jan-24,Commission,00.00,"1,18,002.72","5,90,013.59",
08-Jan-24,Cheque,00.00,"84,287.66","5,05,725.93",
08-Jan-24,Reversal,00.00,"1,26,431.48","3,79,294.45",
08-Jan-24,Commission,"18,10,733.75",00.00,"21,90,028.20",
08-Jan-24,Tax,00.00,"3,12,861.17","18,77,167.03",
08-Jan-24,Debit Card,00.00,"3,75,433.41","15,01,733.62",
08-Jan-24,IMPS,00.00,"1,50,173.36","13,51,560.26",
08-Jan-24,Debit Card,00.00,"2,25,260.04","11,26,300.22",
08-Jan-24,Commission,00.00,"1,40,787.53","9,85,512.69",
09-Jan-24,Transfer,05.80,00.00,"9,85,518.49",
09-Jan-24,Transportellaneous,00.00,"1,97,103.70","7,88,414.79",
09-Jan-24,Cash,"27,122.80",00.00,"8,15,537.59",
09-Jan-24,Commission,00.00,"2,71,845.86","5,43,691.73",
09-Jan-24,Purchase,01.49,00.00,"5,43,693.22",
09-Jan-24,Transfer,53.01,00.00,"5,43,746.23",
09-Jan-24,IMPS,00.00,"1,35,936.56","4,07,809.67",
09-Jan-24,Commission,00.00,"1,35,936.56","2,71,873.11",
09-Jan-24,Reversal,00.00,"67,968.28","2,03,904.83",
09-Jan-24,Commission,"1,85,208.00",00.00,"3,89,112.83",
09-Jan-24,Reversal,00.00,"38,911.28","3,50,201.55",
09-Jan-24,Interest,"8,606.00",00.00,"3,58,807.55",
09-Jan-24,Transportellaneous,00.00,"39,867.51","3,18,940.04",
09-Jan-24,RTGS,00.00,"53,156.67","2,65,783.37",
10-Jan-24,RTGS,00.00,"53,156.67","2,12,626.70",
10-Jan-24,Debit Card,"5,234.41",00.00,"2,17,861.11",
10-Jan-24,ATM,00.00,"1,08,930.56","1,08,930.56",
10-Jan-24,Debit Card,"91,670.00",00.00,"2,00,600.56",
10-Jan-24,Interest,"1,98,504.00",00.00,"3,99,104.56",
10-Jan-24,RTGS,00.00,"1,33,034.85","2,66,069.71",
10-Jan-24,Commission,00.00,"2,66,069.71",00.00,
10-Jan-24,Transportellaneous,"3,969.81",00.00,"3,969.81",
10-Jan-24,Commission,00.00,441.09,"3,528.72",
10-Jan-24,Purchase,"13,173.80",00.00,"16,702.52",
10-Jan-24,Debit Card,"30,320.10",00.00,"47,022.62",
10-Jan-24,Transfer,"3,190.10",00.00,"50,212.72",
10-Jan-24,Reversal,00.00,"5,579.19","44,633.53",
10-Jan-24,NEFT,07.00,00.00,"44,640.53",
10-Jan-24,Purchase,00.00,"14,880.18","29,760.35",
10-Jan-24,ATM,00.00,"29,760.35",00.00,
11-Jan-24,Interest,"29,291.00",00.00,"29,291.00",
11-Jan-24,Transportellaneous,24,00.00,"29,315.00",
11-Jan-24,Interest,07.30,00.00,"29,322.30",
11-Jan-24,Purchase,"21,688.50",00.00,"51,010.80",
11-Jan-24,ATM,00.00,"17,003.60","34,007.20",
11-Jan-24,Commission,"19,836.00",00.00,"53,843.20",
11-Jan-24,Debit Card,06.90,00.00,"53,850.10",
11-Jan-24,Transportellaneous,00.00,"17,950.03","35,900.07",
11-Jan-24,Commission,00.00,"17,950.04","17,950.04",
11-Jan-24,Purchase,"22,570.40",00.00,"40,520.44",
11-Jan-24,Purchase,00.00,"8,104.09","32,416.35",
11-Jan-24,IMPS,"3,755.30",00.00,"36,171.65",
11-Jan-24,Transfer,00.00,"18,085.83","18,085.82",
11-Jan-24,Interest,00.00,"9,042.91","9,042.91",
11-Jan-24,Purchase,"2,977.70",00.00,"12,020.61",
11-Jan-24,Cash,00.00,"1,335.62","10,684.99",
11-Jan-24,Transportellaneous,"16,651.00",00.00,"27,335.99",
11-Jan-24,Tax,00.00,"13,668.00","13,668.00",
11-Jan-24,Debit Card,"4,54,458.25",00.00,"4,68,126.25",
11-Jan-24,Transfer,46,00.00,"4,68,172.25",
11-Jan-24,Interest,00.00,"46,817.23","4,21,355.02",
11-Jan-24,ATM,313.8,00.00,"4,21,668.82",
11-Jan-24,Debit Card,00.00,"1,05,417.21","3,16,251.62",
11-Jan-24,Commission,00.00,"31,625.16","2,84,626.46",
11-Jan-24,NEFT,08.00,00.00,"2,84,634.46",
11-Jan-24,Transfer,63.9,00.00,"2,84,698.36",
11-Jan-24,Bill,00.00,"2,84,698.36",00.00,
11-Jan-24,Bill,29.71,00.00,29.71,
11-Jan-24,NEFT,"8,03,678.00",00.00,"8,03,707.71",
12-Jan-24,RTGS,00.00,"4,01,853.86","4,01,853.86",
12-Jan-24,RTGS,00.00,"80,370.77","3,21,483.09",
12-Jan-24,Reversal,160.14,00.00,"3,21,643.23",
12-Jan-24,ATM,"18,15,761.00",00.00,"21,37,404.23",
12-Jan-24,Purchase,"14,956.50",00.00,"21,52,360.73",
12-Jan-24,Cheque,"2,49,990.00",00.00,"24,02,350.73",
12-Jan-24,IMPS,431,00.00,"24,02,781.73",
12-Jan-24,Purchase,"1,625.40",00.00,"24,04,407.13",
12-Jan-24,Cheque,00.00,"3,43,486.73","20,60,920.40",
12-Jan-24,Cash,00.00,"2,28,991.16","18,31,929.24",
12-Jan-24,Cash,"1,618.70",00.00,"18,33,547.94",
12-Jan-24,Cash,06.32,00.00,"18,33,554.26",
12-Jan-24,IMPS,00.00,"9,16,777.13","9,16,777.13",
12-Jan-24,Transfer,00.00,"1,14,597.14","8,02,179.99",
12-Jan-24,Interest,00.00,"1,00,272.50","7,01,907.49",
12-Jan-24,Reversal,02.00,00.00,"7,01,909.49",
12-Jan-24,Interest,33.3,00.00,"7,01,942.79",
12-Jan-24,Transfer,00.00,"1,40,388.56","5,61,554.23",
12-Jan-24,Purchase,"14,66,137.00",00.00,"20,27,691.23",
12-Jan-24,Tax,00.00,"3,37,948.54","16,89,742.69",
12-Jan-24,Transportellaneous,00.10,00.00,"16,89,742.79",
12-Jan-24,Cheque,45.72,00.00,"16,89,788.51",
12-Jan-24,Cash,00.00,"4,22,447.13","12,67,341.38",
12-Jan-24,Tax,"6,757.75",00.00,"12,74,099.13",
12-Jan-24,Bill,"2,56,997.50",00.00,"15,31,096.63",
12-Jan-24,Bill,00.00,"2,18,728.09","13,12,368.54",
12-Jan-24,Bill,"36,687.00",00.00,"13,49,055.54",
12-Jan-24,NEFT,16.08,00.00,"13,49,071.62",
12-Jan-24,Transportellaneous,"1,977.00",00.00,"13,51,048.62",
12-Jan-24,NEFT,"16,14,136.00",00.00,"29,65,184.62",
12-Jan-24,RTGS,00.00,"14,82,592.31","14,82,592.31",
12-Jan-24,Commission,"3,15,510.00",00.00,"17,98,102.31",
12-Jan-24,Transportellaneous,00.00,"5,99,367.44","11,98,734.87",
13-Jan-24,Interest,54,00.00,"11,98,788.87",
13-Jan-24,ATM,00.00,"2,99,697.22","8,99,091.65",
13-Jan-24,Cash,00.00,"4,49,545.83","4,49,545.82",
13-Jan-24,ATM,00.00,"64,220.83","3,85,324.99",
13-Jan-24,Commission,"3,140.00",00.00,"3,88,464.99",
13-Jan-24,Cheque,00.00,"48,558.12","3,39,906.87",
13-Jan-24,ATM,496.6,00.00,"3,40,403.47",
13-Jan-24,NEFT,00.00,"42,550.43","2,97,853.04",
13-Jan-24,ATM,445.4,00.00,"2,98,298.44",
13-Jan-24,ATM,00.00,"1,49,149.22","1,49,149.22",
13-Jan-24,Reversal,07.50,00.00,"1,49,156.72",
13-Jan-24,Transfer,"10,49,420.00",00.00,"11,98,576.72",
13-Jan-24,Cheque,00.00,"11,98,576.72",00.00,
13-Jan-24,Interest,00.00,00.00,00.00,
13-Jan-24,ATM,"18,11,969.75",00.00,"18,11,969.75",
13-Jan-24,Cash,00.00,00.00,"18,11,969.75",
13-Jan-24,Debit Card,"23,530.61",00.00,"18,35,500.36",
13-Jan-24,Tax,00.00,"2,29,437.55","16,06,062.82",
13-Jan-24,Purchase,00.00,"4,01,515.71","12,04,547.12",
13-Jan-24,Interest,"11,406.54",00.00,"12,15,953.66",
13-Jan-24,Commission,00.00,"3,03,988.42","9,11,965.24",
13-Jan-24,Debit Card,659.62,00.00,"9,12,624.86",
13-Jan-24,NEFT,00.00,"3,04,208.29","6,08,416.57",
13-Jan-24,IMPS,00.00,"1,01,402.76","5,07,013.81",
13-Jan-24,Reversal,00.00,"72,430.54","4,34,583.27",
13-Jan-24,Transfer,"94,503.00",00.00,"5,29,086.27",
13-Jan-24,RTGS,00.00,"1,05,817.25","4,23,269.02",
13-Jan-24,Transfer,"88,655.06",00.00,"5,11,924.08",
13-Jan-24,Reversal,"3,343.90",00.00,"5,15,267.98",
13-Jan-24,IMPS,319.04,00.00,"5,15,587.02",
13-Jan-24,ATM,00.00,"51,558.70","4,64,028.32",
13-Jan-24,Cash,56,00.00,"4,64,084.32",
13-Jan-24,Transfer,87.09,00.00,"4,64,171.41",
13-Jan-24,Commission,01.00,00.00,"4,64,172.41",
13-Jan-24,Debit Card,00.00,"66,310.34","3,97,862.07",
13-Jan-24,Commission,423,00.00,"3,98,285.07",
13-Jan-24,Bill,00.00,"66,380.85","3,31,904.22",
13-Jan-24,RTGS,00.00,"3,31,904.22",00.00,
13-Jan-24,Transportellaneous,"1,92,802.50",00.00,"1,92,802.50",
14-Jan-24,ATM,08.00,00.00,"1,92,810.50",
14-Jan-24,ATM,00.00,"1,92,810.50",00.00,
14-Jan-24,Transportellaneous,"36,130.40",00.00,"36,130.40",
14-Jan-24,Cheque,"12,327.11",00.00,"48,457.51",
14-Jan-24,ATM,"8,75,428.00",00.00,"9,23,885.51",
14-Jan-24,Cash,04.70,00.00,"9,23,890.21",
14-Jan-24,Cheque,191,00.00,"9,24,081.21",
14-Jan-24,Commission,470.9,00.00,"9,24,552.11",
14-Jan-24,Cash,00.00,"1,54,092.02","7,70,460.09",
14-Jan-24,Interest,149.14,00.00,"7,70,609.23",
14-Jan-24,RTGS,"15,95,081.00",00.00,"23,65,690.23",
14-Jan-24,ATM,00.00,"3,94,281.71","19,71,408.52",
14-Jan-24,Interest,61.9,00.00,"19,71,470.42",
14-Jan-24,Transportellaneous,00.00,"2,19,052.27","17,52,418.15",
14-Jan-24,Transportellaneous,"1,96,226.00",00.00,"19,48,644.15",
14-Jan-24,IMPS,"3,787.81",00.00,"19,52,431.96",
14-Jan-24,ATM,"10,65,621.50",00.00,"30,18,053.46",
14-Jan-24,Commission,"5,354.00",00.00,"30,23,407.46",
14-Jan-24,Commission,"15,55,199.00",00.00,"45,78,606.46",
15-Jan-24,Interest,159,00.00,"45,78,765.46",
15-Jan-24,Cheque,00.00,"7,63,127.58","38,15,637.88",
15-Jan-24,ATM,484.4,00.00,"38,16,122.28",
15-Jan-24,Transportellaneous,305,00.00,"38,16,427.28",
15-Jan-24,ATM,"14,731.00",00.00,"38,31,158.28",
15-Jan-24,Interest,"27,354.68",00.00,"38,58,512.96",
15-Jan-24,Transfer,89.8,00.00,"38,58,602.76",
15-Jan-24,Purchase,00.00,"19,29,301.38","19,29,301.38",
15-Jan-24,Transfer,00.00,"2,14,366.82","17,14,934.56",
15-Jan-24,Transfer,"12,91,814.50",00.00,"30,06,749.06",
15-Jan-24,IMPS,00.00,"7,51,687.27","22,55,061.80",
15-Jan-24,IMPS,"12,29,184.00",00.00,"34,84,245.80",
15-Jan-24,RTGS,"1,816.09",00.00,"34,86,061.89",
15-Jan-24,Bill,03.80,00.00,"34,86,065.69",
15-Jan-24,ATM,00.00,"34,86,065.69",00.00,
15-Jan-24,Purchase,819,00.00,819,
15-Jan-24,Bill,"3,474.90",00.00,"4,293.90",
15-Jan-24,Commission,00.00,613.41,"3,680.49",
15-Jan-24,Reversal,04.20,00.00,"3,684.69",
15-Jan-24,Bill,00.00,526.38,"3,158.31",
16-Jan-24,Cash,00.00,"1,579.16","1,579.16",
16-Jan-24,Tax,00.00,225.59,"1,353.57",
16-Jan-24,RTGS,"3,752.92",00.00,"5,106.49",
16-Jan-24,Commission,00.00,851.08,"4,255.41",
16-Jan-24,RTGS,00.00,"4,255.41",00.00,
16-Jan-24,Commission,315,00.00,315,
16-Jan-24,Cash,00.00,315,00.00,
16-Jan-24,Purchase,466.56,00.00,466.56,
16-Jan-24,Purchase,453.2,00.00,919.76,
16-Jan-24,Reversal,"18,53,933.50",00.00,"18,54,853.26",
16-Jan-24,Cheque,00.00,"1,85,485.33","16,69,367.93",
16-Jan-24,Commission,00.00,"1,85,485.33","14,83,882.60",
16-Jan-24,Commission,00.00,"2,47,313.77","12,36,568.83",
16-Jan-24,Commission,"2,217.60",00.00,"12,38,786.43",
16-Jan-24,Transportellaneous,00.00,"1,23,878.64","11,14,907.79",
16-Jan-24,Transfer,00.00,"1,23,878.64","9,91,029.15",
16-Jan-24,Purchase,00.00,"1,98,205.83","7,92,823.32",
17-Jan-24,Purchase,"3,516.00",00.00,"7,96,339.32",
17-Jan-24,Bill,"1,59,252.00",00.00,"9,55,591.32",
18-Jan-24,Debit Card,02.00,00.00,"9,55,593.32",
18-Jan-24,Commission,"24,244.80",00.00,"9,79,838.12",
18-Jan-24,Bill,06.00,00.00,"9,79,844.12",
18-Jan-24,Interest,00.00,"4,89,922.06","4,89,922.06",
18-Jan-24,IMPS,04.30,00.00,"4,89,926.36",
18-Jan-24,Purchase,"3,456.00",00.00,"4,93,382.36",
18-Jan-24,NEFT,00.00,"82,230.39","4,11,151.97",
18-Jan-24,Transportellaneous,48,00.00,"4,11,199.97",
18-Jan-24,Bill,00.00,"4,11,199.97",00.00,
18-Jan-24,IMPS,436.98,00.00,436.98,
18-Jan-24,Cash,00.00,436.98,00.00,
19-Jan-24,Debit Card,"3,92,012.25",00.00,"3,92,012.25",
19-Jan-24,Transfer,"11,19,438.00",00.00,"15,11,450.25",
19-Jan-24,Interest,00.00,"7,55,725.13","7,55,725.12",
19-Jan-24,Commission,00.00,"2,51,908.37","5,03,816.75",
19-Jan-24,Cheque,21.95,00.00,"5,03,838.70",
19-Jan-24,IMPS,00.00,"62,979.84","4,40,858.86",
19-Jan-24,Cheque,00.00,"73,476.48","3,67,382.38",
19-Jan-24,Tax,"10,837.00",00.00,"3,78,219.38",
19-Jan-24,Reversal,42,00.00,"3,78,261.38",
19-Jan-24,Tax,"13,079.10",00.00,"3,91,340.48",
19-Jan-24,Tax,58,00.00,"3,91,398.48",
19-Jan-24,ATM,"1,564.60",00.00,"3,92,963.08",
19-Jan-24,Cash,42,00.00,"3,93,005.08",
19-Jan-24,Tax,09.05,00.00,"3,93,014.13",
19-Jan-24,IMPS,01.00,00.00,"3,93,015.13",
19-Jan-24,Transfer,"2,53,424.00",00.00,"6,46,439.13",
19-Jan-24,Transportellaneous,00.00,"1,29,287.83","5,17,151.30",
19-Jan-24,IMPS,00.00,"5,17,151.30",00.00,
19-Jan-24,Cheque,06.00,00.00,06.00,
19-Jan-24,Interest,00.00,00.86,05.14,
20-Jan-24,RTGS,00.00,01.71,03.43,
20-Jan-24,NEFT,"73,388.62",00.00,"73,392.05",
20-Jan-24,Cash,00.00,"7,339.21","66,052.84",
20-Jan-24,IMPS,00.00,"33,026.42","33,026.42",
20-Jan-24,RTGS,00.00,"4,128.30","28,898.12",
20-Jan-24,NEFT,00.00,"9,632.71","19,265.41",
20-Jan-24,Transportellaneous,00.00,"2,752.20","16,513.21",
20-Jan-24,Transportellaneous,"5,280.00",00.00,"21,793.21",
20-Jan-24,Cheque,49,00.00,"21,842.21",
20-Jan-24,Transportellaneous,"9,57,083.00",00.00,"9,78,925.21",
20-Jan-24,Reversal,461,00.00,"9,79,386.21",
20-Jan-24,Reversal,00.00,"3,26,462.07","6,52,924.14",
20-Jan-24,Transportellaneous,00.00,"72,547.13","5,80,377.01",
20-Jan-24,Transfer,00.00,"64,486.33","5,15,890.68",
21-Jan-24,Purchase,00.00,"57,321.19","4,58,569.49",
21-Jan-24,Bill,692,00.00,"4,59,261.49",
21-Jan-24,IMPS,"6,74,055.20",00.00,"11,33,316.69",
21-Jan-24,Commission,"4,48,081.00",00.00,"15,81,397.69",
21-Jan-24,Commission,"1,77,642.60",00.00,"17,59,040.29",
21-Jan-24,Transfer,00.00,"1,75,904.03","15,83,136.26",
21-Jan-24,Cheque,24.6,00.00,"15,83,160.86",
21-Jan-24,Debit Card,00.00,"1,58,316.09","14,24,844.77",
21-Jan-24,RTGS,00.00,"1,78,105.60","12,46,739.17",
21-Jan-24,Reversal,"3,080.00",00.00,"12,49,819.17",
21-Jan-24,Bill,00.00,"6,24,909.59","6,24,909.58",
21-Jan-24,ATM,00.00,"1,56,227.40","4,68,682.18",
21-Jan-24,Debit Card,00.00,"1,17,170.55","3,51,511.64",
21-Jan-24,Cash,"1,59,355.10",00.00,"5,10,866.74",
21-Jan-24,Commission,170.64,00.00,"5,11,037.38",
21-Jan-24,Tax,"24,450.25",00.00,"5,35,487.63",
21-Jan-24,Cash,00.00,"5,35,487.63",00.00,
21-Jan-24,Reversal,00.70,00.00,00.70,
21-Jan-24,IMPS,00.00,00.09,00.61,
21-Jan-24,Commission,57.1,00.00,57.71,
22-Jan-24,Cash,"70,444.10",00.00,"70,501.81",
22-Jan-24,Transfer,00.00,"14,100.36","56,401.45",
22-Jan-24,IMPS,"3,222.04",00.00,"59,623.49",
22-Jan-24,Transportellaneous,00.00,"6,624.83","52,998.66",
22-Jan-24,IMPS,"2,954.73",00.00,"55,953.39",
22-Jan-24,NEFT,00.00,"5,595.34","50,358.05",
22-Jan-24,RTGS,00.00,"5,595.34","44,762.71",
22-Jan-24,IMPS,00.00,"22,381.36","22,381.36",
22-Jan-24,Debit Card,"32,169.00",00.00,"54,550.36",
22-Jan-24,Transportellaneous,00.00,"5,455.04","49,095.32",
22-Jan-24,Cheque,00.00,"24,547.66","24,547.66",
22-Jan-24,IMPS,00.00,"8,182.55","16,365.11",
22-Jan-24,Bill,00.00,"1,636.51","14,728.60",
22-Jan-24,Reversal,371,00.00,"15,099.60",
22-Jan-24,Cheque,"19,714.00",00.00,"34,813.60",
22-Jan-24,Transfer,00.00,"4,973.37","29,840.23",
22-Jan-24,NEFT,164.8,00.00,"30,005.03",
22-Jan-24,Bill,15,00.00,"30,020.03",
22-Jan-24,Commission,00.00,"30,020.03",00.00,
22-Jan-24,Bill,03.00,00.00,03.00,
22-Jan-24,Interest,00.00,01.50,01.50,
22-Jan-24,Bill,00.00,00.19,01.31,
22-Jan-24,Cash,01.00,00.00,02.31,
22-Jan-24,Debit Card,01.70,00.00,04.01,
22-Jan-24,Transfer,"7,62,675.00",00.00,"7,62,679.01",
22-Jan-24,Interest,00.00,"2,54,226.34","5,08,452.67",
23-Jan-24,Cash,"6,18,696.00",00.00,"11,27,148.67",
23-Jan-24,Commission,"2,529.50",00.00,"11,29,678.17",
23-Jan-24,IMPS,07.00,00.00,"11,29,685.17",
23-Jan-24,Reversal,00.00,"1,41,210.65","9,88,474.52",
23-Jan-24,Cheque,"20,22,251.00",00.00,"30,10,725.52",
23-Jan-24,IMPS,55.16,00.00,"30,10,780.68",
23-Jan-24,Bill,00.00,"6,02,156.14","24,08,624.54",
23-Jan-24,NEFT,00.00,"6,02,156.14","18,06,468.40",
23-Jan-24,Cheque,00.00,"9,03,234.20","9,03,234.20",
24-Jan-24,Transfer,00.00,"1,12,904.28","7,90,329.92",
25-Jan-24,Bill,00.00,"1,12,904.27","6,77,425.65",
25-Jan-24,Debit Card,53,00.00,"6,77,478.65",
25-Jan-24,Reversal,00.00,"75,275.41","6,02,203.24",
25-Jan-24,Purchase,454.89,00.00,"6,02,658.13",
25-Jan-24,Commission,00.00,"6,02,658.13",00.00,
25-Jan-24,NEFT,01.00,00.00,01.00,
25-Jan-24,NEFT,"30,028.30",00.00,"30,029.30",
25-Jan-24,Commission,00.00,"5,004.88","25,024.42",
25-Jan-24,Tax,00.00,"12,512.21","12,512.21",
25-Jan-24,NEFT,"3,710.87",00.00,"16,223.08",
25-Jan-24,Transportellaneous,00.00,"1,622.31","14,600.77",
25-Jan-24,Tax,00.00,"1,622.31","12,978.46",
25-Jan-24,Cash,00.00,"6,489.23","6,489.23",
25-Jan-24,ATM,"2,004.85",00.00,"8,494.08",
25-Jan-24,Interest,"5,70,362.20",00.00,"5,78,856.28",
25-Jan-24,Transportellaneous,"10,289.20",00.00,"5,89,145.48",
25-Jan-24,Debit Card,00.00,"58,914.55","5,30,230.93",
25-Jan-24,ATM,00.00,"2,65,115.47","2,65,115.47",
25-Jan-24,Purchase,"1,357.18",00.00,"2,66,472.65",
25-Jan-24,NEFT,"10,66,039.00",00.00,"13,32,511.65",
25-Jan-24,Bill,"25,549.20",00.00,"13,58,060.85",
25-Jan-24,Commission,275.3,00.00,"13,58,336.15",
26-Jan-24,Cash,00.00,"13,58,336.15",00.00,
26-Jan-24,IMPS,"8,48,322.00",00.00,"8,48,322.00",
26-Jan-24,Tax,00.00,"1,21,188.86","7,27,133.14",
26-Jan-24,Cash,"11,50,307.50",00.00,"18,77,440.64",
26-Jan-24,NEFT,00.00,"2,68,205.81","16,09,234.83",
26-Jan-24,Commission,"30,723.70",00.00,"16,39,958.53",
26-Jan-24,Commission,00.00,"8,19,979.27","8,19,979.26",
26-Jan-24,Reversal,"12,89,694.50",00.00,"21,09,673.76",
26-Jan-24,RTGS,00.00,"3,51,612.29","17,58,061.47",
26-Jan-24,NEFT,32,00.00,"17,58,093.47",
26-Jan-24,Cash,02.90,00.00,"17,58,096.37",
26-Jan-24,ATM,00.00,"3,51,619.27","14,06,477.10",
26-Jan-24,Transfer,00.00,"2,34,412.85","11,72,064.25",
26-Jan-24,ATM,00.00,"2,34,412.85","9,37,651.40",
26-Jan-24,Purchase,00.01,00.00,"9,37,651.41",
26-Jan-24,Tax,"10,710.80",00.00,"9,48,362.21",
27-Jan-24,IMPS,"29,782.69",00.00,"9,78,144.90",
27-Jan-24,ATM,00.00,"1,63,024.15","8,15,120.75",
27-Jan-24,RTGS,15,00.00,"8,15,135.75",
27-Jan-24,Bill,"19,63,279.50",00.00,"27,78,415.25",
27-Jan-24,Tax,"17,657.90",00.00,"27,96,073.15",
27-Jan-24,Purchase,04.00,00.00,"27,96,077.15",
27-Jan-24,Commission,00.00,00.00,"27,96,077.15",
27-Jan-24,Bill,00.00,"4,66,012.86","23,30,064.29",
27-Jan-24,Interest,00.00,"2,33,006.43","20,97,057.86",
27-Jan-24,Reversal,38.57,00.00,"20,97,096.43",
27-Jan-24,RTGS,357,00.00,"20,97,453.43",
27-Jan-24,RTGS,00.00,"3,49,575.57","17,47,877.86",
27-Jan-24,Commission,00.00,"2,91,312.98","14,56,564.88",
27-Jan-24,ATM,495.9,00.00,"14,57,060.78",
27-Jan-24,Interest,182.7,00.00,"14,57,243.48",
27-Jan-24,NEFT,"1,336.44",00.00,"14,58,579.92",
27-Jan-24,Bill,03.70,00.00,"14,58,583.62",
27-Jan-24,ATM,"6,690.41",00.00,"14,65,274.03",
28-Jan-24,Debit Card,"9,73,109.80",00.00,"24,38,383.83",
28-Jan-24,ATM,491,00.00,"24,38,874.83",
28-Jan-24,Commission,00.00,"4,87,774.97","19,51,099.86",
28-Jan-24,Commission,00.00,"2,16,788.87","17,34,310.99",
28-Jan-24,Tax,"9,887.00",00.00,"17,44,197.99",
28-Jan-24,Tax,00.00,"17,44,197.99",00.00,
28-Jan-24,ATM,"1,69,660.00",00.00,"1,69,660.00",
28-Jan-24,RTGS,00.00,"16,966.00","1,52,694.00",
28-Jan-24,RTGS,00.00,"30,538.80","1,22,155.20",
28-Jan-24,NEFT,00.00,"24,431.04","97,724.16",
28-Jan-24,Purchase,00.00,"19,544.83","78,179.33",
28-Jan-24,ATM,00.00,"15,635.87","62,543.46",
28-Jan-24,ATM,"1,15,405.84",00.00,"1,77,949.30",
28-Jan-24,Transportellaneous,00.00,"44,487.33","1,33,461.97",
28-Jan-24,Reversal,"3,520.00",00.00,"1,36,981.97",
28-Jan-24,ATM,"3,453.51",00.00,"1,40,435.48",
28-Jan-24,Interest,00.00,"14,043.55","1,26,391.93",
28-Jan-24,Purchase,00.00,"12,639.19","1,13,752.74",
28-Jan-24,Debit Card,00.00,"14,219.09","99,533.65",
28-Jan-24,Cash,00.00,"24,883.41","74,650.24",
28-Jan-24,IMPS,00.00,"12,441.71","62,208.53",
28-Jan-24,RTGS,"2,02,338.50",00.00,"2,64,547.03",
28-Jan-24,RTGS,06.00,00.00,"2,64,553.03",
28-Jan-24,Transfer,61.86,00.00,"2,64,614.89",
28-Jan-24,RTGS,160,00.00,"2,64,774.89",
28-Jan-24,Cheque,07.62,00.00,"2,64,782.51",
28-Jan-24,Reversal,00.00,"52,956.50","2,11,826.01",
28-Jan-24,Reversal,00.00,"52,956.50","1,58,869.51",
28-Jan-24,Debit Card,00.00,"17,652.17","1,41,217.34",
28-Jan-24,Transfer,00.00,"35,304.34","1,05,913.00",
28-Jan-24,Commission,01.43,00.00,"1,05,914.43",
28-Jan-24,Transfer,00.00,"13,239.30","92,675.13",
28-Jan-24,Cash,"5,77,101.80",00.00,"6,69,776.93",
28-Jan-24,Cheque,00.00,"2,23,258.98","4,46,517.95",
28-Jan-24,IMPS,00.00,"2,23,258.98","2,23,258.98",
28-Jan-24,ATM,03.30,00.00,"2,23,262.28",
28-Jan-24,Transfer,"2,088.90",00.00,"2,25,351.18",
28-Jan-24,IMPS,00.00,"45,070.24","1,80,280.94",
28-Jan-24,Cheque,"6,46,774.25",00.00,"8,27,055.19",
28-Jan-24,IMPS,"2,38,829.00",00.00,"10,65,884.19",
28-Jan-24,Bill,"16,47,059.75",00.00,"27,12,943.94",
28-Jan-24,Cheque,00.00,"3,01,438.22","24,11,505.72",
28-Jan-24,IMPS,"1,52,107.16",00.00,"25,63,612.88",
28-Jan-24,ATM,55.4,00.00,"25,63,668.28",
28-Jan-24,Purchase,"3,46,758.80",00.00,"29,10,427.08",
28-Jan-24,Commission,761.57,00.00,"29,11,188.65",
28-Jan-24,Commission,00.00,"4,85,198.11","24,25,990.54",
28-Jan-24,Purchase,00.00,"6,06,497.64","18,19,492.90",
28-Jan-24,NEFT,00.34,00.00,"18,19,493.24",
28-Jan-24,Transportellaneous,453.5,00.00,"18,19,946.74",
28-Jan-24,Transfer,"3,031.50",00.00,"18,22,978.24",
28-Jan-24,Transfer,00.00,"6,07,659.41","12,15,318.83",
28-Jan-24,Tax,"1,66,585.59",00.00,"13,81,904.42",
29-Jan-24,Tax,"2,47,063.30",00.00,"16,28,967.72",
29-Jan-24,Tax,227.1,00.00,"16,29,194.82",
29-Jan-24,NEFT,"40,794.50",00.00,"16,69,989.32",
29-Jan-24,Transportellaneous,00.00,"3,33,997.86","13,35,991.46",
29-Jan-24,Interest,00.00,"1,33,599.15","12,02,392.31",
29-Jan-24,Purchase,00.00,"1,20,239.23","10,82,153.08",
29-Jan-24,Transportellaneous,00.00,"2,70,538.27","8,11,614.81",
29-Jan-24,Purchase,00.00,"81,161.48","7,30,453.33",
29-Jan-24,Tax,154,00.00,"7,30,607.33",
29-Jan-24,Bill,00.00,"73,060.73","6,57,546.60",
29-Jan-24,Bill,00.00,"73,060.73","5,84,485.87",
29-Jan-24,IMPS,00.00,"64,942.87","5,19,543.00",
29-Jan-24,Tax,00.00,"74,220.43","4,45,322.57",
29-Jan-24,Tax,"12,19,019.25",00.00,"16,64,341.82",
29-Jan-24,Tax,"79,502.62",00.00,"17,43,844.44",
29-Jan-24,Purchase,00.00,"2,90,640.74","14,53,203.70",
29-Jan-24,Tax,"9,52,550.50",00.00,"24,05,754.20",
29-Jan-24,Reversal,00.00,"8,01,918.07","16,03,836.13",
29-Jan-24,Tax,02.81,00.00,"16,03,838.94",
29-Jan-24,Purchase,132.46,00.00,"16,03,971.40",
29-Jan-24,IMPS,72,00.00,"16,04,043.40",
29-Jan-24,Debit Card,00.00,"2,67,340.57","13,36,702.83",
29-Jan-24,Transportellaneous,00.00,"4,45,567.61","8,91,135.22",
29-Jan-24,NEFT,474.41,00.00,"8,91,609.63",
29-Jan-24,Transportellaneous,00.00,"8,91,609.63",00.00,
29-Jan-24,Commission,05.10,00.00,05.10,
29-Jan-24,Transfer,00.00,00.73,04.37,
29-Jan-24,Interest,00.00,01.46,02.91,
29-Jan-24,Purchase,"1,34,306.90",00.00,"1,34,309.81",
29-Jan-24,Transfer,"16,33,943.00",00.00,"17,68,252.81",
29-Jan-24,Transfer,00.00,"1,96,472.53","15,71,780.28",
29-Jan-24,Bill,57.47,00.00,"15,71,837.75",
29-Jan-24,Commission,00.00,"1,74,648.64","13,97,189.11",
29-Jan-24,Debit Card,"2,07,563.30",00.00,"16,04,752.41",
29-Jan-24,IMPS,00.00,"1,60,475.24","14,44,277.17",
29-Jan-24,Purchase,"4,070.00",00.00,"14,48,347.17",
29-Jan-24,NEFT,02.00,00.00,"14,48,349.17",
29-Jan-24,Bill,00.00,"2,41,391.53","12,06,957.64",
29-Jan-24,Debit Card,"2,26,163.00",00.00,"14,33,120.64",
29-Jan-24,Interest,"18,190.70",00.00,"14,51,311.34",
29-Jan-24,Transfer,00.00,"1,45,131.13","13,06,180.21",
29-Jan-24,Transportellaneous,00.00,"2,17,696.70","10,88,483.51",
29-Jan-24,Tax,00.00,"5,44,241.76","5,44,241.76",
29-Jan-24,Bill,00.00,"54,424.18","4,89,817.58",
29-Jan-24,Reversal,98,00.00,"4,89,915.58",
29-Jan-24,Purchase,00.00,"97,983.12","3,91,932.46",
29-Jan-24,Transportellaneous,00.00,"97,983.12","2,93,949.35",
29-Jan-24,Cheque,00.00,"97,983.12","1,95,966.23",
29-Jan-24,Cash,56,00.00,"1,96,022.23",
29-Jan-24,ATM,00.00,"98,011.12","98,011.12",
29-Jan-24,Debit Card,00.00,"49,005.56","49,005.56",
29-Jan-24,Transfer,00.00,"4,900.56","44,105.00",
29-Jan-24,Reversal,"4,42,202.00",00.00,"4,86,307.00",
29-Jan-24,Bill,00.00,"2,43,153.50","2,43,153.50",
29-Jan-24,NEFT,31.2,00.00,"2,43,184.70",
29-Jan-24,Debit Card,"9,93,974.80",00.00,"12,37,159.50",
30-Jan-24,Debit Card,339.54,00.00,"12,37,499.04",
30-Jan-24,Bill,00.00,"1,23,749.90","11,13,749.14",
30-Jan-24,IMPS,00.00,"1,59,107.02","9,54,642.12",
31-Jan-24,Transfer,23.77,00.00,"9,54,665.89",
31-Jan-24,Cheque,294,00.00,"9,54,959.89",
31-Jan-24,Transportellaneous,"1,62,501.90",00.00,"11,17,461.79",
31-Jan-24,NEFT,00.00,"1,11,746.18","10,05,715.61",
31-Jan-24,Reversal,"4,391.90",00.00,"10,10,107.51",
31-Jan-24,Interest,"9,84,426.50",00.00,"19,94,534.01",
31-Jan-24,Tax,"11,23,058.20",00.00,"31,17,592.21",
31-Jan-24,Transfer,"19,588.00",00.00,"31,37,180.21",
31-Jan-24,Cheque,00.00,"5,22,863.37","26,14,316.84",
31-Jan-24,RTGS,00.00,"3,26,789.61","22,87,527.24",
31-Jan-24,Interest,00.00,"7,62,509.08","15,25,018.16",
31-Jan-24,NEFT,31.92,00.00,"15,25,050.08",
31-Jan-24,RTGS,00.00,"5,08,350.03","10,16,700.05",
31-Jan-24,Commission,"4,553.00",00.00,"10,21,253.05",
31-Jan-24,Cash,"16,95,832.25",00.00,"27,17,085.30",
31-Jan-24,Transfer,00.00,"4,52,847.55","22,64,237.75",
31-Jan-24,Transfer,975,00.00,"22,65,212.75",
31-Jan-24,Cash,"16,432.43",00.00,"22,81,645.18",
31-Jan-24,Tax,00.00,"4,56,329.04","18,25,316.14",
31-Jan-24,Commission,00.00,"9,12,658.07","9,12,658.07",
31-Jan-24,NEFT,"7,424.10",00.00,"9,20,082.17",
31-Jan-24,ATM,"9,37,366.00",00.00,"18,57,448.17",
31-Jan-24,Transfer,"2,39,879.78",00.00,"20,97,327.95",
31-Jan-24,Bill,00.00,"2,09,732.80","18,87,595.16",
31-Jan-24,Commission,"92,643.47",00.00,"19,80,238.63",
31-Jan-24,IMPS,"16,30,898.00",00.00,"36,11,136.63",
31-Jan-24,Bill,00.00,"36,11,136.63",00.00,
31-Jan-24,Reversal,01.90,00.00,01.90,
31-Jan-24,Reversal,00.00,00.32,01.58,
31-Jan-24,ATM,00.00,00.16,01.42,
31-Jan-24,Transportellaneous,123.67,00.00,125.09,
31-Jan-24,IMPS,"2,265.59",00.00,"2,390.68",
31-Jan-24,Interest,00.80,00.00,"2,391.48",
31-Jan-24,ATM,00.00,265.72,"2,125.76",
31-Jan-24,RTGS,00.00,"2,125.76",00.00,
31-Jan-24,RTGS,"5,70,641.00",00.00,"5,70,641.00",
31-Jan-24,NEFT,00.00,"5,70,641.00",00.00,
31-Jan-24,ATM,"13,63,906.00",00.00,"13,63,906.00",
31-Jan-24,Reversal,"1,11,345.00",00.00,"14,75,251.00",
31-Jan-24,Transportellaneous,01.00,00.00,"14,75,252.00",
31-Jan-24,IMPS,00.00,"1,47,525.20","13,27,726.80",
31-Jan-24,Transportellaneous,"3,501.00",00.00,"13,31,227.80",
31-Jan-24,Interest,00.00,"1,90,175.40","11,41,052.40",
01-Feb-24,Transfer,"1,12,455.00",00.00,"12,53,507.40",
01-Feb-24,RTGS,00.00,"1,25,350.74","11,28,156.66",
01-Feb-24,Commission,00.00,"1,88,026.11","9,40,130.55",
02-Feb-24,Commission,00.00,"2,35,032.64","7,05,097.91",
02-Feb-24,NEFT,329,00.00,"7,05,426.91",
02-Feb-24,NEFT,"18,634.71",00.00,"7,24,061.62",
02-Feb-24,Reversal,00.00,"1,81,015.41","5,43,046.22",
02-Feb-24,Reversal,00.00,"1,35,761.56","4,07,284.66",
02-Feb-24,Cheque,"1,64,351.62",00.00,"5,71,636.28",
02-Feb-24,Transportellaneous,00.00,"1,42,909.07","4,28,727.21",
02-Feb-24,Transportellaneous,"30,255.73",00.00,"4,58,982.94",
03-Feb-24,Transportellaneous,00.00,"2,29,491.47","2,29,491.47",
04-Feb-24,Interest,73.7,00.00,"2,29,565.17",
04-Feb-24,Tax,00.00,"22,956.52","2,06,608.65",
04-Feb-24,Bill,37.9,00.00,"2,06,646.55",
04-Feb-24,Commission,00.00,"2,06,646.55",00.00,
04-Feb-24,RTGS,18.24,00.00,18.24,
04-Feb-24,NEFT,00.00,01.82,16.42,
04-Feb-24,Reversal,32.4,00.00,48.82,
04-Feb-24,Bill,"60,840.00",00.00,"60,888.82",
04-Feb-24,Tax,00.00,"10,148.14","50,740.68",
04-Feb-24,Interest,902.1,00.00,"51,642.78",
04-Feb-24,Commission,00.00,"5,164.28","46,478.50",
04-Feb-24,RTGS,00.00,"5,809.81","40,668.69",
04-Feb-24,Cash,00.00,"6,778.12","33,890.58",
04-Feb-24,Cash,270,00.00,"34,160.58",
04-Feb-24,Reversal,00.00,"17,080.29","17,080.29",
04-Feb-24,Tax,00.00,"5,693.43","11,386.86",
04-Feb-24,Reversal,00.00,"5,693.43","5,693.43",
04-Feb-24,Transportellaneous,00.00,632.6,"5,060.83",
04-Feb-24,Bill,"2,475.00",00.00,"7,535.83",
04-Feb-24,IMPS,264,00.00,"7,799.83",
04-Feb-24,Debit Card,"72,739.90",00.00,"80,539.73",
04-Feb-24,RTGS,00.00,"26,846.58","53,693.15",
04-Feb-24,Interest,430,00.00,"54,123.15",
04-Feb-24,Transportellaneous,"32,022.13",00.00,"86,145.28",
04-Feb-24,IMPS,"70,453.20",00.00,"1,56,598.48",
04-Feb-24,Debit Card,41.87,00.00,"1,56,640.35",
04-Feb-24,ATM,00.00,"26,106.73","1,30,533.62",
04-Feb-24,Reversal,01.69,00.00,"1,30,535.31",
05-Feb-24,IMPS,00.00,"26,107.06","1,04,428.25",
05-Feb-24,Commission,"73,607.00",00.00,"1,78,035.25",
05-Feb-24,IMPS,00.00,"1,78,035.25",00.00,
05-Feb-24,Tax,05.00,00.00,05.00,
05-Feb-24,NEFT,00.00,00.83,04.17,
05-Feb-24,IMPS,"1,818.60",00.00,"1,822.77",
05-Feb-24,NEFT,"1,648.70",00.00,"3,471.47",
05-Feb-24,Transportellaneous,00.00,"3,471.47",00.00,
05-Feb-24,Reversal,23.98,00.00,23.98,
05-Feb-24,Cheque,00.00,06.00,17.98,
05-Feb-24,Commission,"1,448.06",00.00,"1,466.04",
05-Feb-24,Cash,00.00,209.43,"1,256.61",
05-Feb-24,Debit Card,00.00,"1,256.61",00.00,
05-Feb-24,Tax,29.7,00.00,29.7,
05-Feb-24,Purchase,00.00,03.30,26.4,
05-Feb-24,Bill,29,00.00,55.4,
05-Feb-24,Commission,38.47,00.00,93.87,
06-Feb-24,ATM,00.00,46.94,46.94,
06-Feb-24,Bill,00.00,07.82,39.12,
06-Feb-24,Tax,"2,620.00",00.00,"2,659.12",
06-Feb-24,Tax,373,00.00,"3,032.12",
06-Feb-24,Commission,00.00,"1,516.06","1,516.06",
06-Feb-24,Cheque,00.00,303.21,"1,212.85",
06-Feb-24,NEFT,00.00,173.26,"1,039.59",
06-Feb-24,RTGS,"3,769.48",00.00,"4,809.07",
06-Feb-24,NEFT,00.00,480.91,"4,328.16",
06-Feb-24,Cash,00.00,480.91,"3,847.25",
06-Feb-24,Purchase,"1,14,308.03",00.00,"1,18,155.28",
06-Feb-24,Transportellaneous,"41,232.20",00.00,"1,59,387.48",
06-Feb-24,Cash,00.00,"53,129.16","1,06,258.32",
06-Feb-24,Cheque,00.00,"13,282.29","92,976.03",
06-Feb-24,Cash,325.9,00.00,"93,301.93",
06-Feb-24,Purchase,00.00,"23,325.48","69,976.45",
06-Feb-24,Tax,00.00,"7,775.16","62,201.29",
06-Feb-24,Cheque,04.70,00.00,"62,205.99",
06-Feb-24,Debit Card,"4,32,646.20",00.00,"4,94,852.19",
06-Feb-24,Transfer,00.00,"49,485.22","4,45,366.97",
06-Feb-24,Purchase,00.00,"63,623.85","3,81,743.12",
06-Feb-24,ATM,00.00,"38,174.31","3,43,568.81",
06-Feb-24,Commission,00.00,"57,261.47","2,86,307.34",
06-Feb-24,Commission,00.00,"95,435.78","1,90,871.56",
06-Feb-24,Transfer,00.00,"31,811.93","1,59,059.63",
06-Feb-24,Reversal,"76,558.56",00.00,"2,35,618.19",
06-Feb-24,Transportellaneous,"7,07,180.25",00.00,"9,42,798.44",
06-Feb-24,RTGS,00.00,"9,42,798.44",00.00,
07-Feb-24,Cash,"12,34,537.75",00.00,"12,34,537.75",
07-Feb-24,ATM,00.00,"6,17,268.88","6,17,268.88",
07-Feb-24,Tax,00.00,"6,17,268.88",00.00,
07-Feb-24,Cash,07.20,00.00,07.20,
07-Feb-24,NEFT,52.14,00.00,59.34,
07-Feb-24,Cheque,55.24,00.00,114.58,
07-Feb-24,Tax,00.00,22.92,91.66,
08-Feb-24,Cheque,00.00,13.09,78.57,
08-Feb-24,Purchase,00.00,13.1,65.47,
08-Feb-24,Debit Card,56,00.00,121.47,
08-Feb-24,NEFT,00.00,15.18,106.29,
08-Feb-24,Tax,00.00,13.29,93,
08-Feb-24,Purchase,00.00,11.63,81.38,
09-Feb-24,RTGS,207.2,00.00,288.58,
09-Feb-24,NEFT,00.00,57.72,230.86,
09-Feb-24,Interest,00.00,230.86,00.00,
09-Feb-24,Interest,"2,951.80",00.00,"2,951.80",
09-Feb-24,NEFT,"17,53,467.50",00.00,"17,56,419.30",
09-Feb-24,ATM,02.00,00.00,"17,56,421.30",
09-Feb-24,NEFT,"5,198.00",00.00,"17,61,619.30",
09-Feb-24,ATM,00.00,"2,20,202.41","15,41,416.89",
09-Feb-24,Transfer,"1,115.48",00.00,"15,42,532.37",
09-Feb-24,Transportellaneous,"2,093.00",00.00,"15,44,625.37",
09-Feb-24,Tax,00.00,"15,44,625.37",00.00,
09-Feb-24,Transfer,"1,246.00",00.00,"1,246.00",
09-Feb-24,Debit Card,00.00,"1,246.00",00.00,
09-Feb-24,ATM,03.36,00.00,03.36,
09-Feb-24,Transfer,00.00,00.48,02.88,
09-Feb-24,Reversal,00.00,00.96,01.92,
09-Feb-24,Tax,00.00,01.92,00.00,
09-Feb-24,Cheque,08.00,00.00,08.00,
09-Feb-24,RTGS,04.00,00.00,12,
09-Feb-24,Bill,175.47,00.00,187.47,
09-Feb-24,Purchase,"21,236.60",00.00,"21,424.07",
09-Feb-24,Cash,00.00,"10,712.04","10,712.04",
09-Feb-24,Transfer,00.00,"1,190.23","9,521.81",
09-Feb-24,RTGS,"3,54,420.75",00.00,"3,63,942.56",
09-Feb-24,Cheque,00.00,"51,991.79","3,11,950.77",
10-Feb-24,Cash,00.00,"62,390.15","2,49,560.62",
10-Feb-24,Interest,05.00,00.00,"2,49,565.62",
10-Feb-24,Transfer,335,00.00,"2,49,900.62",
10-Feb-24,Bill,00.00,"83,300.21","1,66,600.41",
10-Feb-24,Debit Card,"2,505.20",00.00,"1,69,105.61",
10-Feb-24,Purchase,"1,895.33",00.00,"1,71,000.94",
10-Feb-24,Debit Card,"11,58,202.80",00.00,"13,29,203.74",
10-Feb-24,Commission,00.00,"6,64,601.87","6,64,601.87",
11-Feb-24,Transportellaneous,06.82,00.00,"6,64,608.69",
11-Feb-24,Purchase,"2,959.10",00.00,"6,67,567.79",
11-Feb-24,Transportellaneous,"19,71,981.80",00.00,"26,39,549.59",
11-Feb-24,RTGS,00.00,"5,27,909.92","21,11,639.67",
11-Feb-24,Transfer,"15,275.80",00.00,"21,26,915.47",
11-Feb-24,IMPS,04.00,00.00,"21,26,919.47",
11-Feb-24,ATM,00.00,"2,65,864.93","18,61,054.54",
11-Feb-24,Interest,00.00,"2,06,783.84","16,54,270.70",
11-Feb-24,Commission,"1,377.61",00.00,"16,55,648.31",
11-Feb-24,Cheque,00.00,"2,75,941.39","13,79,706.92",
11-Feb-24,Purchase,"4,842.31",00.00,"13,84,549.23",
11-Feb-24,Commission,"6,66,473.50",00.00,"20,51,022.73",
11-Feb-24,Commission,27,00.00,"20,51,049.73",
11-Feb-24,ATM,00.00,"4,10,209.95","16,40,839.78",
11-Feb-24,IMPS,00.00,"5,46,946.59","10,93,893.19",
11-Feb-24,Debit Card,226,00.00,"10,94,119.19",
11-Feb-24,Purchase,"71,924.00",00.00,"11,66,043.19",
11-Feb-24,Commission,00.00,"11,66,043.19",00.00,
11-Feb-24,Transfer,"1,952.30",00.00,"1,952.30",
11-Feb-24,IMPS,00.00,"1,952.30",00.00,
11-Feb-24,Purchase,32,00.00,32,
11-Feb-24,NEFT,00.00,05.33,26.67,
11-Feb-24,RTGS,63.8,00.00,90.47,
11-Feb-24,IMPS,373.7,00.00,464.17,
11-Feb-24,Tax,00.00,116.04,348.13,
11-Feb-24,RTGS,00.00,87.03,261.1,
11-Feb-24,Commission,00.00,65.28,195.82,
11-Feb-24,Debit Card,10.94,00.00,206.76,
11-Feb-24,Tax,"20,03,941.20",00.00,"20,04,147.96",
11-Feb-24,Reversal,00.00,"2,22,683.11","17,81,464.85",
11-Feb-24,Tax,507.3,00.00,"17,81,972.15",
11-Feb-24,Cheque,00.00,"1,97,996.91","15,83,975.24",
11-Feb-24,IMPS,"6,51,240.20",00.00,"22,35,215.44",
11-Feb-24,Cheque,"2,35,681.20",00.00,"24,70,896.64",
11-Feb-24,Commission,00.00,"4,11,816.11","20,59,080.53",
11-Feb-24,RTGS,00.00,"5,14,770.13","15,44,310.40",
11-Feb-24,Bill,00.00,"5,14,770.13","10,29,540.27",
11-Feb-24,Purchase,18.9,00.00,"10,29,559.17",
11-Feb-24,Cash,"12,01,305.00",00.00,"22,30,864.17",
11-Feb-24,ATM,"2,20,070.00",00.00,"24,50,934.17",
11-Feb-24,Bill,"9,06,190.25",00.00,"33,57,124.42",
11-Feb-24,Commission,00.00,"8,39,281.11","25,17,843.32",
11-Feb-24,Transportellaneous,07.47,00.00,"25,17,850.79",
11-Feb-24,Transportellaneous,"1,61,752.00",00.00,"26,79,602.79",
11-Feb-24,IMPS,00.00,"8,93,200.93","17,86,401.86",
11-Feb-24,ATM,00.00,"8,93,200.93","8,93,200.93",
11-Feb-24,NEFT,00.00,"2,23,300.23","6,69,900.70",
11-Feb-24,Reversal,01.20,00.00,"6,69,901.90",
11-Feb-24,Transfer,00.00,"6,69,901.90",00.00,
11-Feb-24,ATM,"11,30,358.00",00.00,"11,30,358.00",
11-Feb-24,Cash,00.00,"1,41,294.75","9,89,063.25",
11-Feb-24,NEFT,00.00,"4,94,531.63","4,94,531.62",
11-Feb-24,Reversal,"2,50,219.00",00.00,"7,44,750.62",
11-Feb-24,Transfer,00.00,"7,44,750.62",00.00,
11-Feb-24,Cheque,"1,587.00",00.00,"1,587.00",
11-Feb-24,Bill,00.00,176.33,"1,410.67",
11-Feb-24,ATM,00.00,156.74,"1,253.93",
11-Feb-24,Transfer,00.00,156.74,"1,097.19",
11-Feb-24,Reversal,26.5,00.00,"1,123.69",
11-Feb-24,Purchase,00.00,224.74,898.95,
11-Feb-24,RTGS,00.00,149.83,749.12,
11-Feb-24,NEFT,00.00,107.02,642.1,
11-Feb-24,Cheque,06.72,00.00,648.82,
11-Feb-24,Transfer,"64,277.00",00.00,"64,925.82",
11-Feb-24,ATM,"19,706.00",00.00,"84,631.82",
11-Feb-24,Debit Card,"11,087.53",00.00,"95,719.35",
11-Feb-24,Transfer,00.00,"13,674.19","82,045.16",
11-Feb-24,Transfer,21.6,00.00,"82,066.76",
11-Feb-24,Commission,00.00,"13,677.79","68,388.97",
11-Feb-24,Purchase,00.00,"34,194.49","34,194.48",
11-Feb-24,Bill,71,00.00,"34,265.48",
11-Feb-24,Transfer,00.00,"4,283.19","29,982.30",
11-Feb-24,Cheque,00.00,"4,997.05","24,985.25",
11-Feb-24,Commission,00.00,"2,498.53","22,486.72",
11-Feb-24,Commission,"1,688.40",00.00,"24,175.12",
11-Feb-24,NEFT,339.63,00.00,"24,514.75",
11-Feb-24,Bill,06.00,00.00,"24,520.75",
11-Feb-24,Commission,00.00,"3,065.09","21,455.66",
11-Feb-24,NEFT,"40,303.00",00.00,"61,758.66",
11-Feb-24,Interest,00.00,"6,175.87","55,582.79",
11-Feb-24,IMPS,22,00.00,"55,604.79",
11-Feb-24,Purchase,"1,68,009.75",00.00,"2,23,614.54",
11-Feb-24,Bill,00.00,"24,846.06","1,98,768.48",
11-Feb-24,Cheque,00.00,"24,846.06","1,73,922.42",
11-Feb-24,Cheque,00.00,"57,974.14","1,15,948.28",
11-Feb-24,Transfer,00.00,"11,594.83","1,04,353.45",
11-Feb-24,Transfer,00.00,"1,04,353.45",00.00,
11-Feb-24,Bill,05.68,00.00,05.68,
11-Feb-24,Interest,00.00,00.71,04.97,
11-Feb-24,Cheque,00.00,00.99,03.98,
11-Feb-24,Commission,00.00,00.66,03.32,
11-Feb-24,Purchase,00.00,00.33,02.99,
11-Feb-24,Cash,56.94,00.00,59.93,
11-Feb-24,Bill,43,00.00,102.93,
11-Feb-24,Transportellaneous,00.00,11.44,91.49,
11-Feb-24,Cash,00.00,45.75,45.74,
12-Feb-24,ATM,243.3,00.00,289.04,
12-Feb-24,Cash,"2,07,191.00",00.00,"2,07,480.04",
12-Feb-24,NEFT,10,00.00,"2,07,490.04",
12-Feb-24,Reversal,00.99,00.00,"2,07,491.03",
12-Feb-24,ATM,00.00,"20,749.10","1,86,741.93",
12-Feb-24,ATM,06.86,00.00,"1,86,748.79",
12-Feb-24,RTGS,00.00,"20,749.87","1,65,998.92",
12-Feb-24,Transportellaneous,00.00,"27,666.49","1,38,332.43",
12-Feb-24,Reversal,28,00.00,"1,38,360.43",
12-Feb-24,Interest,25,00.00,"1,38,385.43",
12-Feb-24,Transfer,00.00,"34,596.36","1,03,789.07",
12-Feb-24,Bill,00.00,"34,596.36","69,192.71",
12-Feb-24,Cash,00.00,"9,884.67","59,308.04",
12-Feb-24,Bill,53,00.00,"59,361.04",
12-Feb-24,ATM,00.00,"9,893.51","49,467.53",
12-Feb-24,Cash,00.00,"8,244.59","41,222.94",
12-Feb-24,NEFT,00.00,"4,122.29","37,100.65",
12-Feb-24,Purchase,00.00,"18,550.33","18,550.32",
12-Feb-24,ATM,00.00,"2,650.05","15,900.27",
12-Feb-24,Bill,00.00,"3,180.05","12,720.22",
12-Feb-24,Transportellaneous,00.00,"12,720.22",00.00,
12-Feb-24,Transportellaneous,01.14,00.00,01.14,
12-Feb-24,Transfer,00.00,00.13,01.01,
12-Feb-24,ATM,00.00,00.51,00.50,
12-Feb-24,Cheque,06.00,00.00,06.50,
12-Feb-24,Purchase,812.1,00.00,818.6,
12-Feb-24,RTGS,"9,30,408.00",00.00,"9,31,226.60",
12-Feb-24,Reversal,00.00,"3,10,408.87","6,20,817.73",
12-Feb-24,Debit Card,"1,10,869.70",00.00,"7,31,687.43",
12-Feb-24,Bill,"12,05,767.00",00.00,"19,37,454.43",
12-Feb-24,Cheque,"2,02,643.34",00.00,"21,40,097.77",
12-Feb-24,Transfer,01.74,00.00,"21,40,099.51",
12-Feb-24,Debit Card,"2,794.00",00.00,"21,42,893.51",
12-Feb-24,Interest,"10,642.00",00.00,"21,53,535.51",
12-Feb-24,RTGS,00.00,"5,38,383.88","16,15,151.63",
12-Feb-24,Interest,00.00,"3,23,030.33","12,92,121.30",
12-Feb-24,Interest,00.00,"3,23,030.33","9,69,090.98",
12-Feb-24,Debit Card,88.9,00.00,"9,69,179.88",
12-Feb-24,Commission,"14,73,248.75",00.00,"24,42,428.63",
12-Feb-24,Interest,00.00,"8,14,142.88","16,28,285.75",
12-Feb-24,Commission,00.00,"1,80,920.64","14,47,365.11",
12-Feb-24,IMPS,01.75,00.00,"14,47,366.86",
12-Feb-24,NEFT,00.00,"2,89,473.37","11,57,893.49",
12-Feb-24,Tax,"32,675.10",00.00,"11,90,568.59",
12-Feb-24,IMPS,00.00,"1,98,428.10","9,92,140.49",
12-Feb-24,Cash,15,00.00,"9,92,155.49",
12-Feb-24,Interest,00.00,"4,96,077.75","4,96,077.74",
12-Feb-24,Bill,07.00,00.00,"4,96,084.74",
12-Feb-24,RTGS,"21,128.00",00.00,"5,17,212.74",
12-Feb-24,Commission,00.00,"64,651.59","4,52,561.15",
12-Feb-24,Debit Card,06.50,00.00,"4,52,567.65",
12-Feb-24,Purchase,00.00,"4,52,567.65",00.00,
12-Feb-24,ATM,08.00,00.00,08.00,
13-Feb-24,Bill,00.00,02.67,05.33,
13-Feb-24,Reversal,00.00,05.33,00.00,
13-Feb-24,Transfer,"3,290.40",00.00,"3,290.40",
13-Feb-24,Commission,00.00,411.3,"2,879.10",
13-Feb-24,Transfer,06.00,00.00,"2,885.10",
13-Feb-24,Purchase,"3,826.70",00.00,"6,711.80",
13-Feb-24,IMPS,"4,60,150.00",00.00,"4,66,861.80",
13-Feb-24,Purchase,01.79,00.00,"4,66,863.59",
13-Feb-24,Transfer,"4,927.48",00.00,"4,71,791.07",
13-Feb-24,NEFT,00.00,"1,17,947.77","3,53,843.30",
13-Feb-24,Purchase,"72,886.10",00.00,"4,26,729.40",
13-Feb-24,Commission,"20,38,344.00",00.00,"24,65,073.40",
13-Feb-24,Interest,00.00,"3,08,134.18","21,56,939.22",
13-Feb-24,NEFT,00.00,"3,59,489.87","17,97,449.35",
13-Feb-24,Cash,00.00,"8,98,724.68","8,98,724.68",
13-Feb-24,Transfer,00.00,"1,79,744.94","7,18,979.74",
13-Feb-24,ATM,06.77,00.00,"7,18,986.51",
13-Feb-24,IMPS,00.00,"1,43,797.30","5,75,189.21",
13-Feb-24,ATM,39,00.00,"5,75,228.21",
13-Feb-24,Tax,"2,131.00",00.00,"5,77,359.21",
13-Feb-24,IMPS,02.00,00.00,"5,77,361.21",
13-Feb-24,IMPS,00.00,"96,226.87","4,81,134.34",
13-Feb-24,NEFT,00.00,"60,141.79","4,20,992.55",
13-Feb-24,IMPS,03.34,00.00,"4,20,995.89",
13-Feb-24,Cheque,43.1,00.00,"4,21,038.99",
13-Feb-24,Interest,07.00,00.00,"4,21,045.99",
13-Feb-24,Debit Card,00.00,"84,209.20","3,36,836.79",
13-Feb-24,Interest,00.00,"42,104.60","2,94,732.19",
13-Feb-24,NEFT,17.46,00.00,"2,94,749.65",
13-Feb-24,Transfer,00.00,"2,94,749.65",00.00,
13-Feb-24,Tax,219.3,00.00,219.3,
13-Feb-24,Tax,00.00,73.1,146.2,
13-Feb-24,Interest,01.00,00.00,147.2,
13-Feb-24,NEFT,03.93,00.00,151.13,
13-Feb-24,Commission,33,00.00,184.13,
13-Feb-24,Reversal,00.00,46.03,138.1,
14-Feb-24,NEFT,"20,05,452.00",00.00,"20,05,590.10",
14-Feb-24,Commission,"3,040.00",00.00,"20,08,630.10",
14-Feb-24,Tax,"1,40,697.70",00.00,"21,49,327.80",
14-Feb-24,NEFT,"5,53,949.00",00.00,"27,03,276.80",
14-Feb-24,Purchase,09.00,00.00,"27,03,285.80",
14-Feb-24,ATM,00.00,"6,75,821.45","20,27,464.35",
14-Feb-24,Commission,"1,768.10",00.00,"20,29,232.45",
14-Feb-24,Transportellaneous,00.00,"20,29,232.45",00.00,
14-Feb-24,NEFT,"23,677.00",00.00,"23,677.00",
14-Feb-24,Cash,00.00,"11,838.50","11,838.50",
14-Feb-24,Bill,"27,531.55",00.00,"39,370.05",
14-Feb-24,Commission,00.00,"4,374.45","34,995.60",
14-Feb-24,Cheque,40,00.00,"35,035.60",
14-Feb-24,Commission,00.00,"4,379.45","30,656.15",
14-Feb-24,Cheque,00.00,"7,664.04","22,992.11",
14-Feb-24,Cheque,00.00,"7,664.04","15,328.07",
14-Feb-24,Purchase,00.00,"5,109.36","10,218.71",
14-Feb-24,Transportellaneous,00.00,"3,406.24","6,812.47",
14-Feb-24,Transfer,00.00,"1,703.12","5,109.35",
14-Feb-24,Transfer,"28,126.64",00.00,"33,235.99",
14-Feb-24,ATM,"19,05,059.00",00.00,"19,38,294.99",
14-Feb-24,Commission,03.00,00.00,"19,38,297.99",
14-Feb-24,Commission,00.00,"19,38,297.99",00.00,
14-Feb-24,Reversal,"2,556.69",00.00,"2,556.69",
14-Feb-24,Bill,217.9,00.00,"2,774.59",
14-Feb-24,Bill,16.5,00.00,"2,791.09",
14-Feb-24,Tax,00.00,930.36,"1,860.73",
14-Feb-24,Transfer,00.00,620.24,"1,240.49",
14-Feb-24,Cheque,"2,206.00",00.00,"3,446.49",
14-Feb-24,Cheque,00.00,344.65,"3,101.84",
14-Feb-24,Cash,00.00,"3,101.84",00.00,
14-Feb-24,Transportellaneous,"10,152.30",00.00,"10,152.30",
14-Feb-24,Cheque,"14,682.56",00.00,"24,834.86",
14-Feb-24,Transportellaneous,00.00,"3,547.84","21,287.02",
14-Feb-24,Bill,499.8,00.00,"21,786.82",
14-Feb-24,Cheque,00.00,"7,262.27","14,524.55",
14-Feb-24,Transportellaneous,00.00,"3,631.14","10,893.41",
15-Feb-24,Tax,32.35,00.00,"10,925.76",
15-Feb-24,Purchase,151.4,00.00,"11,077.16",
15-Feb-24,ATM,"16,79,224.25",00.00,"16,90,301.41",
16-Feb-24,Cheque,00.00,"2,11,287.68","14,79,013.73",
16-Feb-24,Tax,00.00,"14,79,013.73",00.00,
16-Feb-24,Debit Card,23.3,00.00,23.3,
16-Feb-24,Reversal,00.00,03.88,19.42,
16-Feb-24,Purchase,133.1,00.00,152.52,
16-Feb-24,Cheque,30.1,00.00,182.62,
17-Feb-24,Cheque,02.30,00.00,184.92,
17-Feb-24,Transportellaneous,00.00,26.42,158.5,
17-Feb-24,Interest,00.00,15.85,142.65,
17-Feb-24,Reversal,00.00,28.53,114.12,
17-Feb-24,Commission,"11,499.27",00.00,"11,613.39",
17-Feb-24,Debit Card,340,00.00,"11,953.39",
17-Feb-24,Bill,00.00,"1,707.63","10,245.76",
17-Feb-24,Commission,00.00,"2,561.44","7,684.32",
17-Feb-24,NEFT,"12,07,180.50",00.00,"12,14,864.82",
17-Feb-24,Purchase,22.83,00.00,"12,14,887.65",
17-Feb-24,Purchase,00.00,"1,21,488.77","10,93,398.88",
17-Feb-24,Interest,00.00,"10,93,398.88",00.00,
18-Feb-24,IMPS,01.32,00.00,01.32,
18-Feb-24,Transfer,389.1,00.00,390.42,
18-Feb-24,IMPS,"34,918.00",00.00,"35,308.42",
18-Feb-24,Reversal,"14,119.00",00.00,"49,427.42",
18-Feb-24,RTGS,00.00,"49,427.42",00.00,
18-Feb-24,Interest,"1,823.30",00.00,"1,823.30",
18-Feb-24,NEFT,00.12,00.00,"1,823.42",
18-Feb-24,Commission,00.00,455.86,"1,367.56",
18-Feb-24,Transportellaneous,147.2,00.00,"1,514.76",
18-Feb-24,Interest,32,00.00,"1,546.76",
18-Feb-24,Cheque,00.00,386.69,"1,160.07",
18-Feb-24,Cash,"1,49,919.30",00.00,"1,51,079.37",
18-Feb-24,Cash,"24,683.00",00.00,"1,75,762.37",
19-Feb-24,RTGS,00.00,"19,529.15","1,56,233.22",
19-Feb-24,Reversal,"16,083.80",00.00,"1,72,317.02",
19-Feb-24,Commission,469.99,00.00,"1,72,787.01",
19-Feb-24,Tax,"1,17,682.40",00.00,"2,90,469.41",
19-Feb-24,Transfer,00.00,"2,90,469.41",00.00,
19-Feb-24,IMPS,32.11,00.00,32.11,
19-Feb-24,Interest,16.4,00.00,48.51,
19-Feb-24,Transportellaneous,00.00,48.51,00.00,
19-Feb-24,Reversal,"1,77,407.00",00.00,"1,77,407.00",
19-Feb-24,Purchase,04.00,00.00,"1,77,411.00",
19-Feb-24,Commission,00.00,"19,712.33","1,57,698.67",
19-Feb-24,NEFT,00.00,"22,528.38","1,35,170.29",
19-Feb-24,Purchase,00.00,"22,528.38","1,12,641.91",
19-Feb-24,Cheque,"3,114.70",00.00,"1,15,756.61",
19-Feb-24,RTGS,05.45,00.00,"1,15,762.06",
19-Feb-24,NEFT,43,00.00,"1,15,805.06",
19-Feb-24,Purchase,00.00,"28,951.27","86,853.80",
19-Feb-24,Reversal,"13,50,494.00",00.00,"14,37,347.80",
19-Feb-24,Cheque,00.00,"4,79,115.93","9,58,231.87",
19-Feb-24,RTGS,00.48,00.00,"9,58,232.35",
19-Feb-24,Cash,"2,356.20",00.00,"9,60,588.55",
19-Feb-24,Cash,"1,85,953.10",00.00,"11,46,541.65",
19-Feb-24,Bill,00.00,"1,63,791.66","9,82,749.99",
19-Feb-24,Reversal,03.00,00.00,"9,82,752.99",
19-Feb-24,Cheque,"15,597.04",00.00,"9,98,350.03",
19-Feb-24,RTGS,"1,06,762.50",00.00,"11,05,112.53",
19-Feb-24,Cheque,04.56,00.00,"11,05,117.09",
19-Feb-24,NEFT,00.00,"3,68,372.36","7,36,744.73",
19-Feb-24,Transfer,00.00,"1,84,186.18","5,52,558.55",
19-Feb-24,Purchase,00.00,"2,76,279.28","2,76,279.28",
19-Feb-24,Debit Card,"78,498.00",00.00,"3,54,777.28",
19-Feb-24,NEFT,11.31,00.00,"3,54,788.59",
19-Feb-24,Cash,00.00,"35,478.86","3,19,309.73",
19-Feb-24,IMPS,"3,150.00",00.00,"3,22,459.73",
19-Feb-24,Purchase,"2,302.40",00.00,"3,24,762.13",
19-Feb-24,Cheque,"2,20,893.44",00.00,"5,45,655.57",
19-Feb-24,Reversal,00.00,"1,36,413.89","4,09,241.68",
19-Feb-24,NEFT,"3,272.00",00.00,"4,12,513.68",
19-Feb-24,Bill,"29,205.00",00.00,"4,41,718.68",
19-Feb-24,RTGS,00.00,"73,619.78","3,68,098.90",
19-Feb-24,Interest,07.00,00.00,"3,68,105.90",
19-Feb-24,Commission,00.00,"92,026.48","2,76,079.43",
19-Feb-24,Bill,01.00,00.00,"2,76,080.43",
19-Feb-24,NEFT,58,00.00,"2,76,138.43",
19-Feb-24,Reversal,00.00,"69,034.61","2,07,103.82",
20-Feb-24,IMPS,"2,29,989.40",00.00,"4,37,093.22",
20-Feb-24,Purchase,00.00,"4,37,093.22",00.00,
20-Feb-24,Tax,"3,600.90",00.00,"3,600.90",
20-Feb-24,Bill,00.00,450.11,"3,150.79",
20-Feb-24,NEFT,"54,982.80",00.00,"58,133.59",
20-Feb-24,Cash,04.00,00.00,"58,137.59",
20-Feb-24,Interest,"2,621.30",00.00,"60,758.89",
20-Feb-24,Transfer,227,00.00,"60,985.89",
20-Feb-24,Reversal,00.00,"60,985.89",00.00,
20-Feb-24,Commission,"16,757.60",00.00,"16,757.60",
20-Feb-24,ATM,05.30,00.00,"16,762.90",
20-Feb-24,Bill,"3,19,450.20",00.00,"3,36,213.10",
20-Feb-24,RTGS,00.00,"84,053.28","2,52,159.82",
20-Feb-24,Purchase,75.8,00.00,"2,52,235.62",
20-Feb-24,Purchase,"2,157.00",00.00,"2,54,392.62",
20-Feb-24,Tax,00.00,"28,265.85","2,26,126.77",
20-Feb-24,ATM,00.00,"56,531.69","1,69,595.08",
21-Feb-24,Tax,00.00,"33,919.02","1,35,676.06",
21-Feb-24,Commission,02.50,00.00,"1,35,678.56",
21-Feb-24,Interest,58.65,00.00,"1,35,737.21",
21-Feb-24,Cash,"6,49,890.00",00.00,"7,85,627.21",
21-Feb-24,Tax,00.00,"98,203.40","6,87,423.81",
21-Feb-24,Transportellaneous,00.00,"2,29,141.27","4,58,282.54",
21-Feb-24,IMPS,00.00,"4,58,282.54",00.00,
21-Feb-24,Transfer,"3,295.00",00.00,"3,295.00",
21-Feb-24,Cash,00.00,"1,647.50","1,647.50",
21-Feb-24,Cash,00.00,329.5,"1,318.00",
21-Feb-24,ATM,00.00,439.33,878.67,
22-Feb-24,NEFT,"2,799.30",00.00,"3,677.97",
22-Feb-24,Transportellaneous,676.76,00.00,"4,354.73",
22-Feb-24,RTGS,"2,43,355.19",00.00,"2,47,709.92",
22-Feb-24,Transportellaneous,00.00,"30,963.74","2,16,746.18",
22-Feb-24,Cheque,00.00,"27,093.27","1,89,652.91",
22-Feb-24,Interest,00.00,"94,826.46","94,826.46",
22-Feb-24,Cheque,00.00,"13,546.64","81,279.82",
22-Feb-24,RTGS,00.00,"16,255.96","65,023.86",
22-Feb-24,Bill,00.00,"13,004.77","52,019.09",
22-Feb-24,RTGS,"1,85,969.22",00.00,"2,37,988.31",
22-Feb-24,Transportellaneous,42,00.00,"2,38,030.31",
22-Feb-24,Purchase,00.00,"1,19,015.16","1,19,015.16",
22-Feb-24,Purchase,00.00,"13,223.91","1,05,791.25",
22-Feb-24,Cash,00.00,"26,447.81","79,343.44",
22-Feb-24,IMPS,391,00.00,"79,734.44",
22-Feb-24,ATM,00.00,"26,578.15","53,156.29",
22-Feb-24,Cheque,00.00,"7,593.76","45,562.53",
22-Feb-24,Reversal,00.00,"5,695.32","39,867.21",
22-Feb-24,Cash,07.60,00.00,"39,874.81",
22-Feb-24,IMPS,00.00,"9,968.70","29,906.11",
22-Feb-24,Commission,333.2,00.00,"30,239.31",
22-Feb-24,Interest,06.00,00.00,"30,245.31",
22-Feb-24,Commission,00.00,"3,024.53","27,220.78",
22-Feb-24,IMPS,232.62,00.00,"27,453.40",
22-Feb-24,Tax,"2,26,351.20",00.00,"2,53,804.60",
22-Feb-24,Reversal,00.00,"1,26,902.30","1,26,902.30",
22-Feb-24,Debit Card,00.00,"21,150.38","1,05,751.92",
22-Feb-24,Cheque,00.00,"11,750.21","94,001.71",
22-Feb-24,IMPS,00.00,"23,500.43","70,501.28",
22-Feb-24,Transportellaneous,"1,85,393.10",00.00,"2,55,894.38",
22-Feb-24,Cash,00.00,"51,178.88","2,04,715.50",
22-Feb-24,Cheque,17,00.00,"2,04,732.50",
22-Feb-24,Tax,"14,04,784.00",00.00,"16,09,516.50",
22-Feb-24,Purchase,"20,482.00",00.00,"16,29,998.50",
22-Feb-24,Tax,"9,40,081.50",00.00,"25,70,080.00",
22-Feb-24,RTGS,"17,295.00",00.00,"25,87,375.00",
22-Feb-24,Debit Card,995.43,00.00,"25,88,370.43",
22-Feb-24,Commission,"2,11,721.80",00.00,"28,00,092.23",
22-Feb-24,IMPS,00.00,00.00,"28,00,092.23",
22-Feb-24,Reversal,00.00,"28,00,092.23",00.00,
22-Feb-24,RTGS,"1,149.00",00.00,"1,149.00",
22-Feb-24,Cheque,33,00.00,"1,182.00",
22-Feb-24,Commission,"2,23,656.94",00.00,"2,24,838.94",
22-Feb-24,Tax,"6,96,135.20",00.00,"9,20,974.14",
22-Feb-24,ATM,00.00,"1,02,330.46","8,18,643.68",
22-Feb-24,Debit Card,00.00,"90,960.41","7,27,683.27",
22-Feb-24,Transfer,00.00,"1,81,920.82","5,45,762.45",
22-Feb-24,RTGS,00.00,"1,09,152.49","4,36,609.96",
22-Feb-24,Transportellaneous,00.00,"4,36,609.96",00.00,
22-Feb-24,Transportellaneous,"66,916.97",00.00,"66,916.97",
23-Feb-24,Bill,00.00,"22,305.66","44,611.31",
23-Feb-24,Transportellaneous,271.34,00.00,"44,882.65",
23-Feb-24,Transfer,00.00,"4,488.27","40,394.38",
23-Feb-24,Transfer,"19,89,978.75",00.00,"20,30,373.13",
23-Feb-24,Transfer,00.00,"2,53,796.64","17,76,576.49",
23-Feb-24,Commission,00.00,"4,44,144.12","13,32,432.37",
23-Feb-24,Transportellaneous,"5,889.28",00.00,"13,38,321.65",
23-Feb-24,Transfer,"17,169.00",00.00,"13,55,490.65",
23-Feb-24,Cash,"12,491.80",00.00,"13,67,982.45",
23-Feb-24,Reversal,324,00.00,"13,68,306.45",
24-Feb-24,Transfer,"11,17,565.00",00.00,"24,85,871.45",
24-Feb-24,Transportellaneous,00.00,"6,21,467.86","18,64,403.59",
24-Feb-24,IMPS,00.00,"4,66,100.90","13,98,302.69",
24-Feb-24,Cheque,00.00,"1,55,366.97","12,42,935.72",
24-Feb-24,Interest,"27,913.00",00.00,"12,70,848.72",
24-Feb-24,ATM,"1,135.85",00.00,"12,71,984.57",
24-Feb-24,Bill,00.00,"4,23,994.86","8,47,989.71",
24-Feb-24,NEFT,"13,253.00",00.00,"8,61,242.71",
24-Feb-24,ATM,00.00,"86,124.27","7,75,118.44",
25-Feb-24,Purchase,"15,84,230.75",00.00,"23,59,349.19",
25-Feb-24,ATM,00.00,"2,35,934.92","21,23,414.27",
25-Feb-24,Tax,00.00,"5,30,853.57","15,92,560.70",
25-Feb-24,Commission,00.00,"1,99,070.09","13,93,490.61",
25-Feb-24,Reversal,365.9,00.00,"13,93,856.51",
25-Feb-24,Debit Card,07.90,00.00,"13,93,864.41",
25-Feb-24,ATM,55,00.00,"13,93,919.41",
25-Feb-24,Bill,00.00,"1,54,879.93","12,39,039.48",
25-Feb-24,Bill,00.00,"1,37,671.05","11,01,368.43",
25-Feb-24,Reversal,19.8,00.00,"11,01,388.23",
25-Feb-24,IMPS,00.00,"1,83,564.71","9,17,823.52",
25-Feb-24,Reversal,00.00,"3,05,941.17","6,11,882.35",
25-Feb-24,Cash,00.00,"2,03,960.78","4,07,921.57",
25-Feb-24,Transportellaneous,00.00,"2,03,960.79","2,03,960.78",
25-Feb-24,Cheque,125,00.00,"2,04,085.78",
25-Feb-24,Bill,"3,423.00",00.00,"2,07,508.78",
25-Feb-24,IMPS,52.54,00.00,"2,07,561.32",
25-Feb-24,ATM,00.00,"34,593.55","1,72,967.77",
25-Feb-24,Transfer,"5,85,480.00",00.00,"7,58,447.77",
25-Feb-24,Transportellaneous,04.45,00.00,"7,58,452.22",
25-Feb-24,Tax,00.00,"1,08,350.32","6,50,101.90",
25-Feb-24,Cash,"2,102.15",00.00,"6,52,204.05",
25-Feb-24,Cash,00.00,"6,52,204.05",00.00,
26-Feb-24,Commission,00.50,00.00,00.50,
26-Feb-24,Debit Card,59,00.00,59.5,
26-Feb-24,Transportellaneous,00.00,05.95,53.55,
26-Feb-24,Transportellaneous,"2,789.47",00.00,"2,843.02",
26-Feb-24,ATM,00.00,355.38,"2,487.64",
26-Feb-24,Tax,00.00,276.4,"2,211.24",
26-Feb-24,Transfer,00.00,221.12,"1,990.12",
26-Feb-24,Transfer,00.00,995.06,995.06,
26-Feb-24,Cheque,50,00.00,"1,045.06",
26-Feb-24,Tax,379,00.00,"1,424.06",
26-Feb-24,IMPS,"70,323.60",00.00,"71,747.66",
26-Feb-24,RTGS,600.66,00.00,"72,348.32",
26-Feb-24,ATM,"11,462.30",00.00,"83,810.62",
26-Feb-24,Bill,00.00,"83,810.62",00.00,
26-Feb-24,Bill,"2,10,942.90",00.00,"2,10,942.90",
26-Feb-24,Transportellaneous,27.43,00.00,"2,10,970.33",
26-Feb-24,RTGS,04.49,00.00,"2,10,974.82",
26-Feb-24,Interest,56,00.00,"2,11,030.82",
26-Feb-24,Commission,00.00,"70,343.61","1,40,687.21",
26-Feb-24,Cash,00.00,"35,171.80","1,05,515.41",
26-Feb-24,Bill,00.00,"10,551.54","94,963.87",
26-Feb-24,Cheque,05.10,00.00,"94,968.97",
26-Feb-24,Debit Card,03.80,00.00,"94,972.77",
26-Feb-24,Bill,00.00,"47,486.39","47,486.38",
26-Feb-24,IMPS,"3,81,047.00",00.00,"4,28,533.38",
26-Feb-24,RTGS,"3,414.20",00.00,"4,31,947.58",
26-Feb-24,Transfer,00.00,"4,31,947.58",00.00,
26-Feb-24,Tax,"1,38,656.00",00.00,"1,38,656.00",
26-Feb-24,RTGS,"3,288.00",00.00,"1,41,944.00",
26-Feb-24,Interest,23,00.00,"1,41,967.00",
26-Feb-24,Transfer,00.00,"17,745.88","1,24,221.12",
26-Feb-24,RTGS,00.00,"12,422.11","1,11,799.01",
26-Feb-24,Cash,"2,815.00",00.00,"1,14,614.01",
26-Feb-24,IMPS,"96,209.00",00.00,"2,10,823.01",
26-Feb-24,Reversal,00.00,"21,082.30","1,89,740.71",
26-Feb-24,Cash,00.00,"31,623.45","1,58,117.26",
26-Feb-24,Transportellaneous,00.00,"39,529.32","1,18,587.94",
26-Feb-24,Tax,"3,33,283.80",00.00,"4,51,871.74",
26-Feb-24,Tax,"16,073.00",00.00,"4,67,944.74",
26-Feb-24,RTGS,"16,401.60",00.00,"4,84,346.34",
26-Feb-24,Cash,00.00,"1,21,086.59","3,63,259.76",
26-Feb-24,Transportellaneous,"1,33,522.80",00.00,"4,96,782.56",
26-Feb-24,Bill,00.00,"70,968.94","4,25,813.62",
26-Feb-24,Debit Card,00.00,"2,12,906.81","2,12,906.81",
26-Feb-24,Purchase,00.00,"30,415.26","1,82,491.55",
26-Feb-24,Debit Card,00.00,"60,830.52","1,21,661.03",
26-Feb-24,Transportellaneous,"1,877.00",00.00,"1,23,538.03",
26-Feb-24,Bill,"3,295.00",00.00,"1,26,833.03",
26-Feb-24,Purchase,00.00,"15,854.13","1,10,978.90",
26-Feb-24,Debit Card,00.00,"27,744.73","83,234.17",
26-Feb-24,RTGS,00.00,"8,323.42","74,910.75",
27-Feb-24,RTGS,239,00.00,"75,149.75",
27-Feb-24,Transportellaneous,00.00,"75,149.75",00.00,
27-Feb-24,Tax,"12,174.00",00.00,"12,174.00",
27-Feb-24,Transportellaneous,00.00,"1,352.67","10,821.33",
27-Feb-24,ATM,"37,446.66",00.00,"48,267.99",
27-Feb-24,Cheque,00.00,"6,895.43","41,372.56",
27-Feb-24,Cheque,04.00,00.00,"41,376.56",
27-Feb-24,IMPS,511.57,00.00,"41,888.13",
27-Feb-24,RTGS,"14,288.90",00.00,"56,177.03",
27-Feb-24,ATM,00.00,"18,725.68","37,451.35",
27-Feb-24,Transportellaneous,"1,146.00",00.00,"38,597.35",
27-Feb-24,Reversal,"1,85,055.44",00.00,"2,23,652.79",
27-Feb-24,Reversal,00.20,00.00,"2,23,652.99",
27-Feb-24,Bill,00.00,"1,11,826.50","1,11,826.50",
27-Feb-24,ATM,00.00,"18,637.75","93,188.75",
27-Feb-24,Transfer,"3,441.85",00.00,"96,630.60",
27-Feb-24,NEFT,"5,776.00",00.00,"1,02,406.60",
27-Feb-24,Purchase,00.00,"14,629.51","87,777.09",
27-Feb-24,Transfer,"18,62,908.00",00.00,"19,50,685.09",
27-Feb-24,NEFT,00.00,"3,90,137.02","15,60,548.07",
27-Feb-24,Cash,14.08,00.00,"15,60,562.15",
27-Feb-24,Cheque,"1,31,527.38",00.00,"16,92,089.53",
28-Feb-24,Cheque,06.52,00.00,"16,92,096.05",
28-Feb-24,Bill,00.00,"1,88,010.67","15,04,085.38",
28-Feb-24,IMPS,00.00,"15,04,085.38",00.00,
29-Feb-24,Cash,125.95,00.00,125.95,
29-Feb-24,ATM,00.00,125.95,00.00,
29-Feb-24,Transfer,"2,025.30",00.00,"2,025.30",
29-Feb-24,Transportellaneous,"15,35,399.00",00.00,"15,37,424.30",
29-Feb-24,Purchase,00.00,"5,12,474.77","10,24,949.53",
29-Feb-24,Tax,00.00,"3,41,649.84","6,83,299.69",
29-Feb-24,Tax,00.00,"2,27,766.56","4,55,533.13",
01-Mar-24,IMPS,06.10,00.00,"4,55,539.23",
01-Mar-24,Bill,02.10,00.00,"4,55,541.33",
01-Mar-24,Transportellaneous,18,00.00,"4,55,559.33",
01-Mar-24,Cheque,"5,688.96",00.00,"4,61,248.29",
01-Mar-24,Tax,"2,16,441.66",00.00,"6,77,689.95",
01-Mar-24,IMPS,00.00,"3,38,844.98","3,38,844.98",
01-Mar-24,Transfer,00.00,"33,884.50","3,04,960.48",
01-Mar-24,Commission,94,00.00,"3,05,054.48",
01-Mar-24,NEFT,00.00,"1,52,527.24","1,52,527.24",
01-Mar-24,Transfer,00.00,"1,52,527.24",00.00,
01-Mar-24,Transfer,852.28,00.00,852.28,
01-Mar-24,Interest,00.00,284.09,568.19,
01-Mar-24,NEFT,00.00,568.19,00.00,
01-Mar-24,Debit Card,137,00.00,137,
01-Mar-24,Purchase,402,00.00,539,
01-Mar-24,Transfer,00.00,269.5,269.5,
01-Mar-24,NEFT,"1,350.36",00.00,"1,619.86",
01-Mar-24,Reversal,"11,631.00",00.00,"13,250.86",
01-Mar-24,Cash,"26,544.30",00.00,"39,795.16",
01-Mar-24,Bill,"15,81,289.50",00.00,"16,21,084.66",
01-Mar-24,Bill,"1,758.00",00.00,"16,22,842.66",
01-Mar-24,Interest,07.40,00.00,"16,22,850.06",
01-Mar-24,Transportellaneous,"8,55,239.00",00.00,"24,78,089.06",
01-Mar-24,NEFT,00.00,"3,09,761.13","21,68,327.93",
01-Mar-24,Reversal,"2,969.00",00.00,"21,71,296.93",
01-Mar-24,Interest,00.00,"21,71,296.93",00.00,
01-Mar-24,RTGS,"5,94,457.80",00.00,"5,94,457.80",
02-Mar-24,RTGS,00.00,"66,050.87","5,28,406.93",
02-Mar-24,Bill,492.33,00.00,"5,28,899.26",
02-Mar-24,NEFT,"13,64,425.00",00.00,"18,93,324.26",
02-Mar-24,Transfer,00.00,"2,70,474.89","16,22,849.37",
02-Mar-24,Debit Card,00.00,"2,02,856.17","14,19,993.20",
02-Mar-24,Tax,00.00,"1,41,999.32","12,77,993.88",
02-Mar-24,NEFT,00.00,"4,25,997.96","8,51,995.92",
02-Mar-24,Bill,00.00,"8,51,995.92",00.00,
02-Mar-24,NEFT,"21,938.70",00.00,"21,938.70",
02-Mar-24,Interest,"32,694.00",00.00,"54,632.70",
02-Mar-24,Cheque,00.00,"18,210.90","36,421.80",
02-Mar-24,Transportellaneous,00.00,"3,642.18","32,779.62",
02-Mar-24,NEFT,00.00,"8,194.91","24,584.72",
02-Mar-24,Interest,"30,309.63",00.00,"54,894.35",
02-Mar-24,RTGS,00.00,"10,978.87","43,915.48",
02-Mar-24,Tax,"2,33,652.72",00.00,"2,77,568.20",
02-Mar-24,RTGS,00.00,"1,38,784.10","1,38,784.10",
02-Mar-24,RTGS,"1,76,641.40",00.00,"3,15,425.50",
02-Mar-24,Commission,45.88,00.00,"3,15,471.38",
02-Mar-24,Cheque,00.00,"52,578.56","2,62,892.82",
02-Mar-24,Bill,00.00,"29,210.31","2,33,682.51",
02-Mar-24,Debit Card,00.00,"29,210.31","2,04,472.20",
02-Mar-24,Bill,00.00,"68,157.40","1,36,314.80",
02-Mar-24,Bill,"1,76,741.50",00.00,"3,13,056.30",
02-Mar-24,RTGS,"1,672.19",00.00,"3,14,728.49",
02-Mar-24,Interest,00.00,"39,341.06","2,75,387.43",
02-Mar-24,ATM,202.1,00.00,"2,75,589.53",
02-Mar-24,Debit Card,00.29,00.00,"2,75,589.82",
02-Mar-24,ATM,00.00,"30,621.09","2,44,968.73",
02-Mar-24,RTGS,00.00,"27,218.75","2,17,749.98",
02-Mar-24,Debit Card,00.00,"31,107.14","1,86,642.84",
02-Mar-24,Tax,"1,63,942.00",00.00,"3,50,584.84",
02-Mar-24,Cheque,00.00,"35,058.48","3,15,526.36",
02-Mar-24,RTGS,124.3,00.00,"3,15,650.66",
02-Mar-24,RTGS,00.00,"35,072.30","2,80,578.36",
02-Mar-24,Transportellaneous,00.00,"93,526.12","1,87,052.24",
02-Mar-24,Bill,02.40,00.00,"1,87,054.64",
02-Mar-24,NEFT,00.00,"20,783.85","1,66,270.79",
02-Mar-24,Interest,00.00,"18,474.53","1,47,796.26",
02-Mar-24,RTGS,00.00,"73,898.13","73,898.13",
02-Mar-24,Cash,00.00,"18,474.53","55,423.60",
02-Mar-24,Debit Card,03.30,00.00,"55,426.90",
02-Mar-24,Transfer,"3,091.92",00.00,"58,518.82",
02-Mar-24,Bill,00.00,"14,629.71","43,889.12",
02-Mar-24,RTGS,00.00,"21,944.56","21,944.56",
02-Mar-24,Bill,279,00.00,"22,223.56",
02-Mar-24,RTGS,00.00,"22,223.56",00.00,
02-Mar-24,Tax,41,00.00,41,
02-Mar-24,Tax,00.50,00.00,41.5,
02-Mar-24,ATM,00.00,05.19,36.31,
02-Mar-24,NEFT,140,00.00,176.31,
02-Mar-24,Bill,"17,857.00",00.00,"18,033.31",
03-Mar-24,Bill,00.00,"1,803.33","16,229.98",
04-Mar-24,Tax,"4,15,206.20",00.00,"4,31,436.18",
04-Mar-24,Purchase,01.44,00.00,"4,31,437.62",
04-Mar-24,IMPS,"4,83,907.75",00.00,"9,15,345.37",
04-Mar-24,Purchase,02.97,00.00,"9,15,348.34",
04-Mar-24,Bill,00.00,"9,15,348.34",00.00,
04-Mar-24,ATM,336.49,00.00,336.49,
04-Mar-24,RTGS,00.00,67.3,269.19,
04-Mar-24,NEFT,00.00,134.6,134.6,
04-Mar-24,Reversal,00.00,67.3,67.3,
04-Mar-24,Cash,"2,61,626.00",00.00,"2,61,693.30",
04-Mar-24,Tax,00.00,"29,077.03","2,32,616.27",
04-Mar-24,Tax,00.00,"46,523.25","1,86,093.02",
04-Mar-24,NEFT,"85,390.00",00.00,"2,71,483.02",
04-Mar-24,Transportellaneous,00.00,"54,296.60","2,17,186.42",
04-Mar-24,Debit Card,00.00,"24,131.82","1,93,054.60",
04-Mar-24,Reversal,"20,598.66",00.00,"2,13,653.26",
04-Mar-24,Reversal,153,00.00,"2,13,806.26",
04-Mar-24,Commission,"14,99,332.00",00.00,"17,13,138.26",
04-Mar-24,NEFT,00.00,"4,28,284.57","12,84,853.70",
04-Mar-24,Debit Card,00.00,"1,60,606.71","11,24,246.99",
04-Mar-24,Tax,00.00,"1,24,916.33","9,99,330.66",
04-Mar-24,Interest,"1,824.80",00.00,"10,01,155.46",
04-Mar-24,Commission,60,00.00,"10,01,215.46",
04-Mar-24,Cheque,"17,386.00",00.00,"10,18,601.46",
04-Mar-24,Interest,00.00,"1,27,325.18","8,91,276.28",
04-Mar-24,Interest,00.00,"1,11,409.54","7,79,866.74",
04-Mar-24,Commission,"1,36,954.70",00.00,"9,16,821.44",
04-Mar-24,NEFT,00.00,"1,01,869.05","8,14,952.39",
04-Mar-24,NEFT,00.00,"8,14,952.39",00.00,
04-Mar-24,IMPS,"22,465.58",00.00,"22,465.58",
04-Mar-24,Commission,59,00.00,"22,524.58",
04-Mar-24,Interest,00.00,"11,262.29","11,262.29",
04-Mar-24,Purchase,00.00,"2,252.46","9,009.83",
04-Mar-24,Cash,00.00,"1,126.23","7,883.60",
04-Mar-24,IMPS,00.00,"2,627.87","5,255.73",
04-Mar-24,Purchase,00.00,875.96,"4,379.77",
04-Mar-24,Transportellaneous,47.4,00.00,"4,427.17",
04-Mar-24,RTGS,"9,72,187.00",00.00,"9,76,614.17",
04-Mar-24,Interest,"1,645.00",00.00,"9,78,259.17",
04-Mar-24,Debit Card,118,00.00,"9,78,377.17",
04-Mar-24,Reversal,27,00.00,"9,78,404.17",
05-Mar-24,NEFT,00.00,"1,39,772.02","8,38,632.15",
05-Mar-24,Debit Card,"22,901.50",00.00,"8,61,533.65",
05-Mar-24,Reversal,00.00,"8,61,533.65",00.00,
05-Mar-24,Interest,491.8,00.00,491.8,
05-Mar-24,IMPS,"1,321.00",00.00,"1,812.80",
05-Mar-24,Purchase,13.89,00.00,"1,826.69",
05-Mar-24,Bill,250.5,00.00,"2,077.19",
05-Mar-24,NEFT,00.00,415.44,"1,661.75",
05-Mar-24,Debit Card,00.00,237.39,"1,424.36",
05-Mar-24,Interest,00.00,356.09,"1,068.27",
05-Mar-24,ATM,23.73,00.00,"1,092.00",
05-Mar-24,Transfer,00.00,109.2,982.8,
05-Mar-24,ATM,"1,15,591.00",00.00,"1,16,573.80",
05-Mar-24,NEFT,00.00,"23,314.76","93,259.04",
05-Mar-24,Reversal,319,00.00,"93,578.04",
05-Mar-24,Commission,00.00,"31,192.68","62,385.36",
05-Mar-24,Transportellaneous,00.00,"31,192.68","31,192.68",
05-Mar-24,Commission,00.00,"3,119.27","28,073.41",
05-Mar-24,Commission,"3,446.80",00.00,"31,520.21",
05-Mar-24,NEFT,14.02,00.00,"31,534.23",
05-Mar-24,Interest,00.00,"3,941.78","27,592.45",
05-Mar-24,RTGS,197.77,00.00,"27,790.22",
05-Mar-24,Commission,00.00,"6,947.56","20,842.66",
05-Mar-24,Bill,00.00,"10,421.33","10,421.33",
05-Mar-24,Transportellaneous,"26,428.00",00.00,"36,849.33",
05-Mar-24,RTGS,"13,793.80",00.00,"50,643.13",
05-Mar-24,IMPS,00.00,"16,881.04","33,762.09",
05-Mar-24,RTGS,"11,13,593.20",00.00,"11,47,355.29",
05-Mar-24,Commission,00.00,"1,91,225.88","9,56,129.41",
05-Mar-24,Bill,05.00,00.00,"9,56,134.41",
05-Mar-24,Purchase,00.00,"95,613.44","8,60,520.97",
05-Mar-24,Debit Card,00.00,"1,72,104.19","6,88,416.78",
05-Mar-24,Bill,33.4,00.00,"6,88,450.18",
05-Mar-24,Reversal,07.00,00.00,"6,88,457.18",
05-Mar-24,RTGS,05.59,00.00,"6,88,462.77",
05-Mar-24,Bill,"18,80,991.20",00.00,"25,69,453.97",
05-Mar-24,Cash,00.00,"12,84,726.99","12,84,726.99",
05-Mar-24,Tax,00.00,"12,84,726.99",00.00,
05-Mar-24,Bill,05.03,00.00,05.03,
05-Mar-24,Debit Card,00.00,00.72,04.31,
05-Mar-24,Bill,245.2,00.00,249.51,
05-Mar-24,Bill,"3,883.50",00.00,"4,133.01",
05-Mar-24,IMPS,00.00,413.3,"3,719.71",
05-Mar-24,Transportellaneous,37,00.00,"3,756.71",
05-Mar-24,Cheque,00.00,939.18,"2,817.53",
05-Mar-24,Commission,"2,451.10",00.00,"5,268.63",
05-Mar-24,Bill,00.00,878.11,"4,390.52",
05-Mar-24,Purchase,460,00.00,"4,850.52",
05-Mar-24,Transportellaneous,00.00,"4,850.52",00.00,
05-Mar-24,Cash,709,00.00,709,
05-Mar-24,ATM,"14,96,844.00",00.00,"14,97,553.00",
05-Mar-24,Debit Card,359.2,00.00,"14,97,912.20",
05-Mar-24,ATM,00.00,"14,97,912.20",00.00,
05-Mar-24,IMPS,"1,84,783.09",00.00,"1,84,783.09",
05-Mar-24,RTGS,661.3,00.00,"1,85,444.39",
05-Mar-24,RTGS,00.00,"92,722.20","92,722.20",
05-Mar-24,Transportellaneous,"94,176.00",00.00,"1,86,898.20",
05-Mar-24,IMPS,00.00,"31,149.70","1,55,748.50",
05-Mar-24,Bill,08.00,00.00,"1,55,756.50",
05-Mar-24,Transfer,95,00.00,"1,55,851.50",
05-Mar-24,Reversal,362.6,00.00,"1,56,214.10",
05-Mar-24,Reversal,00.00,"15,621.41","1,40,592.69",
05-Mar-24,IMPS,00.00,"14,059.27","1,26,533.42",
05-Mar-24,RTGS,00.00,"14,059.27","1,12,474.15",
05-Mar-24,Transfer,00.00,"37,491.38","74,982.77",
05-Mar-24,Bill,"9,566.28",00.00,"84,549.05",
05-Mar-24,IMPS,00.00,"8,454.91","76,094.14",
05-Mar-24,Bill,00.00,"8,454.90","67,639.24",
05-Mar-24,Transfer,06.10,00.00,"67,645.34",
05-Mar-24,RTGS,03.00,00.00,"67,648.34",
05-Mar-24,Tax,00.00,"8,456.04","59,192.30",
05-Mar-24,NEFT,316.44,00.00,"59,508.74",
05-Mar-24,Commission,"3,475.65",00.00,"62,984.39",
05-Mar-24,Tax,07.00,00.00,"62,991.39",
05-Mar-24,Cash,00.00,"20,997.13","41,994.26",
05-Mar-24,NEFT,"1,830.68",00.00,"43,824.94",
05-Mar-24,Transfer,"8,166.88",00.00,"51,991.82",
05-Mar-24,Cheque,699,00.00,"52,690.82",
05-Mar-24,Cheque,00.00,"5,854.54","46,836.28",
05-Mar-24,Tax,"91,724.03",00.00,"1,38,560.31",
05-Mar-24,RTGS,"9,523.00",00.00,"1,48,083.31",
05-Mar-24,Cash,56.4,00.00,"1,48,139.71",
05-Mar-24,Debit Card,"12,513.60",00.00,"1,60,653.31",
05-Mar-24,Purchase,196.1,00.00,"1,60,849.41",
05-Mar-24,Purchase,"11,78,605.00",00.00,"13,39,454.41",
05-Mar-24,Debit Card,00.00,"1,91,350.63","11,48,103.78",
05-Mar-24,Purchase,00.00,"2,87,025.95","8,61,077.84",
05-Mar-24,Transfer,"5,921.10",00.00,"8,66,998.94",
05-Mar-24,Cheque,14.9,00.00,"8,67,013.84",
05-Mar-24,Interest,"12,474.56",00.00,"8,79,488.40",
05-Mar-24,Cheque,30.35,00.00,"8,79,518.75",
05-Mar-24,NEFT,233,00.00,"8,79,751.75",
06-Mar-24,RTGS,"1,69,444.40",00.00,"10,49,196.15",
06-Mar-24,IMPS,07.80,00.00,"10,49,203.95",
06-Mar-24,Debit Card,"1,31,252.50",00.00,"11,80,456.45",
06-Mar-24,Tax,00.00,"2,36,091.29","9,44,365.16",
06-Mar-24,NEFT,"2,437.60",00.00,"9,46,802.76",
06-Mar-24,Transfer,273.04,00.00,"9,47,075.80",
06-Mar-24,Transfer,"23,680.24",00.00,"9,70,756.04",
06-Mar-24,Purchase,"2,765.40",00.00,"9,73,521.44",
06-Mar-24,Commission,00.00,"1,08,169.05","8,65,352.39",
06-Mar-24,Purchase,00.00,"8,65,352.39",00.00,
06-Mar-24,Cash,05.93,00.00,05.93,
06-Mar-24,Cash,"3,833.80",00.00,"3,839.73",
06-Mar-24,Bill,"2,226.10",00.00,"6,065.83",
06-Mar-24,Tax,00.00,758.23,"5,307.60",
06-Mar-24,Transfer,00.00,758.23,"4,549.37",
06-Mar-24,Tax,02.00,00.00,"4,551.37",
06-Mar-24,Transportellaneous,00.00,505.71,"4,045.66",
06-Mar-24,Reversal,"3,703.20",00.00,"7,748.86",
06-Mar-24,Transportellaneous,00.00,"1,291.48","6,457.38",
06-Mar-24,Cheque,"8,05,112.00",00.00,"8,11,569.38",
06-Mar-24,ATM,00.00,"1,62,313.88","6,49,255.50",
06-Mar-24,RTGS,00.00,"72,139.50","5,77,116.00",
06-Mar-24,IMPS,00.00,"64,124.00","5,12,992.00",
06-Mar-24,ATM,00.00,"56,999.11","4,55,992.89",
06-Mar-24,RTGS,"18,88,197.00",00.00,"23,44,189.89",
06-Mar-24,Tax,07.00,00.00,"23,44,196.89",
06-Mar-24,Interest,379,00.00,"23,44,575.89",
06-Mar-24,Transportellaneous,00.00,"2,34,457.59","21,10,118.30",
06-Mar-24,ATM,00.00,"10,55,059.15","10,55,059.15",
06-Mar-24,Purchase,00.00,"1,50,722.74","9,04,336.41",
06-Mar-24,Purchase,"1,20,330.19",00.00,"10,24,666.60",
06-Mar-24,Transfer,00.00,"10,24,666.60",00.00,
06-Mar-24,IMPS,"4,212.00",00.00,"4,212.00",
06-Mar-24,Tax,00.00,702,"3,510.00",
06-Mar-24,Commission,01.00,00.00,"3,511.00",
06-Mar-24,Cash,00.00,"1,755.50","1,755.50",
07-Mar-24,Debit Card,00.00,438.88,"1,316.62",
08-Mar-24,Transportellaneous,"8,48,321.80",00.00,"8,49,638.42",
08-Mar-24,Cash,00.00,"1,21,376.92","7,28,261.50",
08-Mar-24,Debit Card,01.10,00.00,"7,28,262.60",
08-Mar-24,Purchase,00.00,"3,64,131.30","3,64,131.30",
08-Mar-24,Tax,00.00,"45,516.41","3,18,614.89",
08-Mar-24,Interest,00.00,"1,06,204.96","2,12,409.93",
08-Mar-24,NEFT,03.00,00.00,"2,12,412.93",
08-Mar-24,Interest,00.00,"53,103.23","1,59,309.70",
08-Mar-24,IMPS,"11,71,527.75",00.00,"13,30,837.45",
08-Mar-24,Transfer,00.00,"1,47,870.83","11,82,966.62",
08-Mar-24,Reversal,00.00,"1,18,296.66","10,64,669.96",
09-Mar-24,RTGS,05.00,00.00,"10,64,674.96",
09-Mar-24,Transportellaneous,00.00,"1,77,445.83","8,87,229.13",
09-Mar-24,Cheque,00.00,"1,77,445.83","7,09,783.30",
09-Mar-24,Cash,"1,96,850.00",00.00,"9,06,633.30",
09-Mar-24,Transportellaneous,00.00,"1,81,326.66","7,25,306.64",
09-Mar-24,RTGS,06.50,00.00,"7,25,313.14",
09-Mar-24,Bill,"2,35,106.40",00.00,"9,60,419.54",
09-Mar-24,Reversal,"8,325.00",00.00,"9,68,744.54",
09-Mar-24,Interest,00.00,"1,07,638.28","8,61,106.26",
09-Mar-24,Tax,00.00,"2,87,035.42","5,74,070.84",
09-Mar-24,Commission,00.00,"5,74,070.84",00.00,
09-Mar-24,Transfer,"6,18,870.20",00.00,"6,18,870.20",
09-Mar-24,Transfer,00.00,"1,23,774.04","4,95,096.16",
09-Mar-24,NEFT,00.88,00.00,"4,95,097.04",
09-Mar-24,Interest,"2,830.00",00.00,"4,97,927.04",
09-Mar-24,Transportellaneous,00.00,"55,325.23","4,42,601.81",
09-Mar-24,NEFT,"18,97,171.00",00.00,"23,39,772.81",
09-Mar-24,Tax,229,00.00,"23,40,001.81",
09-Mar-24,Cheque,00.00,"3,90,000.30","19,50,001.51",
09-Mar-24,RTGS,00.00,"3,90,000.30","15,60,001.21",
09-Mar-24,Cash,900.4,00.00,"15,60,901.61",
09-Mar-24,Debit Card,00.00,"2,22,985.94","13,37,915.67",
09-Mar-24,NEFT,00.00,"2,67,583.13","10,70,332.54",
09-Mar-24,Debit Card,"1,73,119.91",00.00,"12,43,452.45",
09-Mar-24,Transfer,03.00,00.00,"12,43,455.45",
09-Mar-24,Interest,00.00,"1,24,345.55","11,19,109.90",
09-Mar-24,NEFT,00.00,"1,11,910.99","10,07,198.91",
09-Mar-24,Tax,00.00,"1,25,899.86","8,81,299.05",
09-Mar-24,Reversal,00.00,"88,129.91","7,93,169.14",
09-Mar-24,RTGS,"29,389.00",00.00,"8,22,558.14",
09-Mar-24,Debit Card,06.07,00.00,"8,22,564.21",
09-Mar-24,Interest,00.00,"82,256.42","7,40,307.79",
09-Mar-24,RTGS,00.00,"3,70,153.90","3,70,153.90",
09-Mar-24,Transfer,00.00,"41,128.21","3,29,025.69",
09-Mar-24,Debit Card,154.8,00.00,"3,29,180.49",
09-Mar-24,Cash,00.00,"1,09,726.83","2,19,453.66",
09-Mar-24,Cash,00.00,"21,945.37","1,97,508.29",
09-Mar-24,Transfer,"1,39,724.72",00.00,"3,37,233.01",
09-Mar-24,Tax,"63,885.00",00.00,"4,01,118.01",
09-Mar-24,Cash,"10,803.00",00.00,"4,11,921.01",
09-Mar-24,Debit Card,"38,382.62",00.00,"4,50,303.63",
09-Mar-24,Reversal,"1,22,075.09",00.00,"5,72,378.72",
09-Mar-24,Purchase,477.24,00.00,"5,72,855.96",
09-Mar-24,Reversal,07.10,00.00,"5,72,863.06",
09-Mar-24,ATM,104,00.00,"5,72,967.06",
09-Mar-24,Reversal,00.00,"95,494.51","4,77,472.55",
09-Mar-24,RTGS,00.00,"47,747.26","4,29,725.30",
09-Mar-24,Reversal,00.00,"85,945.06","3,43,780.24",
09-Mar-24,Transportellaneous,05.80,00.00,"3,43,786.04",
10-Mar-24,Transfer,00.00,"85,946.51","2,57,839.53",
10-Mar-24,Bill,04.00,00.00,"2,57,843.53",
10-Mar-24,Bill,00.00,"1,28,921.77","1,28,921.76",
10-Mar-24,Commission,00.00,"12,892.18","1,16,029.58",
10-Mar-24,NEFT,00.00,"1,16,029.58",00.00,
10-Mar-24,ATM,72,00.00,72,
10-Mar-24,NEFT,00.00,18,54,
10-Mar-24,Transportellaneous,26.6,00.00,80.6,
10-Mar-24,NEFT,00.00,20.15,60.45,
10-Mar-24,Reversal,06.00,00.00,66.45,
10-Mar-24,NEFT,390.6,00.00,457.05,
10-Mar-24,Reversal,00.00,457.05,00.00,
10-Mar-24,Interest,"18,105.90",00.00,"18,105.90",
10-Mar-24,Cheque,00.14,00.00,"18,106.04",
10-Mar-24,Transportellaneous,160,00.00,"18,266.04",
10-Mar-24,Purchase,00.00,"18,266.04",00.00,
10-Mar-24,Reversal,"18,715.00",00.00,"18,715.00",
10-Mar-24,Reversal,00.00,"2,079.44","16,635.56",
10-Mar-24,Commission,04.00,00.00,"16,639.56",
10-Mar-24,Cash,00.00,"2,377.08","14,262.48",
10-Mar-24,Transfer,"24,910.00",00.00,"39,172.48",
10-Mar-24,NEFT,00.00,"5,596.07","33,576.41",
10-Mar-24,Cash,00.00,"3,730.71","29,845.70",
10-Mar-24,IMPS,283.71,00.00,"30,129.41",
10-Mar-24,Cheque,"1,136.47",00.00,"31,265.88",
10-Mar-24,Bill,00.00,"10,421.96","20,843.92",
10-Mar-24,RTGS,31.46,00.00,"20,875.38",
10-Mar-24,Bill,00.00,"4,175.08","16,700.30",
10-Mar-24,Cheque,"12,76,675.75",00.00,"12,93,376.05",
11-Mar-24,IMPS,"18,78,617.50",00.00,"31,71,993.55",
11-Mar-24,Purchase,"1,76,881.16",00.00,"33,48,874.71",
11-Mar-24,Debit Card,"7,10,275.00",00.00,"40,59,149.71",
11-Mar-24,Purchase,"1,42,775.00",00.00,"42,01,924.71",
11-Mar-24,NEFT,"9,30,324.50",00.00,"51,32,249.21",
11-Mar-24,Bill,706,00.00,"51,32,955.21",
11-Mar-24,Transfer,202.41,00.00,"51,33,157.62",
11-Mar-24,ATM,"1,219.00",00.00,"51,34,376.62",
11-Mar-24,Debit Card,00.00,"5,13,437.66","46,20,938.96",
11-Mar-24,IMPS,"27,940.70",00.00,"46,48,879.66",
11-Mar-24,Cheque,00.00,"4,64,887.97","41,83,991.69",
11-Mar-24,ATM,00.00,"5,22,998.96","36,60,992.73",
11-Mar-24,ATM,"6,43,178.50",00.00,"43,04,171.23",
11-Mar-24,Transportellaneous,00.00,"21,52,085.62","21,52,085.62",
11-Mar-24,IMPS,00.00,"3,58,680.94","17,93,404.68",
11-Mar-24,Transportellaneous,00.00,"5,97,801.56","11,95,603.12",
11-Mar-24,Bill,00.00,"2,98,900.78","8,96,702.34",
12-Mar-24,ATM,00.00,"1,28,100.33","7,68,602.01",
12-Mar-24,Purchase,00.00,"7,68,602.01",00.00,
12-Mar-24,ATM,"1,17,720.30",00.00,"1,17,720.30",
12-Mar-24,Cheque,00.00,"11,772.03","1,05,948.27",
12-Mar-24,RTGS,"7,34,040.00",00.00,"8,39,988.27",
12-Mar-24,Bill,03.58,00.00,"8,39,991.85",
12-Mar-24,Transfer,00.00,"2,79,997.28","5,59,994.57",
12-Mar-24,Debit Card,"3,547.60",00.00,"5,63,542.17",
12-Mar-24,Interest,"1,34,015.40",00.00,"6,97,557.57",
12-Mar-24,Debit Card,"17,16,005.00",00.00,"24,13,562.57",
12-Mar-24,Transportellaneous,00.00,"4,82,712.51","19,30,850.06",
12-Mar-24,Reversal,00.00,"2,41,356.26","16,89,493.80",
12-Mar-24,Cash,00.00,"1,87,721.53","15,01,772.27",
12-Mar-24,Transportellaneous,00.00,"2,14,538.90","12,87,233.37",
12-Mar-24,RTGS,00.00,"6,43,616.69","6,43,616.69",
12-Mar-24,NEFT,00.00,"1,60,904.17","4,82,712.52",
12-Mar-24,Tax,00.00,"1,60,904.17","3,21,808.35",
12-Mar-24,Tax,32,00.00,"3,21,840.35",
13-Mar-24,Transportellaneous,00.00,"80,460.09","2,41,380.26",
13-Mar-24,Interest,00.00,"80,460.09","1,60,920.17",
13-Mar-24,Cheque,57,00.00,"1,60,977.17",
13-Mar-24,Transportellaneous,00.00,"80,488.59","80,488.59",
13-Mar-24,Bill,"6,168.53",00.00,"86,657.12",
13-Mar-24,Tax,00.00,"43,328.56","43,328.56",
13-Mar-24,Cheque,461.5,00.00,"43,790.06",
13-Mar-24,ATM,"1,65,378.00",00.00,"2,09,168.06",
13-Mar-24,ATM,"3,617.54",00.00,"2,12,785.60",
13-Mar-24,Cheque,"8,26,050.50",00.00,"10,38,836.10",
13-Mar-24,IMPS,06.00,00.00,"10,38,842.10",
13-Mar-24,ATM,00.00,"5,19,421.05","5,19,421.05",
14-Mar-24,Commission,52.2,00.00,"5,19,473.25",
14-Mar-24,Purchase,00.00,"74,210.46","4,45,262.79",
14-Mar-24,Cash,348.93,00.00,"4,45,611.72",
14-Mar-24,ATM,00.00,"4,45,611.72",00.00,
14-Mar-24,Reversal,"62,427.00",00.00,"62,427.00",
14-Mar-24,RTGS,00.00,"20,809.00","41,618.00",
14-Mar-24,Cheque,"2,249.00",00.00,"43,867.00",
14-Mar-24,Commission,61.9,00.00,"43,928.90",
14-Mar-24,Transportellaneous,"1,91,157.70",00.00,"2,35,086.60",
14-Mar-24,Cheque,00.00,"33,583.80","2,01,502.80",
15-Mar-24,Cheque,00.00,"1,00,751.40","1,00,751.40",
15-Mar-24,NEFT,352.7,00.00,"1,01,104.10",
15-Mar-24,NEFT,357,00.00,"1,01,461.10",
15-Mar-24,Transfer,08.00,00.00,"1,01,469.10",
15-Mar-24,Cash,00.00,"12,683.64","88,785.46",
15-Mar-24,Transfer,"1,306.90",00.00,"90,092.36",
15-Mar-24,Transfer,00.00,"10,010.26","80,082.10",
15-Mar-24,Reversal,00.00,"80,082.10",00.00,
15-Mar-24,Transfer,"2,54,295.20",00.00,"2,54,295.20",
15-Mar-24,Debit Card,00.00,"25,429.52","2,28,865.68",
15-Mar-24,Transfer,"2,18,557.00",00.00,"4,47,422.68",
15-Mar-24,Interest,00.00,"63,917.53","3,83,505.15",
15-Mar-24,Transportellaneous,00.00,"47,938.14","3,35,567.01",
15-Mar-24,Debit Card,00.00,"1,67,783.51","1,67,783.50",
15-Mar-24,ATM,234.95,00.00,"1,68,018.45",
15-Mar-24,Tax,01.80,00.00,"1,68,020.25",
15-Mar-24,NEFT,00.00,"56,006.75","1,12,013.50",
15-Mar-24,Cheque,00.00,"28,003.38","84,010.12",
15-Mar-24,Cheque,00.00,"16,802.02","67,208.10",
15-Mar-24,Debit Card,"15,92,602.50",00.00,"16,59,810.60",
15-Mar-24,NEFT,01.19,00.00,"16,59,811.79",
15-Mar-24,Debit Card,00.00,"2,76,635.30","13,83,176.49",
15-Mar-24,Debit Card,00.00,"1,38,317.65","12,44,858.84",
15-Mar-24,Bill,00.00,"2,07,476.47","10,37,382.37",
15-Mar-24,Debit Card,"7,362.00",00.00,"10,44,744.37",
15-Mar-24,NEFT,00.00,"1,49,249.20","8,95,495.17",
15-Mar-24,Purchase,44.05,00.00,"8,95,539.22",
15-Mar-24,Reversal,"1,910.97",00.00,"8,97,450.19",
15-Mar-24,IMPS,425.53,00.00,"8,97,875.72",
15-Mar-24,Commission,08.00,00.00,"8,97,883.72",
15-Mar-24,RTGS,"31,819.10",00.00,"9,29,702.82",
15-Mar-24,Commission,00.00,"1,16,212.85","8,13,489.97",
15-Mar-24,ATM,00.00,"2,03,372.49","6,10,117.48",
15-Mar-24,RTGS,58.6,00.00,"6,10,176.08",
15-Mar-24,Commission,00.00,"67,797.34","5,42,378.74",
15-Mar-24,Commission,00.00,"2,71,189.37","2,71,189.37",
15-Mar-24,Cash,00.00,"27,118.94","2,44,070.43",
15-Mar-24,RTGS,00.00,"1,22,035.22","1,22,035.22",
15-Mar-24,NEFT,00.00,"20,339.20","1,01,696.02",
15-Mar-24,Transfer,00.00,"11,299.56","90,396.46",
15-Mar-24,IMPS,"11,30,577.00",00.00,"12,20,973.46",
15-Mar-24,RTGS,"1,820.02",00.00,"12,22,793.48",
15-Mar-24,RTGS,203,00.00,"12,22,996.48",
15-Mar-24,Debit Card,00.00,"2,44,599.30","9,78,397.18",
15-Mar-24,Commission,00.00,"1,08,710.80","8,69,686.38",
15-Mar-24,Purchase,00.00,"86,968.64","7,82,717.74",
15-Mar-24,Commission,00.00,"86,968.64","6,95,749.10",
15-Mar-24,Reversal,"2,60,783.00",00.00,"9,56,532.10",
15-Mar-24,Purchase,00.00,"1,36,647.44","8,19,884.66",
15-Mar-24,IMPS,06.18,00.00,"8,19,890.84",
15-Mar-24,RTGS,"9,373.07",00.00,"8,29,263.91",
15-Mar-24,NEFT,628,00.00,"8,29,891.91",
15-Mar-24,Cash,15.09,00.00,"8,29,907.00",
15-Mar-24,Commission,262.88,00.00,"8,30,169.88",
15-Mar-24,Bill,00.00,"2,07,542.47","6,22,627.41",
15-Mar-24,RTGS,00.00,"77,828.43","5,44,798.98",
15-Mar-24,ATM,232.46,00.00,"5,45,031.44",
15-Mar-24,Purchase,00.00,"77,861.63","4,67,169.81",
15-Mar-24,Transportellaneous,00.00,"77,861.64","3,89,308.18",
15-Mar-24,Transportellaneous,00.00,"77,861.64","3,11,446.54",
15-Mar-24,Cheque,00.00,"31,144.65","2,80,301.89",
15-Mar-24,NEFT,00.00,"93,433.96","1,86,867.93",
15-Mar-24,IMPS,"1,88,155.72",00.00,"3,75,023.65",
15-Mar-24,Cheque,00.00,"41,669.29","3,33,354.36",
15-Mar-24,Reversal,00.87,00.00,"3,33,355.23",
15-Mar-24,Purchase,"1,021.00",00.00,"3,34,376.23",
15-Mar-24,NEFT,"16,741.30",00.00,"3,51,117.53",
15-Mar-24,Transportellaneous,"1,56,020.00",00.00,"5,07,137.53",
15-Mar-24,Transportellaneous,"4,276.10",00.00,"5,11,413.63",
15-Mar-24,Cheque,00.00,"51,141.36","4,60,272.27",
15-Mar-24,Debit Card,"19,18,819.80",00.00,"23,79,092.07",
15-Mar-24,IMPS,"70,903.00",00.00,"24,49,995.07",
16-Mar-24,IMPS,00.00,"3,06,249.38","21,43,745.69",
16-Mar-24,NEFT,00.00,"2,67,968.21","18,75,777.48",
16-Mar-24,Cheque,00.00,"2,34,472.19","16,41,305.30",
16-Mar-24,Purchase,"1,138.00",00.00,"16,42,443.30",
16-Mar-24,Purchase,00.00,"8,21,221.65","8,21,221.65",
16-Mar-24,Commission,"13,064.00",00.00,"8,34,285.65",
16-Mar-24,ATM,00.00,"4,17,142.83","4,17,142.82",
16-Mar-24,Transportellaneous,00.00,"1,39,047.61","2,78,095.21",
16-Mar-24,Interest,00.00,"30,899.47","2,47,195.74",
16-Mar-24,Reversal,"22,622.40",00.00,"2,69,818.14",
16-Mar-24,ATM,00.00,"2,69,818.14",00.00,
16-Mar-24,Debit Card,167,00.00,167,
16-Mar-24,Bill,45.94,00.00,212.94,
16-Mar-24,Cheque,00.00,23.66,189.28,
16-Mar-24,Transfer,00.00,21.03,168.25,
16-Mar-24,Transportellaneous,73,00.00,241.25,
16-Mar-24,Cash,00.00,30.16,211.09,
16-Mar-24,Tax,466.49,00.00,677.58,
16-Mar-24,Transportellaneous,293,00.00,970.58,
16-Mar-24,Cash,00.00,107.84,862.74,
16-Mar-24,Transportellaneous,"13,51,096.25",00.00,"13,51,958.99",
16-Mar-24,Transportellaneous,"2,461.20",00.00,"13,54,420.19",
16-Mar-24,Cash,00.00,"1,69,302.52","11,85,117.67",
16-Mar-24,Tax,"2,16,463.00",00.00,"14,01,580.67",
16-Mar-24,Commission,00.00,"1,40,158.07","12,61,422.60",
16-Mar-24,ATM,00.00,"2,52,284.52","10,09,138.08",
16-Mar-24,RTGS,289.71,00.00,"10,09,427.79",
16-Mar-24,NEFT,00.00,"5,04,713.90","5,04,713.90",
16-Mar-24,Reversal,"1,91,902.25",00.00,"6,96,616.15",
16-Mar-24,Tax,"14,401.25",00.00,"7,11,017.40",
16-Mar-24,NEFT,00.00,"88,877.18","6,22,140.22",
16-Mar-24,Tax,118.7,00.00,"6,22,258.92",
16-Mar-24,Reversal,00.00,"2,07,419.64","4,14,839.28",
16-Mar-24,Cash,"18,606.90",00.00,"4,33,446.18",
16-Mar-24,Purchase,00.00,"61,920.88","3,71,525.30",
16-Mar-24,Commission,00.00,"37,152.53","3,34,372.77",
16-Mar-24,Reversal,28.56,00.00,"3,34,401.33",
16-Mar-24,Tax,"63,896.75",00.00,"3,98,298.08",
16-Mar-24,Transfer,03.21,00.00,"3,98,301.29",
16-Mar-24,Tax,"19,360.60",00.00,"4,17,661.89",
16-Mar-24,Tax,04.90,00.00,"4,17,666.79",
16-Mar-24,IMPS,00.00,"46,407.42","3,71,259.37",
16-Mar-24,Cheque,00.00,"61,876.56","3,09,382.81",
16-Mar-24,Purchase,00.00,"3,09,382.81",00.00,
16-Mar-24,RTGS,"90,525.28",00.00,"90,525.28",
16-Mar-24,Tax,00.00,"45,262.64","45,262.64",
16-Mar-24,Cheque,09.70,00.00,"45,272.34",
16-Mar-24,Commission,00.00,"11,318.09","33,954.25",
16-Mar-24,Cash,00.00,"11,318.08","22,636.17",
16-Mar-24,Cash,"1,575.00",00.00,"24,211.17",
16-Mar-24,Debit Card,"16,573.00",00.00,"40,784.17",
16-Mar-24,Debit Card,03.80,00.00,"40,787.97",
16-Mar-24,Commission,05.40,00.00,"40,793.37",
16-Mar-24,Tax,"2,748.60",00.00,"43,541.97",
16-Mar-24,NEFT,46.45,00.00,"43,588.42",
16-Mar-24,NEFT,00.00,"10,897.11","32,691.32",
16-Mar-24,Commission,"2,11,902.00",00.00,"2,44,593.32",
16-Mar-24,ATM,"4,94,173.00",00.00,"7,38,766.32",
16-Mar-24,Debit Card,"23,574.00",00.00,"7,62,340.32",
16-Mar-24,RTGS,"2,800.15",00.00,"7,65,140.47",
16-Mar-24,Transfer,"1,50,215.00",00.00,"9,15,355.47",
16-Mar-24,Transportellaneous,00.00,"2,28,838.87","6,86,516.60",
16-Mar-24,Purchase,00.00,"85,814.58","6,00,702.02",
16-Mar-24,Interest,00.00,"1,20,140.40","4,80,561.62",
16-Mar-24,Bill,477.1,00.00,"4,81,038.72",
16-Mar-24,Purchase,"22,790.30",00.00,"5,03,829.02",
16-Mar-24,Interest,"3,271.00",00.00,"5,07,100.02",
16-Mar-24,Tax,01.90,00.00,"5,07,101.92",
16-Mar-24,RTGS,00.00,"1,01,420.38","4,05,681.54",
16-Mar-24,Reversal,00.00,"1,35,227.18","2,70,454.36",
16-Mar-24,Debit Card,"1,393.80",00.00,"2,71,848.16",
17-Mar-24,Reversal,58.61,00.00,"2,71,906.77",
17-Mar-24,Transportellaneous,"1,76,087.90",00.00,"4,47,994.67",
17-Mar-24,Purchase,62.12,00.00,"4,48,056.79",
17-Mar-24,Interest,00.00,"74,676.13","3,73,380.66",
17-Mar-24,ATM,153.9,00.00,"3,73,534.56",
17-Mar-24,Transportellaneous,"2,27,632.00",00.00,"6,01,166.56",
17-Mar-24,NEFT,194,00.00,"6,01,360.56",
17-Mar-24,Bill,00.00,"6,01,360.56",00.00,
17-Mar-24,Interest,"1,010.00",00.00,"1,010.00",
17-Mar-24,Cheque,"1,187.00",00.00,"2,197.00",
17-Mar-24,Bill,00.00,244.11,"1,952.89",
17-Mar-24,Cash,00.00,976.45,976.44,
17-Mar-24,Commission,00.00,976.44,00.00,
17-Mar-24,IMPS,"25,867.60",00.00,"25,867.60",
17-Mar-24,Debit Card,00.00,"8,622.53","17,245.07",
17-Mar-24,Interest,31.2,00.00,"17,276.27",
17-Mar-24,Tax,00.00,"8,638.14","8,638.14",
17-Mar-24,Bill,"6,25,035.20",00.00,"6,33,673.34",
17-Mar-24,NEFT,00.00,"1,58,418.34","4,75,255.00",
17-Mar-24,Transfer,46,00.00,"4,75,301.00",
17-Mar-24,NEFT,"27,290.60",00.00,"5,02,591.60",
17-Mar-24,Transportellaneous,"6,81,678.00",00.00,"11,84,269.60",
17-Mar-24,Bill,00.00,"1,97,378.27","9,86,891.33",
17-Mar-24,Purchase,00.00,"1,40,984.48","8,45,906.85",
17-Mar-24,NEFT,00.00,"1,20,843.84","7,25,063.01",
17-Mar-24,IMPS,00.00,"1,45,012.60","5,80,050.41",
18-Mar-24,RTGS,"28,414.00",00.00,"6,08,464.41",
18-Mar-24,NEFT,00.00,"6,08,464.41",00.00,
18-Mar-24,Commission,"2,24,655.56",00.00,"2,24,655.56",
18-Mar-24,Debit Card,00.00,"24,961.73","1,99,693.83",
18-Mar-24,NEFT,"25,422.75",00.00,"2,25,116.58",
18-Mar-24,ATM,00.00,"28,139.57","1,96,977.01",
18-Mar-24,ATM,59.21,00.00,"1,97,036.22",
18-Mar-24,Cash,00.00,"24,629.53","1,72,406.69",
18-Mar-24,ATM,"2,18,340.12",00.00,"3,90,746.81",
18-Mar-24,Transfer,00.00,"48,843.35","3,41,903.46",
18-Mar-24,Reversal,00.80,00.00,"3,41,904.26",
18-Mar-24,Bill,00.00,"3,41,904.26",00.00,
18-Mar-24,Interest,"4,933.69",00.00,"4,933.69",
18-Mar-24,IMPS,916,00.00,"5,849.69",
18-Mar-24,Purchase,"1,973.00",00.00,"7,822.69",
18-Mar-24,Cheque,33.88,00.00,"7,856.57",
18-Mar-24,Transportellaneous,05.00,00.00,"7,861.57",
18-Mar-24,Cash,00.00,"3,930.79","3,930.78",
18-Mar-24,Debit Card,03.00,00.00,"3,933.78",
18-Mar-24,IMPS,47.1,00.00,"3,980.88",
18-Mar-24,Cheque,00.00,"3,980.88",00.00,
18-Mar-24,Bill,"3,086.10",00.00,"3,086.10",
18-Mar-24,Tax,00.00,"3,086.10",00.00,
18-Mar-24,Transportellaneous,878.6,00.00,878.6,
18-Mar-24,ATM,331.6,00.00,"1,210.20",
18-Mar-24,Commission,00.00,302.55,907.65,
18-Mar-24,RTGS,00.00,226.91,680.74,
18-Mar-24,Purchase,00.00,680.74,00.00,
18-Mar-24,Purchase,313.2,00.00,313.2,
18-Mar-24,Cheque,"1,225.90",00.00,"1,539.10",
18-Mar-24,Transfer,00.00,256.52,"1,282.58",
18-Mar-24,Commission,"1,56,809.20",00.00,"1,58,091.78",
18-Mar-24,Reversal,00.00,"17,565.75","1,40,526.03",
18-Mar-24,Transportellaneous,63.86,00.00,"1,40,589.89",
18-Mar-24,Cheque,"2,314.42",00.00,"1,42,904.31",
18-Mar-24,Bill,00.00,"23,817.39","1,19,086.92",
18-Mar-24,RTGS,00.00,"17,012.42","1,02,074.50",
18-Mar-24,Transfer,00.00,"1,02,074.50",00.00,
19-Mar-24,Cash,189,00.00,189,
19-Mar-24,Interest,00.00,27,162,
19-Mar-24,Cheque,00.00,81,81,
19-Mar-24,Bill,00.00,08.10,72.9,
19-Mar-24,IMPS,408.2,00.00,481.1,
19-Mar-24,NEFT,"12,60,210.20",00.00,"12,60,691.30",
20-Mar-24,Interest,"64,968.00",00.00,"13,25,659.30",
20-Mar-24,Transportellaneous,00.00,"2,65,131.86","10,60,527.44",
20-Mar-24,Transportellaneous,00.00,"1,17,836.38","9,42,691.06",
20-Mar-24,Debit Card,388,00.00,"9,43,079.06",
20-Mar-24,ATM,00.00,"1,88,615.81","7,54,463.25",
20-Mar-24,Transportellaneous,02.00,00.00,"7,54,465.25",
20-Mar-24,Transportellaneous,"3,93,216.00",00.00,"11,47,681.25",
20-Mar-24,Purchase,00.00,"3,82,560.42","7,65,120.83",
20-Mar-24,NEFT,00.00,"76,512.08","6,88,608.75",
20-Mar-24,Purchase,00.00,"2,29,536.25","4,59,072.50",
20-Mar-24,Reversal,47,00.00,"4,59,119.50",
20-Mar-24,Purchase,"1,260.00",00.00,"4,60,379.50",
20-Mar-24,Interest,390.9,00.00,"4,60,770.40",
20-Mar-24,IMPS,00.00,"1,53,590.13","3,07,180.27",
20-Mar-24,Commission,06.00,00.00,"3,07,186.27",
20-Mar-24,RTGS,00.00,"43,883.75","2,63,302.52",
21-Mar-24,IMPS,00.00,"52,660.50","2,10,642.02",
21-Mar-24,Transportellaneous,24,00.00,"2,10,666.02",
21-Mar-24,Interest,00.00,"2,10,666.02",00.00,
21-Mar-24,Tax,00.80,00.00,00.80,
21-Mar-24,Bill,"89,699.00",00.00,"89,699.80",
21-Mar-24,RTGS,270,00.00,"89,969.80",
21-Mar-24,Debit Card,00.00,"44,984.90","44,984.90",
21-Mar-24,Tax,00.00,"22,492.45","22,492.45",
21-Mar-24,IMPS,"2,052.10",00.00,"24,544.55",
21-Mar-24,IMPS,00.00,"2,454.46","22,090.10",
21-Mar-24,IMPS,00.00,"2,209.01","19,881.09",
21-Mar-24,Commission,00.00,"9,940.55","9,940.54",
21-Mar-24,Transportellaneous,48.12,00.00,"9,988.66",
21-Mar-24,NEFT,55.2,00.00,"10,043.86",
21-Mar-24,NEFT,00.00,"5,021.93","5,021.93",
21-Mar-24,Interest,00.00,"1,255.48","3,766.45",
21-Mar-24,Cheque,00.00,753.29,"3,013.16",
21-Mar-24,ATM,"1,48,141.00",00.00,"1,51,154.16",
21-Mar-24,Interest,00.55,00.00,"1,51,154.71",
21-Mar-24,Cheque,00.00,"18,894.34","1,32,260.37",
21-Mar-24,Cheque,06.30,00.00,"1,32,266.67",
21-Mar-24,Interest,00.00,"33,066.67","99,200.00",
21-Mar-24,Transportellaneous,00.00,"49,600.00","49,600.00",
21-Mar-24,Tax,"4,251.00",00.00,"53,851.00",
21-Mar-24,RTGS,04.60,00.00,"53,855.60",
21-Mar-24,Cash,409.9,00.00,"54,265.50",
21-Mar-24,ATM,00.00,"5,426.55","48,838.95",
21-Mar-24,Debit Card,00.00,"12,209.74","36,629.21",
21-Mar-24,Bill,31,00.00,"36,660.21",
21-Mar-24,IMPS,00.00,"9,165.05","27,495.16",
21-Mar-24,Cheque,44.8,00.00,"27,539.96",
21-Mar-24,Bill,00.00,"3,442.50","24,097.46",
21-Mar-24,Commission,"2,638.00",00.00,"26,735.46",
21-Mar-24,Reversal,"2,644.98",00.00,"29,380.44",
21-Mar-24,ATM,00.00,"3,672.56","25,707.88",
21-Mar-24,Reversal,46.2,00.00,"25,754.08",
21-Mar-24,IMPS,00.00,"12,877.04","12,877.04",
21-Mar-24,Interest,22,00.00,"12,899.04",
21-Mar-24,Interest,"66,480.60",00.00,"79,379.64",
21-Mar-24,Cheque,"13,780.00",00.00,"93,159.64",
21-Mar-24,Purchase,04.30,00.00,"93,163.94",
21-Mar-24,Reversal,19,00.00,"93,182.94",
21-Mar-24,Tax,00.00,"15,530.49","77,652.45",
21-Mar-24,ATM,"2,41,060.00",00.00,"3,18,712.45",
21-Mar-24,RTGS,"1,263.33",00.00,"3,19,975.78",
21-Mar-24,Interest,00.00,"1,06,658.59","2,13,317.19",
21-Mar-24,RTGS,"1,84,315.31",00.00,"3,97,632.50",
21-Mar-24,Tax,"3,750.00",00.00,"4,01,382.50",
21-Mar-24,RTGS,"8,76,532.00",00.00,"12,77,914.50",
21-Mar-24,Transportellaneous,00.00,"4,25,971.50","8,51,943.00",
21-Mar-24,Bill,00.00,"85,194.30","7,66,748.70",
22-Mar-24,Bill,"6,005.00",00.00,"7,72,753.70",
22-Mar-24,IMPS,00.00,"96,594.21","6,76,159.49",
22-Mar-24,Purchase,"2,974.79",00.00,"6,79,134.28",
22-Mar-24,Transportellaneous,00.00,"3,39,567.14","3,39,567.14",
22-Mar-24,RTGS,"1,59,048.20",00.00,"4,98,615.34",
23-Mar-24,Cash,"23,341.66",00.00,"5,21,957.00",
23-Mar-24,Commission,334,00.00,"5,22,291.00",
23-Mar-24,NEFT,00.00,"87,048.50","4,35,242.50",
23-Mar-24,Purchase,02.00,00.00,"4,35,244.50",
23-Mar-24,Purchase,00.00,"72,540.75","3,62,703.75",
24-Mar-24,Purchase,"7,103.89",00.00,"3,69,807.64",
24-Mar-24,Transportellaneous,00.00,"36,980.76","3,32,826.88",
24-Mar-24,Bill,00.00,"3,32,826.88",00.00,
24-Mar-24,Interest,00.68,00.00,00.68,
24-Mar-24,Purchase,07.00,00.00,07.68,
24-Mar-24,ATM,224.4,00.00,232.08,
24-Mar-24,Transportellaneous,00.00,77.36,154.72,
24-Mar-24,Reversal,"32,539.17",00.00,"32,693.89",
24-Mar-24,IMPS,00.00,"16,346.95","16,346.94",
24-Mar-24,Interest,"15,39,548.50",00.00,"15,55,895.44",
24-Mar-24,RTGS,776,00.00,"15,56,671.44",
24-Mar-24,Transportellaneous,29.2,00.00,"15,56,700.64",
24-Mar-24,Cash,00.00,"1,94,587.58","13,62,113.06",
24-Mar-24,ATM,00.00,"1,51,345.90","12,10,767.16",
24-Mar-24,Commission,376.79,00.00,"12,11,143.95",
24-Mar-24,Purchase,38,00.00,"12,11,181.95",
24-Mar-24,Commission,"3,452.00",00.00,"12,14,633.95",
24-Mar-24,Interest,"10,601.00",00.00,"12,25,234.95",
24-Mar-24,Reversal,680.2,00.00,"12,25,915.15",
24-Mar-24,Bill,63,00.00,"12,25,978.15",
24-Mar-24,Commission,"3,69,559.80",00.00,"15,95,537.95",
24-Mar-24,IMPS,09.00,00.00,"15,95,546.95",
24-Mar-24,RTGS,00.00,"1,77,282.99","14,18,263.96",
25-Mar-24,Commission,00.00,"7,09,131.98","7,09,131.98",
25-Mar-24,Debit Card,"63,225.00",00.00,"7,72,356.98",
25-Mar-24,Bill,07.00,00.00,"7,72,363.98",
25-Mar-24,Interest,00.00,"85,818.22","6,86,545.76",
25-Mar-24,Reversal,00.00,"3,43,272.88","3,43,272.88",
25-Mar-24,Tax,00.00,"38,141.43","3,05,131.45",
25-Mar-24,Reversal,00.00,"1,52,565.73","1,52,565.72",
25-Mar-24,Purchase,00.00,"76,282.86","76,282.86",
25-Mar-24,IMPS,00.00,"9,535.36","66,747.50",
25-Mar-24,Interest,"2,917.03",00.00,"69,664.53",
25-Mar-24,ATM,00.00,"9,952.08","59,712.45",
25-Mar-24,ATM,25,00.00,"59,737.45",
25-Mar-24,Reversal,"15,641.00",00.00,"75,378.45",
25-Mar-24,Commission,"1,99,684.00",00.00,"2,75,062.45",
25-Mar-24,Cash,"3,601.20",00.00,"2,78,663.65",
26-Mar-24,Commission,154.67,00.00,"2,78,818.32",
26-Mar-24,Transportellaneous,00.00,"39,831.19","2,38,987.13",
26-Mar-24,Debit Card,00.00,"26,554.13","2,12,433.00",
26-Mar-24,Commission,02.00,00.00,"2,12,435.00",
26-Mar-24,Interest,00.00,"1,06,217.50","1,06,217.50",
26-Mar-24,Debit Card,"3,862.00",00.00,"1,10,079.50",
26-Mar-24,Tax,"1,23,433.80",00.00,"2,33,513.30",
26-Mar-24,Tax,"10,29,520.00",00.00,"12,63,033.30",
26-Mar-24,IMPS,00.00,"3,15,758.33","9,47,274.98",
26-Mar-24,Commission,00.00,"2,36,818.75","7,10,456.24",
26-Mar-24,NEFT,00.00,"1,42,091.25","5,68,364.99",
26-Mar-24,Interest,"1,89,329.00",00.00,"7,57,693.99",
26-Mar-24,Cheque,"3,326.54",00.00,"7,61,020.53",
26-Mar-24,IMPS,00.00,"84,557.84","6,76,462.69",
26-Mar-24,Tax,01.66,00.00,"6,76,464.35",
26-Mar-24,Tax,"10,25,829.50",00.00,"17,02,293.85",
27-Mar-24,RTGS,289.5,00.00,"17,02,583.35",
27-Mar-24,Debit Card,00.00,"2,12,822.92","14,89,760.43",
27-Mar-24,NEFT,"11,59,139.00",00.00,"26,48,899.43",
27-Mar-24,Tax,"2,58,092.06",00.00,"29,06,991.49",
27-Mar-24,Debit Card,111,00.00,"29,07,102.49",
27-Mar-24,Purchase,265.07,00.00,"29,07,367.56",
27-Mar-24,Purchase,00.00,"2,90,736.76","26,16,630.80",
27-Mar-24,Commission,"2,476.00",00.00,"26,19,106.80",
27-Mar-24,Commission,"9,39,803.25",00.00,"35,58,910.05",
28-Mar-24,Interest,"2,07,272.62",00.00,"37,66,182.67",
28-Mar-24,Purchase,00.00,"6,27,697.11","31,38,485.56",
28-Mar-24,Bill,"9,39,190.00",00.00,"40,77,675.56",
28-Mar-24,ATM,"2,121.18",00.00,"40,79,796.74",
28-Mar-24,Transportellaneous,05.00,00.00,"40,79,801.74",
28-Mar-24,Cash,55.45,00.00,"40,79,857.19",
28-Mar-24,Purchase,06.50,00.00,"40,79,863.69",
28-Mar-24,Cheque,00.00,"5,09,982.96","35,69,880.73",
28-Mar-24,NEFT,"26,857.90",00.00,"35,96,738.63",
28-Mar-24,Interest,13,00.00,"35,96,751.63",
28-Mar-24,Tax,00.00,"4,49,593.95","31,47,157.68",
28-Mar-24,Purchase,00.00,"15,73,578.84","15,73,578.84",
28-Mar-24,Transfer,00.00,"1,57,357.88","14,16,220.96",
28-Mar-24,Cash,"17,217.75",00.00,"14,33,438.71",
28-Mar-24,Interest,22.9,00.00,"14,33,461.61",
28-Mar-24,RTGS,268.2,00.00,"14,33,729.81",
28-Mar-24,Transfer,00.00,"3,58,432.45","10,75,297.36",
28-Mar-24,Interest,00.00,"1,34,412.17","9,40,885.19",
28-Mar-24,ATM,41.55,00.00,"9,40,926.74",
28-Mar-24,Cheque,05.00,00.00,"9,40,931.74",
28-Mar-24,Cash,441,00.00,"9,41,372.74",
28-Mar-24,Debit Card,00.00,"9,41,372.74",00.00,
28-Mar-24,Cash,"14,82,365.50",00.00,"14,82,365.50",
28-Mar-24,NEFT,00.00,"1,48,236.55","13,34,128.95",
28-Mar-24,Debit Card,00.00,"4,44,709.65","8,89,419.30",
28-Mar-24,Tax,00.00,"1,11,177.41","7,78,241.89",
28-Mar-24,Transfer,00.00,"1,94,560.47","5,83,681.42",
28-Mar-24,Purchase,00.00,"58,368.14","5,25,313.28",
28-Mar-24,NEFT,"14,45,874.00",00.00,"19,71,187.28",
28-Mar-24,IMPS,00.00,"1,97,118.73","17,74,068.55",
28-Mar-24,Commission,00.00,"2,95,678.09","14,78,390.46",
28-Mar-24,Cheque,00.00,"2,11,198.64","12,67,191.82",
28-Mar-24,Cash,28.1,00.00,"12,67,219.92",
28-Mar-24,Reversal,"2,043.10",00.00,"12,69,263.02",
28-Mar-24,Reversal,697.53,00.00,"12,69,960.55",
28-Mar-24,NEFT,00.00,"6,34,980.28","6,34,980.28",
28-Mar-24,Tax,"2,33,448.00",00.00,"8,68,428.28",
28-Mar-24,Transfer,"2,651.00",00.00,"8,71,079.28",
28-Mar-24,RTGS,00.00,"8,71,079.28",00.00,
28-Mar-24,Bill,"1,390.92",00.00,"1,390.92",
28-Mar-24,Tax,00.00,463.64,927.28,
28-Mar-24,Cheque,03.70,00.00,930.98,
28-Mar-24,Cheque,06.00,00.00,936.98,
28-Mar-24,Interest,"3,048.00",00.00,"3,984.98",
28-Mar-24,ATM,00.00,"3,984.98",00.00,
28-Mar-24,Cash,"11,057.40",00.00,"11,057.40",
28-Mar-24,NEFT,00.00,"5,528.70","5,528.70",
28-Mar-24,Cheque,00.00,552.87,"4,975.83",
28-Mar-24,Reversal,"1,431.02",00.00,"6,406.85",
28-Mar-24,Cheque,00.00,"1,281.37","5,125.48",
29-Mar-24,Transfer,"3,501.00",00.00,"8,626.48",
29-Mar-24,Purchase,"6,09,858.25",00.00,"6,18,484.73",
30-Mar-24,Purchase,00.00,"88,354.96","5,30,129.77",
31-Mar-24,Cheque,00.00,"1,06,025.95","4,24,103.82",
31-Mar-24,ATM,00.00,"70,683.97","3,53,419.85",
31-Mar-24,Interest,00.00,"35,341.99","3,18,077.86",
31-Mar-24,Purchase,00.00,"79,519.47","2,38,558.40",
31-Mar-24,Cheque,00.00,"34,079.77","2,04,478.63",
31-Mar-24,NEFT,00.00,"29,211.23","1,75,267.40",
31-Mar-24,Tax,05.50,00.00,"1,75,272.90",
31-Mar-24,Tax,00.00,"43,818.23","1,31,454.67",
31-Mar-24,Interest,386,00.00,"1,31,840.67",
31-Mar-24,Purchase,07.16,00.00,"1,31,847.83",
31-Mar-24,Debit Card,"1,51,753.40",00.00,"2,83,601.23",
31-Mar-24,NEFT,28.35,00.00,"2,83,629.58",
31-Mar-24,Cash,00.00,"94,543.19","1,89,086.39",
31-Mar-24,Commission,"11,45,190.50",00.00,"13,34,276.89",
31-Mar-24,NEFT,05.09,00.00,"13,34,281.98",
31-Mar-24,Reversal,00.00,"1,48,253.55","11,86,028.43",
31-Mar-24,RTGS,01.03,00.00,"11,86,029.46",
31-Mar-24,Reversal,"48,272.00",00.00,"12,34,301.46",
31-Mar-24,Debit Card,"25,550.00",00.00,"12,59,851.46",
31-Mar-24,Commission,"3,367.00",00.00,"12,63,218.46",
31-Mar-24,Commission,"20,09,887.00",00.00,"32,73,105.46",
31-Mar-24,Reversal,"2,108.95",00.00,"32,75,214.41",
31-Mar-24,Transportellaneous,"3,461.00",00.00,"32,78,675.41",
31-Mar-24,Purchase,"4,646.80",00.00,"32,83,322.21",
31-Mar-24,Cash,"26,101.78",00.00,"33,09,423.99",
31-Mar-24,Transportellaneous,"1,69,138.94",00.00,"34,78,562.93",
31-Mar-24,Commission,"10,88,279.00",00.00,"45,66,841.93",
31-Mar-24,NEFT,00.00,"45,66,841.93",00.00,
01-Apr-24,Transfer,31.25,00.00,31.25,
01-Apr-24,Interest,362,00.00,393.25,
01-Apr-24,ATM,00.00,56.18,337.07,
01-Apr-24,RTGS,00.00,00.00,337.07,
01-Apr-24,ATM,00.00,112.36,224.71,
01-Apr-24,Commission,00.00,28.09,196.62,
01-Apr-24,RTGS,00.00,196.62,00.00,
02-Apr-24,Debit Card,"31,440.36",00.00,"31,440.36",
02-Apr-24,NEFT,"3,908.08",00.00,"35,348.44",
02-Apr-24,ATM,"2,963.20",00.00,"38,311.64",
02-Apr-24,Debit Card,02.00,00.00,"38,313.64",
02-Apr-24,Bill,00.00,"9,578.41","28,735.23",
02-Apr-24,Purchase,00.00,"28,735.23",00.00,
02-Apr-24,Commission,130.2,00.00,130.2,
02-Apr-24,Interest,00.00,13.02,117.18,
02-Apr-24,Reversal,"2,268.40",00.00,"2,385.58",
02-Apr-24,Transportellaneous,00.00,340.8,"2,044.78",
02-Apr-24,Debit Card,00.00,511.2,"1,533.58",
02-Apr-24,Transportellaneous,08.00,00.00,"1,541.58",
02-Apr-24,ATM,00.00,256.93,"1,284.65",
02-Apr-24,Cash,"79,248.00",00.00,"80,532.65",
02-Apr-24,RTGS,00.00,"40,266.33","40,266.32",
02-Apr-24,IMPS,427,00.00,"40,693.32",
02-Apr-24,RTGS,00.00,"20,346.66","20,346.66",
02-Apr-24,Bill,"5,03,606.80",00.00,"5,23,953.46",
02-Apr-24,Tax,00.00,"1,04,790.69","4,19,162.77",
02-Apr-24,Transportellaneous,630.3,00.00,"4,19,793.07",
02-Apr-24,Interest,00.00,"59,970.44","3,59,822.63",
02-Apr-24,Debit Card,"4,442.15",00.00,"3,64,264.78",
02-Apr-24,Purchase,"2,317.00",00.00,"3,66,581.78",
02-Apr-24,RTGS,"17,70,159.00",00.00,"21,36,740.78",
02-Apr-24,Reversal,"8,471.00",00.00,"21,45,211.78",
02-Apr-24,NEFT,00.00,"4,29,042.36","17,16,169.42",
02-Apr-24,NEFT,00.00,"8,58,084.71","8,58,084.71",
02-Apr-24,Transportellaneous,"7,37,138.25",00.00,"15,95,222.96",
02-Apr-24,Transportellaneous,00.00,"1,99,402.87","13,95,820.09",
02-Apr-24,ATM,00.00,"13,95,820.09",00.00,
02-Apr-24,Cheque,"3,026.10",00.00,"3,026.10",
02-Apr-24,IMPS,"6,587.33",00.00,"9,613.43",
02-Apr-24,Bill,45.11,00.00,"9,658.54",
02-Apr-24,Transportellaneous,"1,07,528.34",00.00,"1,17,186.88",
02-Apr-24,Bill,00.00,"39,062.29","78,124.59",
02-Apr-24,Reversal,"10,39,576.25",00.00,"11,17,700.84",
02-Apr-24,Commission,"9,202.00",00.00,"11,26,902.84",
03-Apr-24,Cash,00.00,"1,60,986.12","9,65,916.72",
03-Apr-24,Cash,"1,10,995.44",00.00,"10,76,912.16",
03-Apr-24,Bill,00.00,"2,15,382.43","8,61,529.73",
03-Apr-24,Debit Card,00.00,"1,43,588.29","7,17,941.44",
03-Apr-24,Debit Card,"1,09,713.10",00.00,"8,27,654.54",
03-Apr-24,Bill,02.06,00.00,"8,27,656.60",
03-Apr-24,Transportellaneous,05.79,00.00,"8,27,662.39",
03-Apr-24,RTGS,07.51,00.00,"8,27,669.90",
03-Apr-24,Tax,58.8,00.00,"8,27,728.70",
03-Apr-24,Cheque,"2,210.00",00.00,"8,29,938.70",
03-Apr-24,Cheque,00.00,"2,76,646.23","5,53,292.47",
04-Apr-24,Cash,00.00,"5,53,292.47",00.00,
04-Apr-24,IMPS,"1,901.00",00.00,"1,901.00",
04-Apr-24,IMPS,00.00,237.63,"1,663.38",
04-Apr-24,Purchase,00.00,332.68,"1,330.70",
04-Apr-24,Bill,00.00,190.1,"1,140.60",
05-Apr-24,Cash,00.00,570.3,570.3,
05-Apr-24,Commission,00.00,81.47,488.83,
05-Apr-24,Commission,05.80,00.00,494.63,
05-Apr-24,RTGS,"22,454.30",00.00,"22,948.93",
05-Apr-24,Bill,"5,010.32",00.00,"27,959.25",
05-Apr-24,IMPS,00.00,"3,994.18","23,965.07",
05-Apr-24,RTGS,922.02,00.00,"24,887.09",
05-Apr-24,Interest,00.00,"4,147.85","20,739.24",
05-Apr-24,Transportellaneous,"13,14,343.80",00.00,"13,35,083.04",
05-Apr-24,Interest,00.00,"4,45,027.68","8,90,055.36",
05-Apr-24,Cheque,340.21,00.00,"8,90,395.57",
05-Apr-24,Interest,189,00.00,"8,90,584.57",
05-Apr-24,Transportellaneous,"16,30,298.80",00.00,"25,20,883.37",
05-Apr-24,ATM,492.4,00.00,"25,21,375.77",
05-Apr-24,Purchase,00.00,"25,21,375.77",00.00,
05-Apr-24,Transportellaneous,"6,994.00",00.00,"6,994.00",
05-Apr-24,Debit Card,00.00,"3,497.00","3,497.00",
05-Apr-24,Cheque,01.20,00.00,"3,498.20",
05-Apr-24,Purchase,"17,84,083.00",00.00,"17,87,581.20",
05-Apr-24,Interest,00.80,00.00,"17,87,582.00",
05-Apr-24,Interest,00.00,"5,95,860.67","11,91,721.33",
05-Apr-24,Transportellaneous,48,00.00,"11,91,769.33",
05-Apr-24,Cheque,00.00,"1,19,176.93","10,72,592.40",
05-Apr-24,RTGS,"3,201.64",00.00,"10,75,794.04",
05-Apr-24,Transfer,46.52,00.00,"10,75,840.56",
05-Apr-24,Cash,00.00,"3,58,613.52","7,17,227.04",
05-Apr-24,Transfer,00.00,"89,653.38","6,27,573.66",
05-Apr-24,Cash,00.00,"3,13,786.83","3,13,786.83",
05-Apr-24,Interest,01.30,00.00,"3,13,788.13",
05-Apr-24,Bill,00.00,"44,826.88","2,68,961.25",
06-Apr-24,RTGS,00.00,"67,240.31","2,01,720.94",
06-Apr-24,Commission,06.00,00.00,"2,01,726.94",
06-Apr-24,Commission,00.00,"40,345.39","1,61,381.55",
06-Apr-24,Purchase,"2,910.81",00.00,"1,64,292.36",
06-Apr-24,RTGS,58,00.00,"1,64,350.36",
06-Apr-24,Interest,48,00.00,"1,64,398.36",
06-Apr-24,Interest,00.00,"41,099.59","1,23,298.77",
06-Apr-24,Tax,"1,20,403.00",00.00,"2,43,701.77",
06-Apr-24,Cash,00.00,"24,370.18","2,19,331.59",
06-Apr-24,Bill,00.00,"1,09,665.80","1,09,665.80",
06-Apr-24,Cheque,"2,13,032.00",00.00,"3,22,697.80",
06-Apr-24,RTGS,00.00,"1,61,348.90","1,61,348.90",
06-Apr-24,Cash,00.00,"32,269.78","1,29,079.12",
06-Apr-24,ATM,00.00,"16,134.89","1,12,944.23",
06-Apr-24,Transportellaneous,"3,300.20",00.00,"1,16,244.43",
06-Apr-24,Commission,"13,73,040.00",00.00,"14,89,284.43",
06-Apr-24,Reversal,00.00,"2,12,754.92","12,76,529.51",
06-Apr-24,Reversal,00.00,"4,25,509.84","8,51,019.67",
06-Apr-24,Purchase,00.00,"1,41,836.61","7,09,183.06",
06-Apr-24,RTGS,"3,99,179.50",00.00,"11,08,362.56",
06-Apr-24,NEFT,00.00,"1,10,836.26","9,97,526.30",
06-Apr-24,Cash,00.00,"9,97,526.30",00.00,
06-Apr-24,Bill,"19,74,457.00",00.00,"19,74,457.00",
06-Apr-24,Reversal,298,00.00,"19,74,755.00",
06-Apr-24,Cheque,00.00,"3,94,951.00","15,79,804.00",
06-Apr-24,Reversal,53,00.00,"15,79,857.00",
06-Apr-24,Debit Card,00.00,"3,15,971.40","12,63,885.60",
06-Apr-24,ATM,00.00,"1,40,431.73","11,23,453.87",
07-Apr-24,Reversal,00.00,"5,61,726.94","5,61,726.94",
07-Apr-24,Debit Card,"7,42,795.00",00.00,"13,04,521.94",
07-Apr-24,Purchase,"79,215.80",00.00,"13,83,737.74",
07-Apr-24,Debit Card,"2,22,227.60",00.00,"16,05,965.34",
07-Apr-24,RTGS,00.00,"1,78,440.59","14,27,524.75",
07-Apr-24,Debit Card,00.00,"1,78,440.59","12,49,084.16",
07-Apr-24,NEFT,477.1,00.00,"12,49,561.26",
07-Apr-24,Cash,00.00,"2,49,912.25","9,99,649.01",
07-Apr-24,Cash,"2,72,759.20",00.00,"12,72,408.21",
07-Apr-24,Purchase,954.63,00.00,"12,73,362.84",
07-Apr-24,RTGS,05.70,00.00,"12,73,368.54",
07-Apr-24,Transfer,00.00,"3,18,342.14","9,55,026.40",
07-Apr-24,Tax,00.00,"1,91,005.28","7,64,021.12",
07-Apr-24,NEFT,18,00.00,"7,64,039.12",
07-Apr-24,Cash,00.00,"1,91,009.78","5,73,029.34",
07-Apr-24,Transfer,00.00,"1,43,257.34","4,29,772.00",
07-Apr-24,Cheque,00.00,"4,29,772.00",00.00,
07-Apr-24,Transportellaneous,"1,861.70",00.00,"1,861.70",
07-Apr-24,Tax,00.00,620.57,"1,241.13",
07-Apr-24,Cheque,00.00,"1,241.13",00.00,
07-Apr-24,Tax,"19,988.00",00.00,"19,988.00",
07-Apr-24,NEFT,05.90,00.00,"19,993.90",
07-Apr-24,ATM,00.00,"4,998.48","14,995.42",
07-Apr-24,RTGS,02.00,00.00,"14,997.42",
07-Apr-24,RTGS,255.5,00.00,"15,252.92",
07-Apr-24,Transportellaneous,00.00,"15,252.92",00.00,
07-Apr-24,RTGS,"59,226.09",00.00,"59,226.09",
07-Apr-24,NEFT,00.00,"11,845.22","47,380.87",
07-Apr-24,Interest,495.4,00.00,"47,876.27",
07-Apr-24,RTGS,"17,15,448.00",00.00,"17,63,324.27",
07-Apr-24,Reversal,58.9,00.00,"17,63,383.17",
07-Apr-24,NEFT,00.00,"4,40,845.79","13,22,537.38",
07-Apr-24,Purchase,"50,925.16",00.00,"13,73,462.54",
07-Apr-24,Cash,02.78,00.00,"13,73,465.32",
07-Apr-24,RTGS,00.00,"4,57,821.77","9,15,643.55",
07-Apr-24,Commission,"4,772.00",00.00,"9,20,415.55",
07-Apr-24,NEFT,00.00,"1,84,083.11","7,36,332.44",
07-Apr-24,NEFT,03.55,00.00,"7,36,335.99",
07-Apr-24,RTGS,00.00,"2,45,445.33","4,90,890.66",
07-Apr-24,Debit Card,00.00,"81,815.11","4,09,075.55",
07-Apr-24,ATM,00.00,"2,04,537.78","2,04,537.78",
07-Apr-24,RTGS,"2,23,907.12",00.00,"4,28,444.90",
07-Apr-24,Bill,00.00,"4,28,444.90",00.00,
07-Apr-24,Cheque,477,00.00,477,
07-Apr-24,Transportellaneous,112.11,00.00,589.11,
07-Apr-24,RTGS,"25,569.56",00.00,"26,158.67",
07-Apr-24,Bill,"2,32,429.97",00.00,"2,58,588.64",
07-Apr-24,ATM,332.1,00.00,"2,58,920.74",
07-Apr-24,Commission,00.00,"36,988.68","2,21,932.06",
07-Apr-24,RTGS,00.00,"55,483.02","1,66,449.04",
07-Apr-24,Transportellaneous,"17,73,730.75",00.00,"19,40,179.79",
07-Apr-24,Interest,"19,67,136.50",00.00,"39,07,316.29",
07-Apr-24,Tax,52,00.00,"39,07,368.29",
07-Apr-24,Transportellaneous,02.00,00.00,"39,07,370.29",
07-Apr-24,Cheque,03.00,00.00,"39,07,373.29",
07-Apr-24,Interest,00.00,"19,53,686.65","19,53,686.64",
07-Apr-24,Transfer,01.70,00.00,"19,53,688.34",
07-Apr-24,Transfer,"2,50,240.60",00.00,"22,03,928.94",
08-Apr-24,Transfer,00.00,"2,44,880.99","19,59,047.95",
08-Apr-24,Interest,"1,36,430.80",00.00,"20,95,478.75",
08-Apr-24,Interest,"1,051.60",00.00,"20,96,530.35",
08-Apr-24,Transfer,00.00,"3,49,421.73","17,47,108.62",
08-Apr-24,Commission,"26,432.00",00.00,"17,73,540.62",
08-Apr-24,NEFT,"4,50,706.00",00.00,"22,24,246.62",
08-Apr-24,Bill,00.00,"3,70,707.77","18,53,538.85",
08-Apr-24,Transfer,"28,964.90",00.00,"18,82,503.75",
08-Apr-24,NEFT,00.00,"2,68,929.11","16,13,574.64",
08-Apr-24,NEFT,18,00.00,"16,13,592.64",
08-Apr-24,Bill,"2,246.07",00.00,"16,15,838.71",
08-Apr-24,Debit Card,"2,013.14",00.00,"16,17,851.85",
08-Apr-24,Debit Card,142.8,00.00,"16,17,994.65",
08-Apr-24,Bill,"19,65,479.50",00.00,"35,83,474.15",
08-Apr-24,Tax,47.8,00.00,"35,83,521.95",
08-Apr-24,Cash,"14,81,969.00",00.00,"50,65,490.95",
08-Apr-24,Interest,678,00.00,"50,66,168.95",
08-Apr-24,Tax,"1,78,594.00",00.00,"52,44,762.95",
08-Apr-24,Transportellaneous,"45,773.00",00.00,"52,90,535.95",
08-Apr-24,Transfer,"11,637.00",00.00,"53,02,172.95",
08-Apr-24,Purchase,00.00,"17,67,390.98","35,34,781.97",
08-Apr-24,Commission,431.58,00.00,"35,35,213.55",
08-Apr-24,RTGS,00.00,00.00,"35,35,213.55",
09-Apr-24,Interest,01.73,00.00,"35,35,215.28",
09-Apr-24,Purchase,183,00.00,"35,35,398.28",
09-Apr-24,Tax,00.20,00.00,"35,35,398.48",
09-Apr-24,Bill,"1,890.90",00.00,"35,37,289.38",
09-Apr-24,Bill,00.00,"5,89,548.23","29,47,741.15",
09-Apr-24,Commission,00.00,"5,89,548.23","23,58,192.92",
09-Apr-24,Cheque,00.00,"3,36,884.70","20,21,308.22",
09-Apr-24,Bill,00.00,"2,24,589.80","17,96,718.42",
09-Apr-24,RTGS,"14,879.45",00.00,"18,11,597.87",
09-Apr-24,Transfer,"12,38,784.80",00.00,"30,50,382.67",
09-Apr-24,Debit Card,00.00,"6,10,076.53","24,40,306.14",
09-Apr-24,Transportellaneous,00.00,"24,40,306.14",00.00,
09-Apr-24,NEFT,"2,683.00",00.00,"2,683.00",
09-Apr-24,Reversal,"28,988.00",00.00,"31,671.00",
09-Apr-24,Cheque,"98,685.20",00.00,"1,30,356.20",
09-Apr-24,Transportellaneous,00.00,"1,30,356.20",00.00,
09-Apr-24,Purchase,"2,927.50",00.00,"2,927.50",
09-Apr-24,Interest,28.1,00.00,"2,955.60",
09-Apr-24,IMPS,00.00,"2,955.60",00.00,
09-Apr-24,NEFT,"7,87,484.25",00.00,"7,87,484.25",
09-Apr-24,IMPS,"14,20,574.00",00.00,"22,08,058.25",
09-Apr-24,Cheque,331.32,00.00,"22,08,389.57",
09-Apr-24,RTGS,881.5,00.00,"22,09,271.07",
09-Apr-24,Purchase,00.00,"3,15,610.15","18,93,660.92",
09-Apr-24,Cheque,"11,33,769.00",00.00,"30,27,429.92",
09-Apr-24,Interest,00.00,"3,78,428.74","26,49,001.18",
09-Apr-24,Purchase,00.00,"4,41,500.20","22,07,500.98",
09-Apr-24,Cash,"6,752.30",00.00,"22,14,253.28",
09-Apr-24,Bill,06.04,00.00,"22,14,259.32",
09-Apr-24,Reversal,"7,542.50",00.00,"22,21,801.82",
09-Apr-24,Cash,"2,700.30",00.00,"22,24,502.12",
09-Apr-24,Tax,00.00,"2,47,166.90","19,77,335.22",
09-Apr-24,IMPS,46,00.00,"19,77,381.22",
09-Apr-24,Cheque,00.00,"3,29,563.54","16,47,817.68",
09-Apr-24,Purchase,346.41,00.00,"16,48,164.09",
09-Apr-24,ATM,"18,95,528.00",00.00,"35,43,692.09",
09-Apr-24,Transfer,00.00,"8,85,923.02","26,57,769.07",
09-Apr-24,Cheque,"6,98,533.80",00.00,"33,56,302.87",
09-Apr-24,ATM,00.00,"6,71,260.57","26,85,042.30",
09-Apr-24,Transportellaneous,11,00.00,"26,85,053.30",
09-Apr-24,Transfer,"6,50,165.00",00.00,"33,35,218.30",
09-Apr-24,Debit Card,00.00,"16,67,609.15","16,67,609.15",
09-Apr-24,ATM,36.76,00.00,"16,67,645.91",
09-Apr-24,Transportellaneous,00.00,"8,33,822.96","8,33,822.96",
09-Apr-24,Reversal,"32,734.00",00.00,"8,66,556.96",
09-Apr-24,Tax,"18,98,027.80",00.00,"27,64,584.76",
09-Apr-24,NEFT,"2,192.00",00.00,"27,66,776.76",
09-Apr-24,ATM,26.5,00.00,"27,66,803.26",
09-Apr-24,Transportellaneous,00.00,"4,61,133.88","23,05,669.38",
09-Apr-24,Bill,"7,343.00",00.00,"23,13,012.38",
09-Apr-24,Tax,00.00,"23,13,012.38",00.00,
09-Apr-24,Cheque,575.35,00.00,575.35,
09-Apr-24,Bill,00.00,71.92,503.43,
09-Apr-24,Transportellaneous,00.00,251.72,251.72,
09-Apr-24,Purchase,00.00,125.86,125.86,
09-Apr-24,Purchase,00.00,20.98,104.88,
09-Apr-24,ATM,06.80,00.00,111.68,
09-Apr-24,IMPS,00.00,18.61,93.07,
09-Apr-24,Cash,"2,56,202.00",00.00,"2,56,295.07",
09-Apr-24,ATM,"1,36,947.28",00.00,"3,93,242.35",
09-Apr-24,Transfer,00.00,"49,155.29","3,44,087.06",
09-Apr-24,Cash,04.02,00.00,"3,44,091.08",
09-Apr-24,Transportellaneous,00.00,"38,232.34","3,05,858.74",
09-Apr-24,ATM,"2,35,840.00",00.00,"5,41,698.74",
09-Apr-24,Debit Card,05.22,00.00,"5,41,703.96",
09-Apr-24,Cash,00.00,"2,70,851.98","2,70,851.98",
09-Apr-24,Cheque,06.90,00.00,"2,70,858.88",
09-Apr-24,NEFT,00.00,"1,35,429.44","1,35,429.44",
09-Apr-24,Transportellaneous,00.00,"33,857.36","1,01,572.08",
09-Apr-24,Interest,00.00,"14,510.30","87,061.78",
09-Apr-24,Commission,"9,016.10",00.00,"96,077.88",
09-Apr-24,Reversal,469.41,00.00,"96,547.29",
09-Apr-24,Cash,"8,926.00",00.00,"1,05,473.29",
09-Apr-24,IMPS,00.00,"26,368.32","79,104.97",
09-Apr-24,Bill,00.00,"79,104.97",00.00,
10-Apr-24,Bill,15.82,00.00,15.82,
10-Apr-24,Interest,"6,14,488.00",00.00,"6,14,503.82",
10-Apr-24,Cheque,"2,530.60",00.00,"6,17,034.42",
10-Apr-24,Interest,28.21,00.00,"6,17,062.63",
10-Apr-24,NEFT,"1,566.90",00.00,"6,18,629.53",
10-Apr-24,Commission,00.00,"2,06,209.84","4,12,419.69",
10-Apr-24,Bill,51,00.00,"4,12,470.69",
10-Apr-24,Debit Card,00.00,"1,37,490.23","2,74,980.46",
10-Apr-24,Bill,"2,37,900.25",00.00,"5,12,880.71",
10-Apr-24,Commission,"15,147.22",00.00,"5,28,027.93",
10-Apr-24,Bill,"10,97,546.00",00.00,"16,25,573.93",
10-Apr-24,RTGS,00.00,"2,70,928.99","13,54,644.94",
10-Apr-24,RTGS,00.00,"3,38,661.24","10,15,983.70",
10-Apr-24,Purchase,"5,009.90",00.00,"10,20,993.60",
10-Apr-24,NEFT,00.00,"3,40,331.20","6,80,662.40",
10-Apr-24,Cheque,00.00,"2,26,887.47","4,53,774.93",
10-Apr-24,Transportellaneous,00.00,"90,754.99","3,63,019.94",
10-Apr-24,Transportellaneous,00.25,00.00,"3,63,020.19",
10-Apr-24,Reversal,"3,453.90",00.00,"3,66,474.09",
10-Apr-24,Cheque,10.12,00.00,"3,66,484.21",
10-Apr-24,Reversal,489.72,00.00,"3,66,973.93",
10-Apr-24,Commission,"24,562.73",00.00,"3,91,536.66",
10-Apr-24,NEFT,55,00.00,"3,91,591.66",
10-Apr-24,Cheque,00.00,"3,91,591.66",00.00,
10-Apr-24,Purchase,"9,779.00",00.00,"9,779.00",
10-Apr-24,Cheque,"8,73,274.00",00.00,"8,83,053.00",
10-Apr-24,Purchase,"1,133.00",00.00,"8,84,186.00",
10-Apr-24,Commission,"30,173.43",00.00,"9,14,359.43",
10-Apr-24,Transfer,"27,464.93",00.00,"9,41,824.36",
10-Apr-24,Cash,00.00,"9,41,824.36",00.00,
10-Apr-24,ATM,"3,594.64",00.00,"3,594.64",
10-Apr-24,Debit Card,01.89,00.00,"3,596.53",
10-Apr-24,Tax,00.00,"1,798.27","1,798.26",
10-Apr-24,RTGS,00.00,599.42,"1,198.84",
10-Apr-24,Commission,00.00,149.86,"1,048.98",
10-Apr-24,ATM,54,00.00,"1,102.98",
10-Apr-24,Interest,05.72,00.00,"1,108.70",
10-Apr-24,Transfer,00.00,221.74,886.96,
10-Apr-24,Purchase,"29,552.00",00.00,"30,438.96",
10-Apr-24,Cash,00.00,"10,146.32","20,292.64",
10-Apr-24,Interest,00.00,"20,292.64",00.00,
10-Apr-24,Bill,287.35,00.00,287.35,
10-Apr-24,Interest,00.00,47.89,239.46,
10-Apr-24,Cheque,"3,28,456.00",00.00,"3,28,695.46",
10-Apr-24,Cheque,00.00,"54,782.58","2,73,912.88",
10-Apr-24,Commission,03.40,00.00,"2,73,916.28",
10-Apr-24,NEFT,00.00,"34,239.54","2,39,676.75",
10-Apr-24,ATM,00.00,"23,967.68","2,15,709.08",
11-Apr-24,RTGS,00.00,"43,141.82","1,72,567.26",
11-Apr-24,ATM,26,00.00,"1,72,593.26",
11-Apr-24,Transportellaneous,28,00.00,"1,72,621.26",
11-Apr-24,Purchase,00.00,"43,155.32","1,29,465.94",
11-Apr-24,Cash,"15,78,285.00",00.00,"17,07,750.94",
11-Apr-24,ATM,00.00,"2,13,468.87","14,94,282.07",
11-Apr-24,Cash,00.00,"2,49,047.01","12,45,235.06",
11-Apr-24,IMPS,281,00.00,"12,45,516.06",
11-Apr-24,Interest,00.00,"4,15,172.02","8,30,344.04",
11-Apr-24,NEFT,"5,04,338.00",00.00,"13,34,682.04",
11-Apr-24,ATM,00.00,"1,48,298.00","11,86,384.04",
11-Apr-24,Commission,00.00,"5,93,192.02","5,93,192.02",
11-Apr-24,NEFT,00.00,"84,741.72","5,08,450.30",
11-Apr-24,Tax,"10,83,197.00",00.00,"15,91,647.30",
11-Apr-24,RTGS,00.00,"2,65,274.55","13,26,372.75",
11-Apr-24,Bill,00.00,"4,42,124.25","8,84,248.50",
11-Apr-24,Reversal,04.00,00.00,"8,84,252.50",
11-Apr-24,Transportellaneous,00.00,"1,10,531.56","7,73,720.94",
11-Apr-24,Purchase,00.00,"3,86,860.47","3,86,860.47",
11-Apr-24,Cash,"16,165.10",00.00,"4,03,025.57",
11-Apr-24,RTGS,00.00,"2,01,512.79","2,01,512.78",
12-Apr-24,ATM,07.82,00.00,"2,01,520.60",
12-Apr-24,Cheque,"1,208.00",00.00,"2,02,728.60",
12-Apr-24,ATM,06.70,00.00,"2,02,735.30",
12-Apr-24,ATM,00.00,"28,962.19","1,73,773.11",
12-Apr-24,Commission,06.40,00.00,"1,73,779.51",
12-Apr-24,Debit Card,00.00,"17,377.95","1,56,401.56",
12-Apr-24,Debit Card,00.00,"22,343.08","1,34,058.48",
12-Apr-24,Cheque,00.00,"67,029.24","67,029.24",
12-Apr-24,Commission,44.22,00.00,"67,073.46",
12-Apr-24,Cheque,00.00,"8,384.18","58,689.28",
12-Apr-24,Bill,00.00,"58,689.28",00.00,
12-Apr-24,RTGS,"8,08,290.00",00.00,"8,08,290.00",
12-Apr-24,Purchase,00.00,"1,15,470.00","6,92,820.00",
12-Apr-24,Purchase,00.00,"86,602.50","6,06,217.50",
12-Apr-24,Debit Card,00.00,"3,03,108.75","3,03,108.75",
13-Apr-24,RTGS,00.00,"3,03,108.75",00.00,
13-Apr-24,Transportellaneous,"14,753.48",00.00,"14,753.48",
13-Apr-24,Bill,"17,47,250.75",00.00,"17,62,004.23",
13-Apr-24,RTGS,00.00,"1,76,200.42","15,85,803.81",
13-Apr-24,Tax,"1,31,801.00",00.00,"17,17,604.81",
13-Apr-24,Debit Card,00.00,"2,86,267.47","14,31,337.34",
13-Apr-24,RTGS,00.00,"4,77,112.45","9,54,224.89",
13-Apr-24,Purchase,"21,000.18",00.00,"9,75,225.07",
13-Apr-24,NEFT,02.00,00.00,"9,75,227.07",
13-Apr-24,Cheque,00.00,"3,25,075.69","6,50,151.38",
13-Apr-24,Transfer,"32,070.00",00.00,"6,82,221.38",
13-Apr-24,Tax,"3,761.00",00.00,"6,85,982.38",
13-Apr-24,Transportellaneous,705,00.00,"6,86,687.38",
13-Apr-24,Reversal,"1,541.40",00.00,"6,88,228.78",
13-Apr-24,Cheque,00.00,"1,37,645.76","5,50,583.02",
13-Apr-24,Cheque,"2,94,049.50",00.00,"8,44,632.52",
13-Apr-24,Debit Card,"9,92,913.25",00.00,"18,37,545.77",
13-Apr-24,ATM,00.00,"3,06,257.63","15,31,288.14",
13-Apr-24,Transfer,00.00,"1,91,411.02","13,39,877.12",
13-Apr-24,Cash,00.00,"1,67,484.64","11,72,392.48",
13-Apr-24,Interest,00.00,"1,46,549.06","10,25,843.42",
13-Apr-24,Debit Card,00.00,"1,02,584.34","9,23,259.08",
13-Apr-24,RTGS,00.00,"1,84,651.82","7,38,607.26",
13-Apr-24,IMPS,00.00,"82,067.47","6,56,539.79",
13-Apr-24,NEFT,"17,54,679.25",00.00,"24,11,219.04",
13-Apr-24,IMPS,00.00,"3,44,459.86","20,66,759.18",
13-Apr-24,RTGS,57,00.00,"20,66,816.18",
13-Apr-24,Cheque,00.00,"10,33,408.09","10,33,408.09",
13-Apr-24,Interest,00.00,"1,03,340.81","9,30,067.28",
13-Apr-24,Tax,00.00,"2,32,516.82","6,97,550.46",
13-Apr-24,NEFT,06.00,00.00,"6,97,556.46",
13-Apr-24,Purchase,00.00,"1,74,389.12","5,23,167.34",
13-Apr-24,Transportellaneous,00.00,"87,194.56","4,35,972.78",
13-Apr-24,Commission,"2,269.10",00.00,"4,38,241.88",
13-Apr-24,Purchase,00.00,"73,040.31","3,65,201.57",
13-Apr-24,IMPS,00.82,00.00,"3,65,202.39",
13-Apr-24,Transfer,00.00,"52,171.77","3,13,030.62",
13-Apr-24,Purchase,11.3,00.00,"3,13,041.92",
13-Apr-24,Debit Card,"27,203.72",00.00,"3,40,245.64",
13-Apr-24,Reversal,00.00,"1,13,415.21","2,26,830.43",
14-Apr-24,Commission,"42,656.40",00.00,"2,69,486.83",
14-Apr-24,IMPS,95,00.00,"2,69,581.83",
14-Apr-24,Purchase,"1,710.26",00.00,"2,71,292.09",
14-Apr-24,Debit Card,"4,367.50",00.00,"2,75,659.59",
14-Apr-24,Bill,"17,92,838.25",00.00,"20,68,497.84",
14-Apr-24,Transportellaneous,00.00,"2,06,849.78","18,61,648.06",
14-Apr-24,Debit Card,25.14,00.00,"18,61,673.20",
14-Apr-24,Transportellaneous,04.30,00.00,"18,61,677.50",
14-Apr-24,Purchase,00.00,"4,65,419.38","13,96,258.12",
14-Apr-24,Tax,446.6,00.00,"13,96,704.72",
14-Apr-24,Debit Card,07.50,00.00,"13,96,712.22",
14-Apr-24,Bill,408.7,00.00,"13,97,120.92",
14-Apr-24,Cheque,00.00,"13,97,120.92",00.00,
14-Apr-24,NEFT,350.4,00.00,350.4,
14-Apr-24,Bill,00.00,38.93,311.47,
14-Apr-24,RTGS,260.7,00.00,572.17,
14-Apr-24,IMPS,00.00,190.72,381.45,
14-Apr-24,Transfer,00.00,190.73,190.72,
14-Apr-24,ATM,00.00,190.72,00.00,
14-Apr-24,NEFT,"19,99,370.50",00.00,"19,99,370.50",
14-Apr-24,Cheque,00.00,"1,99,937.05","17,99,433.45",
14-Apr-24,Cash,"1,26,948.00",00.00,"19,26,381.45",
14-Apr-24,Reversal,00.00,"2,14,042.38","17,12,339.07",
14-Apr-24,Bill,"13,01,669.50",00.00,"30,14,008.57",
14-Apr-24,Purchase,"20,030.66",00.00,"30,34,039.23",
14-Apr-24,Bill,00.00,"3,37,115.47","26,96,923.76",
14-Apr-24,Transportellaneous,"1,849.00",00.00,"26,98,772.76",
14-Apr-24,Tax,360,00.00,"26,99,132.76",
14-Apr-24,Purchase,"6,29,752.00",00.00,"33,28,884.76",
14-Apr-24,ATM,06.00,00.00,"33,28,890.76",
15-Apr-24,Reversal,00.00,"11,09,630.25","22,19,260.51",
15-Apr-24,Purchase,00.00,"3,69,876.75","18,49,383.76",
15-Apr-24,Bill,"9,538.00",00.00,"18,58,921.76",
15-Apr-24,Debit Card,"2,44,056.62",00.00,"21,02,978.38",
15-Apr-24,Interest,00.00,"4,20,595.68","16,82,382.70",
15-Apr-24,Interest,"1,06,311.00",00.00,"17,88,693.70",
15-Apr-24,Tax,00.00,"4,47,173.43","13,41,520.27",
15-Apr-24,Transportellaneous,"5,58,224.00",00.00,"18,99,744.27",
15-Apr-24,Purchase,"3,348.00",00.00,"19,03,092.27",
15-Apr-24,Commission,00.00,"3,80,618.45","15,22,473.82",
15-Apr-24,RTGS,00.00,"2,17,496.26","13,04,977.56",
15-Apr-24,RTGS,"1,99,423.00",00.00,"15,04,400.56",
15-Apr-24,Debit Card,00.00,"2,14,914.37","12,89,486.19",
15-Apr-24,Tax,"21,744.20",00.00,"13,11,230.39",
15-Apr-24,Transportellaneous,00.00,"3,27,807.60","9,83,422.79",
15-Apr-24,Cheque,"3,416.50",00.00,"9,86,839.29",
15-Apr-24,Debit Card,441,00.00,"9,87,280.29",
15-Apr-24,NEFT,"86,284.94",00.00,"10,73,565.23",
15-Apr-24,Debit Card,00.00,"3,57,855.08","7,15,710.15",
15-Apr-24,Tax,00.00,"79,523.35","6,36,186.80",
15-Apr-24,Cheque,"2,42,615.00",00.00,"8,78,801.80",
15-Apr-24,Transportellaneous,00.00,"2,19,700.45","6,59,101.35",
15-Apr-24,Cheque,04.00,00.00,"6,59,105.35",
15-Apr-24,Cash,"13,85,468.00",00.00,"20,44,573.35",
15-Apr-24,ATM,00.00,"2,27,174.82","18,17,398.53",
15-Apr-24,Transfer,"16,59,901.50",00.00,"34,77,300.03",
15-Apr-24,Transportellaneous,21,00.00,"34,77,321.03",
15-Apr-24,Cheque,00.00,"34,77,321.03",00.00,
15-Apr-24,Tax,"1,032.70",00.00,"1,032.70",
15-Apr-24,Debit Card,33.34,00.00,"1,066.04",
15-Apr-24,Transfer,00.00,266.51,799.53,
15-Apr-24,Commission,"3,43,410.00",00.00,"3,44,209.53",
15-Apr-24,RTGS,00.00,"86,052.38","2,58,157.15",
15-Apr-24,ATM,"2,223.00",00.00,"2,60,380.15",
15-Apr-24,RTGS,00.00,"65,095.04","1,95,285.11",
15-Apr-24,IMPS,02.30,00.00,"1,95,287.41",
15-Apr-24,IMPS,"20,86,848.80",00.00,"22,82,136.21",
15-Apr-24,ATM,00.00,"3,80,356.04","19,01,780.18",
15-Apr-24,Reversal,"73,870.80",00.00,"19,75,650.98",
15-Apr-24,Bill,00.10,00.00,"19,75,651.08",
15-Apr-24,Transfer,00.00,"3,95,130.22","15,80,520.86",
15-Apr-24,Cash,00.00,"2,63,420.14","13,17,100.72",
15-Apr-24,Purchase,380,00.00,"13,17,480.72",
15-Apr-24,NEFT,00.00,"1,31,748.07","11,85,732.65",
15-Apr-24,Interest,"15,27,942.75",00.00,"27,13,675.40",
15-Apr-24,IMPS,490.2,00.00,"27,14,165.60",
15-Apr-24,ATM,"6,69,916.20",00.00,"33,84,081.80",
16-Apr-24,NEFT,497.93,00.00,"33,84,579.73",
16-Apr-24,Transfer,00.00,"11,28,193.24","22,56,386.49",
17-Apr-24,Purchase,"21,943.94",00.00,"22,78,330.43",
17-Apr-24,NEFT,04.65,00.00,"22,78,335.08",
17-Apr-24,Cheque,35,00.00,"22,78,370.08",
17-Apr-24,Interest,00.00,"7,59,456.69","15,18,913.39",
17-Apr-24,Transportellaneous,00.00,"1,51,891.34","13,67,022.05",
17-Apr-24,Bill,00.59,00.00,"13,67,022.64",
17-Apr-24,RTGS,"2,712.40",00.00,"13,69,735.04",
17-Apr-24,Transfer,"1,227.19",00.00,"13,70,962.23",
17-Apr-24,RTGS,04.68,00.00,"13,70,966.91",
17-Apr-24,Transportellaneous,295,00.00,"13,71,261.91",
18-Apr-24,Transportellaneous,"2,30,391.90",00.00,"16,01,653.81",
18-Apr-24,Cash,00.00,"2,00,206.73","14,01,447.08",
18-Apr-24,Bill,155.5,00.00,"14,01,602.58",
18-Apr-24,Debit Card,00.00,"2,80,320.52","11,21,282.06",
18-Apr-24,ATM,00.00,"11,21,282.06",00.00,
18-Apr-24,Interest,14.39,00.00,14.39,
18-Apr-24,Tax,00.00,01.80,12.59,
18-Apr-24,Debit Card,40,00.00,52.59,
18-Apr-24,Bill,"2,59,406.62",00.00,"2,59,459.21",
18-Apr-24,ATM,00.00,"64,864.80","1,94,594.41",
18-Apr-24,IMPS,"1,07,485.00",00.00,"3,02,079.41",
18-Apr-24,Transportellaneous,"1,37,889.80",00.00,"4,39,969.21",
18-Apr-24,Interest,00.00,"43,996.92","3,95,972.29",
18-Apr-24,NEFT,00.00,"39,597.23","3,56,375.06",
18-Apr-24,Purchase,00.00,"50,910.72","3,05,464.34",
18-Apr-24,Bill,00.00,"76,366.09","2,29,098.26",
18-Apr-24,Reversal,00.00,"1,14,549.13","1,14,549.13",
18-Apr-24,Commission,00.00,"12,727.68","1,01,821.45",
18-Apr-24,IMPS,"3,754.37",00.00,"1,05,575.82",
18-Apr-24,RTGS,00.00,"13,196.98","92,378.84",
18-Apr-24,Purchase,00.00,"30,792.95","61,585.89",
18-Apr-24,Commission,52,00.00,"61,637.89",
18-Apr-24,Transportellaneous,00.00,"10,272.98","51,364.91",
18-Apr-24,Bill,07.46,00.00,"51,372.37",
18-Apr-24,Reversal,00.00,"5,137.24","46,235.13",
19-Apr-24,Transportellaneous,00.00,"5,137.24","41,097.89",
19-Apr-24,Reversal,05.40,00.00,"41,103.29",
19-Apr-24,Cash,"15,39,162.20",00.00,"15,80,265.49",
19-Apr-24,IMPS,15.29,00.00,"15,80,280.78",
20-Apr-24,Transportellaneous,00.00,"7,90,140.39","7,90,140.39",
20-Apr-24,Reversal,48,00.00,"7,90,188.39",
20-Apr-24,NEFT,00.00,"7,90,188.39",00.00,
20-Apr-24,Transportellaneous,"5,190.00",00.00,"5,190.00",
20-Apr-24,Transportellaneous,"2,404.80",00.00,"7,594.80",
20-Apr-24,Commission,"26,287.63",00.00,"33,882.43",
20-Apr-24,Interest,00.00,"8,470.61","25,411.82",
20-Apr-24,Cheque,"52,836.00",00.00,"78,247.82",
20-Apr-24,IMPS,311,00.00,"78,558.82",
20-Apr-24,Tax,00.00,"39,279.41","39,279.41",
20-Apr-24,NEFT,970,00.00,"40,249.41",
20-Apr-24,Interest,"16,85,069.00",00.00,"17,25,318.41",
20-Apr-24,Cheque,00.00,"4,31,329.60","12,93,988.81",
20-Apr-24,Reversal,41,00.00,"12,94,029.81",
20-Apr-24,Tax,"25,910.60",00.00,"13,19,940.41",
20-Apr-24,Cheque,00.00,"1,46,660.05","11,73,280.36",
20-Apr-24,Cheque,"64,448.47",00.00,"12,37,728.83",
20-Apr-24,Reversal,04.60,00.00,"12,37,733.43",
21-Apr-24,RTGS,15.58,00.00,"12,37,749.01",
21-Apr-24,Transfer,"6,214.05",00.00,"12,43,963.06",
21-Apr-24,Transportellaneous,00.00,"1,77,709.01","10,66,254.05",
21-Apr-24,IMPS,"3,295.00",00.00,"10,69,549.05",
21-Apr-24,Bill,00.00,"2,67,387.26","8,02,161.79",
21-Apr-24,Tax,00.00,"4,01,080.90","4,01,080.90",
21-Apr-24,IMPS,00.00,"1,33,693.63","2,67,387.27",
21-Apr-24,ATM,00.00,"66,846.82","2,00,540.45",
21-Apr-24,Commission,350,00.00,"2,00,890.45",
22-Apr-24,Transportellaneous,00.00,"22,321.16","1,78,569.29",
22-Apr-24,Purchase,205,00.00,"1,78,774.29",
22-Apr-24,Tax,"3,01,930.50",00.00,"4,80,704.79",
22-Apr-24,ATM,"2,07,134.00",00.00,"6,87,838.79",
22-Apr-24,Interest,00.00,"3,43,919.40","3,43,919.40",
22-Apr-24,Commission,00.00,"34,391.94","3,09,527.46",
22-Apr-24,Commission,"9,536.69",00.00,"3,19,064.15",
22-Apr-24,Interest,801.33,00.00,"3,19,865.48",
22-Apr-24,Reversal,05.00,00.00,"3,19,870.48",
22-Apr-24,Transportellaneous,04.97,00.00,"3,19,875.45",
22-Apr-24,Cash,"2,00,968.00",00.00,"5,20,843.45",
22-Apr-24,Purchase,07.10,00.00,"5,20,850.55",
22-Apr-24,ATM,00.00,"1,30,212.64","3,90,637.91",
22-Apr-24,Transfer,00.00,"1,30,212.64","2,60,425.27",
22-Apr-24,Transportellaneous,118.1,00.00,"2,60,543.37",
23-Apr-24,Interest,04.58,00.00,"2,60,547.95",
23-Apr-24,Cash,00.00,"52,109.59","2,08,438.36",
23-Apr-24,Purchase,"21,272.10",00.00,"2,29,710.46",
23-Apr-24,Purchase,"58,262.00",00.00,"2,87,972.46",
23-Apr-24,Interest,422.89,00.00,"2,88,395.35",
23-Apr-24,NEFT,03.59,00.00,"2,88,398.94",
23-Apr-24,Debit Card,00.00,"28,839.89","2,59,559.05",
23-Apr-24,Debit Card,00.00,"25,955.91","2,33,603.14",
23-Apr-24,Interest,00.00,"46,720.63","1,86,882.51",
23-Apr-24,Cash,00.00,"23,360.31","1,63,522.20",
23-Apr-24,Transfer,00.00,"1,63,522.20",00.00,
23-Apr-24,ATM,34.1,00.00,34.1,
23-Apr-24,NEFT,502,00.00,536.1,
23-Apr-24,RTGS,00.00,134.03,402.08,
23-Apr-24,Cash,00.00,134.03,268.05,
23-Apr-24,ATM,"14,903.12",00.00,"15,171.17",
24-Apr-24,Interest,00.00,"1,896.40","13,274.77",
24-Apr-24,Transfer,00.00,"1,327.48","11,947.29",
24-Apr-24,ATM,00.00,"1,706.76","10,240.53",
24-Apr-24,Reversal,00.00,"5,120.27","5,120.27",
24-Apr-24,Commission,63.48,00.00,"5,183.75",
24-Apr-24,Purchase,"2,47,644.00",00.00,"2,52,827.75",
24-Apr-24,IMPS,"14,41,703.75",00.00,"16,94,531.50",
24-Apr-24,Debit Card,"51,244.00",00.00,"17,45,775.50",
24-Apr-24,Transfer,00.00,"2,18,221.94","15,27,553.56",
24-Apr-24,RTGS,00.00,"1,52,755.36","13,74,798.20",
24-Apr-24,NEFT,290.1,00.00,"13,75,088.30",
24-Apr-24,ATM,"3,878.00",00.00,"13,78,966.30",
24-Apr-24,NEFT,00.00,"1,72,370.79","12,06,595.51",
24-Apr-24,IMPS,02.00,00.00,"12,06,597.51",
24-Apr-24,Bill,00.00,"1,34,066.39","10,72,531.12",
24-Apr-24,NEFT,"29,901.80",00.00,"11,02,432.92",
24-Apr-24,NEFT,"27,338.30",00.00,"11,29,771.22",
24-Apr-24,RTGS,00.00,"1,41,221.40","9,88,549.82",
24-Apr-24,Purchase,00.00,"9,88,549.82",00.00,
24-Apr-24,Cheque,"83,005.80",00.00,"83,005.80",
24-Apr-24,Transportellaneous,"1,563.40",00.00,"84,569.20",
24-Apr-24,ATM,00.00,"16,913.84","67,655.36",
24-Apr-24,IMPS,"3,386.10",00.00,"71,041.46",
24-Apr-24,ATM,"2,402.00",00.00,"73,443.46",
24-Apr-24,ATM,"2,23,159.20",00.00,"2,96,602.66",
24-Apr-24,Reversal,00.00,"42,371.81","2,54,230.85",
24-Apr-24,Interest,"3,032.50",00.00,"2,57,263.35",
24-Apr-24,Tax,436.4,00.00,"2,57,699.75",
24-Apr-24,NEFT,145,00.00,"2,57,844.75",
24-Apr-24,Tax,41.49,00.00,"2,57,886.24",
24-Apr-24,Tax,44.64,00.00,"2,57,930.88",
25-Apr-24,Bill,00.00,"51,586.18","2,06,344.70",
25-Apr-24,Transfer,00.00,"25,793.09","1,80,551.61",
25-Apr-24,Interest,00.80,00.00,"1,80,552.41",
25-Apr-24,Tax,214,00.00,"1,80,766.41",
25-Apr-24,Cash,00.00,"36,153.28","1,44,613.13",
25-Apr-24,Reversal,00.00,"1,44,613.13",00.00,
25-Apr-24,IMPS,"30,160.81",00.00,"30,160.81",
25-Apr-24,NEFT,00.00,"3,016.08","27,144.73",
25-Apr-24,Bill,00.00,"2,714.47","24,430.26",
25-Apr-24,Transportellaneous,07.00,00.00,"24,437.26",
25-Apr-24,Cash,00.00,"24,437.26",00.00,
25-Apr-24,Purchase,01.00,00.00,01.00,
25-Apr-24,Transportellaneous,380.47,00.00,381.47,
25-Apr-24,Interest,05.00,00.00,386.47,
25-Apr-24,ATM,"2,983.83",00.00,"3,370.30",
25-Apr-24,Commission,00.00,"1,123.43","2,246.87",
25-Apr-24,Cash,"3,702.40",00.00,"5,949.27",
25-Apr-24,Purchase,00.00,743.66,"5,205.61",
25-Apr-24,Bill,197,00.00,"5,402.61",
25-Apr-24,Interest,02.63,00.00,"5,405.24",
25-Apr-24,NEFT,00.00,"1,801.75","3,603.49",
26-Apr-24,Cheque,"4,36,078.25",00.00,"4,39,681.74",
26-Apr-24,Bill,00.00,"54,960.22","3,84,721.52",
27-Apr-24,NEFT,"21,485.18",00.00,"4,06,206.70",
27-Apr-24,Tax,00.00,"1,35,402.23","2,70,804.47",
27-Apr-24,Interest,"20,074.20",00.00,"2,90,878.67",
28-Apr-24,Cheque,"1,34,753.38",00.00,"4,25,632.05",
28-Apr-24,Reversal,234.8,00.00,"4,25,866.85",
28-Apr-24,RTGS,"1,34,340.00",00.00,"5,60,206.85",
28-Apr-24,NEFT,00.00,"5,60,206.85",00.00,
28-Apr-24,Transportellaneous,56,00.00,56,
28-Apr-24,Transfer,"1,041.70",00.00,"1,097.70",
28-Apr-24,Debit Card,00.00,548.85,548.85,
28-Apr-24,RTGS,"28,044.00",00.00,"28,592.85",
28-Apr-24,Transportellaneous,00.00,"2,859.29","25,733.56",
28-Apr-24,Commission,00.00,"6,433.39","19,300.17",
29-Apr-24,Transportellaneous,"2,905.22",00.00,"22,205.39",
29-Apr-24,Debit Card,"17,44,570.00",00.00,"17,66,775.39",
29-Apr-24,Transportellaneous,152.6,00.00,"17,66,927.99",
30-Apr-24,Cash,00.00,"2,94,488.00","14,72,439.99",
30-Apr-24,Reversal,00.00,"7,36,220.00","7,36,220.00",
30-Apr-24,Debit Card,00.00,"1,84,055.00","5,52,165.00",
30-Apr-24,Purchase,00.00,"1,10,433.00","4,41,732.00",
30-Apr-24,Tax,"3,99,882.75",00.00,"8,41,614.75",
30-Apr-24,Cash,00.00,"84,161.48","7,57,453.28",
30-Apr-24,Bill,00.00,"1,51,490.66","6,05,962.62",
30-Apr-24,Bill,"14,074.00",00.00,"6,20,036.62",
30-Apr-24,IMPS,00.00,"3,10,018.31","3,10,018.31",
30-Apr-24,Debit Card,"31,288.55",00.00,"3,41,306.86",
30-Apr-24,Cash,00.00,"1,70,653.43","1,70,653.43",
30-Apr-24,Purchase,00.00,"85,326.72","85,326.72",
30-Apr-24,Reversal,01.53,00.00,"85,328.25",
30-Apr-24,Commission,00.00,"12,189.75","73,138.50",
30-Apr-24,Commission,03.50,00.00,"73,142.00",
30-Apr-24,Debit Card,"2,45,583.00",00.00,"3,18,725.00",
30-Apr-24,Commission,00.00,"1,59,362.50","1,59,362.50",
30-Apr-24,RTGS,"12,17,209.50",00.00,"13,76,572.00",
30-Apr-24,Transportellaneous,59,00.00,"13,76,631.00",
30-Apr-24,Commission,00.00,"4,58,877.00","9,17,754.00",
30-Apr-24,Cheque,61.6,00.00,"9,17,815.60",
30-Apr-24,NEFT,00.00,"3,05,938.53","6,11,877.07",
30-Apr-24,ATM,56.21,00.00,"6,11,933.28",
30-Apr-24,Cheque,00.00,"76,491.66","5,35,441.62",
30-Apr-24,Transfer,00.00,"76,491.66","4,58,949.96",
30-Apr-24,Tax,"7,767.24",00.00,"4,66,717.20",
30-Apr-24,Reversal,05.73,00.00,"4,66,722.93",
30-Apr-24,IMPS,02.10,00.00,"4,66,725.03",
30-Apr-24,ATM,169.5,00.00,"4,66,894.53",
30-Apr-24,ATM,00.00,"58,361.82","4,08,532.71",
30-Apr-24,RTGS,00.00,"40,853.27","3,67,679.44",
30-Apr-24,Cheque,00.00,00.00,"3,67,679.44",
30-Apr-24,RTGS,00.00,"1,83,839.72","1,83,839.72",
30-Apr-24,Interest,"13,278.00",00.00,"1,97,117.72",
30-Apr-24,Purchase,00.00,"21,901.97","1,75,215.75",
30-Apr-24,Bill,00.00,"1,75,215.75",00.00,
30-Apr-24,NEFT,"96,836.00",00.00,"96,836.00",
30-Apr-24,IMPS,"9,254.50",00.00,"1,06,090.50",
30-Apr-24,Tax,06.49,00.00,"1,06,096.99",
30-Apr-24,ATM,"3,00,378.00",00.00,"4,06,474.99",
30-Apr-24,Transfer,"91,390.70",00.00,"4,97,865.69",
30-Apr-24,Cheque,"2,13,743.40",00.00,"7,11,609.09",
30-Apr-24,RTGS,"1,78,603.40",00.00,"8,90,212.49",
30-Apr-24,Debit Card,"15,09,765.00",00.00,"23,99,977.49",
30-Apr-24,Interest,00.00,"4,79,995.50","19,19,981.99",
30-Apr-24,Purchase,"27,039.00",00.00,"19,47,020.99",
30-Apr-24,Reversal,00.00,"2,78,145.86","16,68,875.13",
30-Apr-24,Bill,00.00,"1,85,430.57","14,83,444.56",
30-Apr-24,Bill,"36,911.47",00.00,"15,20,356.03",
30-Apr-24,Debit Card,"14,680.27",00.00,"15,35,036.30",
30-Apr-24,Bill,"31,440.16",00.00,"15,66,476.46",
30-Apr-24,Commission,"9,43,803.00",00.00,"25,10,279.46",
30-Apr-24,NEFT,"7,470.75",00.00,"25,17,750.21",
30-Apr-24,Transportellaneous,00.00,"2,79,750.02","22,38,000.19",
30-Apr-24,Bill,481.69,00.00,"22,38,481.88",
30-Apr-24,Reversal,00.00,"2,23,848.19","20,14,633.69",
30-Apr-24,RTGS,"15,88,609.80",00.00,"36,03,243.49",
30-Apr-24,Commission,"17,485.00",00.00,"36,20,728.49",
30-Apr-24,Reversal,00.00,"18,10,364.25","18,10,364.24",
30-Apr-24,Interest,07.00,00.00,"18,10,371.24",
30-Apr-24,Tax,"32,698.00",00.00,"18,43,069.24",
30-Apr-24,Cheque,00.00,"4,60,767.31","13,82,301.93",
30-Apr-24,Purchase,02.00,00.00,"13,82,303.93",
30-Apr-24,Bill,399,00.00,"13,82,702.93",
30-Apr-24,ATM,"13,58,855.75",00.00,"27,41,558.68",
30-Apr-24,Transfer,"18,106.96",00.00,"27,59,665.64",
30-Apr-24,Interest,07.74,00.00,"27,59,673.38",
30-Apr-24,NEFT,"1,66,036.88",00.00,"29,25,710.26",
30-Apr-24,Debit Card,00.00,"5,85,142.05","23,40,568.21",
30-Apr-24,RTGS,00.00,"2,60,063.13","20,80,505.08",
30-Apr-24,Tax,31.87,00.00,"20,80,536.95",
30-Apr-24,Commission,"2,538.10",00.00,"20,83,075.05",
30-Apr-24,Purchase,00.00,"3,47,179.18","17,35,895.88",
30-Apr-24,Debit Card,00.00,"5,78,631.96","11,57,263.92",
01-May-24,Bill,"3,15,635.00",00.00,"14,72,898.92",
01-May-24,Transfer,"30,229.50",00.00,"15,03,128.42",
01-May-24,Cheque,"2,916.00",00.00,"15,06,044.42",
01-May-24,Debit Card,32.34,00.00,"15,06,076.76",
01-May-24,Debit Card,"16,98,102.00",00.00,"32,04,178.76",
01-May-24,Commission,"47,237.00",00.00,"32,51,415.76",
01-May-24,RTGS,"1,216.30",00.00,"32,52,632.06",
01-May-24,Bill,"2,304.70",00.00,"32,54,936.76",
01-May-24,RTGS,224.26,00.00,"32,55,161.02",
01-May-24,Reversal,00.00,"3,25,516.10","29,29,644.92",
01-May-24,Cheque,21.13,00.00,"29,29,666.05",
01-May-24,ATM,00.00,"29,29,666.05",00.00,
01-May-24,Cash,"2,358.80",00.00,"2,358.80",
01-May-24,Transfer,00.00,589.7,"1,769.10",
01-May-24,NEFT,835.3,00.00,"2,604.40",
01-May-24,IMPS,48.9,00.00,"2,653.30",
01-May-24,IMPS,00.00,294.81,"2,358.49",
01-May-24,Commission,00.00,589.62,"1,768.87",
01-May-24,Transfer,70.8,00.00,"1,839.67",
01-May-24,Debit Card,00.00,613.22,"1,226.45",
01-May-24,Debit Card,"9,08,418.25",00.00,"9,09,644.70",
01-May-24,Debit Card,"8,00,660.00",00.00,"17,10,304.70",
01-May-24,Cash,00.00,"2,44,329.24","14,65,975.46",
01-May-24,IMPS,"84,418.69",00.00,"15,50,394.15",
01-May-24,RTGS,"13,09,157.25",00.00,"28,59,551.40",
01-May-24,IMPS,"27,706.00",00.00,"28,87,257.40",
01-May-24,Cheque,13,00.00,"28,87,270.40",
01-May-24,Purchase,00.00,"7,21,817.60","21,65,452.80",
01-May-24,IMPS,00.00,"7,21,817.60","14,43,635.20",
01-May-24,ATM,00.00,"2,06,233.60","12,37,401.60",
01-May-24,Tax,00.00,"2,47,480.32","9,89,921.28",
01-May-24,Transportellaneous,494,00.00,"9,90,415.28",
01-May-24,Purchase,00.00,"3,30,138.43","6,60,276.85",
01-May-24,Transfer,00.00,"1,32,055.37","5,28,221.48",
01-May-24,Bill,00.00,"58,691.28","4,69,530.20",
01-May-24,IMPS,00.00,"78,255.03","3,91,275.17",
02-May-24,NEFT,00.00,"1,30,425.06","2,60,850.11",
02-May-24,Cash,00.00,"32,606.26","2,28,243.85",
02-May-24,Debit Card,"1,620.00",00.00,"2,29,863.85",
02-May-24,Purchase,00.00,"32,837.69","1,97,026.16",
02-May-24,IMPS,"1,62,614.20",00.00,"3,59,640.36",
02-May-24,Tax,04.49,00.00,"3,59,644.85",
02-May-24,NEFT,"1,81,675.80",00.00,"5,41,320.65",
02-May-24,Interest,"2,299.74",00.00,"5,43,620.39",
02-May-24,ATM,"14,02,932.00",00.00,"19,46,552.39",
02-May-24,NEFT,"2,682.73",00.00,"19,49,235.12",
02-May-24,Transfer,399,00.00,"19,49,634.12",
02-May-24,Debit Card,00.00,"2,78,519.16","16,71,114.96",
02-May-24,Transportellaneous,00.00,"2,38,730.71","14,32,384.25",
02-May-24,Cash,"1,64,932.10",00.00,"15,97,316.35",
02-May-24,Transportellaneous,257,00.00,"15,97,573.35",
02-May-24,ATM,00.00,"7,98,786.68","7,98,786.68",
02-May-24,Transfer,"67,619.28",00.00,"8,66,405.96",
02-May-24,RTGS,00.00,"1,44,400.99","7,22,004.97",
02-May-24,Interest,"68,151.75",00.00,"7,90,156.72",
02-May-24,Bill,"1,21,518.00",00.00,"9,11,674.72",
02-May-24,Tax,"2,129.74",00.00,"9,13,804.46",
02-May-24,Bill,00.00,"1,82,760.89","7,31,043.57",
02-May-24,Interest,"1,525.00",00.00,"7,32,568.57",
02-May-24,NEFT,36,00.00,"7,32,604.57",
02-May-24,Purchase,"2,28,496.00",00.00,"9,61,100.57",
02-May-24,Cheque,"28,199.50",00.00,"9,89,300.07",
03-May-24,ATM,00.00,"1,09,922.23","8,79,377.84",
03-May-24,NEFT,386,00.00,"8,79,763.84",
03-May-24,Transfer,00.00,"97,751.54","7,82,012.30",
03-May-24,Reversal,00.00,"3,91,006.15","3,91,006.15",
03-May-24,Cheque,00.00,"55,858.02","3,35,148.13",
03-May-24,Transportellaneous,00.00,"3,35,148.13",00.00,
03-May-24,Transfer,"21,193.60",00.00,"21,193.60",
03-May-24,ATM,"58,811.00",00.00,"80,004.60",
03-May-24,IMPS,00.00,"40,002.30","40,002.30",
03-May-24,Interest,00.00,"6,667.05","33,335.25",
04-May-24,Transportellaneous,"1,707.64",00.00,"35,042.89",
04-May-24,Transfer,00.00,"3,504.29","31,538.60",
04-May-24,Bill,00.00,"3,504.29","28,034.31",
04-May-24,Cash,11.2,00.00,"28,045.51",
04-May-24,Reversal,62,00.00,"28,107.51",
04-May-24,Cash,291.52,00.00,"28,399.03",
04-May-24,RTGS,00.00,"9,466.34","18,932.69",
04-May-24,Interest,15.7,00.00,"18,948.39",
05-May-24,RTGS,01.40,00.00,"18,949.79",
05-May-24,ATM,00.00,"4,737.45","14,212.34",
05-May-24,Debit Card,430.05,00.00,"14,642.39",
05-May-24,Transfer,00.00,"1,626.93","13,015.46",
05-May-24,Commission,"1,959.00",00.00,"14,974.46",
05-May-24,Cash,00.00,"14,974.46",00.00,
05-May-24,Transfer,"9,45,487.75",00.00,"9,45,487.75",
05-May-24,Cash,00.00,"1,18,185.97","8,27,301.78",
05-May-24,Reversal,00.00,"1,65,460.36","6,61,841.42",
05-May-24,Interest,"9,064.73",00.00,"6,70,906.15",
05-May-24,Transportellaneous,"2,849.26",00.00,"6,73,755.41",
05-May-24,RTGS,16.09,00.00,"6,73,771.50",
05-May-24,Reversal,00.46,00.00,"6,73,771.96",
05-May-24,Debit Card,00.00,"3,36,885.98","3,36,885.98",
05-May-24,Commission,00.00,"56,147.66","2,80,738.32",
05-May-24,Transportellaneous,00.00,"70,184.58","2,10,553.74",
05-May-24,Commission,00.00,"30,079.11","1,80,474.63",
05-May-24,NEFT,00.00,"25,782.09","1,54,692.54",
05-May-24,NEFT,"3,003.00",00.00,"1,57,695.54",
05-May-24,Interest,05.05,00.00,"1,57,700.59",
05-May-24,Debit Card,433.2,00.00,"1,58,133.79",
05-May-24,Transportellaneous,03.40,00.00,"1,58,137.19",
05-May-24,Reversal,00.00,"31,627.44","1,26,509.75",
05-May-24,Reversal,00.00,"14,056.64","1,12,453.11",
05-May-24,Transfer,00.00,"18,742.19","93,710.92",
05-May-24,Tax,00.00,"10,412.32","83,298.60",
05-May-24,Commission,00.00,"13,883.10","69,415.50",
05-May-24,Reversal,"20,672.70",00.00,"90,088.20",
05-May-24,Cheque,14.67,00.00,"90,102.87",
05-May-24,Debit Card,446.2,00.00,"90,549.07",
05-May-24,Cash,02.60,00.00,"90,551.67",
05-May-24,Cheque,"2,316.26",00.00,"92,867.93",
05-May-24,Tax,"6,16,583.20",00.00,"7,09,451.13",
05-May-24,Transportellaneous,00.00,"1,77,362.78","5,32,088.35",
05-May-24,RTGS,58,00.00,"5,32,146.35",
05-May-24,Cash,00.00,"2,66,073.18","2,66,073.18",
05-May-24,Cash,00.00,"29,563.69","2,36,509.49",
05-May-24,Bill,00.00,"33,787.07","2,02,722.42",
05-May-24,Transportellaneous,"22,498.00",00.00,"2,25,220.42",
05-May-24,Bill,"3,534.00",00.00,"2,28,754.42",
05-May-24,Transportellaneous,00.00,"2,28,754.42",00.00,
05-May-24,Purchase,509.8,00.00,509.8,
05-May-24,Cash,476.16,00.00,985.96,
05-May-24,Transportellaneous,"5,181.40",00.00,"6,167.36",
05-May-24,Debit Card,"1,51,350.00",00.00,"1,57,517.36",
05-May-24,NEFT,10,00.00,"1,57,527.36",
05-May-24,NEFT,00.00,"52,509.12","1,05,018.24",
05-May-24,Bill,00.00,"17,503.04","87,515.20",
05-May-24,Bill,00.00,"29,171.73","58,343.47",
05-May-24,Cheque,"16,72,381.00",00.00,"17,30,724.47",
05-May-24,Transportellaneous,00.00,"1,73,072.45","15,57,652.02",
05-May-24,IMPS,00.00,"7,78,826.01","7,78,826.01",
05-May-24,IMPS,00.00,"1,29,804.34","6,49,021.68",
05-May-24,IMPS,"1,45,288.00",00.00,"7,94,309.68",
05-May-24,Cash,06.76,00.00,"7,94,316.44",
05-May-24,Commission,00.00,"1,58,863.29","6,35,453.15",
05-May-24,IMPS,"3,493.20",00.00,"6,38,946.35",
05-May-24,NEFT,03.80,00.00,"6,38,950.15",
05-May-24,Tax,00.00,"1,27,790.03","5,11,160.12",
05-May-24,Transportellaneous,00.00,"73,022.87","4,38,137.25",
05-May-24,Bill,00.00,"2,19,068.63","2,19,068.62",
05-May-24,NEFT,159.37,00.00,"2,19,227.99",
05-May-24,Bill,00.00,"27,403.50","1,91,824.49",
05-May-24,Reversal,17.9,00.00,"1,91,842.39",
05-May-24,ATM,00.00,"23,980.30","1,67,862.09",
05-May-24,Cash,02.59,00.00,"1,67,864.68",
05-May-24,Bill,"1,786.00",00.00,"1,69,650.68",
05-May-24,Transfer,05.00,00.00,"1,69,655.68",
05-May-24,Purchase,"3,451.50",00.00,"1,73,107.18",
05-May-24,Reversal,"1,515.81",00.00,"1,74,622.99",
05-May-24,IMPS,00.00,"34,924.60","1,39,698.39",
05-May-24,Reversal,"20,334.00",00.00,"1,60,032.39",
05-May-24,Tax,00.00,"80,016.20","80,016.20",
05-May-24,Interest,00.00,"20,004.05","60,012.15",
05-May-24,Reversal,00.00,"6,668.02","53,344.13",
05-May-24,NEFT,00.00,"53,344.13",00.00,
06-May-24,Cheque,"47,113.00",00.00,"47,113.00",
06-May-24,Debit Card,44.3,00.00,"47,157.30",
06-May-24,Cash,41.49,00.00,"47,198.79",
06-May-24,Debit Card,501.47,00.00,"47,700.26",
06-May-24,Debit Card,00.00,"6,814.32","40,885.94",
07-May-24,Reversal,00.00,"13,628.65","27,257.29",
07-May-24,Interest,07.90,00.00,"27,265.19",
07-May-24,Tax,00.00,"6,816.30","20,448.89",
07-May-24,RTGS,"1,45,798.00",00.00,"1,66,246.89",
07-May-24,ATM,00.00,"16,624.69","1,49,622.20",
07-May-24,Commission,00.00,"49,874.07","99,748.13",
07-May-24,Debit Card,00.00,"99,748.13",00.00,
07-May-24,Bill,07.94,00.00,07.94,
07-May-24,Interest,00.00,01.99,05.96,
07-May-24,Transportellaneous,"2,070.87",00.00,"2,076.83",
07-May-24,NEFT,00.00,"2,076.83",00.00,
07-May-24,ATM,40,00.00,40,
07-May-24,Purchase,00.00,05.71,34.29,
07-May-24,Commission,"8,05,905.80",00.00,"8,05,940.09",
07-May-24,Interest,"6,188.87",00.00,"8,12,128.96",
07-May-24,Transfer,"49,143.00",00.00,"8,61,271.96",
07-May-24,IMPS,09.00,00.00,"8,61,280.96",
07-May-24,Cash,00.00,"4,30,640.48","4,30,640.48",
07-May-24,Tax,00.00,"2,15,320.24","2,15,320.24",
07-May-24,Reversal,00.00,"2,15,320.24",00.00,
07-May-24,Transfer,104,00.00,104,
07-May-24,Reversal,"2,499.30",00.00,"2,603.30",
07-May-24,Transfer,00.00,325.41,"2,277.89",
07-May-24,Tax,00.00,455.58,"1,822.31",
07-May-24,Cheque,"49,910.88",00.00,"51,733.19",
07-May-24,Debit Card,00.00,"25,866.60","25,866.60",
07-May-24,IMPS,317,00.00,"26,183.60",
07-May-24,Purchase,00.00,"3,740.51","22,443.09",
07-May-24,RTGS,"10,37,634.00",00.00,"10,60,077.09",
07-May-24,Reversal,"12,37,917.80",00.00,"22,97,994.89",
07-May-24,Debit Card,"10,63,140.00",00.00,"33,61,134.89",
07-May-24,NEFT,00.00,"6,72,226.98","26,88,907.91",
07-May-24,Bill,"18,32,045.00",00.00,"45,20,952.91",
07-May-24,Bill,05.10,00.00,"45,20,958.01",
07-May-24,IMPS,00.00,"5,02,328.67","40,18,629.34",
07-May-24,NEFT,04.54,00.00,"40,18,633.88",
07-May-24,ATM,00.00,"5,02,329.24","35,16,304.64",
07-May-24,Interest,00.00,"11,72,101.55","23,44,203.09",
07-May-24,Interest,"9,20,953.50",00.00,"32,65,156.59",
07-May-24,Bill,47.7,00.00,"32,65,204.29",
07-May-24,Tax,00.00,"8,16,301.07","24,48,903.22",
07-May-24,Cash,"6,27,158.80",00.00,"30,76,062.02",
07-May-24,Interest,00.00,"5,12,677.00","25,63,385.02",
07-May-24,Bill,"66,726.00",00.00,"26,30,111.02",
07-May-24,Tax,00.00,"3,75,730.15","22,54,380.87",
07-May-24,Interest,"3,522.58",00.00,"22,57,903.45",
07-May-24,Bill,00.00,"2,82,237.93","19,75,665.52",
07-May-24,Tax,"1,891.70",00.00,"19,77,557.22",
07-May-24,RTGS,00.00,"9,88,778.61","9,88,778.61",
07-May-24,RTGS,"30,372.00",00.00,"10,19,150.61",
07-May-24,Transfer,00.00,"2,03,830.12","8,15,320.49",
07-May-24,NEFT,20,00.00,"8,15,340.49",
07-May-24,Tax,168.8,00.00,"8,15,509.29",
07-May-24,Cash,"16,73,647.75",00.00,"24,89,157.04",
07-May-24,Interest,00.00,"24,89,157.04",00.00,
07-May-24,Commission,"3,429.70",00.00,"3,429.70",
07-May-24,IMPS,01.33,00.00,"3,431.03",
07-May-24,Reversal,00.00,571.84,"2,859.19",
07-May-24,Reversal,05.00,00.00,"2,864.19",
08-May-24,Debit Card,00.00,409.17,"2,455.02",
08-May-24,Cheque,02.48,00.00,"2,457.50",
08-May-24,RTGS,403.04,00.00,"2,860.54",
08-May-24,RTGS,00.00,317.84,"2,542.70",
08-May-24,Tax,"12,584.43",00.00,"15,127.13",
08-May-24,Reversal,00.00,"3,781.78","11,345.35",
08-May-24,Cheque,00.00,"1,620.76","9,724.59",
08-May-24,Debit Card,00.00,"1,389.23","8,335.36",
08-May-24,Cash,00.00,"2,083.84","6,251.52",
08-May-24,Debit Card,01.71,00.00,"6,253.23",
08-May-24,Transportellaneous,"2,03,591.50",00.00,"2,09,844.73",
08-May-24,IMPS,"1,160.00",00.00,"2,11,004.73",
08-May-24,Cheque,"3,537.60",00.00,"2,14,542.33",
09-May-24,Transportellaneous,00.00,"21,454.23","1,93,088.10",
09-May-24,Interest,40.2,00.00,"1,93,128.30",
09-May-24,Transfer,00.00,"21,458.70","1,71,669.60",
09-May-24,Bill,00.00,"19,074.40","1,52,595.20",
09-May-24,Cash,00.00,"15,259.52","1,37,335.68",
09-May-24,Debit Card,"20,25,025.75",00.00,"21,62,361.43",
10-May-24,Cheque,00.00,"3,60,393.57","18,01,967.86",
10-May-24,Transfer,147.43,00.00,"18,02,115.29",
10-May-24,Bill,38.45,00.00,"18,02,153.74",
10-May-24,Bill,00.00,"4,50,538.44","13,51,615.30",
11-May-24,Transportellaneous,"8,776.00",00.00,"13,60,391.30",
11-May-24,IMPS,"24,978.70",00.00,"13,85,370.00",
11-May-24,Bill,"1,85,903.50",00.00,"15,71,273.50",
11-May-24,Purchase,06.43,00.00,"15,71,279.93",
11-May-24,Reversal,64.6,00.00,"15,71,344.53",
11-May-24,Commission,00.00,"1,57,134.45","14,14,210.08",
11-May-24,NEFT,00.00,"14,14,210.08",00.00,
11-May-24,Transportellaneous,"32,075.92",00.00,"32,075.92",
11-May-24,Bill,00.00,"3,207.59","28,868.33",
11-May-24,Tax,00.00,"2,886.83","25,981.50",
11-May-24,Tax,07.00,00.00,"25,988.50",
11-May-24,Reversal,00.00,"2,598.85","23,389.65",
11-May-24,Reversal,00.00,"2,923.71","20,465.94",
11-May-24,Debit Card,"5,60,563.25",00.00,"5,81,029.19",
11-May-24,Purchase,00.00,"1,45,257.30","4,35,771.89",
11-May-24,Cheque,"24,293.01",00.00,"4,60,064.90",
11-May-24,Commission,00.00,"1,53,354.97","3,06,709.93",
11-May-24,Tax,"21,303.80",00.00,"3,28,013.73",
11-May-24,Commission,661,00.00,"3,28,674.73",
11-May-24,ATM,30.2,00.00,"3,28,704.93",
11-May-24,Tax,00.00,"82,176.23","2,46,528.70",
11-May-24,Interest,00.00,"2,46,528.70",00.00,
11-May-24,ATM,"27,437.00",00.00,"27,437.00",
11-May-24,Tax,00.00,"9,145.67","18,291.33",
11-May-24,Reversal,06.00,00.00,"18,297.33",
11-May-24,Reversal,"4,745.44",00.00,"23,042.77",
11-May-24,Purchase,00.00,"4,608.55","18,434.22",
11-May-24,Commission,00.00,"3,686.84","14,747.38",
11-May-24,Transfer,00.00,"4,915.79","9,831.59",
11-May-24,Interest,03.30,00.00,"9,834.89",
11-May-24,Cash,00.00,983.49,"8,851.40",
11-May-24,Bill,00.00,"2,212.85","6,638.55",
11-May-24,Debit Card,"7,95,706.00",00.00,"8,02,344.55",
11-May-24,Transfer,54.08,00.00,"8,02,398.63",
11-May-24,Bill,00.00,"80,239.86","7,22,158.77",
11-May-24,Debit Card,00.00,"1,80,539.69","5,41,619.08",
11-May-24,Cheque,"3,572.42",00.00,"5,45,191.50",
11-May-24,Cash,04.00,00.00,"5,45,195.50",
11-May-24,Bill,320,00.00,"5,45,515.50",
11-May-24,Transfer,01.00,00.00,"5,45,516.50",
11-May-24,ATM,11,00.00,"5,45,527.50",
11-May-24,Reversal,00.00,"1,09,105.50","4,36,422.00",
11-May-24,Transfer,08.00,00.00,"4,36,430.00",
11-May-24,Transportellaneous,60.5,00.00,"4,36,490.50",
11-May-24,Transfer,484.81,00.00,"4,36,975.31",
11-May-24,IMPS,00.00,"48,552.81","3,88,422.50",
12-May-24,ATM,00.00,"48,552.81","3,39,869.69",
12-May-24,NEFT,00.00,"48,552.81","2,91,316.88",
12-May-24,Debit Card,"10,98,854.00",00.00,"13,90,170.88",
12-May-24,Reversal,00.00,"4,63,390.29","9,26,780.59",
12-May-24,Reversal,20,00.00,"9,26,800.59",
12-May-24,IMPS,00.00,"4,63,400.30","4,63,400.30",
12-May-24,Cash,00.00,"92,680.06","3,70,720.24",
12-May-24,Cash,00.00,"1,85,360.12","1,85,360.12",
12-May-24,NEFT,06.00,00.00,"1,85,366.12",
12-May-24,Transfer,57,00.00,"1,85,423.12",
12-May-24,Transfer,00.00,"1,85,423.12",00.00,
12-May-24,NEFT,"3,694.00",00.00,"3,694.00",
12-May-24,Commission,00.00,410.44,"3,283.56",
12-May-24,RTGS,00.00,"3,283.56",00.00,
12-May-24,Debit Card,05.00,00.00,05.00,
12-May-24,Bill,"2,439.00",00.00,"2,444.00",
12-May-24,Interest,"28,700.00",00.00,"31,144.00",
12-May-24,Debit Card,00.00,"6,228.80","24,915.20",
12-May-24,NEFT,00.00,"4,152.53","20,762.67",
12-May-24,Reversal,06.00,00.00,"20,768.67",
12-May-24,RTGS,00.00,"2,966.95","17,801.72",
12-May-24,Reversal,00.00,"5,933.91","11,867.81",
12-May-24,Debit Card,"4,056.09",00.00,"15,923.90",
12-May-24,IMPS,00.00,"5,307.97","10,615.93",
12-May-24,Cheque,04.86,00.00,"10,620.79",
12-May-24,Commission,00.00,"2,124.16","8,496.63",
12-May-24,Bill,00.00,"4,248.32","4,248.31",
12-May-24,Bill,00.00,606.9,"3,641.41",
12-May-24,Commission,00.00,910.35,"2,731.06",
12-May-24,Cash,03.30,00.00,"2,734.36",
12-May-24,Interest,"6,969.00",00.00,"9,703.36",
12-May-24,Cheque,"26,675.60",00.00,"36,378.96",
12-May-24,Commission,00.00,"9,094.74","27,284.22",
12-May-24,Cash,00.00,"9,094.74","18,189.48",
12-May-24,Reversal,"4,38,974.00",00.00,"4,57,163.48",
12-May-24,Bill,417,00.00,"4,57,580.48",
12-May-24,Debit Card,"1,07,155.00",00.00,"5,64,735.48",
12-May-24,Transportellaneous,00.00,"1,12,947.10","4,51,788.38",
12-May-24,RTGS,"6,25,369.50",00.00,"10,77,157.88",
12-May-24,Commission,462.3,00.00,"10,77,620.18",
12-May-24,Commission,250.94,00.00,"10,77,871.12",
12-May-24,Purchase,"1,369.10",00.00,"10,79,240.22",
12-May-24,NEFT,03.00,00.00,"10,79,243.22",
12-May-24,RTGS,55.5,00.00,"10,79,298.72",
12-May-24,Transportellaneous,00.00,"1,19,922.08","9,59,376.64",
12-May-24,Commission,00.00,"1,59,896.11","7,99,480.53",
12-May-24,Debit Card,00.00,"1,59,896.11","6,39,584.42",
12-May-24,Cash,00.00,"1,06,597.40","5,32,987.02",
12-May-24,NEFT,364.05,00.00,"5,33,351.07",
12-May-24,Cheque,00.00,"88,891.85","4,44,459.22",
12-May-24,NEFT,224.1,00.00,"4,44,683.32",
12-May-24,Interest,"10,04,146.25",00.00,"14,48,829.57",
12-May-24,Reversal,409,00.00,"14,49,238.57",
12-May-24,Purchase,915,00.00,"14,50,153.57",
12-May-24,Commission,14.7,00.00,"14,50,168.27",
12-May-24,IMPS,00.00,"14,50,168.27",00.00,
12-May-24,Cash,48.57,00.00,48.57,
12-May-24,ATM,00.00,48.57,00.00,
12-May-24,Cash,"17,975.00",00.00,"17,975.00",
12-May-24,RTGS,00.00,"2,995.83","14,979.17",
12-May-24,Transportellaneous,357,00.00,"15,336.17",
12-May-24,Transportellaneous,"32,418.70",00.00,"47,754.87",
12-May-24,Interest,00.00,"15,918.29","31,836.58",
12-May-24,Debit Card,"4,004.00",00.00,"35,840.58",
12-May-24,Transportellaneous,00.00,"5,120.08","30,720.50",
12-May-24,NEFT,"34,033.09",00.00,"64,753.59",
12-May-24,Interest,00.38,00.00,"64,753.97",
12-May-24,Commission,"46,840.00",00.00,"1,11,593.97",
12-May-24,IMPS,00.00,"37,197.99","74,395.98",
12-May-24,Reversal,00.00,"24,798.66","49,597.32",
12-May-24,RTGS,05.00,00.00,"49,602.32",
12-May-24,Bill,08.00,00.00,"49,610.32",
12-May-24,Tax,"15,88,443.00",00.00,"16,38,053.32",
12-May-24,Transportellaneous,"10,105.00",00.00,"16,48,158.32",
12-May-24,IMPS,00.00,"2,74,693.05","13,73,465.27",
12-May-24,ATM,"25,896.60",00.00,"13,99,361.87",
12-May-24,Tax,00.00,"4,66,453.96","9,32,907.91",
12-May-24,Interest,"2,813.30",00.00,"9,35,721.21",
12-May-24,Commission,"2,002.00",00.00,"9,37,723.21",
12-May-24,Reversal,07.00,00.00,"9,37,730.21",
13-May-24,Interest,"11,40,881.00",00.00,"20,78,611.21",
13-May-24,Cheque,"1,15,954.59",00.00,"21,94,565.80",
13-May-24,Tax,"18,54,274.00",00.00,"40,48,839.80",
13-May-24,Cash,00.00,"40,48,839.80",00.00,
13-May-24,Purchase,"2,56,668.00",00.00,"2,56,668.00",
13-May-24,Transportellaneous,00.00,"25,666.80","2,31,001.20",
13-May-24,Commission,00.00,"57,750.30","1,73,250.90",
13-May-24,ATM,"20,846.00",00.00,"1,94,096.90",
13-May-24,RTGS,"2,17,432.88",00.00,"4,11,529.78",
13-May-24,Commission,00.00,"58,789.97","3,52,739.81",
13-May-24,Cash,"3,81,464.00",00.00,"7,34,203.81",
13-May-24,NEFT,"1,88,878.00",00.00,"9,23,081.81",
13-May-24,Transfer,00.00,"1,02,564.65","8,20,517.16",
13-May-24,IMPS,00.00,"91,168.57","7,29,348.59",
13-May-24,Interest,00.00,"72,934.86","6,56,413.73",
13-May-24,ATM,00.00,"6,56,413.73",00.00,
13-May-24,Cash,05.30,00.00,05.30,
13-May-24,Bill,00.00,02.65,02.65,
13-May-24,RTGS,00.00,00.33,02.32,
13-May-24,Cheque,"1,31,158.20",00.00,"1,31,160.52",
13-May-24,ATM,29.2,00.00,"1,31,189.72",
14-May-24,Reversal,00.00,"65,594.86","65,594.86",
14-May-24,ATM,00.00,"21,864.95","43,729.91",
14-May-24,Interest,00.00,"21,864.96","21,864.96",
14-May-24,Purchase,00.00,"5,466.24","16,398.72",
14-May-24,Transportellaneous,00.00,"2,733.12","13,665.60",
14-May-24,Transfer,03.00,00.00,"13,668.60",
14-May-24,NEFT,"13,811.00",00.00,"27,479.60",
14-May-24,Interest,00.00,"3,434.95","24,044.65",
14-May-24,Commission,01.53,00.00,"24,046.18",
14-May-24,Transportellaneous,00.00,"4,809.24","19,236.94",
14-May-24,Interest,00.00,"1,923.69","17,313.25",
14-May-24,Transportellaneous,23,00.00,"17,336.25",
14-May-24,Reversal,00.00,"2,167.03","15,169.22",
14-May-24,Cash,311.85,00.00,"15,481.07",
14-May-24,Purchase,00.00,"3,096.21","12,384.86",
15-May-24,NEFT,"2,58,102.50",00.00,"2,70,487.36",
15-May-24,Interest,00.00,"67,621.84","2,02,865.52",
15-May-24,Transportellaneous,39.39,00.00,"2,02,904.91",
15-May-24,Tax,05.00,00.00,"2,02,909.91",
15-May-24,Reversal,"2,330.00",00.00,"2,05,239.91",
16-May-24,RTGS,00.00,"25,654.99","1,79,584.92",
17-May-24,Cash,00.00,"22,448.12","1,57,136.81",
17-May-24,Commission,63.16,00.00,"1,57,199.97",
17-May-24,Commission,04.00,00.00,"1,57,203.97",
17-May-24,IMPS,"6,73,605.75",00.00,"8,30,809.72",
17-May-24,Bill,444,00.00,"8,31,253.72",
17-May-24,Cheque,53,00.00,"8,31,306.72",
17-May-24,Transfer,508.46,00.00,"8,31,815.18",
17-May-24,Cheque,"3,954.00",00.00,"8,35,769.18",
17-May-24,Reversal,00.00,"4,17,884.59","4,17,884.59",
17-May-24,NEFT,00.00,"1,39,294.86","2,78,589.73",
17-May-24,Purchase,"3,711.56",00.00,"2,82,301.29",
17-May-24,Tax,"21,913.47",00.00,"3,04,214.76",
17-May-24,Cash,"2,06,236.00",00.00,"5,10,450.76",
17-May-24,Commission,01.76,00.00,"5,10,452.52",
17-May-24,ATM,"2,42,193.40",00.00,"7,52,645.92",
17-May-24,Cash,00.00,"83,627.32","6,69,018.60",
17-May-24,Transfer,"8,95,900.50",00.00,"15,64,919.10",
17-May-24,Cash,"16,733.30",00.00,"15,81,652.40",
17-May-24,Transfer,"4,52,502.00",00.00,"20,34,154.40",
17-May-24,Transportellaneous,00.00,"2,26,017.16","18,08,137.24",
17-May-24,ATM,"2,135.90",00.00,"18,10,273.14",
17-May-24,Commission,"27,250.00",00.00,"18,37,523.14",
17-May-24,Bill,"2,37,064.00",00.00,"20,74,587.14",
17-May-24,NEFT,"82,296.59",00.00,"21,56,883.73",
17-May-24,Debit Card,"1,484.00",00.00,"21,58,367.73",
17-May-24,Transportellaneous,"16,544.91",00.00,"21,74,912.64",
17-May-24,Reversal,00.00,"3,62,485.44","18,12,427.20",
17-May-24,Tax,"4,095.70",00.00,"18,16,522.90",
17-May-24,Transportellaneous,751,00.00,"18,17,273.90",
17-May-24,Purchase,00.00,"1,81,727.39","16,35,546.51",
17-May-24,RTGS,00.00,"2,04,443.31","14,31,103.20",
17-May-24,Reversal,00.00,"3,57,775.80","10,73,327.40",
17-May-24,Cheque,01.00,00.00,"10,73,328.40",
17-May-24,Interest,"22,644.00",00.00,"10,95,972.40",
17-May-24,Debit Card,190.75,00.00,"10,96,163.15",
18-May-24,Interest,00.00,"2,74,040.79","8,22,122.36",
18-May-24,Transfer,"3,569.80",00.00,"8,25,692.16",
18-May-24,RTGS,00.00,"8,25,692.16",00.00,
18-May-24,RTGS,"9,14,221.00",00.00,"9,14,221.00",
19-May-24,Bill,"13,303.26",00.00,"9,27,524.26",
19-May-24,Bill,07.87,00.00,"9,27,532.13",
19-May-24,Cheque,"1,604.80",00.00,"9,29,136.93",
19-May-24,Cheque,"80,127.00",00.00,"10,09,263.93",
19-May-24,Transfer,"22,383.60",00.00,"10,31,647.53",
19-May-24,Reversal,"2,31,481.50",00.00,"12,63,129.03",
19-May-24,Purchase,00.00,"1,40,347.67","11,22,781.36",
19-May-24,Cash,165.4,00.00,"11,22,946.76",
19-May-24,Transfer,00.00,"1,12,294.68","10,10,652.08",
19-May-24,Transfer,"1,65,502.56",00.00,"11,76,154.64",
19-May-24,IMPS,00.00,"1,30,683.85","10,45,470.79",
19-May-24,Cheque,"74,061.80",00.00,"11,19,532.59",
19-May-24,Interest,"7,16,265.75",00.00,"18,35,798.34",
19-May-24,IMPS,00.00,"9,17,899.17","9,17,899.17",
19-May-24,Interest,00.00,"1,52,983.20","7,64,915.98",
19-May-24,RTGS,00.00,"76,491.60","6,88,424.38",
19-May-24,Transfer,00.00,"76,491.60","6,11,932.78",
19-May-24,Tax,"18,74,506.00",00.00,"24,86,438.78",
20-May-24,IMPS,00.00,"2,48,643.88","22,37,794.90",
20-May-24,Transfer,"15,437.60",00.00,"22,53,232.50",
20-May-24,Bill,00.00,"2,81,654.06","19,71,578.44",
20-May-24,Purchase,00.00,"3,94,315.69","15,77,262.75",
20-May-24,RTGS,"6,112.80",00.00,"15,83,375.55",
20-May-24,Transportellaneous,00.00,"15,83,375.55",00.00,
20-May-24,Commission,"37,492.00",00.00,"37,492.00",
20-May-24,ATM,00.00,"4,165.78","33,326.22",
20-May-24,Reversal,00.00,"4,165.78","29,160.44",
20-May-24,Interest,02.32,00.00,"29,162.76",
20-May-24,ATM,"17,637.84",00.00,"46,800.60",
20-May-24,Tax,"22,451.93",00.00,"69,252.53",
20-May-24,ATM,"8,37,339.25",00.00,"9,06,591.78",
20-May-24,RTGS,"3,012.00",00.00,"9,09,603.78",
20-May-24,Interest,00.00,"4,54,801.89","4,54,801.89",
20-May-24,Purchase,"19,62,614.00",00.00,"24,17,415.89",
20-May-24,NEFT,00.00,"6,04,353.97","18,13,061.92",
20-May-24,RTGS,00.00,"3,62,612.38","14,50,449.54",
20-May-24,Bill,371,00.00,"14,50,820.54",
20-May-24,NEFT,00.00,"1,45,082.05","13,05,738.49",
20-May-24,Commission,00.00,"1,30,573.85","11,75,164.64",
20-May-24,Reversal,00.00,"3,91,721.55","7,83,443.09",
20-May-24,RTGS,00.00,"1,30,573.85","6,52,869.24",
20-May-24,Reversal,00.00,"93,267.03","5,59,602.21",
20-May-24,Reversal,00.00,"5,59,602.21",00.00,
20-May-24,Commission,"24,149.00",00.00,"24,149.00",
20-May-24,Cheque,00.00,"4,829.80","19,319.20",
20-May-24,ATM,00.00,"4,829.80","14,489.40",
20-May-24,Cash,00.00,"1,811.18","12,678.22",
20-May-24,NEFT,780,00.00,"13,458.22",
20-May-24,Reversal,"1,67,924.75",00.00,"1,81,382.97",
20-May-24,Tax,00.00,"18,138.30","1,63,244.67",
20-May-24,RTGS,00.00,"27,207.45","1,36,037.22",
20-May-24,Cash,28.94,00.00,"1,36,066.16",
20-May-24,Debit Card,"71,089.00",00.00,"2,07,155.16",
21-May-24,RTGS,00.00,"34,525.86","1,72,629.30",
21-May-24,ATM,12,00.00,"1,72,641.30",
21-May-24,Cheque,"9,864.61",00.00,"1,82,505.91",
21-May-24,Transfer,"3,322.00",00.00,"1,85,827.91",
21-May-24,RTGS,"2,28,975.10",00.00,"4,14,803.01",
21-May-24,Transportellaneous,06.30,00.00,"4,14,809.31",
21-May-24,NEFT,"2,54,006.25",00.00,"6,68,815.56",
21-May-24,Purchase,00.00,"83,601.95","5,85,213.62",
21-May-24,Cash,"1,913.00",00.00,"5,87,126.62",
21-May-24,Transportellaneous,"2,853.20",00.00,"5,89,979.82",
21-May-24,Commission,00.00,"84,282.83","5,05,696.99",
21-May-24,Cash,43,00.00,"5,05,739.99",
21-May-24,IMPS,00.00,"63,217.50","4,42,522.49",
21-May-24,Purchase,"16,84,150.25",00.00,"21,26,672.74",
21-May-24,Bill,00.00,"2,12,667.27","19,14,005.47",
21-May-24,IMPS,"31,432.31",00.00,"19,45,437.78",
21-May-24,RTGS,00.00,"1,94,543.78","17,50,894.00",
21-May-24,NEFT,00.00,"17,50,894.00",00.00,
21-May-24,IMPS,"1,31,906.40",00.00,"1,31,906.40",
21-May-24,Bill,00.00,"26,381.28","1,05,525.12",
21-May-24,IMPS,"1,278.00",00.00,"1,06,803.12",
21-May-24,Interest,13.4,00.00,"1,06,816.52",
21-May-24,Transportellaneous,00.00,"26,704.13","80,112.39",
21-May-24,Tax,"22,554.00",00.00,"1,02,666.39",
21-May-24,RTGS,00.00,"17,111.07","85,555.32",
21-May-24,Cash,00.00,"21,388.83","64,166.49",
21-May-24,Reversal,00.00,"12,833.30","51,333.19",
21-May-24,Purchase,00.00,"6,416.65","44,916.54",
21-May-24,Transportellaneous,19,00.00,"44,935.54",
21-May-24,Debit Card,46.4,00.00,"44,981.94",
21-May-24,Transportellaneous,00.00,"14,993.98","29,987.96",
21-May-24,Debit Card,00.00,"7,496.99","22,490.97",
22-May-24,Purchase,120,00.00,"22,610.97",
22-May-24,Bill,"21,837.60",00.00,"44,448.57",
22-May-24,Bill,14,00.00,"44,462.57",
22-May-24,NEFT,00.00,"22,231.29","22,231.28",
22-May-24,Interest,00.00,"2,470.14","19,761.14",
22-May-24,Interest,00.00,"2,195.68","17,565.46",
22-May-24,Bill,82.5,00.00,"17,647.96",
22-May-24,Purchase,06.00,00.00,"17,653.96",
22-May-24,Transportellaneous,47.43,00.00,"17,701.39",
22-May-24,Cash,"1,75,809.40",00.00,"1,93,510.79",
22-May-24,NEFT,00.00,"19,351.08","1,74,159.71",
22-May-24,NEFT,00.00,"19,351.08","1,54,808.63",
22-May-24,Commission,00.00,"51,602.88","1,03,205.75",
22-May-24,Interest,00.00,"17,200.96","86,004.79",
22-May-24,ATM,05.64,00.00,"86,010.43",
23-May-24,Commission,09.00,00.00,"86,019.43",
23-May-24,Debit Card,33,00.00,"86,052.43",
23-May-24,Interest,313.6,00.00,"86,366.03",
23-May-24,Tax,00.00,"10,795.75","75,570.28",
23-May-24,Debit Card,00.00,"15,114.06","60,456.22",
23-May-24,Debit Card,00.00,"20,152.07","40,304.15",
23-May-24,Bill,"14,662.82",00.00,"54,966.97",
23-May-24,Debit Card,414.2,00.00,"55,381.17",
23-May-24,ATM,340.6,00.00,"55,721.77",
23-May-24,Transportellaneous,00.00,"11,144.35","44,577.42",
23-May-24,Bill,00.00,"4,953.05","39,624.37",
23-May-24,Reversal,"13,182.50",00.00,"52,806.87",
23-May-24,Interest,00.00,"6,600.86","46,206.01",
23-May-24,ATM,"2,697.00",00.00,"48,903.01",
23-May-24,Cheque,01.90,00.00,"48,904.91",
23-May-24,ATM,40.95,00.00,"48,945.86",
23-May-24,IMPS,00.00,"5,438.43","43,507.43",
23-May-24,RTGS,168.68,00.00,"43,676.11",
23-May-24,IMPS,"12,788.00",00.00,"56,464.11",
23-May-24,IMPS,"1,44,315.00",00.00,"2,00,779.11",
23-May-24,NEFT,00.00,"22,308.79","1,78,470.32",
23-May-24,Interest,"1,34,789.00",00.00,"3,13,259.32",
23-May-24,Transportellaneous,"3,335.00",00.00,"3,16,594.32",
23-May-24,Cash,00.00,"45,227.76","2,71,366.56",
23-May-24,Reversal,00.00,"90,455.52","1,80,911.04",
23-May-24,Transportellaneous,30.9,00.00,"1,80,941.94",
23-May-24,RTGS,00.00,"1,80,941.94",00.00,
23-May-24,Purchase,"5,69,997.00",00.00,"5,69,997.00",
23-May-24,Cheque,00.00,"2,84,998.50","2,84,998.50",
23-May-24,Bill,"55,471.80",00.00,"3,40,470.30",
23-May-24,Bill,"1,214.00",00.00,"3,41,684.30",
23-May-24,Transportellaneous,00.00,"68,336.86","2,73,347.44",
23-May-24,Reversal,"10,308.00",00.00,"2,83,655.44",
23-May-24,Transfer,00.00,"31,517.27","2,52,138.17",
23-May-24,Transportellaneous,"1,83,833.00",00.00,"4,35,971.17",
23-May-24,RTGS,55,00.00,"4,36,026.17",
23-May-24,Commission,01.10,00.00,"4,36,027.27",
23-May-24,Transportellaneous,02.80,00.00,"4,36,030.07",
23-May-24,IMPS,"20,105.50",00.00,"4,56,135.57",
23-May-24,ATM,474.4,00.00,"4,56,609.97",
23-May-24,Purchase,00.00,"2,28,304.99","2,28,304.98",
23-May-24,IMPS,377.04,00.00,"2,28,682.02",
23-May-24,Tax,00.00,"76,227.34","1,52,454.68",
23-May-24,Debit Card,00.00,"16,939.41","1,35,515.27",
23-May-24,IMPS,00.00,"19,359.32","1,16,155.95",
23-May-24,NEFT,00.00,"12,906.22","1,03,249.73",
23-May-24,Transfer,00.00,"12,906.22","90,343.51",
24-May-24,Cheque,22.18,00.00,"90,365.69",
24-May-24,Cash,00.00,"22,591.42","67,774.27",
24-May-24,Transfer,00.00,"11,295.71","56,478.56",
24-May-24,Debit Card,"2,16,725.25",00.00,"2,73,203.81",
24-May-24,Reversal,00.00,"2,73,203.81",00.00,
24-May-24,Commission,50,00.00,50,
24-May-24,Debit Card,00.00,07.14,42.86,
24-May-24,Cash,00.00,10.72,32.14,
24-May-24,RTGS,01.00,00.00,33.14,
24-May-24,IMPS,01.98,00.00,35.12,
24-May-24,IMPS,02.30,00.00,37.42,
24-May-24,Commission,"21,268.90",00.00,"21,306.32",
24-May-24,Cash,32,00.00,"21,338.32",
24-May-24,Bill,"2,19,913.00",00.00,"2,41,251.32",
24-May-24,Purchase,142,00.00,"2,41,393.32",
25-May-24,Commission,00.00,"26,821.48","2,14,571.84",
25-May-24,Bill,00.00,"23,841.32","1,90,730.52",
25-May-24,ATM,"1,295.68",00.00,"1,92,026.20",
25-May-24,Reversal,00.00,"96,013.10","96,013.10",
25-May-24,Purchase,05.52,00.00,"96,018.62",
25-May-24,Purchase,00.00,"19,203.72","76,814.90",
25-May-24,IMPS,"13,180.20",00.00,"89,995.10",
25-May-24,Bill,"5,54,412.00",00.00,"6,44,407.10",
25-May-24,Tax,00.00,"92,058.16","5,52,348.94",
25-May-24,Transportellaneous,00.00,"1,10,469.79","4,41,879.15",
25-May-24,IMPS,186.2,00.00,"4,42,065.35",
25-May-24,IMPS,919,00.00,"4,42,984.35",
25-May-24,RTGS,15.3,00.00,"4,42,999.65",
25-May-24,IMPS,"17,693.27",00.00,"4,60,692.92",
25-May-24,Transportellaneous,00.00,"1,53,564.31","3,07,128.61",
25-May-24,Commission,"9,98,914.00",00.00,"13,06,042.61",
25-May-24,Tax,03.89,00.00,"13,06,046.50",
25-May-24,NEFT,"2,69,212.00",00.00,"15,75,258.50",
25-May-24,ATM,00.00,"2,25,036.93","13,50,221.57",
25-May-24,Reversal,05.10,00.00,"13,50,226.67",
25-May-24,Commission,35.6,00.00,"13,50,262.27",
25-May-24,Debit Card,244,00.00,"13,50,506.27",
25-May-24,Bill,00.00,"2,25,084.38","11,25,421.89",
25-May-24,Interest,01.16,00.00,"11,25,423.05",
25-May-24,Interest,11.3,00.00,"11,25,434.35",
25-May-24,Purchase,"10,292.30",00.00,"11,35,726.65",
25-May-24,Bill,00.00,"1,41,965.83","9,93,760.82",
25-May-24,Interest,"3,08,148.00",00.00,"13,01,908.82",
25-May-24,ATM,"40,218.00",00.00,"13,42,126.82",
25-May-24,Tax,00.00,"3,35,531.71","10,06,595.12",
25-May-24,Purchase,00.00,"1,43,799.30","8,62,795.82",
25-May-24,Cash,"64,326.00",00.00,"9,27,121.82",
25-May-24,Debit Card,00.00,"1,03,013.54","8,24,108.28",
25-May-24,Transportellaneous,00.00,"1,17,729.75","7,06,378.53",
25-May-24,Bill,00.00,"78,486.50","6,27,892.03",
25-May-24,Cash,"3,034.10",00.00,"6,30,926.13",
25-May-24,Cash,"3,250.00",00.00,"6,34,176.13",
25-May-24,Bill,"12,805.80",00.00,"6,46,981.93",
25-May-24,Purchase,"19,95,559.00",00.00,"26,42,540.93",
26-May-24,Reversal,00.00,"3,30,317.62","23,12,223.31",
26-May-24,NEFT,07.70,00.00,"23,12,231.01",
26-May-24,Cheque,00.00,"23,12,231.01",00.00,
26-May-24,IMPS,465,00.00,465,
26-May-24,Commission,331,00.00,796,
26-May-24,Bill,00.00,159.2,636.8,
26-May-24,NEFT,105,00.00,741.8,
26-May-24,RTGS,"1,675.00",00.00,"2,416.80",
27-May-24,Tax,"14,017.41",00.00,"16,434.21",
27-May-24,Commission,00.00,"16,434.21",00.00,
27-May-24,RTGS,"15,42,260.00",00.00,"15,42,260.00",
27-May-24,Cash,00.00,"2,57,043.33","12,85,216.67",
27-May-24,Reversal,22.13,00.00,"12,85,238.80",
27-May-24,Cheque,00.00,"2,57,047.76","10,28,191.04",
27-May-24,Commission,"11,88,703.00",00.00,"22,16,894.04",
27-May-24,Cash,278.1,00.00,"22,17,172.14",
27-May-24,IMPS,"1,408.59",00.00,"22,18,580.73",
27-May-24,Commission,07.00,00.00,"22,18,587.73",
27-May-24,IMPS,"1,19,786.00",00.00,"23,38,373.73",
28-May-24,Purchase,00.00,"5,84,593.43","17,53,780.30",
28-May-24,Transportellaneous,00.00,"2,92,296.72","14,61,483.58",
28-May-24,IMPS,"10,961.68",00.00,"14,72,445.26",
28-May-24,Transportellaneous,00.00,"2,45,407.54","12,27,037.72",
28-May-24,Interest,"8,274.00",00.00,"12,35,311.72",
28-May-24,Reversal,00.00,"1,37,256.86","10,98,054.86",
28-May-24,IMPS,12.17,00.00,"10,98,067.03",
28-May-24,Interest,00.00,"1,37,258.38","9,60,808.65",
28-May-24,Commission,17.04,00.00,"9,60,825.69",
28-May-24,RTGS,"6,16,353.50",00.00,"15,77,179.19",
28-May-24,NEFT,"3,116.78",00.00,"15,80,295.97",
28-May-24,Purchase,178,00.00,"15,80,473.97",
28-May-24,Debit Card,00.00,"2,63,412.33","13,17,061.64",
28-May-24,RTGS,05.00,00.00,"13,17,066.64",
28-May-24,Transportellaneous,"2,918.04",00.00,"13,19,984.68",
28-May-24,NEFT,00.00,"1,88,569.24","11,31,415.44",
28-May-24,IMPS,00.00,"1,88,569.24","9,42,846.20",
28-May-24,Cash,"24,706.90",00.00,"9,67,553.10",
28-May-24,Transportellaneous,00.00,"1,20,944.14","8,46,608.96",
28-May-24,Bill,308.94,00.00,"8,46,917.90",
28-May-24,Purchase,00.00,"1,05,864.74","7,41,053.16",
28-May-24,RTGS,00.00,"1,48,210.63","5,92,842.53",
28-May-24,NEFT,00.00,"1,48,210.63","4,44,631.90",
28-May-24,Purchase,00.00,"44,463.19","4,00,168.71",
28-May-24,Commission,00.00,"50,021.09","3,50,147.62",
28-May-24,Tax,27,00.00,"3,50,174.62",
28-May-24,Tax,00.00,"50,024.95","3,00,149.67",
28-May-24,Bill,39.3,00.00,"3,00,188.97",
28-May-24,Transportellaneous,00.00,"30,018.90","2,70,170.07",
28-May-24,Bill,"8,08,328.50",00.00,"10,78,498.57",
28-May-24,NEFT,55.7,00.00,"10,78,554.27",
28-May-24,Bill,"1,31,778.00",00.00,"12,10,332.27",
28-May-24,Reversal,00.00,"3,02,583.07","9,07,749.20",
28-May-24,Tax,00.00,"9,07,749.20",00.00,
28-May-24,Transfer,07.50,00.00,07.50,
28-May-24,Cheque,00.00,00.83,06.67,
28-May-24,Reversal,"1,26,418.00",00.00,"1,26,424.67",
28-May-24,Interest,07.14,00.00,"1,26,431.81",
28-May-24,ATM,00.00,"21,071.97","1,05,359.84",
28-May-24,Interest,00.00,"13,169.98","92,189.86",
28-May-24,Purchase,00.00,"18,437.97","73,751.89",
28-May-24,Commission,04.75,00.00,"73,756.64",
28-May-24,Reversal,"7,18,633.25",00.00,"7,92,389.89",
28-May-24,Transportellaneous,00.00,"7,92,389.89",00.00,
28-May-24,Transportellaneous,07.00,00.00,07.00,
28-May-24,Debit Card,"1,39,990.60",00.00,"1,39,997.60",
28-May-24,Cash,"14,12,780.00",00.00,"15,52,777.60",
28-May-24,IMPS,00.00,"1,94,097.20","13,58,680.40",
28-May-24,Debit Card,"35,541.20",00.00,"13,94,221.60",
28-May-24,Transportellaneous,02.40,00.00,"13,94,224.00",
28-May-24,ATM,00.00,"1,54,913.78","12,39,310.22",
28-May-24,ATM,"1,975.00",00.00,"12,41,285.22",
28-May-24,Transportellaneous,"1,17,404.80",00.00,"13,58,690.02",
28-May-24,Cheque,"43,425.00",00.00,"14,02,115.02",
29-May-24,Tax,08.00,00.00,"14,02,123.02",
29-May-24,Debit Card,00.00,"2,80,424.60","11,21,698.42",
29-May-24,Debit Card,62,00.00,"11,21,760.42",
29-May-24,Debit Card,"13,29,061.50",00.00,"24,50,821.92",
29-May-24,Cash,"3,474.50",00.00,"24,54,296.42",
29-May-24,IMPS,386.9,00.00,"24,54,683.32",
29-May-24,Cheque,"32,721.54",00.00,"24,87,404.86",
29-May-24,IMPS,57,00.00,"24,87,461.86",
29-May-24,Transportellaneous,"4,54,392.25",00.00,"29,41,854.11",
29-May-24,ATM,00.00,"29,41,854.11",00.00,
29-May-24,NEFT,"2,465.10",00.00,"2,465.10",
29-May-24,Tax,00.00,616.28,"1,848.82",
29-May-24,Transfer,"1,90,579.40",00.00,"1,92,428.22",
29-May-24,Reversal,00.00,"19,242.82","1,73,185.40",
29-May-24,Interest,"1,27,145.00",00.00,"3,00,330.40",
29-May-24,Interest,00.00,"3,00,330.40",00.00,
29-May-24,Cash,326.9,00.00,326.9,
29-May-24,Tax,"1,680.00",00.00,"2,006.90",
29-May-24,Bill,505,00.00,"2,511.90",
29-May-24,Cheque,00.00,627.98,"1,883.93",
29-May-24,Reversal,"75,672.00",00.00,"77,555.93",
29-May-24,Bill,"8,24,059.00",00.00,"9,01,614.93",
29-May-24,Purchase,00.00,"1,00,179.44","8,01,435.49",
29-May-24,Bill,00.00,"2,00,358.87","6,01,076.62",
29-May-24,RTGS,04.74,00.00,"6,01,081.36",
29-May-24,Transfer,00.00,"1,50,270.34","4,50,811.02",
29-May-24,Cash,00.00,"1,12,702.76","3,38,108.26",
29-May-24,Debit Card,89.7,00.00,"3,38,197.96",
29-May-24,Cheque,34.9,00.00,"3,38,232.86",
29-May-24,Commission,00.00,"56,372.14","2,81,860.72",
29-May-24,Cash,46,00.00,"2,81,906.72",
29-May-24,ATM,"1,18,508.00",00.00,"4,00,414.72",
29-May-24,Reversal,366.9,00.00,"4,00,781.62",
29-May-24,Cheque,"2,015.50",00.00,"4,02,797.12",
29-May-24,Cheque,00.00,"4,02,797.12",00.00,
29-May-24,Transportellaneous,"14,90,686.00",00.00,"14,90,686.00",
29-May-24,Transportellaneous,00.00,"1,86,335.75","13,04,350.25",
29-May-24,Tax,"11,587.60",00.00,"13,15,937.85",
30-May-24,RTGS,"20,04,091.00",00.00,"33,20,028.85",
30-May-24,ATM,05.00,00.00,"33,20,033.85",
30-May-24,Bill,458.8,00.00,"33,20,492.65",
30-May-24,Interest,00.00,"3,68,943.63","29,51,549.02",
30-May-24,Purchase,00.00,"3,27,949.89","26,23,599.13",
30-May-24,Interest,00.00,"13,11,799.57","13,11,799.56",
30-May-24,Transfer,00.00,"2,62,359.91","10,49,439.65",
30-May-24,Transportellaneous,"2,944.80",00.00,"10,52,384.45",
30-May-24,Cheque,"24,171.00",00.00,"10,76,555.45",
30-May-24,Tax,00.00,"5,38,277.73","5,38,277.72",
30-May-24,Interest,"70,383.00",00.00,"6,08,660.72",
30-May-24,NEFT,00.00,"1,01,443.45","5,07,217.27",
30-May-24,Tax,"3,109.41",00.00,"5,10,326.68",
30-May-24,Cheque,00.00,"1,02,065.34","4,08,261.34",
30-May-24,Debit Card,00.00,"1,02,065.34","3,06,196.00",
30-May-24,IMPS,00.00,"30,619.60","2,75,576.40",
30-May-24,Reversal,41.8,00.00,"2,75,618.20",
30-May-24,Bill,00.00,"39,374.03","2,36,244.17",
30-May-24,Reversal,00.00,"78,748.06","1,57,496.11",
30-May-24,Debit Card,95.4,00.00,"1,57,591.51",
30-May-24,Reversal,00.00,"17,510.17","1,40,081.34",
30-May-24,Commission,"22,370.99",00.00,"1,62,452.33",
30-May-24,Cash,256.5,00.00,"1,62,708.83",
30-May-24,Cheque,00.00,"23,244.12","1,39,464.71",
30-May-24,Interest,305.9,00.00,"1,39,770.61",
30-May-24,Purchase,550.91,00.00,"1,40,321.52",
30-May-24,Bill,"8,13,762.00",00.00,"9,54,083.52",
30-May-24,Transfer,"8,71,380.00",00.00,"18,25,463.52",
30-May-24,Purchase,00.00,"2,28,182.94","15,97,280.58",
30-May-24,Reversal,00.00,"3,19,456.12","12,77,824.46",
31-May-24,Cheque,"40,964.70",00.00,"13,18,789.16",
31-May-24,RTGS,39.71,00.00,"13,18,828.87",
31-May-24,Commission,00.00,"2,19,804.81","10,99,024.06",
31-May-24,Debit Card,156.16,00.00,"10,99,180.22",
31-May-24,Transportellaneous,00.00,"1,57,025.75","9,42,154.47",
31-May-24,Transfer,00.00,"4,71,077.24","4,71,077.24",
31-May-24,Cash,00.00,"47,107.72","4,23,969.52",
31-May-24,Bill,178,00.00,"4,24,147.52",
31-May-24,Commission,00.00,"47,127.50","3,77,020.02",
31-May-24,Cheque,00.00,"41,891.11","3,35,128.91",
31-May-24,Purchase,"69,019.10",00.00,"4,04,148.01",
31-May-24,ATM,56.8,00.00,"4,04,204.81",
31-May-24,Transfer,692.03,00.00,"4,04,896.84",
31-May-24,NEFT,00.00,"40,489.68","3,64,407.16",
31-May-24,Bill,"9,95,819.75",00.00,"13,60,226.91",
31-May-24,Bill,00.00,"2,72,045.38","10,88,181.53",
31-May-24,Cash,00.00,"3,62,727.18","7,25,454.35",
31-May-24,Reversal,314.4,00.00,"7,25,768.75",
31-May-24,Purchase,00.00,"2,41,922.92","4,83,845.83",
31-May-24,Transfer,00.00,"1,20,961.46","3,62,884.37",
31-May-24,IMPS,00.00,"90,721.09","2,72,163.28",
31-May-24,NEFT,00.00,"38,880.47","2,33,282.81",
31-May-24,IMPS,36.89,00.00,"2,33,319.70",
31-May-24,Bill,00.00,00.00,"2,33,319.70",
31-May-24,Reversal,00.00,"38,886.62","1,94,433.08",
31-May-24,Commission,"1,33,068.12",00.00,"3,27,501.20",
31-May-24,Bill,"10,771.57",00.00,"3,38,272.77",
31-May-24,Transportellaneous,00.00,"48,324.68","2,89,948.09",
31-May-24,Purchase,"23,101.40",00.00,"3,13,049.49",
31-May-24,Commission,03.19,00.00,"3,13,052.68",
31-May-24,Cheque,00.00,"44,721.81","2,68,330.87",
31-May-24,Bill,30.8,00.00,"2,68,361.67",
31-May-24,Bill,00.00,"33,545.21","2,34,816.46",
31-May-24,Cash,00.00,"58,704.12","1,76,112.34",
31-May-24,Transfer,"2,470.00",00.00,"1,78,582.34",
31-May-24,Tax,"23,259.60",00.00,"2,01,841.94",
31-May-24,Tax,00.00,"67,280.65","1,34,561.29",
31-May-24,Commission,"23,353.00",00.00,"1,57,914.29",
31-May-24,Tax,00.00,"31,582.86","1,26,331.43",
31-May-24,Transfer,"1,48,600.44",00.00,"2,74,931.87",
31-May-24,Debit Card,05.13,00.00,"2,74,937.00",
31-May-24,Debit Card,216.7,00.00,"2,75,153.70",
31-May-24,Transfer,00.00,"68,788.43","2,06,365.28",
31-May-24,Debit Card,"6,920.00",00.00,"2,13,285.28",
31-May-24,Reversal,00.00,"2,13,285.28",00.00,
31-May-24,RTGS,01.72,00.00,01.72,
31-May-24,Cheque,00.00,00.19,01.53,
31-May-24,IMPS,02.10,00.00,03.63,
31-May-24,IMPS,00.00,00.40,03.23,
31-May-24,Reversal,00.00,03.23,00.00,
31-May-24,IMPS,16.4,00.00,16.4,
31-May-24,RTGS,"3,46,132.50",00.00,"3,46,148.90",
31-May-24,Bill,"12,55,692.25",00.00,"16,01,841.15",
31-May-24,Cash,00.00,"1,77,982.35","14,23,858.80",
31-May-24,Purchase,00.00,"7,11,929.40","7,11,929.40",
31-May-24,NEFT,00.00,"79,103.27","6,32,826.13",
31-May-24,NEFT,163,00.00,"6,32,989.13",
31-May-24,Commission,00.00,"70,332.13","5,62,657.00",
31-May-24,Reversal,"8,799.60",00.00,"5,71,456.60",
31-May-24,Cheque,"20,57,834.00",00.00,"26,29,290.60",
31-May-24,Purchase,00.00,"5,25,858.12","21,03,432.48",
31-May-24,Debit Card,00.00,"2,62,929.06","18,40,503.42",
01-Jun-24,Bill,361.5,00.00,"18,40,864.92",
01-Jun-24,Transfer,"14,14,406.00",00.00,"32,55,270.92",
01-Jun-24,ATM,"1,726.00",00.00,"32,56,996.92",
01-Jun-24,ATM,00.00,"16,28,498.46","16,28,498.46",
01-Jun-24,Tax,406,00.00,"16,28,904.46",
01-Jun-24,Tax,"1,52,168.10",00.00,"17,81,072.56",
01-Jun-24,Bill,27.7,00.00,"17,81,100.26",
01-Jun-24,Reversal,"9,235.90",00.00,"17,90,336.16",
01-Jun-24,Cheque,128.41,00.00,"17,90,464.57",
02-Jun-24,Interest,38,00.00,"17,90,502.57",
02-Jun-24,Commission,00.00,"2,55,786.08","15,34,716.49",
02-Jun-24,Interest,01.04,00.00,"15,34,717.53",
02-Jun-24,ATM,00.00,"1,70,524.17","13,64,193.36",
02-Jun-24,ATM,00.00,"3,41,048.34","10,23,145.02",
02-Jun-24,Cheque,"25,604.97",00.00,"10,48,749.99",
02-Jun-24,Tax,00.00,"3,49,583.33","6,99,166.66",
02-Jun-24,Commission,"15,38,076.00",00.00,"22,37,242.66",
02-Jun-24,Transfer,35.3,00.00,"22,37,277.96",
02-Jun-24,Commission,"1,87,492.20",00.00,"24,24,770.16",
02-Jun-24,ATM,00.00,"24,24,770.16",00.00,
02-Jun-24,Cheque,414,00.00,414,
02-Jun-24,Interest,00.00,51.75,362.25,
02-Jun-24,Cash,00.00,40.25,322,
02-Jun-24,Cheque,220.5,00.00,542.5,
02-Jun-24,NEFT,00.00,135.63,406.88,
02-Jun-24,Tax,"3,164.00",00.00,"3,570.88",
02-Jun-24,IMPS,"1,78,136.91",00.00,"1,81,707.79",
02-Jun-24,Interest,00.00,"45,426.95","1,36,280.84",
02-Jun-24,ATM,"1,21,122.59",00.00,"2,57,403.43",
02-Jun-24,Interest,00.00,"28,600.38","2,28,803.05",
02-Jun-24,ATM,141,00.00,"2,28,944.05",
02-Jun-24,Commission,00.00,"2,28,944.05",00.00,
02-Jun-24,Commission,"2,289.00",00.00,"2,289.00",
02-Jun-24,Interest,00.00,286.13,"2,002.88",
02-Jun-24,Tax,"3,226.46",00.00,"5,229.34",
02-Jun-24,Tax,"19,60,007.00",00.00,"19,65,236.34",
02-Jun-24,Tax,00.00,"2,18,359.59","17,46,876.75",
02-Jun-24,Transportellaneous,"2,732.00",00.00,"17,49,608.75",
02-Jun-24,Purchase,00.00,"1,74,960.88","15,74,647.88",
02-Jun-24,Reversal,00.00,"2,24,949.70","13,49,698.18",
02-Jun-24,NEFT,25.73,00.00,"13,49,723.91",
02-Jun-24,RTGS,751.23,00.00,"13,50,475.14",
02-Jun-24,RTGS,"18,070.30",00.00,"13,68,545.44",
02-Jun-24,Tax,00.00,"1,52,060.60","12,16,484.84",
02-Jun-24,Reversal,00.00,"2,43,296.97","9,73,187.87",
02-Jun-24,Debit Card,00.00,"1,62,197.98","8,10,989.89",
02-Jun-24,RTGS,"4,068.92",00.00,"8,15,058.81",
02-Jun-24,RTGS,"14,03,848.00",00.00,"22,18,906.81",
02-Jun-24,Tax,00.00,"2,77,363.35","19,41,543.46",
02-Jun-24,RTGS,00.00,"19,41,543.46",00.00,
02-Jun-24,RTGS,"1,92,023.00",00.00,"1,92,023.00",
02-Jun-24,Purchase,141,00.00,"1,92,164.00",
02-Jun-24,RTGS,00.00,"27,452.00","1,64,712.00",
02-Jun-24,Bill,"53,444.50",00.00,"2,18,156.50",
02-Jun-24,Purchase,00.00,"24,239.61","1,93,916.89",
02-Jun-24,Debit Card,90,00.00,"1,94,006.89",
02-Jun-24,ATM,07.00,00.00,"1,94,013.89",
02-Jun-24,RTGS,00.00,"27,716.27","1,66,297.62",
02-Jun-24,Commission,00.00,"41,574.41","1,24,723.22",
02-Jun-24,Cash,00.00,"13,858.14","1,10,865.08",
02-Jun-24,IMPS,00.00,"27,716.27","83,148.81",
02-Jun-24,Tax,00.47,00.00,"83,149.28",
02-Jun-24,RTGS,00.00,00.00,"83,149.28",
02-Jun-24,Purchase,02.40,00.00,"83,151.68",
02-Jun-24,Cash,00.00,"8,315.17","74,836.51",
02-Jun-24,Bill,03.40,00.00,"74,839.91",
02-Jun-24,Interest,"2,635.00",00.00,"77,474.91",
02-Jun-24,Purchase,00.00,"19,368.73","58,106.18",
02-Jun-24,Bill,00.00,"8,300.88","49,805.30",
02-Jun-24,Cheque,"23,567.80",00.00,"73,373.10",
02-Jun-24,Debit Card,00.00,"12,228.85","61,144.25",
02-Jun-24,Tax,"9,61,194.00",00.00,"10,22,338.25",
02-Jun-24,Debit Card,"1,58,488.72",00.00,"11,80,826.97",
02-Jun-24,Transfer,00.00,"11,80,826.97",00.00,
02-Jun-24,Reversal,"38,437.00",00.00,"38,437.00",
02-Jun-24,Tax,"3,490.42",00.00,"41,927.42",
02-Jun-24,Tax,00.00,"4,658.60","37,268.82",
03-Jun-24,Interest,00.00,"9,317.21","27,951.62",
03-Jun-24,Interest,00.00,"5,590.32","22,361.30",
03-Jun-24,Interest,00.00,"5,590.33","16,770.97",
03-Jun-24,NEFT,00.00,"2,096.37","14,674.60",
03-Jun-24,Cash,04.91,00.00,"14,679.51",
03-Jun-24,Cheque,00.00,"2,097.07","12,582.44",
03-Jun-24,Bill,00.00,"2,097.07","10,485.37",
03-Jun-24,ATM,00.00,"1,747.56","8,737.81",
03-Jun-24,Interest,00.00,"1,456.30","7,281.51",
03-Jun-24,Interest,01.81,00.00,"7,283.32",
03-Jun-24,IMPS,"16,92,950.00",00.00,"17,00,233.32",
03-Jun-24,Debit Card,"21,273.30",00.00,"17,21,506.62",
03-Jun-24,RTGS,"8,365.87",00.00,"17,29,872.49",
03-Jun-24,Cash,00.00,"17,29,872.49",00.00,
03-Jun-24,RTGS,"2,41,089.00",00.00,"2,41,089.00",
03-Jun-24,Cheque,03.90,00.00,"2,41,092.90",
03-Jun-24,Bill,00.00,"80,364.30","1,60,728.60",
03-Jun-24,Transportellaneous,"14,022.91",00.00,"1,74,751.51",
03-Jun-24,Cheque,42.3,00.00,"1,74,793.81",
04-Jun-24,ATM,00.00,"21,849.23","1,52,944.58",
04-Jun-24,NEFT,31,00.00,"1,52,975.58",
04-Jun-24,Debit Card,"15,48,317.25",00.00,"17,01,292.83",
04-Jun-24,Bill,"7,824.00",00.00,"17,09,116.83",
04-Jun-24,IMPS,"17,44,138.75",00.00,"34,53,255.58",
05-Jun-24,Transportellaneous,"1,27,753.00",00.00,"35,81,008.58",
05-Jun-24,Debit Card,07.73,00.00,"35,81,016.31",
05-Jun-24,Transportellaneous,"2,316.75",00.00,"35,83,333.06",
05-Jun-24,IMPS,339.87,00.00,"35,83,672.93",
05-Jun-24,Debit Card,00.00,"35,83,672.93",00.00,
05-Jun-24,Reversal,86.3,00.00,86.3,
05-Jun-24,Bill,00.00,08.63,77.67,
06-Jun-24,Purchase,00.00,08.63,69.04,
06-Jun-24,Tax,00.00,09.86,59.18,
06-Jun-24,Bill,00.00,05.92,53.26,
06-Jun-24,ATM,07.40,00.00,60.66,
06-Jun-24,Cash,"14,389.60",00.00,"14,450.26",
06-Jun-24,Purchase,57,00.00,"14,507.26",
06-Jun-24,RTGS,"28,797.16",00.00,"43,304.42",
06-Jun-24,NEFT,00.00,"6,186.35","37,118.07",
06-Jun-24,Debit Card,746,00.00,"37,864.07",
06-Jun-24,Transfer,00.00,"12,621.36","25,242.71",
06-Jun-24,Commission,00.00,"2,804.75","22,437.96",
06-Jun-24,IMPS,"1,61,774.00",00.00,"1,84,211.96",
06-Jun-24,Commission,00.00,"61,403.99","1,22,807.97",
06-Jun-24,IMPS,"8,963.24",00.00,"1,31,771.21",
06-Jun-24,Transportellaneous,05.00,00.00,"1,31,776.21",
06-Jun-24,Commission,"3,462.80",00.00,"1,35,239.01",
06-Jun-24,Debit Card,00.00,"22,539.84","1,12,699.18",
06-Jun-24,IMPS,00.00,"37,566.39","75,132.79",
06-Jun-24,Cash,00.00,"25,044.26","50,088.53",
06-Jun-24,Debit Card,"6,275.60",00.00,"56,364.13",
06-Jun-24,Transportellaneous,00.00,"9,394.02","46,970.11",
06-Jun-24,Purchase,"1,75,181.00",00.00,"2,22,151.11",
06-Jun-24,Bill,00.00,"24,683.46","1,97,467.65",
06-Jun-24,Purchase,"1,103.00",00.00,"1,98,570.65",
06-Jun-24,Bill,00.00,"99,285.33","99,285.32",
06-Jun-24,NEFT,00.00,"12,410.67","86,874.66",
06-Jun-24,IMPS,00.00,"8,687.47","78,187.19",
06-Jun-24,RTGS,00.00,"11,169.60","67,017.59",
06-Jun-24,Tax,00.00,"6,701.76","60,315.83",
06-Jun-24,RTGS,00.00,"6,701.76","53,614.07",
06-Jun-24,Debit Card,24,00.00,"53,638.07",
06-Jun-24,Cheque,00.00,00.00,"53,638.07",
06-Jun-24,Transfer,"7,814.00",00.00,"61,452.07",
06-Jun-24,Commission,00.00,"61,452.07",00.00,
06-Jun-24,Reversal,"66,164.00",00.00,"66,164.00",
06-Jun-24,Bill,116.39,00.00,"66,280.39",
07-Jun-24,Reversal,00.00,"11,046.73","55,233.66",
07-Jun-24,Tax,"1,74,114.00",00.00,"2,29,347.66",
07-Jun-24,NEFT,62,00.00,"2,29,409.66",
07-Jun-24,ATM,170,00.00,"2,29,579.66",
07-Jun-24,Transportellaneous,00.00,"57,394.92","1,72,184.74",
07-Jun-24,Cheque,00.00,"21,523.09","1,50,661.65",
07-Jun-24,Cash,"1,783.00",00.00,"1,52,444.65",
07-Jun-24,Cheque,00.00,"19,055.58","1,33,389.07",
07-Jun-24,Transportellaneous,"15,234.00",00.00,"1,48,623.07",
07-Jun-24,Transportellaneous,"15,609.00",00.00,"1,64,232.07",
07-Jun-24,Debit Card,00.00,"23,461.72","1,40,770.35",
07-Jun-24,Debit Card,06.00,00.00,"1,40,776.35",
07-Jun-24,NEFT,00.00,"28,155.27","1,12,621.08",
07-Jun-24,Purchase,00.00,"14,077.64","98,543.44",
07-Jun-24,Bill,665.5,00.00,"99,208.94",
07-Jun-24,Purchase,00.00,"24,802.24","74,406.70",
07-Jun-24,IMPS,"37,857.00",00.00,"1,12,263.70",
07-Jun-24,ATM,"15,13,917.50",00.00,"16,26,181.20",
07-Jun-24,Transfer,"1,69,321.66",00.00,"17,95,502.86",
07-Jun-24,Debit Card,00.00,"5,98,500.95","11,97,001.91",
07-Jun-24,Debit Card,"8,65,595.00",00.00,"20,62,596.91",
07-Jun-24,Commission,00.00,"10,31,298.46","10,31,298.46",
07-Jun-24,Purchase,00.00,"2,57,824.62","7,73,473.84",
07-Jun-24,Transfer,00.00,"1,28,912.31","6,44,561.53",
07-Jun-24,Commission,"6,22,605.80",00.00,"12,67,167.33",
07-Jun-24,Transportellaneous,"34,426.44",00.00,"13,01,593.77",
07-Jun-24,RTGS,00.00,"2,60,318.75","10,41,275.02",
07-Jun-24,Reversal,312.02,00.00,"10,41,587.04",
08-Jun-24,Transfer,00.00,"1,30,198.38","9,11,388.66",
08-Jun-24,Commission,00.00,"2,27,847.17","6,83,541.50",
08-Jun-24,NEFT,03.00,00.00,"6,83,544.50",
08-Jun-24,Tax,07.84,00.00,"6,83,552.34",
08-Jun-24,Cash,00.00,"75,950.26","6,07,602.08",
08-Jun-24,Purchase,00.00,"86,800.30","5,20,801.78",
08-Jun-24,IMPS,00.00,"52,080.18","4,68,721.60",
08-Jun-24,Debit Card,139.5,00.00,"4,68,861.10",
08-Jun-24,Cash,00.00,"52,095.68","4,16,765.42",
08-Jun-24,Interest,00.00,"46,307.27","3,70,458.15",
08-Jun-24,IMPS,00.00,"46,307.27","3,24,150.88",
08-Jun-24,Cheque,00.00,"54,025.15","2,70,125.73",
08-Jun-24,IMPS,277,00.00,"2,70,402.73",
08-Jun-24,Reversal,39.28,00.00,"2,70,442.01",
08-Jun-24,Interest,00.00,"2,70,442.01",00.00,
08-Jun-24,Debit Card,48,00.00,48,
08-Jun-24,NEFT,00.00,06.00,42,
08-Jun-24,Transfer,"11,62,362.50",00.00,"11,62,404.50",
08-Jun-24,Cash,00.00,"1,16,240.45","10,46,164.05",
08-Jun-24,Transportellaneous,"12,618.31",00.00,"10,58,782.36",
08-Jun-24,ATM,"7,00,959.75",00.00,"17,59,742.11",
08-Jun-24,Transfer,00.00,"4,39,935.53","13,19,806.58",
08-Jun-24,Transportellaneous,"3,926.00",00.00,"13,23,732.58",
08-Jun-24,Debit Card,53.57,00.00,"13,23,786.15",
08-Jun-24,Interest,20,00.00,"13,23,806.15",
08-Jun-24,NEFT,"2,403.00",00.00,"13,26,209.15",
08-Jun-24,Cash,48,00.00,"13,26,257.15",
08-Jun-24,NEFT,00.00,"1,32,625.72","11,93,631.43",
08-Jun-24,Bill,"1,519.00",00.00,"11,95,150.43",
08-Jun-24,Debit Card,392.82,00.00,"11,95,543.25",
08-Jun-24,Purchase,"77,297.00",00.00,"12,72,840.25",
08-Jun-24,Interest,00.00,"2,12,140.04","10,60,700.21",
08-Jun-24,ATM,"5,043.10",00.00,"10,65,743.31",
08-Jun-24,RTGS,00.00,"3,55,247.77","7,10,495.54",
08-Jun-24,Purchase,"29,082.00",00.00,"7,39,577.54",
08-Jun-24,ATM,00.00,"73,957.75","6,65,619.79",
09-Jun-24,Interest,00.00,"3,32,809.90","3,32,809.90",
09-Jun-24,Reversal,"23,039.00",00.00,"3,55,848.90",
10-Jun-24,IMPS,00.00,"44,481.11","3,11,367.79",
10-Jun-24,Reversal,00.00,"1,03,789.26","2,07,578.53",
10-Jun-24,NEFT,00.00,"51,894.63","1,55,683.90",
10-Jun-24,Interest,00.00,"51,894.63","1,03,789.27",
10-Jun-24,NEFT,"15,596.82",00.00,"1,19,386.09",
10-Jun-24,NEFT,00.00,"39,795.36","79,590.73",
10-Jun-24,Interest,"26,218.78",00.00,"1,05,809.51",
10-Jun-24,Transfer,28,00.00,"1,05,837.51",
10-Jun-24,RTGS,"9,10,423.00",00.00,"10,16,260.51",
10-Jun-24,Bill,00.00,"2,03,252.10","8,13,008.41",
10-Jun-24,Commission,00.00,"2,71,002.80","5,42,005.61",
10-Jun-24,RTGS,"98,010.30",00.00,"6,40,015.91",
10-Jun-24,IMPS,"15,696.00",00.00,"6,55,711.91",
10-Jun-24,ATM,00.00,"65,571.19","5,90,140.72",
10-Jun-24,ATM,53.9,00.00,"5,90,194.62",
10-Jun-24,Bill,00.00,"1,18,038.92","4,72,155.70",
10-Jun-24,ATM,00.00,"78,692.62","3,93,463.08",
10-Jun-24,NEFT,00.00,"43,718.12","3,49,744.96",
10-Jun-24,Cheque,"20,917.67",00.00,"3,70,662.63",
10-Jun-24,Cash,"2,941.00",00.00,"3,73,603.63",
10-Jun-24,Tax,27.75,00.00,"3,73,631.38",
10-Jun-24,Transfer,00.00,"53,375.91","3,20,255.47",
10-Jun-24,Commission,486.14,00.00,"3,20,741.61",
10-Jun-24,Transportellaneous,00.00,"64,148.32","2,56,593.29",
10-Jun-24,Debit Card,00.00,"42,765.55","2,13,827.74",
10-Jun-24,RTGS,"13,55,789.00",00.00,"15,69,616.74",
10-Jun-24,IMPS,07.00,00.00,"15,69,623.74",
10-Jun-24,RTGS,"1,71,360.00",00.00,"17,40,983.74",
10-Jun-24,RTGS,00.00,"8,70,491.87","8,70,491.87",
10-Jun-24,Reversal,00.00,"96,721.32","7,73,770.55",
10-Jun-24,Bill,300.88,00.00,"7,74,071.43",
10-Jun-24,RTGS,29.96,00.00,"7,74,101.39",
10-Jun-24,Debit Card,15.08,00.00,"7,74,116.47",
10-Jun-24,Debit Card,00.00,"7,74,116.47",00.00,
10-Jun-24,NEFT,"1,79,855.00",00.00,"1,79,855.00",
10-Jun-24,Interest,00.00,"22,481.88","1,57,373.12",
10-Jun-24,Debit Card,"14,199.19",00.00,"1,71,572.31",
10-Jun-24,IMPS,00.00,"28,595.39","1,42,976.92",
10-Jun-24,Reversal,00.00,"28,595.38","1,14,381.54",
10-Jun-24,Cheque,00.00,"16,340.22","98,041.32",
10-Jun-24,Debit Card,42.1,00.00,"98,083.42",
10-Jun-24,NEFT,00.00,"16,347.24","81,736.18",
10-Jun-24,Interest,00.00,"10,217.02","71,519.16",
10-Jun-24,Interest,00.00,"7,151.92","64,367.24",
10-Jun-24,IMPS,00.00,"16,091.81","48,275.43",
10-Jun-24,Cheque,56,00.00,"48,331.43",
10-Jun-24,Debit Card,00.00,"9,666.29","38,665.14",
10-Jun-24,Commission,"1,61,272.70",00.00,"1,99,937.84",
10-Jun-24,Bill,00.00,"1,99,937.84",00.00,
10-Jun-24,IMPS,41.32,00.00,41.32,
10-Jun-24,Reversal,00.00,20.66,20.66,
10-Jun-24,Cheque,00.00,05.17,15.5,
10-Jun-24,ATM,434.9,00.00,450.4,
10-Jun-24,Transfer,"1,198.00",00.00,"1,648.40",
10-Jun-24,Cheque,"16,42,325.80",00.00,"16,43,974.20",
11-Jun-24,Transportellaneous,00.00,"1,64,397.42","14,79,576.78",
12-Jun-24,Cheque,"3,807.37",00.00,"14,83,384.15",
12-Jun-24,Commission,00.00,"2,47,230.69","12,36,153.46",
12-Jun-24,Debit Card,00.00,"6,18,076.73","6,18,076.73",
12-Jun-24,Bill,00.00,"3,09,038.37","3,09,038.36",
13-Jun-24,Interest,"1,08,030.25",00.00,"4,17,068.61",
13-Jun-24,Purchase,00.00,"83,413.72","3,33,654.89",
13-Jun-24,Commission,00.00,"66,730.98","2,66,923.91",
13-Jun-24,Transfer,00.00,"33,365.49","2,33,558.42",
13-Jun-24,IMPS,"1,10,561.25",00.00,"3,44,119.67",
13-Jun-24,Tax,"11,684.42",00.00,"3,55,804.09",
13-Jun-24,Debit Card,"17,282.00",00.00,"3,73,086.09",
14-Jun-24,Bill,606,00.00,"3,73,692.09",
14-Jun-24,RTGS,"1,428.20",00.00,"3,75,120.29",
14-Jun-24,Transfer,15.49,00.00,"3,75,135.78",
14-Jun-24,RTGS,"13,73,409.75",00.00,"17,48,545.53",
14-Jun-24,Reversal,"4,366.10",00.00,"17,52,911.63",
14-Jun-24,RTGS,"1,13,520.91",00.00,"18,66,432.54",
14-Jun-24,Transportellaneous,00.00,"1,86,643.25","16,79,789.29",
14-Jun-24,Interest,00.00,"1,67,978.93","15,11,810.36",
14-Jun-24,RTGS,00.00,"15,11,810.36",00.00,
14-Jun-24,Debit Card,193.33,00.00,193.33,
14-Jun-24,Debit Card,06.92,00.00,200.25,
14-Jun-24,Interest,00.00,22.25,178,
14-Jun-24,Cash,"1,72,259.70",00.00,"1,72,437.70",
14-Jun-24,Reversal,170,00.00,"1,72,607.70",
14-Jun-24,Transfer,843.51,00.00,"1,73,451.21",
14-Jun-24,Transfer,00.00,"28,908.54","1,44,542.67",
14-Jun-24,Reversal,00.00,"72,271.34","72,271.34",
14-Jun-24,Bill,00.00,"72,271.34",00.00,
14-Jun-24,Cheque,46,00.00,46,
14-Jun-24,ATM,318.28,00.00,364.28,
14-Jun-24,Cheque,00.00,364.28,00.00,
14-Jun-24,Transfer,02.10,00.00,02.10,
14-Jun-24,RTGS,"28,663.62",00.00,"28,665.72",
14-Jun-24,RTGS,04.00,00.00,"28,669.72",
14-Jun-24,Tax,"12,45,102.50",00.00,"12,73,772.22",
14-Jun-24,Debit Card,00.00,"2,54,754.44","10,19,017.78",
14-Jun-24,Commission,"2,025.27",00.00,"10,21,043.05",
14-Jun-24,Transfer,00.00,"10,21,043.05",00.00,
14-Jun-24,IMPS,"62,777.20",00.00,"62,777.20",
14-Jun-24,Commission,"32,245.90",00.00,"95,023.10",
14-Jun-24,ATM,62.2,00.00,"95,085.30",
14-Jun-24,Tax,00.00,"13,583.61","81,501.69",
14-Jun-24,Cheque,00.00,"40,750.85","40,750.84",
14-Jun-24,Debit Card,00.00,"4,075.08","36,675.76",
14-Jun-24,Transfer,00.00,"36,675.76",00.00,
14-Jun-24,IMPS,"1,134.99",00.00,"1,134.99",
14-Jun-24,Transfer,"2,084.44",00.00,"3,219.43",
14-Jun-24,NEFT,00.00,536.57,"2,682.86",
14-Jun-24,IMPS,00.00,670.72,"2,012.14",
14-Jun-24,Purchase,"1,65,629.59",00.00,"1,67,641.73",
14-Jun-24,Purchase,"2,058.90",00.00,"1,69,700.63",
14-Jun-24,Cash,"6,18,978.25",00.00,"7,88,678.88",
14-Jun-24,IMPS,345.37,00.00,"7,89,024.25",
14-Jun-24,Interest,00.00,"98,628.03","6,90,396.22",
14-Jun-24,Debit Card,03.00,00.00,"6,90,399.22",
14-Jun-24,Interest,00.00,"3,45,199.61","3,45,199.61",
14-Jun-24,Debit Card,223,00.00,"3,45,422.61",
14-Jun-24,Debit Card,"18,358.79",00.00,"3,63,781.40",
14-Jun-24,Tax,"2,37,782.10",00.00,"6,01,563.50",
14-Jun-24,Interest,"74,345.00",00.00,"6,75,908.50",
14-Jun-24,Commission,00.00,"96,558.36","5,79,350.14",
14-Jun-24,Transfer,00.00,"1,93,116.71","3,86,233.43",
14-Jun-24,Transportellaneous,"1,665.00",00.00,"3,87,898.43",
14-Jun-24,Interest,138.9,00.00,"3,88,037.33",
14-Jun-24,NEFT,00.03,00.00,"3,88,037.36",
14-Jun-24,Transfer,00.00,"48,504.67","3,39,532.69",
14-Jun-24,IMPS,"21,912.10",00.00,"3,61,444.79",
14-Jun-24,Cash,"1,55,438.20",00.00,"5,16,882.99",
14-Jun-24,Bill,00.00,"64,610.37","4,52,272.62",
14-Jun-24,Transfer,00.00,"75,378.77","3,76,893.85",
14-Jun-24,Cheque,47.73,00.00,"3,76,941.58",
14-Jun-24,ATM,00.00,"47,117.70","3,29,823.88",
14-Jun-24,Purchase,00.00,"47,117.70","2,82,706.18",
14-Jun-24,Bill,00.00,"31,411.80","2,51,294.38",
14-Jun-24,Reversal,00.00,"62,823.60","1,88,470.78",
14-Jun-24,Transportellaneous,00.00,"1,88,470.78",00.00,
14-Jun-24,ATM,"17,23,350.00",00.00,"17,23,350.00",
14-Jun-24,ATM,14.94,00.00,"17,23,364.94",
14-Jun-24,IMPS,"1,49,190.90",00.00,"18,72,555.84",
14-Jun-24,Debit Card,327.2,00.00,"18,72,883.04",
14-Jun-24,Debit Card,"1,798.30",00.00,"18,74,681.34",
14-Jun-24,Transportellaneous,00.00,"3,12,446.89","15,62,234.45",
14-Jun-24,Purchase,479,00.00,"15,62,713.45",
14-Jun-24,Reversal,"3,515.00",00.00,"15,66,228.45",
14-Jun-24,IMPS,"15,706.00",00.00,"15,81,934.45",
14-Jun-24,Transportellaneous,00.00,"15,81,934.45",00.00,
14-Jun-24,Tax,02.90,00.00,02.90,
14-Jun-24,Reversal,07.00,00.00,09.90,
14-Jun-24,Cash,00.00,03.30,06.60,
14-Jun-24,Cheque,11.86,00.00,18.46,
15-Jun-24,Debit Card,"1,05,313.10",00.00,"1,05,331.56",
15-Jun-24,NEFT,00.00,"26,332.89","78,998.67",
15-Jun-24,Cheque,00.00,"8,777.63","70,221.04",
15-Jun-24,Cheque,"6,57,054.00",00.00,"7,27,275.04",
15-Jun-24,Cash,54,00.00,"7,27,329.04",
15-Jun-24,Transfer,00.00,"90,916.13","6,36,412.91",
15-Jun-24,Reversal,00.00,"63,641.29","5,72,771.62",
15-Jun-24,RTGS,00.00,"95,461.94","4,77,309.68",
15-Jun-24,RTGS,00.00,"2,38,654.84","2,38,654.84",
15-Jun-24,IMPS,"15,54,374.00",00.00,"17,93,028.84",
15-Jun-24,Purchase,"2,49,735.00",00.00,"20,42,763.84",
15-Jun-24,Bill,00.00,"2,55,345.48","17,87,418.36",
15-Jun-24,Debit Card,00.00,"1,78,741.84","16,08,676.52",
15-Jun-24,IMPS,01.50,00.00,"16,08,678.02",
15-Jun-24,Cash,00.00,"16,08,678.02",00.00,
15-Jun-24,Tax,393.3,00.00,393.3,
15-Jun-24,Interest,"2,03,655.00",00.00,"2,04,048.30",
15-Jun-24,RTGS,175.5,00.00,"2,04,223.80",
15-Jun-24,ATM,00.00,"1,02,111.90","1,02,111.90",
15-Jun-24,Commission,00.00,"14,587.41","87,524.49",
15-Jun-24,Purchase,32.72,00.00,"87,557.21",
15-Jun-24,Transfer,00.00,"14,592.87","72,964.34",
15-Jun-24,ATM,86.17,00.00,"73,050.51",
15-Jun-24,Tax,222.76,00.00,"73,273.27",
15-Jun-24,IMPS,"4,810.20",00.00,"78,083.47",
15-Jun-24,Cash,07.00,00.00,"78,090.47",
15-Jun-24,Transportellaneous,00.00,"9,761.31","68,329.16",
15-Jun-24,Cheque,00.00,"17,082.29","51,246.87",
15-Jun-24,Commission,00.00,"8,541.15","42,705.73",
15-Jun-24,ATM,00.00,"21,352.87","21,352.86",
15-Jun-24,Purchase,"1,56,049.90",00.00,"1,77,402.76",
15-Jun-24,RTGS,05.20,00.00,"1,77,407.96",
15-Jun-24,Transfer,00.00,"44,351.99","1,33,055.97",
15-Jun-24,Cheque,25.5,00.00,"1,33,081.47",
15-Jun-24,Purchase,"3,356.00",00.00,"1,36,437.47",
15-Jun-24,IMPS,00.00,"19,491.07","1,16,946.40",
15-Jun-24,Debit Card,"1,75,419.50",00.00,"2,92,365.90",
15-Jun-24,Bill,00.00,"73,091.48","2,19,274.42",
15-Jun-24,Cheque,00.00,"24,363.82","1,94,910.60",
15-Jun-24,Bill,00.00,"24,363.83","1,70,546.78",
15-Jun-24,Tax,00.00,"21,318.35","1,49,228.43",
15-Jun-24,Tax,00.00,"74,614.22","74,614.22",
15-Jun-24,Cash,00.00,"8,290.47","66,323.75",
15-Jun-24,RTGS,00.00,"13,264.75","53,059.00",
15-Jun-24,Cheque,06.00,00.00,"53,065.00",
16-Jun-24,Transfer,00.00,"5,306.50","47,758.50",
16-Jun-24,Bill,"22,031.38",00.00,"69,789.88",
16-Jun-24,Tax,00.00,"23,263.29","46,526.59",
16-Jun-24,Cash,50.2,00.00,"46,576.79",
16-Jun-24,Bill,302.17,00.00,"46,878.96",
16-Jun-24,Reversal,"3,900.80",00.00,"50,779.76",
16-Jun-24,Reversal,00.00,"5,077.98","45,701.78",
16-Jun-24,RTGS,00.00,"5,712.72","39,989.06",
16-Jun-24,RTGS,26.62,00.00,"40,015.68",
17-Jun-24,ATM,00.00,"4,446.19","35,569.49",
17-Jun-24,RTGS,00.00,"35,569.49",00.00,
17-Jun-24,Tax,07.10,00.00,07.10,
17-Jun-24,Tax,00.00,00.71,06.39,
17-Jun-24,Commission,00.00,01.07,05.32,
18-Jun-24,Transportellaneous,00.00,00.89,04.43,
18-Jun-24,IMPS,"1,42,991.70",00.00,"1,42,996.13",
18-Jun-24,IMPS,00.00,"15,888.46","1,27,107.67",
18-Jun-24,IMPS,07.00,00.00,"1,27,114.67",
18-Jun-24,ATM,746.99,00.00,"1,27,861.66",
18-Jun-24,Debit Card,"11,29,400.00",00.00,"12,57,261.66",
18-Jun-24,Interest,00.00,"12,57,261.66",00.00,
18-Jun-24,Cheque,44.4,00.00,44.4,
18-Jun-24,Cash,01.60,00.00,46,
18-Jun-24,Transportellaneous,00.00,05.11,40.89,
18-Jun-24,ATM,440,00.00,480.89,
18-Jun-24,Bill,00.00,120.22,360.67,
18-Jun-24,NEFT,00.00,36.07,324.6,
18-Jun-24,Interest,161,00.00,485.6,
18-Jun-24,Cheque,08.76,00.00,494.36,
18-Jun-24,Transportellaneous,02.00,00.00,496.36,
18-Jun-24,Cash,"6,21,651.80",00.00,"6,22,148.16",
18-Jun-24,Commission,00.00,"77,768.52","5,44,379.64",
18-Jun-24,Commission,55,00.00,"5,44,434.64",
18-Jun-24,Interest,"98,506.38",00.00,"6,42,941.02",
18-Jun-24,NEFT,00.00,00.00,"6,42,941.02",
18-Jun-24,Tax,06.54,00.00,"6,42,947.56",
18-Jun-24,Cheque,"1,43,020.00",00.00,"7,85,967.56",
18-Jun-24,Transportellaneous,434.8,00.00,"7,86,402.36",
18-Jun-24,Debit Card,00.00,"1,31,067.06","6,55,335.30",
18-Jun-24,Commission,00.00,"1,63,833.83","4,91,501.48",
18-Jun-24,IMPS,"17,53,471.00",00.00,"22,44,972.48",
18-Jun-24,Transportellaneous,00.00,"3,20,710.35","19,24,262.13",
18-Jun-24,Debit Card,01.06,00.00,"19,24,263.19",
18-Jun-24,NEFT,"3,704.00",00.00,"19,27,967.19",
18-Jun-24,RTGS,"30,161.04",00.00,"19,58,128.23",
18-Jun-24,Tax,00.00,"9,79,064.12","9,79,064.12",
18-Jun-24,Debit Card,02.23,00.00,"9,79,066.35",
18-Jun-24,Transportellaneous,01.60,00.00,"9,79,067.95",
18-Jun-24,Cheque,00.00,"9,79,067.95",00.00,
18-Jun-24,Bill,55.44,00.00,55.44,
18-Jun-24,Transportellaneous,00.00,13.86,41.58,
18-Jun-24,ATM,"22,304.30",00.00,"22,345.88",
18-Jun-24,Debit Card,01.20,00.00,"22,347.08",
18-Jun-24,NEFT,00.00,"3,724.51","18,622.57",
18-Jun-24,Debit Card,00.00,"9,311.29","9,311.28",
18-Jun-24,RTGS,"32,735.68",00.00,"42,046.96",
18-Jun-24,Purchase,00.00,"42,046.96",00.00,
18-Jun-24,ATM,08.00,00.00,08.00,
18-Jun-24,Cheque,00.00,08.00,00.00,
18-Jun-24,RTGS,"10,52,518.00",00.00,"10,52,518.00",
18-Jun-24,Cash,"95,794.00",00.00,"11,48,312.00",
18-Jun-24,Transportellaneous,392,00.00,"11,48,704.00",
18-Jun-24,Debit Card,00.00,"11,48,704.00",00.00,
18-Jun-24,Transfer,"1,94,384.00",00.00,"1,94,384.00",
18-Jun-24,Tax,04.80,00.00,"1,94,388.80",
18-Jun-24,Interest,"1,86,501.00",00.00,"3,80,889.80",
18-Jun-24,NEFT,00.00,"42,321.09","3,38,568.71",
18-Jun-24,ATM,00.00,"33,856.87","3,04,711.84",
18-Jun-24,Bill,00.00,"30,471.18","2,74,240.66",
18-Jun-24,Cheque,"13,28,950.00",00.00,"16,03,190.66",
18-Jun-24,RTGS,"11,021.78",00.00,"16,14,212.44",
18-Jun-24,NEFT,00.00,"2,30,601.78","13,83,610.66",
18-Jun-24,Cash,05.38,00.00,"13,83,616.04",
18-Jun-24,ATM,01.25,00.00,"13,83,617.29",
18-Jun-24,IMPS,"1,811.00",00.00,"13,85,428.29",
18-Jun-24,Commission,00.00,"1,38,542.83","12,46,885.46",
18-Jun-24,RTGS,00.00,"2,07,814.24","10,39,071.22",
18-Jun-24,RTGS,"7,40,908.00",00.00,"17,79,979.22",
18-Jun-24,Purchase,20.8,00.00,"17,80,000.02",
18-Jun-24,Cash,00.00,"5,93,333.34","11,86,666.68",
18-Jun-24,Debit Card,00.00,"1,97,777.78","9,88,888.90",
18-Jun-24,Transportellaneous,00.00,"3,29,629.63","6,59,259.27",
18-Jun-24,Cash,504.9,00.00,"6,59,764.17",
18-Jun-24,Transfer,00.00,"1,09,960.70","5,49,803.48",
18-Jun-24,Transfer,00.00,"5,49,803.48",00.00,
18-Jun-24,Cheque,"89,972.00",00.00,"89,972.00",
18-Jun-24,ATM,48,00.00,"90,020.00",
18-Jun-24,Bill,01.37,00.00,"90,021.37",
18-Jun-24,RTGS,"23,551.60",00.00,"1,13,572.97",
18-Jun-24,Tax,"1,723.20",00.00,"1,15,296.17",
18-Jun-24,Transportellaneous,"25,889.76",00.00,"1,41,185.93",
18-Jun-24,Bill,"1,96,030.50",00.00,"3,37,216.43",
18-Jun-24,IMPS,00.00,"48,173.78","2,89,042.65",
18-Jun-24,Cheque,00.00,"96,347.55","1,92,695.10",
18-Jun-24,RTGS,00.00,"32,115.85","1,60,579.25",
18-Jun-24,RTGS,"1,978.90",00.00,"1,62,558.15",
18-Jun-24,ATM,62,00.00,"1,62,620.15",
18-Jun-24,ATM,00.00,"18,068.91","1,44,551.24",
18-Jun-24,Cash,00.00,"28,910.25","1,15,640.99",
18-Jun-24,Reversal,00.00,"38,547.00","77,093.99",
18-Jun-24,Transportellaneous,"12,17,164.25",00.00,"12,94,258.24",
18-Jun-24,Cheque,"1,17,262.00",00.00,"14,11,520.24",
18-Jun-24,Purchase,63.2,00.00,"14,11,583.44",
18-Jun-24,Interest,25,00.00,"14,11,608.44",
18-Jun-24,IMPS,"10,146.74",00.00,"14,21,755.18",
18-Jun-24,Bill,00.00,"7,10,877.59","7,10,877.59",
18-Jun-24,Reversal,"15,20,764.75",00.00,"22,31,642.34",
18-Jun-24,ATM,00.00,"2,78,955.29","19,52,687.05",
18-Jun-24,Purchase,"1,58,894.30",00.00,"21,11,581.35",
18-Jun-24,Interest,00.00,"2,34,620.15","18,76,961.20",
18-Jun-24,Transportellaneous,00.00,"3,75,392.24","15,01,568.96",
18-Jun-24,RTGS,"96,592.70",00.00,"15,98,161.66",
18-Jun-24,IMPS,64,00.00,"15,98,225.66",
18-Jun-24,NEFT,52,00.00,"15,98,277.66",
18-Jun-24,Cash,386.39,00.00,"15,98,664.05",
18-Jun-24,ATM,00.00,"1,77,629.34","14,21,034.71",
18-Jun-24,Transfer,37,00.00,"14,21,071.71",
18-Jun-24,Transfer,07.39,00.00,"14,21,079.10",
18-Jun-24,Cash,40.19,00.00,"14,21,119.29",
18-Jun-24,Transfer,625.3,00.00,"14,21,744.59",
18-Jun-24,Tax,275.7,00.00,"14,22,020.29",
19-Jun-24,Interest,00.00,"1,58,002.25","12,64,018.04",
19-Jun-24,Cash,"17,63,976.75",00.00,"30,27,994.79",
19-Jun-24,Reversal,54,00.00,"30,28,048.79",
19-Jun-24,Tax,00.00,"4,32,578.40","25,95,470.39",
19-Jun-24,ATM,00.00,"5,19,094.08","20,76,376.31",
19-Jun-24,Cheque,00.00,"3,46,062.72","17,30,313.59",
19-Jun-24,Reversal,00.00,"2,16,289.20","15,14,024.39",
19-Jun-24,ATM,"1,84,212.16",00.00,"16,98,236.55",
19-Jun-24,Transportellaneous,00.00,"2,83,039.43","14,15,197.12",
19-Jun-24,RTGS,"2,288.65",00.00,"14,17,485.77",
19-Jun-24,IMPS,157.9,00.00,"14,17,643.67",
19-Jun-24,Reversal,00.00,"7,08,821.84","7,08,821.84",
19-Jun-24,Interest,00.00,"78,757.98","6,30,063.86",
19-Jun-24,Cheque,00.00,"2,10,021.29","4,20,042.57",
19-Jun-24,Commission,00.00,"1,05,010.64","3,15,031.93",
19-Jun-24,Transfer,"2,044.14",00.00,"3,17,076.07",
19-Jun-24,Transfer,00.00,"63,415.21","2,53,660.86",
19-Jun-24,Purchase,05.85,00.00,"2,53,666.71",
19-Jun-24,Cheque,00.00,"1,26,833.36","1,26,833.36",
19-Jun-24,IMPS,"16,61,450.00",00.00,"17,88,283.36",
19-Jun-24,IMPS,00.00,"3,57,656.67","14,30,626.69",
19-Jun-24,Transportellaneous,00.00,"3,57,656.67","10,72,970.02",
19-Jun-24,Transportellaneous,"1,01,435.69",00.00,"11,74,405.71",
19-Jun-24,Cash,"6,202.00",00.00,"11,80,607.71",
19-Jun-24,Debit Card,00.00,"3,93,535.90","7,87,071.81",
19-Jun-24,Interest,00.00,"1,57,414.36","6,29,657.45",
19-Jun-24,Tax,00.00,"1,25,931.49","5,03,725.96",
19-Jun-24,Transfer,03.30,00.00,"5,03,729.26",
19-Jun-24,Transfer,"21,317.28",00.00,"5,25,046.54",
19-Jun-24,RTGS,00.00,"87,507.76","4,37,538.78",
20-Jun-24,RTGS,00.00,"62,505.54","3,75,033.24",
20-Jun-24,Transportellaneous,00.00,"1,25,011.08","2,50,022.16",
20-Jun-24,Debit Card,00.00,"83,340.72","1,66,681.44",
20-Jun-24,Cash,00.00,"16,668.14","1,50,013.30",
20-Jun-24,Transfer,00.00,"30,002.66","1,20,010.64",
20-Jun-24,Debit Card,00.00,"60,005.32","60,005.32",
20-Jun-24,Transfer,"2,76,808.00",00.00,"3,36,813.32",
20-Jun-24,Tax,00.00,"48,116.19","2,88,697.13",
20-Jun-24,Transfer,00.00,"96,232.38","1,92,464.75",
20-Jun-24,RTGS,35.08,00.00,"1,92,499.83",
20-Jun-24,Interest,04.00,00.00,"1,92,503.83",
20-Jun-24,ATM,499,00.00,"1,93,002.83",
20-Jun-24,Cash,07.90,00.00,"1,93,010.73",
20-Jun-24,Cheque,"9,37,916.00",00.00,"11,30,926.73",
20-Jun-24,Interest,52.1,00.00,"11,30,978.83",
21-Jun-24,Commission,"3,811.40",00.00,"11,34,790.23",
21-Jun-24,IMPS,00.00,"5,67,395.12","5,67,395.12",
21-Jun-24,Transfer,07.90,00.00,"5,67,403.02",
21-Jun-24,Cheque,05.00,00.00,"5,67,408.02",
21-Jun-24,Transfer,00.00,"1,89,136.01","3,78,272.01",
21-Jun-24,ATM,"15,91,450.50",00.00,"19,69,722.51",
21-Jun-24,Bill,00.00,"2,18,858.06","17,50,864.45",
21-Jun-24,Transfer,"2,26,198.50",00.00,"19,77,062.95",
21-Jun-24,Cash,"28,445.00",00.00,"20,05,507.95",
21-Jun-24,RTGS,00.00,00.00,"20,05,507.95",
21-Jun-24,Transfer,00.00,"2,22,834.22","17,82,673.73",
21-Jun-24,RTGS,00.00,"3,56,534.75","14,26,138.98",
21-Jun-24,Transfer,00.00,"1,78,267.37","12,47,871.61",
21-Jun-24,Transfer,07.26,00.00,"12,47,878.87",
21-Jun-24,Tax,174.5,00.00,"12,48,053.37",
21-Jun-24,Interest,00.00,"1,78,293.34","10,69,760.03",
21-Jun-24,Debit Card,"2,89,349.75",00.00,"13,59,109.78",
21-Jun-24,Interest,"17,845.18",00.00,"13,76,954.96",
21-Jun-24,Transportellaneous,"2,901.30",00.00,"13,79,856.26",
21-Jun-24,Bill,"20,15,829.00",00.00,"33,95,685.26",
21-Jun-24,Purchase,07.91,00.00,"33,95,693.17",
21-Jun-24,Commission,"3,228.00",00.00,"33,98,921.17",
21-Jun-24,RTGS,00.00,"3,39,892.12","30,59,029.05",
21-Jun-24,ATM,00.00,"3,05,902.91","27,53,126.14",
21-Jun-24,Debit Card,"14,45,836.00",00.00,"41,98,962.14",
21-Jun-24,Bill,"2,827.90",00.00,"42,01,790.04",
21-Jun-24,Tax,132,00.00,"42,01,922.04",
22-Jun-24,IMPS,"2,021.77",00.00,"42,03,943.81",
22-Jun-24,NEFT,00.00,"8,40,788.76","33,63,155.05",
22-Jun-24,Commission,00.05,00.00,"33,63,155.10",
22-Jun-24,Cash,00.00,"16,81,577.55","16,81,577.55",
22-Jun-24,Reversal,05.20,00.00,"16,81,582.75",
22-Jun-24,Bill,"23,647.30",00.00,"17,05,230.05",
22-Jun-24,Transfer,05.60,00.00,"17,05,235.65",
22-Jun-24,ATM,00.00,"2,84,205.94","14,21,029.71",
22-Jun-24,Tax,00.00,"2,36,838.29","11,84,191.42",
22-Jun-24,Cheque,"30,011.07",00.00,"12,14,202.49",
22-Jun-24,IMPS,03.35,00.00,"12,14,205.84",
22-Jun-24,ATM,00.00,"1,73,457.98","10,40,747.86",
22-Jun-24,RTGS,54,00.00,"10,40,801.86",
22-Jun-24,Transfer,00.00,"1,48,685.98","8,92,115.88",
22-Jun-24,Reversal,00.00,00.00,"8,92,115.88",
22-Jun-24,Transfer,00.00,"1,11,514.49","7,80,601.40",
22-Jun-24,Transfer,00.00,"7,80,601.40",00.00,
22-Jun-24,Cheque,269.9,00.00,269.9,
22-Jun-24,Cheque,00.00,134.95,134.95,
22-Jun-24,Commission,00.00,134.95,00.00,
22-Jun-24,Transfer,"2,272.00",00.00,"2,272.00",
22-Jun-24,ATM,00.00,757.33,"1,514.67",
22-Jun-24,RTGS,"9,54,019.50",00.00,"9,55,534.17",
22-Jun-24,RTGS,"2,287.13",00.00,"9,57,821.30",
22-Jun-24,Transportellaneous,00.00,"1,06,424.59","8,51,396.71",
22-Jun-24,Tax,"19,203.30",00.00,"8,70,600.01",
22-Jun-24,Transfer,31.56,00.00,"8,70,631.57",
22-Jun-24,Cash,00.00,"96,736.84","7,73,894.73",
22-Jun-24,Bill,00.00,"96,736.84","6,77,157.89",
22-Jun-24,Debit Card,"9,33,603.80",00.00,"16,10,761.69",
22-Jun-24,RTGS,"30,156.90",00.00,"16,40,918.59",
22-Jun-24,Bill,00.00,"2,73,486.43","13,67,432.16",
22-Jun-24,Cash,00.00,"4,55,810.72","9,11,621.44",
22-Jun-24,Purchase,00.00,"1,30,231.63","7,81,389.81",
22-Jun-24,NEFT,00.00,"3,90,694.91","3,90,694.90",
22-Jun-24,RTGS,00.00,"1,95,347.45","1,95,347.45",
22-Jun-24,Reversal,62.3,00.00,"1,95,409.75",
22-Jun-24,Cheque,00.00,"48,852.44","1,46,557.31",
22-Jun-24,Bill,05.33,00.00,"1,46,562.64",
22-Jun-24,IMPS,07.02,00.00,"1,46,569.66",
22-Jun-24,Cash,300.39,00.00,"1,46,870.05",
23-Jun-24,RTGS,00.00,"24,478.34","1,22,391.71",
23-Jun-24,ATM,00.00,"13,599.08","1,08,792.63",
23-Jun-24,Interest,00.00,"13,599.08","95,193.55",
23-Jun-24,Purchase,00.00,"47,596.78","47,596.78",
23-Jun-24,Purchase,"1,48,653.97",00.00,"1,96,250.75",
23-Jun-24,Reversal,00.00,"98,125.38","98,125.38",
23-Jun-24,Cheque,00.00,"12,265.67","85,859.71",
23-Jun-24,Cash,00.00,"10,732.46","75,127.25",
23-Jun-24,Tax,00.00,"15,025.45","60,101.80",
23-Jun-24,Bill,00.00,"6,677.98","53,423.82",
23-Jun-24,Cheque,00.00,"10,684.76","42,739.06",
23-Jun-24,RTGS,03.00,00.00,"42,742.06",
23-Jun-24,IMPS,42.72,00.00,"42,784.78",
23-Jun-24,Bill,01.40,00.00,"42,786.18",
23-Jun-24,IMPS,"1,53,403.41",00.00,"1,96,189.59",
23-Jun-24,Reversal,33.02,00.00,"1,96,222.61",
23-Jun-24,Purchase,00.00,"32,703.77","1,63,518.84",
23-Jun-24,IMPS,02.81,00.00,"1,63,521.65",
23-Jun-24,Interest,00.00,"32,704.33","1,30,817.32",
23-Jun-24,Transfer,00.00,"43,605.77","87,211.55",
23-Jun-24,Cash,"13,49,115.75",00.00,"14,36,327.30",
23-Jun-24,IMPS,00.00,"2,05,189.61","12,31,137.69",
23-Jun-24,Transfer,"8,844.00",00.00,"12,39,981.69",
23-Jun-24,Commission,332,00.00,"12,40,313.69",
23-Jun-24,Tax,00.00,"2,48,062.74","9,92,250.95",
23-Jun-24,Purchase,279.65,00.00,"9,92,530.60",
23-Jun-24,Debit Card,"1,20,708.00",00.00,"11,13,238.60",
23-Jun-24,Purchase,00.00,"1,11,323.86","10,01,914.74",
23-Jun-24,Cheque,"1,81,824.00",00.00,"11,83,738.74",
23-Jun-24,Reversal,"17,25,352.00",00.00,"29,09,090.74",
23-Jun-24,Debit Card,00.00,"3,63,636.34","25,45,454.40",
23-Jun-24,Debit Card,00.00,"3,63,636.34","21,81,818.06",
23-Jun-24,Transportellaneous,63.6,00.00,"21,81,881.66",
23-Jun-24,Bill,00.00,"2,42,431.30","19,39,450.36",
23-Jun-24,Cheque,"4,062.21",00.00,"19,43,512.57",
23-Jun-24,Reversal,00.00,"3,23,918.76","16,19,593.81",
23-Jun-24,Commission,00.00,"5,39,864.60","10,79,729.21",
23-Jun-24,ATM,00.00,"5,39,864.61","5,39,864.60",
23-Jun-24,Transfer,"1,474.40",00.00,"5,41,339.00",
23-Jun-24,Cash,00.00,"1,35,334.75","4,06,004.25",
23-Jun-24,Purchase,"8,666.90",00.00,"4,14,671.15",
23-Jun-24,IMPS,00.00,"51,833.89","3,62,837.26",
23-Jun-24,IMPS,00.00,"1,81,418.63","1,81,418.63",
23-Jun-24,Transportellaneous,00.00,"36,283.73","1,45,134.90",
23-Jun-24,IMPS,00.00,"1,45,134.90",00.00,
23-Jun-24,Interest,29.07,00.00,29.07,
23-Jun-24,ATM,00.00,04.85,24.22,
23-Jun-24,Debit Card,00.00,02.69,21.53,
23-Jun-24,Commission,"12,07,552.75",00.00,"12,07,574.28",
23-Jun-24,Purchase,01.00,00.00,"12,07,575.28",
23-Jun-24,ATM,00.00,"2,01,262.55","10,06,312.73",
23-Jun-24,Transfer,00.00,"3,35,437.58","6,70,875.15",
23-Jun-24,Interest,138.54,00.00,"6,71,013.69",
23-Jun-24,Reversal,00.00,"95,859.10","5,75,154.59",
23-Jun-24,Bill,296.3,00.00,"5,75,450.89",
23-Jun-24,ATM,00.00,"1,91,816.96","3,83,633.93",
23-Jun-24,RTGS,00.00,"63,938.99","3,19,694.94",
23-Jun-24,Cash,"19,998.60",00.00,"3,39,693.54",
23-Jun-24,Debit Card,"1,77,476.00",00.00,"5,17,169.54",
23-Jun-24,Purchase,502,00.00,"5,17,671.54",
23-Jun-24,NEFT,00.00,"1,29,417.89","3,88,253.66",
23-Jun-24,Purchase,00.00,"38,825.37","3,49,428.29",
23-Jun-24,NEFT,"3,983.00",00.00,"3,53,411.29",
23-Jun-24,Bill,00.00,"88,352.82","2,65,058.47",
23-Jun-24,NEFT,00.00,"29,450.94","2,35,607.53",
23-Jun-24,IMPS,"1,39,770.50",00.00,"3,75,378.03",
23-Jun-24,Reversal,"3,25,890.25",00.00,"7,01,268.28",
23-Jun-24,NEFT,00.00,"87,658.54","6,13,609.74",
23-Jun-24,RTGS,"1,40,403.97",00.00,"7,54,013.71",
23-Jun-24,Tax,06.00,00.00,"7,54,019.71",
23-Jun-24,Purchase,00.00,"1,25,669.95","6,28,349.76",
23-Jun-24,Reversal,00.00,"78,543.72","5,49,806.04",
23-Jun-24,Cash,06.00,00.00,"5,49,812.04",
23-Jun-24,Transfer,00.00,"91,635.34","4,58,176.70",
23-Jun-24,NEFT,00.00,"50,908.52","4,07,268.18",
23-Jun-24,Debit Card,00.00,"4,07,268.18",00.00,
23-Jun-24,Transfer,14,00.00,14,
23-Jun-24,Bill,"11,349.00",00.00,"11,363.00",
23-Jun-24,Reversal,10.8,00.00,"11,373.80",
23-Jun-24,RTGS,"2,032.90",00.00,"13,406.70",
23-Jun-24,IMPS,00.00,"2,681.34","10,725.36",
23-Jun-24,IMPS,00.00,"1,787.56","8,937.80",
23-Jun-24,Purchase,00.00,893.78,"8,044.02",
23-Jun-24,RTGS,00.00,"1,608.80","6,435.22",
23-Jun-24,Transportellaneous,00.00,"1,608.81","4,826.42",
23-Jun-24,Transportellaneous,00.00,804.4,"4,022.02",
23-Jun-24,NEFT,"15,49,873.00",00.00,"15,53,895.02",
23-Jun-24,IMPS,07.83,00.00,"15,53,902.85",
24-Jun-24,Bill,00.00,"2,58,983.81","12,94,919.04",
24-Jun-24,Purchase,00.00,"2,58,983.81","10,35,935.23",
24-Jun-24,ATM,00.00,"1,29,491.90","9,06,443.33",
24-Jun-24,Tax,"3,551.00",00.00,"9,09,994.33",
24-Jun-24,RTGS,11.8,00.00,"9,10,006.13",
24-Jun-24,Cash,00.00,"1,30,000.88","7,80,005.25",
25-Jun-24,Bill,"4,66,391.20",00.00,"12,46,396.45",
25-Jun-24,Purchase,00.00,"1,78,056.64","10,68,339.81",
25-Jun-24,Debit Card,"2,53,669.00",00.00,"13,22,008.81",
25-Jun-24,Transfer,21.72,00.00,"13,22,030.53",
25-Jun-24,Transportellaneous,00.00,"1,32,203.05","11,89,827.48",
25-Jun-24,RTGS,00.00,"1,98,304.58","9,91,522.90",
25-Jun-24,NEFT,"31,703.00",00.00,"10,23,225.90",
25-Jun-24,Transfer,06.50,00.00,"10,23,232.40",
25-Jun-24,Cash,451,00.00,"10,23,683.40",
25-Jun-24,RTGS,229.6,00.00,"10,23,913.00",
25-Jun-24,Cheque,"21,180.00",00.00,"10,45,093.00",
25-Jun-24,Cash,00.00,"5,22,546.50","5,22,546.50",
25-Jun-24,Tax,"14,724.00",00.00,"5,37,270.50",
25-Jun-24,Reversal,00.00,"59,696.72","4,77,573.78",
25-Jun-24,Transportellaneous,"28,623.00",00.00,"5,06,196.78",
25-Jun-24,Cheque,00.00,"72,313.83","4,33,882.95",
25-Jun-24,Cheque,"59,284.40",00.00,"4,93,167.35",
25-Jun-24,Tax,17,00.00,"4,93,184.35",
25-Jun-24,Commission,00.00,"49,318.44","4,43,865.92",
25-Jun-24,Bill,00.00,"1,10,966.48","3,32,899.44",
25-Jun-24,Purchase,00.00,"83,224.86","2,49,674.58",
25-Jun-24,Debit Card,00.00,"41,612.43","2,08,062.15",
25-Jun-24,Bill,200.7,00.00,"2,08,262.85",
25-Jun-24,ATM,"81,427.20",00.00,"2,89,690.05",
25-Jun-24,Bill,00.00,"2,89,690.05",00.00,
25-Jun-24,Cheque,"15,075.05",00.00,"15,075.05",
25-Jun-24,Transportellaneous,"10,13,238.80",00.00,"10,28,313.85",
25-Jun-24,Commission,29.88,00.00,"10,28,343.73",
25-Jun-24,Cheque,"10,473.53",00.00,"10,38,817.26",
25-Jun-24,Tax,00.00,"2,59,704.32","7,79,112.94",
26-Jun-24,RTGS,07.00,00.00,"7,79,119.94",
26-Jun-24,Debit Card,"18,83,055.50",00.00,"26,62,175.44",
26-Jun-24,Reversal,"8,982.00",00.00,"26,71,157.44",
26-Jun-24,Interest,"1,46,255.12",00.00,"28,17,412.56",
26-Jun-24,Cash,02.50,00.00,"28,17,415.06",
26-Jun-24,RTGS,"8,18,858.00",00.00,"36,36,273.06",
26-Jun-24,Transfer,"3,54,866.00",00.00,"39,91,139.06",
26-Jun-24,NEFT,"2,712.88",00.00,"39,93,851.94",
26-Jun-24,Transfer,"2,02,810.00",00.00,"41,96,661.94",
26-Jun-24,Transportellaneous,"2,44,904.70",00.00,"44,41,566.64",
26-Jun-24,IMPS,00.00,"14,80,522.21","29,61,044.43",
26-Jun-24,Transfer,00.00,"7,40,261.11","22,20,783.32",
27-Jun-24,NEFT,00.00,"2,77,597.92","19,43,185.40",
27-Jun-24,ATM,"4,65,792.50",00.00,"24,08,977.90",
27-Jun-24,ATM,00.00,"3,44,139.70","20,64,838.20",
27-Jun-24,Reversal,00.00,"2,58,104.78","18,06,733.42",
27-Jun-24,Cheque,"16,46,806.00",00.00,"34,53,539.42",
27-Jun-24,Reversal,00.00,"17,26,769.71","17,26,769.71",
27-Jun-24,Bill,"15,073.00",00.00,"17,41,842.71",
27-Jun-24,RTGS,07.20,00.00,"17,41,849.91",
27-Jun-24,Transfer,00.00,"1,93,538.88","15,48,311.03",
27-Jun-24,Transportellaneous,"1,299.40",00.00,"15,49,610.43",
27-Jun-24,Transportellaneous,00.00,"2,58,268.41","12,91,342.02",
27-Jun-24,Tax,"6,81,776.00",00.00,"19,73,118.02",
27-Jun-24,Bill,440.1,00.00,"19,73,558.12",
27-Jun-24,RTGS,"11,02,834.00",00.00,"30,76,392.12",
27-Jun-24,Cash,05.32,00.00,"30,76,397.44",
27-Jun-24,Cheque,00.00,"6,15,279.49","24,61,117.95",
27-Jun-24,Debit Card,"2,36,609.80",00.00,"26,97,727.75",
27-Jun-24,Reversal,18,00.00,"26,97,745.75",
27-Jun-24,Purchase,"1,160.95",00.00,"26,98,906.70",
27-Jun-24,NEFT,02.00,00.00,"26,98,908.70",
27-Jun-24,Transportellaneous,"51,404.20",00.00,"27,50,312.90",
27-Jun-24,Bill,00.00,"9,16,770.97","18,33,541.93",
27-Jun-24,Commission,00.00,"2,03,726.88","16,29,815.05",
27-Jun-24,Commission,00.00,"2,32,830.72","13,96,984.33",
27-Jun-24,Tax,00.00,"1,55,220.48","12,41,763.85",
27-Jun-24,Cash,00.00,"1,24,176.39","11,17,587.47",
27-Jun-24,Reversal,"10,89,226.20",00.00,"22,06,813.67",
27-Jun-24,IMPS,00.00,"2,45,201.52","19,61,612.15",
27-Jun-24,RTGS,998,00.00,"19,62,610.15",
27-Jun-24,ATM,"19,48,829.50",00.00,"39,11,439.65",
27-Jun-24,ATM,"11,756.71",00.00,"39,23,196.36",
27-Jun-24,Debit Card,00.00,"19,61,598.18","19,61,598.18",
27-Jun-24,Interest,00.00,"2,80,228.31","16,81,369.87",
27-Jun-24,ATM,"10,23,960.50",00.00,"27,05,330.37",
27-Jun-24,Interest,00.00,"13,52,665.19","13,52,665.18",
27-Jun-24,Commission,00.00,"3,38,166.30","10,14,498.88",
27-Jun-24,Cheque,"14,71,982.00",00.00,"24,86,480.88",
28-Jun-24,Tax,00.00,"12,43,240.44","12,43,240.44",
28-Jun-24,Debit Card,00.00,"1,77,605.78","10,65,634.66",
28-Jun-24,Bill,"4,596.95",00.00,"10,70,231.61",
28-Jun-24,Bill,00.00,"1,33,778.95","9,36,452.66",
28-Jun-24,ATM,02.00,00.00,"9,36,454.66",
28-Jun-24,Cash,"61,186.80",00.00,"9,97,641.46",
28-Jun-24,Transportellaneous,"19,072.12",00.00,"10,16,713.58",
28-Jun-24,Tax,00.00,"1,69,452.26","8,47,261.32",
28-Jun-24,RTGS,00.00,"84,726.13","7,62,535.19",
28-Jun-24,Cash,00.00,"1,52,507.04","6,10,028.15",
28-Jun-24,Cheque,06.00,00.00,"6,10,034.15",
28-Jun-24,Transfer,311,00.00,"6,10,345.15",
28-Jun-24,Purchase,"1,80,000.56",00.00,"7,90,345.71",
28-Jun-24,IMPS,"7,697.94",00.00,"7,98,043.65",
28-Jun-24,NEFT,"92,112.00",00.00,"8,90,155.65",
28-Jun-24,Bill,"18,79,929.75",00.00,"27,70,085.40",
28-Jun-24,RTGS,00.00,"3,95,726.49","23,74,358.91",
28-Jun-24,Debit Card,00.00,"2,96,794.86","20,77,564.05",
28-Jun-24,Tax,369.1,00.00,"20,77,933.15",
28-Jun-24,Reversal,06.70,00.00,"20,77,939.85",
28-Jun-24,Tax,"3,389.70",00.00,"20,81,329.55",
28-Jun-24,ATM,00.00,"2,60,166.19","18,21,163.36",
28-Jun-24,RTGS,00.00,"2,02,351.48","16,18,811.88",
28-Jun-24,IMPS,"9,216.00",00.00,"16,28,027.88",
28-Jun-24,Bill,04.40,00.00,"16,28,032.28",
28-Jun-24,Bill,"31,347.10",00.00,"16,59,379.38",
28-Jun-24,Tax,05.00,00.00,"16,59,384.38",
28-Jun-24,ATM,02.42,00.00,"16,59,386.80",
28-Jun-24,ATM,369,00.00,"16,59,755.80",
28-Jun-24,Transportellaneous,"23,283.00",00.00,"16,83,038.80",
28-Jun-24,Purchase,04.00,00.00,"16,83,042.80",
28-Jun-24,Bill,00.00,"4,20,760.70","12,62,282.10",
28-Jun-24,NEFT,"10,38,347.50",00.00,"23,00,629.60",
28-Jun-24,Cash,29.3,00.00,"23,00,658.90",
28-Jun-24,Commission,"1,92,546.62",00.00,"24,93,205.52",
28-Jun-24,RTGS,00.00,"4,15,534.25","20,77,671.27",
28-Jun-24,Cheque,00.00,"2,59,708.91","18,17,962.36",
28-Jun-24,Interest,"54,550.00",00.00,"18,72,512.36",
28-Jun-24,Tax,160.4,00.00,"18,72,672.76",
28-Jun-24,Purchase,"4,002.00",00.00,"18,76,674.76",
28-Jun-24,Transportellaneous,00.00,"3,75,334.95","15,01,339.81",
28-Jun-24,Cash,00.39,00.00,"15,01,340.20",
28-Jun-24,Reversal,00.00,"7,50,670.10","7,50,670.10",
28-Jun-24,NEFT,00.00,"1,87,667.53","5,63,002.57",
28-Jun-24,Purchase,"1,772.70",00.00,"5,64,775.27",
28-Jun-24,Debit Card,"13,51,444.20",00.00,"19,16,219.47",
29-Jun-24,Cash,148,00.00,"19,16,367.47",
29-Jun-24,NEFT,"2,976.00",00.00,"19,19,343.47",
29-Jun-24,RTGS,40.59,00.00,"19,19,384.06",
29-Jun-24,Bill,00.00,"2,39,923.01","16,79,461.05",
29-Jun-24,Transportellaneous,00.00,"2,79,910.18","13,99,550.88",
29-Jun-24,Purchase,00.00,"2,33,258.48","11,66,292.40",
29-Jun-24,Reversal,00.00,"1,45,786.55","10,20,505.85",
30-Jun-24,Interest,00.00,"1,45,786.55","8,74,719.30",
30-Jun-24,Cash,00.00,"1,74,943.86","6,99,775.44",
30-Jun-24,IMPS,00.00,"99,967.92","5,99,807.52",
30-Jun-24,Reversal,34,00.00,"5,99,841.52",
30-Jun-24,Cash,51,00.00,"5,99,892.52",
30-Jun-24,Cash,05.00,00.00,"5,99,897.52",
30-Jun-24,Cash,00.00,"1,49,974.38","4,49,923.14",
30-Jun-24,Reversal,00.00,"64,274.73","3,85,648.41",
30-Jun-24,Bill,00.00,"1,92,824.21","1,92,824.20",
30-Jun-24,Interest,00.00,"19,282.42","1,73,541.78",
01-Jul-24,Bill,00.00,"28,923.63","1,44,618.15",
01-Jul-24,Cash,00.00,"16,068.68","1,28,549.47",
01-Jul-24,NEFT,"2,957.50",00.00,"1,31,506.97",
01-Jul-24,Reversal,00.00,"26,301.39","1,05,205.58",
01-Jul-24,NEFT,00.00,"10,520.56","94,685.02",
01-Jul-24,Cash,00.00,"13,526.43","81,158.59",
01-Jul-24,Interest,"53,288.78",00.00,"1,34,447.37",
01-Jul-24,Purchase,00.00,"26,889.47","1,07,557.90",
01-Jul-24,Transportellaneous,00.00,"21,511.58","86,046.32",
01-Jul-24,Tax,00.00,"12,292.33","73,753.99",
01-Jul-24,Debit Card,00.00,"24,584.66","49,169.33",
01-Jul-24,ATM,166,00.00,"49,335.33",
01-Jul-24,Tax,07.02,00.00,"49,342.35",
01-Jul-24,Bill,02.20,00.00,"49,344.55",
01-Jul-24,Commission,00.00,"16,448.18","32,896.37",
01-Jul-24,Cash,00.00,"3,655.15","29,241.22",
01-Jul-24,Tax,"9,15,882.00",00.00,"9,45,123.22",
01-Jul-24,Cash,"21,537.90",00.00,"9,66,661.12",
01-Jul-24,Transfer,00.00,"1,93,332.22","7,73,328.90",
01-Jul-24,RTGS,00.00,"85,925.43","6,87,403.47",
01-Jul-24,Bill,04.10,00.00,"6,87,407.57",
01-Jul-24,Reversal,"12,384.00",00.00,"6,99,791.57",
01-Jul-24,IMPS,482.79,00.00,"7,00,274.36",
01-Jul-24,Transportellaneous,00.00,"1,75,068.59","5,25,205.77",
01-Jul-24,IMPS,30,00.00,"5,25,235.77",
01-Jul-24,Interest,00.00,"75,033.68","4,50,202.09",
01-Jul-24,NEFT,00.00,"64,314.58","3,85,887.51",
01-Jul-24,Transfer,00.00,"55,126.79","3,30,760.72",
01-Jul-24,ATM,"1,43,084.30",00.00,"4,73,845.02",
01-Jul-24,Transfer,00.00,"4,73,845.02",00.00,
01-Jul-24,Cash,"2,79,032.20",00.00,"2,79,032.20",
01-Jul-24,ATM,191.29,00.00,"2,79,223.49",
02-Jul-24,Tax,502,00.00,"2,79,725.49",
02-Jul-24,Reversal,00.00,"2,79,725.49",00.00,
02-Jul-24,Cash,"3,41,659.25",00.00,"3,41,659.25",
02-Jul-24,Purchase,"2,60,120.60",00.00,"6,01,779.85",
02-Jul-24,Interest,331,00.00,"6,02,110.85",
02-Jul-24,Commission,"3,016.00",00.00,"6,05,126.85",
02-Jul-24,Debit Card,"3,968.93",00.00,"6,09,095.78",
03-Jul-24,IMPS,04.40,00.00,"6,09,100.18",
03-Jul-24,Tax,00.00,"3,04,550.09","3,04,550.09",
03-Jul-24,IMPS,"11,717.00",00.00,"3,16,267.09",
03-Jul-24,IMPS,"2,32,952.16",00.00,"5,49,219.25",
03-Jul-24,Commission,"52,731.00",00.00,"6,01,950.25",
03-Jul-24,Transfer,00.00,"60,195.03","5,41,755.22",
03-Jul-24,RTGS,00.00,"54,175.52","4,87,579.70",
03-Jul-24,Transfer,"17,56,228.00",00.00,"22,43,807.70",
03-Jul-24,Transfer,422,00.00,"22,44,229.70",
03-Jul-24,Bill,00.00,"2,80,528.71","19,63,700.99",
03-Jul-24,Transfer,45.74,00.00,"19,63,746.73",
03-Jul-24,Cheque,00.00,"2,18,194.08","17,45,552.65",
03-Jul-24,Transportellaneous,00.00,"4,36,388.16","13,09,164.49",
03-Jul-24,Interest,00.00,"4,36,388.16","8,72,776.33",
03-Jul-24,Cash,00.00,"1,45,462.72","7,27,313.61",
03-Jul-24,Interest,00.00,"1,81,828.40","5,45,485.21",
03-Jul-24,Interest,00.00,"1,36,371.30","4,09,113.91",
03-Jul-24,Transportellaneous,00.00,"1,36,371.30","2,72,742.61",
03-Jul-24,Transportellaneous,"13,21,469.50",00.00,"15,94,212.11",
03-Jul-24,Transportellaneous,00.00,"7,97,106.06","7,97,106.06",
03-Jul-24,NEFT,00.00,"1,13,872.29","6,83,233.77",
03-Jul-24,ATM,337.47,00.00,"6,83,571.24",
03-Jul-24,IMPS,05.70,00.00,"6,83,576.94",
03-Jul-24,ATM,00.00,"1,36,715.39","5,46,861.55",
03-Jul-24,Bill,00.00,"91,143.59","4,55,717.96",
03-Jul-24,Bill,213.64,00.00,"4,55,931.60",
03-Jul-24,IMPS,"17,50,036.00",00.00,"22,05,967.60",
03-Jul-24,Bill,"2,173.10",00.00,"22,08,140.70",
03-Jul-24,RTGS,00.00,"11,04,070.35","11,04,070.35",
03-Jul-24,Interest,00.00,"2,20,814.07","8,83,256.28",
03-Jul-24,Cheque,00.00,"1,10,407.04","7,72,849.24",
03-Jul-24,Tax,00.00,"2,57,616.41","5,15,232.83",
03-Jul-24,Reversal,07.20,00.00,"5,15,240.03",
03-Jul-24,Cash,"2,743.00",00.00,"5,17,983.03",
03-Jul-24,Interest,"1,262.30",00.00,"5,19,245.33",
03-Jul-24,Interest,38.7,00.00,"5,19,284.03",
03-Jul-24,Cash,655.3,00.00,"5,19,939.33",
03-Jul-24,Transportellaneous,02.00,00.00,"5,19,941.33",
03-Jul-24,Transportellaneous,111,00.00,"5,20,052.33",
03-Jul-24,Purchase,00.00,"2,60,026.17","2,60,026.16",
03-Jul-24,Transportellaneous,00.00,"26,002.62","2,34,023.54",
03-Jul-24,Interest,31.78,00.00,"2,34,055.32",
03-Jul-24,Cheque,00.00,"78,018.44","1,56,036.88",
03-Jul-24,Purchase,"1,10,431.91",00.00,"2,66,468.79",
03-Jul-24,Debit Card,00.00,"29,607.64","2,36,861.15",
03-Jul-24,Interest,00.00,"23,686.12","2,13,175.04",
03-Jul-24,ATM,00.00,"2,13,175.04",00.00,
03-Jul-24,Purchase,"1,84,248.28",00.00,"1,84,248.28",
03-Jul-24,Bill,00.00,"92,124.14","92,124.14",
03-Jul-24,Cheque,00.00,"46,062.07","46,062.07",
03-Jul-24,NEFT,00.00,"15,354.02","30,708.05",
03-Jul-24,NEFT,01.92,00.00,"30,709.97",
03-Jul-24,Transportellaneous,"11,863.00",00.00,"42,572.97",
04-Jul-24,NEFT,28,00.00,"42,600.97",
04-Jul-24,Bill,19.61,00.00,"42,620.58",
04-Jul-24,Tax,"3,636.00",00.00,"46,256.58",
04-Jul-24,Commission,00.00,"15,418.86","30,837.72",
04-Jul-24,Debit Card,"12,75,749.75",00.00,"13,06,587.47",
04-Jul-24,Bill,00.00,"1,30,658.75","11,75,928.72",
04-Jul-24,Purchase,00.00,"1,95,988.12","9,79,940.60",
04-Jul-24,Bill,00.00,"1,39,991.51","8,39,949.09",
04-Jul-24,Reversal,"42,491.00",00.00,"8,82,440.09",
04-Jul-24,Cheque,00.00,"2,20,610.02","6,61,830.07",
04-Jul-24,Cheque,00.00,"73,536.67","5,88,293.40",
04-Jul-24,Commission,"2,27,976.00",00.00,"8,16,269.40",
04-Jul-24,Transportellaneous,489.31,00.00,"8,16,758.71",
04-Jul-24,Tax,"1,048.00",00.00,"8,17,806.71",
04-Jul-24,Debit Card,00.00,"4,08,903.36","4,08,903.36",
04-Jul-24,Commission,00.00,"4,08,903.36",00.00,
04-Jul-24,NEFT,"22,218.00",00.00,"22,218.00",
04-Jul-24,Tax,00.00,"2,468.67","19,749.33",
04-Jul-24,Debit Card,"2,26,094.50",00.00,"2,45,843.83",
04-Jul-24,Cheque,00.00,"24,584.38","2,21,259.45",
05-Jul-24,Reversal,177,00.00,"2,21,436.45",
05-Jul-24,NEFT,00.00,"36,906.08","1,84,530.38",
05-Jul-24,ATM,43.66,00.00,"1,84,574.04",
05-Jul-24,Interest,00.00,"1,84,574.04",00.00,
05-Jul-24,NEFT,"26,399.57",00.00,"26,399.57",
05-Jul-24,Transfer,00.00,"4,399.93","21,999.64",
05-Jul-24,Tax,43,00.00,"22,042.64",
05-Jul-24,IMPS,"11,70,348.00",00.00,"11,92,390.64",
05-Jul-24,NEFT,"4,81,143.75",00.00,"16,73,534.39",
05-Jul-24,Cash,14,00.00,"16,73,548.39",
05-Jul-24,Transportellaneous,"2,190.40",00.00,"16,75,738.79",
05-Jul-24,Commission,00.00,"3,35,147.76","13,40,591.03",
05-Jul-24,Cheque,00.00,"1,91,513.00","11,49,078.03",
05-Jul-24,Purchase,00.00,"1,64,154.00","9,84,924.03",
05-Jul-24,Bill,01.10,00.00,"9,84,925.13",
05-Jul-24,Purchase,00.00,"3,28,308.38","6,56,616.75",
05-Jul-24,Transfer,00.00,"1,64,154.19","4,92,462.56",
05-Jul-24,Cash,103,00.00,"4,92,565.56",
05-Jul-24,Cheque,00.00,"4,92,565.56",00.00,
05-Jul-24,RTGS,"6,33,933.00",00.00,"6,33,933.00",
05-Jul-24,Transfer,226.62,00.00,"6,34,159.62",
06-Jul-24,IMPS,00.00,"1,26,831.92","5,07,327.70",
06-Jul-24,Cheque,00.00,"1,26,831.93","3,80,495.78",
06-Jul-24,Transportellaneous,36.98,00.00,"3,80,532.76",
06-Jul-24,Cheque,33.3,00.00,"3,80,566.06",
06-Jul-24,Commission,60.84,00.00,"3,80,626.90",
06-Jul-24,NEFT,03.00,00.00,"3,80,629.90",
06-Jul-24,Interest,00.00,"42,292.21","3,38,337.69",
06-Jul-24,Interest,00.00,"37,593.08","3,00,744.61",
06-Jul-24,Purchase,"2,153.50",00.00,"3,02,898.11",
06-Jul-24,Purchase,52,00.00,"3,02,950.11",
06-Jul-24,Cheque,"2,204.00",00.00,"3,05,154.11",
06-Jul-24,Interest,00.00,"3,05,154.11",00.00,
06-Jul-24,Cash,"7,194.00",00.00,"7,194.00",
06-Jul-24,Interest,35.27,00.00,"7,229.27",
06-Jul-24,Tax,"3,133.00",00.00,"10,362.27",
06-Jul-24,ATM,00.00,"1,480.32","8,881.95",
06-Jul-24,Purchase,06.55,00.00,"8,888.50",
06-Jul-24,Commission,"1,467.79",00.00,"10,356.29",
06-Jul-24,Purchase,"8,930.06",00.00,"19,286.35",
06-Jul-24,RTGS,"13,802.25",00.00,"33,088.60",
06-Jul-24,ATM,00.00,"8,272.15","24,816.45",
06-Jul-24,Interest,52,00.00,"24,868.45",
06-Jul-24,Purchase,00.00,"3,108.56","21,759.89",
06-Jul-24,Cash,00.00,"2,175.99","19,583.90",
06-Jul-24,Transfer,00.00,"4,895.98","14,687.92",
06-Jul-24,Tax,00.00,"1,468.79","13,219.13",
06-Jul-24,RTGS,00.00,"6,609.57","6,609.56",
06-Jul-24,Cheque,00.00,"2,203.19","4,406.37",
06-Jul-24,Purchase,08.00,00.00,"4,414.37",
06-Jul-24,Commission,00.00,630.62,"3,783.75",
06-Jul-24,Transfer,00.00,472.97,"3,310.78",
06-Jul-24,Reversal,"18,817.09",00.00,"22,127.87",
06-Jul-24,Commission,04.90,00.00,"22,132.77",
06-Jul-24,RTGS,00.00,"2,766.60","19,366.17",
06-Jul-24,Transfer,00.00,"1,936.62","17,429.55",
06-Jul-24,RTGS,00.00,"2,904.93","14,524.62",
06-Jul-24,Transportellaneous,73,00.00,"14,597.62",
06-Jul-24,Reversal,"19,71,745.25",00.00,"19,86,342.87",
06-Jul-24,Transportellaneous,00.00,"6,62,114.29","13,24,228.58",
06-Jul-24,Debit Card,"1,46,521.84",00.00,"14,70,750.42",
06-Jul-24,ATM,04.00,00.00,"14,70,754.42",
06-Jul-24,Purchase,00.00,"1,83,844.30","12,86,910.12",
06-Jul-24,Tax,00.00,"2,14,485.02","10,72,425.10",
06-Jul-24,Cheque,00.00,"2,14,485.02","8,57,940.08",
06-Jul-24,ATM,46,00.00,"8,57,986.08",
06-Jul-24,Transportellaneous,00.00,"1,42,997.68","7,14,988.40",
06-Jul-24,RTGS,00.00,"89,373.55","6,25,614.85",
06-Jul-24,Debit Card,00.00,"2,08,538.28","4,17,076.57",
06-Jul-24,Bill,00.00,"59,582.37","3,57,494.20",
06-Jul-24,Tax,"18,318.00",00.00,"3,75,812.20",
06-Jul-24,Debit Card,"1,30,396.00",00.00,"5,06,208.20",
06-Jul-24,IMPS,28,00.00,"5,06,236.20",
06-Jul-24,IMPS,02.30,00.00,"5,06,238.50",
06-Jul-24,IMPS,00.00,"56,248.72","4,49,989.78",
06-Jul-24,Transportellaneous,"18,76,807.00",00.00,"23,26,796.78",
06-Jul-24,Transfer,00.00,"7,75,598.93","15,51,197.85",
06-Jul-24,Bill,00.00,"3,87,799.46","11,63,398.39",
06-Jul-24,Interest,09.09,00.00,"11,63,407.48",
06-Jul-24,Cash,00.00,"1,16,340.75","10,47,066.73",
06-Jul-24,Transportellaneous,00.00,"3,49,022.24","6,98,044.49",
06-Jul-24,Tax,00.00,"1,39,608.90","5,58,435.59",
06-Jul-24,Bill,00.00,"1,86,145.20","3,72,290.39",
06-Jul-24,Reversal,00.00,"41,365.60","3,30,924.79",
06-Jul-24,Debit Card,"16,76,832.75",00.00,"20,07,757.54",
06-Jul-24,ATM,00.00,"2,50,969.69","17,56,787.85",
06-Jul-24,Transfer,"19,827.00",00.00,"17,76,614.85",
06-Jul-24,Interest,00.00,"1,97,401.65","15,79,213.20",
06-Jul-24,Transportellaneous,46.45,00.00,"15,79,259.65",
06-Jul-24,Interest,00.00,"2,63,209.94","13,16,049.71",
06-Jul-24,Tax,"1,60,887.16",00.00,"14,76,936.87",
06-Jul-24,ATM,00.00,"1,47,693.69","13,29,243.18",
07-Jul-24,ATM,00.00,"2,21,540.53","11,07,702.65",
07-Jul-24,RTGS,00.00,"5,53,851.33","5,53,851.32",
07-Jul-24,Reversal,"7,02,780.00",00.00,"12,56,631.32",
07-Jul-24,Bill,359,00.00,"12,56,990.32",
08-Jul-24,Tax,00.00,"6,28,495.16","6,28,495.16",
08-Jul-24,Cash,"2,34,788.00",00.00,"8,63,283.16",
08-Jul-24,Purchase,00.00,"95,920.35","7,67,362.81",
08-Jul-24,Transfer,"13,23,241.00",00.00,"20,90,603.81",
09-Jul-24,Transportellaneous,159,00.00,"20,90,762.81",
09-Jul-24,Transportellaneous,00.00,"2,61,345.35","18,29,417.46",
09-Jul-24,Cheque,00.00,"1,82,941.75","16,46,475.71",
09-Jul-24,Interest,00.00,"2,35,210.82","14,11,264.89",
09-Jul-24,Bill,00.00,"14,11,264.89",00.00,
09-Jul-24,Bill,56,00.00,56,
09-Jul-24,Purchase,"92,465.00",00.00,"92,521.00",
09-Jul-24,Tax,00.00,"11,565.13","80,955.88",
09-Jul-24,Tax,00.00,"40,477.94","40,477.94",
09-Jul-24,ATM,"11,324.00",00.00,"51,801.94",
09-Jul-24,RTGS,00.00,"12,950.49","38,851.46",
09-Jul-24,Cheque,96,00.00,"38,947.46",
09-Jul-24,Cash,00.00,"3,894.75","35,052.71",
09-Jul-24,Bill,17,00.00,"35,069.71",
09-Jul-24,ATM,00.00,"5,844.95","29,224.76",
09-Jul-24,Commission,"10,495.33",00.00,"39,720.09",
09-Jul-24,Tax,192.51,00.00,"39,912.60",
09-Jul-24,ATM,00.00,"7,982.52","31,930.08",
09-Jul-24,Cash,00.00,"3,991.26","27,938.82",
09-Jul-24,Transportellaneous,57.8,00.00,"27,996.62",
09-Jul-24,NEFT,"2,27,369.47",00.00,"2,55,366.09",
09-Jul-24,Cheque,01.10,00.00,"2,55,367.19",
09-Jul-24,RTGS,00.00,"1,27,683.60","1,27,683.60",
09-Jul-24,ATM,335,00.00,"1,28,018.60",
10-Jul-24,Bill,00.00,"21,336.43","1,06,682.17",
10-Jul-24,Cheque,00.00,"15,240.31","91,441.86",
10-Jul-24,ATM,"13,391.30",00.00,"1,04,833.16",
10-Jul-24,Tax,"3,032.04",00.00,"1,07,865.20",
10-Jul-24,NEFT,"11,562.22",00.00,"1,19,427.42",
10-Jul-24,Interest,00.00,"29,856.86","89,570.56",
10-Jul-24,IMPS,02.00,00.00,"89,572.56",
10-Jul-24,Cheque,"75,032.00",00.00,"1,64,604.56",
10-Jul-24,IMPS,00.00,"27,434.09","1,37,170.47",
10-Jul-24,NEFT,"2,15,310.30",00.00,"3,52,480.77",
10-Jul-24,Tax,00.00,"3,52,480.77",00.00,
10-Jul-24,Debit Card,444,00.00,444,
10-Jul-24,Transfer,00.00,44.4,399.6,
10-Jul-24,Tax,431.9,00.00,831.5,
10-Jul-24,Cheque,00.00,415.75,415.75,
10-Jul-24,Bill,380,00.00,795.75,
10-Jul-24,Cheque,00.00,159.15,636.6,
10-Jul-24,RTGS,"41,800.50",00.00,"42,437.10",
10-Jul-24,Tax,"15,616.50",00.00,"58,053.60",
10-Jul-24,NEFT,00.00,"7,256.70","50,796.90",
10-Jul-24,NEFT,00.00,"25,398.45","25,398.45",
10-Jul-24,Debit Card,00.00,"12,699.23","12,699.22",
10-Jul-24,Cash,00.00,"6,349.61","6,349.61",
10-Jul-24,Bill,"3,573.84",00.00,"9,923.45",
10-Jul-24,Debit Card,"11,55,664.80",00.00,"11,65,588.25",
10-Jul-24,Purchase,"20,402.48",00.00,"11,85,990.73",
10-Jul-24,RTGS,00.00,"1,18,599.07","10,67,391.66",
10-Jul-24,NEFT,467,00.00,"10,67,858.66",
10-Jul-24,Cheque,00.00,"1,33,482.33","9,34,376.33",
10-Jul-24,Tax,103,00.00,"9,34,479.33",
10-Jul-24,Transfer,00.00,"2,33,619.83","7,00,859.50",
10-Jul-24,Commission,10.4,00.00,"7,00,869.90",
10-Jul-24,Debit Card,00.00,"1,40,173.98","5,60,695.92",
10-Jul-24,Interest,120.28,00.00,"5,60,816.20",
10-Jul-24,Cash,44.2,00.00,"5,60,860.40",
10-Jul-24,Tax,00.00,"1,12,172.08","4,48,688.32",
10-Jul-24,Bill,00.00,"56,086.04","3,92,602.28",
10-Jul-24,Cheque,00.00,"98,150.57","2,94,451.71",
10-Jul-24,Transfer,27.63,00.00,"2,94,479.34",
10-Jul-24,NEFT,"8,86,937.00",00.00,"11,81,416.34",
10-Jul-24,Cheque,433.9,00.00,"11,81,850.24",
10-Jul-24,Cash,"1,86,713.30",00.00,"13,68,563.54",
10-Jul-24,IMPS,"1,24,458.28",00.00,"14,93,021.82",
10-Jul-24,Debit Card,00.00,"3,73,255.46","11,19,766.36",
10-Jul-24,Cash,00.00,"1,24,418.48","9,95,347.88",
10-Jul-24,Cash,07.00,00.00,"9,95,354.88",
10-Jul-24,Interest,00.00,"1,10,594.99","8,84,759.89",
10-Jul-24,RTGS,03.60,00.00,"8,84,763.49",
10-Jul-24,Transfer,00.00,"88,476.35","7,96,287.14",
10-Jul-24,ATM,00.00,"3,98,143.57","3,98,143.57",
10-Jul-24,Cheque,00.00,"1,99,071.79","1,99,071.78",
10-Jul-24,Interest,"4,78,042.00",00.00,"6,77,113.78",
10-Jul-24,NEFT,"12,73,334.00",00.00,"19,50,447.78",
10-Jul-24,Transportellaneous,00.00,"2,43,805.97","17,06,641.81",
10-Jul-24,Commission,00.00,"17,06,641.81",00.00,
10-Jul-24,Transportellaneous,144,00.00,144,
10-Jul-24,NEFT,00.00,144,00.00,
10-Jul-24,Cheque,07.47,00.00,07.47,
10-Jul-24,Reversal,00.00,00.83,06.64,
10-Jul-24,Bill,00.00,00.95,05.69,
10-Jul-24,ATM,62.56,00.00,68.25,
10-Jul-24,ATM,00.00,07.58,60.67,
10-Jul-24,Transfer,00.00,06.74,53.93,
10-Jul-24,Bill,00.00,17.98,35.95,
10-Jul-24,Bill,00.00,04.49,31.46,
10-Jul-24,ATM,00.00,04.49,26.97,
10-Jul-24,ATM,"30,468.00",00.00,"30,494.97",
10-Jul-24,NEFT,"10,07,046.00",00.00,"10,37,540.97",
10-Jul-24,Cash,88.2,00.00,"10,37,629.17",
10-Jul-24,Transfer,"1,716.58",00.00,"10,39,345.75",
10-Jul-24,IMPS,80,00.00,"10,39,425.75",
10-Jul-24,RTGS,00.00,"1,29,928.22","9,09,497.53",
10-Jul-24,Reversal,00.00,"1,01,055.28","8,08,442.25",
10-Jul-24,Transfer,00.00,"4,04,221.13","4,04,221.12",
10-Jul-24,Tax,00.00,"4,04,221.12",00.00,
10-Jul-24,RTGS,"3,984.40",00.00,"3,984.40",
10-Jul-24,RTGS,"2,625.00",00.00,"6,609.40",
10-Jul-24,RTGS,00.00,734.38,"5,875.02",
10-Jul-24,NEFT,00.00,"1,468.76","4,406.27",
10-Jul-24,Transfer,00.00,489.59,"3,916.68",
10-Jul-24,ATM,"1,500.11",00.00,"5,416.79",
10-Jul-24,Debit Card,"16,911.88",00.00,"22,328.67",
10-Jul-24,Cash,00.00,"11,164.34","11,164.34",
10-Jul-24,Debit Card,00.00,"1,860.72","9,303.62",
10-Jul-24,Debit Card,00.00,"9,303.62",00.00,
10-Jul-24,Interest,"7,130.00",00.00,"7,130.00",
10-Jul-24,NEFT,00.00,792.22,"6,337.78",
10-Jul-24,Tax,00.00,"2,112.59","4,225.19",
10-Jul-24,Transportellaneous,"2,855.30",00.00,"7,080.49",
10-Jul-24,RTGS,608.7,00.00,"7,689.19",
10-Jul-24,Cash,145,00.00,"7,834.19",
10-Jul-24,Purchase,00.00,979.27,"6,854.92",
10-Jul-24,IMPS,228,00.00,"7,082.92",
10-Jul-24,RTGS,00.00,786.99,"6,295.93",
10-Jul-24,ATM,00.00,"1,259.19","5,036.74",
10-Jul-24,RTGS,00.00,839.46,"4,197.28",
10-Jul-24,Interest,"1,03,144.84",00.00,"1,07,342.12",
10-Jul-24,NEFT,00.00,"15,334.59","92,007.53",
10-Jul-24,NEFT,449.23,00.00,"92,456.76",
10-Jul-24,ATM,00.00,"13,208.11","79,248.65",
10-Jul-24,RTGS,"3,814.00",00.00,"83,062.65",
10-Jul-24,Cash,00.00,"16,612.53","66,450.12",
10-Jul-24,Debit Card,00.00,"33,225.06","33,225.06",
10-Jul-24,Cash,00.00,"16,612.53","16,612.53",
10-Jul-24,Purchase,"1,145.27",00.00,"17,757.80",
10-Jul-24,Reversal,53.1,00.00,"17,810.90",
10-Jul-24,Bill,04.50,00.00,"17,815.40",
10-Jul-24,Commission,25,00.00,"17,840.40",
10-Jul-24,Transportellaneous,"20,69,791.80",00.00,"20,87,632.20",
10-Jul-24,Bill,242.3,00.00,"20,87,874.50",
10-Jul-24,IMPS,02.34,00.00,"20,87,876.84",
10-Jul-24,Reversal,"2,17,232.00",00.00,"23,05,108.84",
10-Jul-24,Cash,00.00,"4,61,021.77","18,44,087.07",
10-Jul-24,Transfer,"27,457.30",00.00,"18,71,544.37",
10-Jul-24,Cash,00.00,"6,23,848.12","12,47,696.25",
10-Jul-24,IMPS,"83,489.20",00.00,"13,31,185.45",
10-Jul-24,Bill,00.00,"3,32,796.36","9,98,389.09",
10-Jul-24,IMPS,00.00,"1,66,398.18","8,31,990.91",
10-Jul-24,Purchase,00.00,"2,77,330.30","5,54,660.61",
10-Jul-24,RTGS,43,00.00,"5,54,703.61",
10-Jul-24,Interest,00.00,"2,77,351.81","2,77,351.80",
10-Jul-24,Purchase,00.00,"2,77,351.80",00.00,
10-Jul-24,Reversal,"1,017.80",00.00,"1,017.80",
10-Jul-24,Transfer,00.00,508.9,508.9,
10-Jul-24,IMPS,"17,97,547.80",00.00,"17,98,056.70",
10-Jul-24,ATM,00.00,"2,24,757.09","15,73,299.61",
10-Jul-24,Cash,00.00,"1,57,329.96","14,15,969.65",
10-Jul-24,Cheque,00.00,"1,41,596.97","12,74,372.68",
10-Jul-24,NEFT,"1,44,223.00",00.00,"14,18,595.68",
10-Jul-24,Tax,"20,35,068.50",00.00,"34,53,664.18",
10-Jul-24,Cash,145,00.00,"34,53,809.18",
10-Jul-24,NEFT,06.20,00.00,"34,53,815.38",
10-Jul-24,Purchase,"17,19,729.80",00.00,"51,73,545.18",
10-Jul-24,Transportellaneous,00.00,"25,86,772.59","25,86,772.59",
10-Jul-24,Transfer,16.68,00.00,"25,86,789.27",
10-Jul-24,Commission,00.00,"8,62,263.09","17,24,526.18",
10-Jul-24,Interest,61,00.00,"17,24,587.18",
10-Jul-24,Commission,00.00,"2,87,431.20","14,37,155.98",
10-Jul-24,Interest,00.00,"1,79,644.50","12,57,511.48",
10-Jul-24,Transportellaneous,03.03,00.00,"12,57,514.51",
10-Jul-24,Bill,"21,313.00",00.00,"12,78,827.51",
10-Jul-24,Tax,219,00.00,"12,79,046.51",
10-Jul-24,Commission,32.07,00.00,"12,79,078.58",
10-Jul-24,Transportellaneous,"8,921.40",00.00,"12,87,999.98",
10-Jul-24,Cash,00.00,"1,28,800.00","11,59,199.98",
10-Jul-24,Bill,"2,29,525.10",00.00,"13,88,725.08",
10-Jul-24,Reversal,00.00,"6,94,362.54","6,94,362.54",
10-Jul-24,Transfer,"1,00,348.20",00.00,"7,94,710.74",
10-Jul-24,Cash,00.00,"7,94,710.74",00.00,
11-Jul-24,Purchase,88,00.00,88,
11-Jul-24,NEFT,00.00,44,44,
12-Jul-24,Debit Card,00.00,22,22,
12-Jul-24,Purchase,00.00,07.33,14.67,
12-Jul-24,Transportellaneous,"1,179.00",00.00,"1,193.67",
12-Jul-24,Reversal,00.00,149.21,"1,044.46",
12-Jul-24,Bill,00.00,208.89,835.57,
12-Jul-24,Reversal,00.00,83.56,752.01,
12-Jul-24,ATM,"13,208.00",00.00,"13,960.01",
12-Jul-24,NEFT,00.00,"13,960.01",00.00,
13-Jul-24,NEFT,08.70,00.00,08.70,
13-Jul-24,Reversal,00.00,01.45,07.25,
13-Jul-24,Debit Card,"1,04,123.00",00.00,"1,04,130.25",
13-Jul-24,IMPS,00.00,"11,570.03","92,560.22",
13-Jul-24,NEFT,00.00,"18,512.04","74,048.18",
13-Jul-24,NEFT,00.00,"12,341.36","61,706.82",
13-Jul-24,RTGS,"1,448.60",00.00,"63,155.42",
13-Jul-24,Reversal,00.00,"31,577.71","31,577.71",
13-Jul-24,Cash,00.00,"3,947.21","27,630.50",
13-Jul-24,NEFT,00.00,"3,947.21","23,683.29",
13-Jul-24,Cash,03.78,00.00,"23,687.07",
13-Jul-24,Reversal,00.00,"7,895.69","15,791.38",
13-Jul-24,Tax,00.00,"2,255.91","13,535.47",
13-Jul-24,ATM,24,00.00,"13,559.47",
13-Jul-24,NEFT,04.00,00.00,"13,563.47",
13-Jul-24,IMPS,00.00,"1,937.64","11,625.83",
13-Jul-24,Reversal,00.00,"1,291.76","10,334.07",
13-Jul-24,Reversal,"2,212.00",00.00,"12,546.07",
14-Jul-24,Bill,"12,420.00",00.00,"24,966.07",
14-Jul-24,RTGS,00.00,"3,566.58","21,399.49",
14-Jul-24,Reversal,03.70,00.00,"21,403.19",
14-Jul-24,IMPS,00.00,"21,403.19",00.00,
14-Jul-24,Transfer,298,00.00,298,
14-Jul-24,IMPS,00.00,99.33,198.67,
14-Jul-24,IMPS,245.9,00.00,444.57,
14-Jul-24,Cheque,00.00,63.51,381.06,
14-Jul-24,Purchase,"23,345.35",00.00,"23,726.41",
14-Jul-24,IMPS,00.00,"7,908.80","15,817.61",
14-Jul-24,Debit Card,03.70,00.00,"15,821.31",
14-Jul-24,Tax,04.00,00.00,"15,825.31",
14-Jul-24,ATM,00.00,"2,637.55","13,187.76",
14-Jul-24,Tax,270.2,00.00,"13,457.96",
14-Jul-24,Tax,06.91,00.00,"13,464.87",
14-Jul-24,RTGS,33.78,00.00,"13,498.65",
14-Jul-24,Cash,42.5,00.00,"13,541.15",
14-Jul-24,Reversal,"1,22,732.53",00.00,"1,36,273.68",
14-Jul-24,Commission,05.00,00.00,"1,36,278.68",
14-Jul-24,Bill,"2,58,812.20",00.00,"3,95,090.88",
14-Jul-24,Bill,"1,83,760.94",00.00,"5,78,851.82",
14-Jul-24,IMPS,"1,49,968.90",00.00,"7,28,820.72",
14-Jul-24,Transportellaneous,"2,367.91",00.00,"7,31,188.63",
14-Jul-24,Transportellaneous,07.84,00.00,"7,31,196.47",
14-Jul-24,Bill,00.00,"7,31,196.47",00.00,
14-Jul-24,Commission,"2,38,857.28",00.00,"2,38,857.28",
14-Jul-24,Interest,44.3,00.00,"2,38,901.58",
14-Jul-24,RTGS,00.00,"23,890.16","2,15,011.42",
14-Jul-24,NEFT,28.89,00.00,"2,15,040.31",
14-Jul-24,Interest,00.00,"30,720.04","1,84,320.27",
14-Jul-24,RTGS,"1,09,120.88",00.00,"2,93,441.15",
14-Jul-24,Tax,00.00,"2,93,441.15",00.00,
14-Jul-24,Commission,06.00,00.00,06.00,
14-Jul-24,Cheque,00.00,01.20,04.80,
14-Jul-24,Commission,153.35,00.00,158.15,
14-Jul-24,Debit Card,"8,429.72",00.00,"8,587.87",
14-Jul-24,Purchase,00.00,"1,431.31","7,156.56",
14-Jul-24,RTGS,117,00.00,"7,273.56",
14-Jul-24,Transportellaneous,"13,802.95",00.00,"21,076.51",
14-Jul-24,Transfer,00.00,"10,538.26","10,538.26",
14-Jul-24,Transfer,00.00,"10,538.26",00.00,
15-Jul-24,Transportellaneous,02.31,00.00,02.31,
15-Jul-24,IMPS,00.00,00.23,02.08,
15-Jul-24,Bill,15.65,00.00,17.73,
15-Jul-24,Reversal,63,00.00,80.73,
15-Jul-24,NEFT,"2,41,785.25",00.00,"2,41,865.98",
15-Jul-24,Debit Card,00.00,"26,874.00","2,14,991.98",
15-Jul-24,Bill,"17,01,798.80",00.00,"19,16,790.78",
15-Jul-24,NEFT,00.00,"3,19,465.13","15,97,325.65",
15-Jul-24,Interest,"1,96,031.50",00.00,"17,93,357.15",
15-Jul-24,Interest,00.00,"1,99,261.91","15,94,095.24",
15-Jul-24,Cheque,00.00,"1,99,261.91","13,94,833.34",
15-Jul-24,Debit Card,"32,207.49",00.00,"14,27,040.83",
15-Jul-24,NEFT,"6,40,543.25",00.00,"20,67,584.08",
15-Jul-24,ATM,181,00.00,"20,67,765.08",
15-Jul-24,Cash,00.00,"2,29,751.68","18,38,013.40",
15-Jul-24,Transfer,00.00,"3,67,602.68","14,70,410.72",
15-Jul-24,ATM,00.00,"2,94,082.14","11,76,328.58",
15-Jul-24,Commission,02.42,00.00,"11,76,331.00",
15-Jul-24,Debit Card,00.00,"11,76,331.00",00.00,
15-Jul-24,IMPS,11,00.00,11,
15-Jul-24,Interest,"2,009.08",00.00,"2,020.08",
15-Jul-24,Purchase,"20,207.50",00.00,"22,227.58",
15-Jul-24,RTGS,00.00,"7,409.19","14,818.39",
15-Jul-24,Transfer,06.30,00.00,"14,824.69",
15-Jul-24,IMPS,00.00,"3,706.17","11,118.52",
15-Jul-24,RTGS,"2,670.20",00.00,"13,788.72",
15-Jul-24,Purchase,"2,04,944.72",00.00,"2,18,733.44",
15-Jul-24,Commission,"27,318.20",00.00,"2,46,051.64",
16-Jul-24,IMPS,00.00,"27,339.07","2,18,712.57",
17-Jul-24,Bill,00.00,"27,339.07","1,91,373.50",
17-Jul-24,ATM,00.00,"31,895.58","1,59,477.92",
17-Jul-24,Cheque,89,00.00,"1,59,566.92",
17-Jul-24,IMPS,00.00,"26,594.49","1,32,972.43",
17-Jul-24,Transfer,05.00,00.00,"1,32,977.43",
17-Jul-24,NEFT,"30,312.20",00.00,"1,63,289.63",
17-Jul-24,Cheque,00.00,"40,822.41","1,22,467.22",
17-Jul-24,Reversal,36.3,00.00,"1,22,503.52",
17-Jul-24,Cash,00.00,"12,250.35","1,10,253.17",
17-Jul-24,ATM,"34,423.84",00.00,"1,44,677.01",
17-Jul-24,Cash,"2,959.40",00.00,"1,47,636.41",
17-Jul-24,Bill,00.00,"29,527.28","1,18,109.13",
17-Jul-24,Commission,00.00,"1,18,109.13",00.00,
17-Jul-24,Bill,"1,76,706.22",00.00,"1,76,706.22",
17-Jul-24,Reversal,00.00,"17,670.62","1,59,035.60",
17-Jul-24,IMPS,"23,734.91",00.00,"1,82,770.51",
17-Jul-24,Transportellaneous,"28,190.00",00.00,"2,10,960.51",
17-Jul-24,RTGS,07.20,00.00,"2,10,967.71",
17-Jul-24,RTGS,00.00,"26,370.96","1,84,596.75",
17-Jul-24,Reversal,"2,884.74",00.00,"1,87,481.49",
17-Jul-24,Interest,01.00,00.00,"1,87,482.49",
17-Jul-24,Transfer,00.00,"37,496.50","1,49,985.99",
17-Jul-24,IMPS,00.00,"14,998.60","1,34,987.39",
17-Jul-24,Debit Card,"23,807.46",00.00,"1,58,794.85",
17-Jul-24,Tax,120.9,00.00,"1,58,915.75",
17-Jul-24,Transfer,00.00,"15,891.58","1,43,024.17",
17-Jul-24,Reversal,01.00,00.00,"1,43,025.17",
17-Jul-24,Cheque,00.00,"71,512.59","71,512.59",
17-Jul-24,Tax,136.7,00.00,"71,649.29",
17-Jul-24,IMPS,00.00,"71,649.29",00.00,
17-Jul-24,Tax,89,00.00,89,
17-Jul-24,Commission,07.90,00.00,96.9,
17-Jul-24,Debit Card,00.00,48.45,48.45,
17-Jul-24,IMPS,00.00,08.08,40.38,
17-Jul-24,Purchase,00.00,08.08,32.3,
17-Jul-24,Cash,"19,19,686.25",00.00,"19,19,718.55",
17-Jul-24,Commission,00.00,"9,59,859.28","9,59,859.28",
17-Jul-24,RTGS,19.1,00.00,"9,59,878.38",
17-Jul-24,RTGS,"1,46,543.20",00.00,"11,06,421.58",
17-Jul-24,Debit Card,"1,66,005.00",00.00,"12,72,426.58",
17-Jul-24,ATM,06.00,00.00,"12,72,432.58",
17-Jul-24,Transportellaneous,"4,97,623.00",00.00,"17,70,055.58",
17-Jul-24,Tax,412.8,00.00,"17,70,468.38",
17-Jul-24,IMPS,"9,03,980.00",00.00,"26,74,448.38",
17-Jul-24,Interest,06.00,00.00,"26,74,454.38",
17-Jul-24,Commission,00.00,"5,34,890.88","21,39,563.50",
17-Jul-24,Purchase,00.00,"5,34,890.88","16,04,672.62",
17-Jul-24,NEFT,05.42,00.00,"16,04,678.04",
17-Jul-24,Transportellaneous,54,00.00,"16,04,732.04",
17-Jul-24,Reversal,00.00,"1,60,473.20","14,44,258.84",
17-Jul-24,Tax,00.00,"1,60,473.20","12,83,785.64",
18-Jul-24,Purchase,00.00,"3,20,946.41","9,62,839.23",
19-Jul-24,ATM,00.00,"3,20,946.41","6,41,892.82",
19-Jul-24,Commission,00.00,"64,189.28","5,77,703.54",
19-Jul-24,Reversal,00.00,"5,77,703.54",00.00,
19-Jul-24,Purchase,"7,99,093.20",00.00,"7,99,093.20",
19-Jul-24,Interest,798.23,00.00,"7,99,891.43",
19-Jul-24,Debit Card,00.00,"1,14,270.20","6,85,621.23",
19-Jul-24,ATM,00.00,"6,85,621.23",00.00,
19-Jul-24,Transfer,"1,22,223.03",00.00,"1,22,223.03",
19-Jul-24,Cheque,458.1,00.00,"1,22,681.13",
19-Jul-24,ATM,00.00,"20,446.86","1,02,234.28",
19-Jul-24,Commission,02.60,00.00,"1,02,236.88",
19-Jul-24,RTGS,"5,36,603.20",00.00,"6,38,840.08",
19-Jul-24,ATM,00.00,"1,59,710.02","4,79,130.06",
19-Jul-24,Debit Card,"17,09,352.80",00.00,"21,88,482.86",
19-Jul-24,ATM,00.00,"2,18,848.29","19,69,634.57",
20-Jul-24,Reversal,37.7,00.00,"19,69,672.27",
20-Jul-24,Bill,32.1,00.00,"19,69,704.37",
20-Jul-24,Cheque,00.00,"9,84,852.19","9,84,852.18",
20-Jul-24,Reversal,883.4,00.00,"9,85,735.58",
21-Jul-24,Transportellaneous,"16,680.00",00.00,"10,02,415.58",
21-Jul-24,ATM,00.00,"3,34,138.53","6,68,277.05",
22-Jul-24,Bill,"2,30,525.84",00.00,"8,98,802.89",
22-Jul-24,Commission,"4,702.20",00.00,"9,03,505.09",
22-Jul-24,Tax,"87,736.53",00.00,"9,91,241.62",
22-Jul-24,IMPS,"3,882.00",00.00,"9,95,123.62",
23-Jul-24,Purchase,00.00,"1,10,569.29","8,84,554.33",
23-Jul-24,Commission,"19,62,984.00",00.00,"28,47,538.33",
23-Jul-24,Transportellaneous,"3,342.45",00.00,"28,50,880.78",
23-Jul-24,Reversal,"2,236.80",00.00,"28,53,117.58",
23-Jul-24,IMPS,05.69,00.00,"28,53,123.27",
23-Jul-24,Cash,00.00,"4,75,520.55","23,77,602.72",
23-Jul-24,Transfer,"20,821.28",00.00,"23,98,424.00",
23-Jul-24,Transportellaneous,00.00,"4,79,684.80","19,18,739.20",
23-Jul-24,NEFT,00.00,"6,39,579.73","12,79,159.47",
23-Jul-24,Commission,494,00.00,"12,79,653.47",
23-Jul-24,Reversal,397,00.00,"12,80,050.47",
23-Jul-24,RTGS,374.59,00.00,"12,80,425.06",
23-Jul-24,RTGS,00.00,"3,20,106.27","9,60,318.80",
23-Jul-24,Interest,00.00,"4,80,159.40","4,80,159.40",
23-Jul-24,Reversal,00.00,"2,40,079.70","2,40,079.70",
23-Jul-24,RTGS,00.00,"80,026.57","1,60,053.13",
23-Jul-24,Transportellaneous,"15,738.00",00.00,"1,75,791.13",
23-Jul-24,Transfer,"1,062.00",00.00,"1,76,853.13",
23-Jul-24,NEFT,00.00,"35,370.63","1,41,482.50",
23-Jul-24,Tax,00.00,"47,160.83","94,321.67",
23-Jul-24,RTGS,00.00,"31,440.56","62,881.11",
23-Jul-24,Tax,00.00,"15,720.28","47,160.83",
23-Jul-24,RTGS,00.00,"6,737.26","40,423.57",
23-Jul-24,Cheque,"8,579.62",00.00,"49,003.19",
23-Jul-24,Bill,00.00,"24,501.60","24,501.60",
23-Jul-24,Transfer,489,00.00,"24,990.60",
23-Jul-24,Transportellaneous,"19,931.39",00.00,"44,921.99",
23-Jul-24,IMPS,"19,17,267.00",00.00,"19,62,188.99",
23-Jul-24,Reversal,00.00,"2,18,021.00","17,44,167.99",
23-Jul-24,Cash,"18,14,500.50",00.00,"35,58,668.49",
23-Jul-24,NEFT,00.00,"3,55,866.85","32,02,801.64",
23-Jul-24,NEFT,00.00,"10,67,600.55","21,35,201.09",
23-Jul-24,Purchase,347,00.00,"21,35,548.09",
23-Jul-24,Bill,00.00,"4,27,109.62","17,08,438.47",
23-Jul-24,Transfer,00.00,"5,69,479.49","11,38,958.98",
23-Jul-24,RTGS,"70,625.10",00.00,"12,09,584.08",
23-Jul-24,Bill,"3,906.00",00.00,"12,13,490.08",
23-Jul-24,Cash,"8,99,642.50",00.00,"21,13,132.58",
23-Jul-24,Transportellaneous,05.88,00.00,"21,13,138.46",
23-Jul-24,Commission,00.00,"4,22,627.69","16,90,510.77",
23-Jul-24,ATM,92.87,00.00,"16,90,603.64",
23-Jul-24,Commission,00.00,"2,81,767.27","14,08,836.37",
23-Jul-24,Interest,00.00,"2,01,262.34","12,07,574.03",
23-Jul-24,Bill,00.00,"6,03,787.02","6,03,787.02",
23-Jul-24,Reversal,"3,024.50",00.00,"6,06,811.52",
23-Jul-24,ATM,00.00,"3,03,405.76","3,03,405.76",
23-Jul-24,Cash,00.00,"33,711.75","2,69,694.01",
23-Jul-24,Bill,772,00.00,"2,70,466.01",
23-Jul-24,IMPS,00.00,"67,616.50","2,02,849.51",
23-Jul-24,Transportellaneous,"13,405.44",00.00,"2,16,254.95",
23-Jul-24,Commission,"1,327.60",00.00,"2,17,582.55",
23-Jul-24,ATM,00.00,"43,516.51","1,74,066.04",
23-Jul-24,Transportellaneous,"15,941.40",00.00,"1,90,007.44",
23-Jul-24,Commission,"1,25,772.81",00.00,"3,15,780.25",
23-Jul-24,Transportellaneous,"10,66,126.25",00.00,"13,81,906.50",
23-Jul-24,Transportellaneous,00.00,"4,60,635.50","9,21,271.00",
23-Jul-24,Transfer,"1,49,100.00",00.00,"10,70,371.00",
23-Jul-24,Bill,00.00,"10,70,371.00",00.00,
23-Jul-24,Transportellaneous,01.10,00.00,01.10,
23-Jul-24,Debit Card,335.95,00.00,337.05,
24-Jul-24,Purchase,"16,18,975.00",00.00,"16,19,312.05",
24-Jul-24,Cash,"3,800.00",00.00,"16,23,112.05",
24-Jul-24,Transportellaneous,08.18,00.00,"16,23,120.23",
24-Jul-24,IMPS,00.00,"3,24,624.05","12,98,496.18",
24-Jul-24,RTGS,38.8,00.00,"12,98,534.98",
25-Jul-24,RTGS,00.00,"1,85,505.00","11,13,029.98",
25-Jul-24,ATM,"1,96,226.91",00.00,"13,09,256.89",
25-Jul-24,Bill,103.4,00.00,"13,09,360.29",
25-Jul-24,RTGS,26.8,00.00,"13,09,387.09",
25-Jul-24,Cash,"7,99,890.00",00.00,"21,09,277.09",
25-Jul-24,Debit Card,150,00.00,"21,09,427.09",
25-Jul-24,Cash,00.00,"21,09,427.09",00.00,
25-Jul-24,NEFT,"1,00,639.00",00.00,"1,00,639.00",
25-Jul-24,Tax,"14,872.70",00.00,"1,15,511.70",
25-Jul-24,Transfer,399.39,00.00,"1,15,911.09",
25-Jul-24,Reversal,"2,36,706.88",00.00,"3,52,617.97",
25-Jul-24,Transfer,"1,31,621.30",00.00,"4,84,239.27",
25-Jul-24,Cash,00.00,"48,423.93","4,35,815.34",
25-Jul-24,Cash,00.00,"87,163.07","3,48,652.27",
25-Jul-24,NEFT,02.83,00.00,"3,48,655.10",
25-Jul-24,Cheque,52.9,00.00,"3,48,708.00",
25-Jul-24,RTGS,00.00,"1,74,354.00","1,74,354.00",
25-Jul-24,Reversal,00.00,"24,907.71","1,49,446.29",
25-Jul-24,Bill,"26,279.00",00.00,"1,75,725.29",
26-Jul-24,Cash,177,00.00,"1,75,902.29",
26-Jul-24,IMPS,"20,50,238.50",00.00,"22,26,140.79",
26-Jul-24,Cheque,00.00,"4,45,228.16","17,80,912.63",
26-Jul-24,Cheque,08.60,00.00,"17,80,921.23",
26-Jul-24,Transportellaneous,00.00,"2,22,615.15","15,58,306.08",
27-Jul-24,Cash,00.00,"2,22,615.15","13,35,690.93",
27-Jul-24,Bill,00.00,"13,35,690.93",00.00,
27-Jul-24,Purchase,"6,292.00",00.00,"6,292.00",
27-Jul-24,IMPS,"17,120.90",00.00,"23,412.90",
27-Jul-24,RTGS,00.60,00.00,"23,413.50",
27-Jul-24,RTGS,"9,622.00",00.00,"33,035.50",
27-Jul-24,NEFT,"1,107.00",00.00,"34,142.50",
27-Jul-24,ATM,03.00,00.00,"34,145.50",
27-Jul-24,NEFT,00.00,"8,536.38","25,609.12",
27-Jul-24,IMPS,00.00,"25,609.12",00.00,
27-Jul-24,Transportellaneous,"12,91,961.00",00.00,"12,91,961.00",
27-Jul-24,Interest,"2,25,007.59",00.00,"15,16,968.59",
27-Jul-24,Debit Card,57,00.00,"15,17,025.59",
27-Jul-24,IMPS,"24,033.80",00.00,"15,41,059.39",
27-Jul-24,Bill,00.00,"1,54,105.94","13,86,953.45",
27-Jul-24,NEFT,41.84,00.00,"13,86,995.29",
27-Jul-24,Debit Card,00.00,"2,31,165.88","11,55,829.41",
27-Jul-24,IMPS,00.00,"1,28,425.49","10,27,403.92",
27-Jul-24,Cheque,07.00,00.00,"10,27,410.92",
27-Jul-24,Tax,03.40,00.00,"10,27,414.32",
27-Jul-24,Transfer,00.00,"5,13,707.16","5,13,707.16",
27-Jul-24,Bill,"1,62,491.00",00.00,"6,76,198.16",
27-Jul-24,Debit Card,04.26,00.00,"6,76,202.42",
27-Jul-24,Transportellaneous,"4,332.00",00.00,"6,80,534.42",
27-Jul-24,NEFT,00.00,"6,80,534.42",00.00,
27-Jul-24,ATM,01.00,00.00,01.00,
27-Jul-24,Purchase,00.00,00.10,00.90,
27-Jul-24,Purchase,"11,58,536.75",00.00,"11,58,537.65",
27-Jul-24,Transfer,40,00.00,"11,58,577.65",
27-Jul-24,Purchase,00.00,"11,58,577.65",00.00,
27-Jul-24,Cheque,"24,429.75",00.00,"24,429.75",
27-Jul-24,ATM,00.00,"3,053.72","21,376.03",
27-Jul-24,NEFT,00.00,"2,375.11","19,000.92",
27-Jul-24,Commission,00.00,"3,800.18","15,200.74",
27-Jul-24,ATM,00.00,"5,066.91","10,133.83",
27-Jul-24,Cheque,00.00,"1,125.98","9,007.85",
27-Jul-24,IMPS,00.00,"9,007.85",00.00,
27-Jul-24,Purchase,"17,344.57",00.00,"17,344.57",
27-Jul-24,Commission,31.12,00.00,"17,375.69",
27-Jul-24,Cash,00.00,"1,930.63","15,445.06",
27-Jul-24,Commission,07.90,00.00,"15,452.96",
27-Jul-24,Cheque,"29,101.10",00.00,"44,554.06",
27-Jul-24,ATM,"8,570.30",00.00,"53,124.36",
27-Jul-24,Transfer,01.00,00.00,"53,125.36",
27-Jul-24,Cash,00.00,"13,281.34","39,844.02",
27-Jul-24,NEFT,00.00,"6,640.67","33,203.35",
27-Jul-24,Debit Card,00.00,"3,320.34","29,883.02",
27-Jul-24,Transportellaneous,"3,035.58",00.00,"32,918.60",
27-Jul-24,Transfer,"1,766.00",00.00,"34,684.60",
27-Jul-24,Purchase,"1,94,606.00",00.00,"2,29,290.60",
27-Jul-24,Reversal,00.00,"28,661.33","2,00,629.28",
27-Jul-24,Bill,"5,51,258.75",00.00,"7,51,888.03",
27-Jul-24,Reversal,00.00,"1,07,412.58","6,44,475.45",
27-Jul-24,Interest,00.00,"3,22,237.73","3,22,237.72",
27-Jul-24,Cheque,03.79,00.00,"3,22,241.51",
27-Jul-24,Bill,00.00,"1,61,120.76","1,61,120.76",
27-Jul-24,Debit Card,29.7,00.00,"1,61,150.46",
27-Jul-24,Bill,"16,456.30",00.00,"1,77,606.76",
27-Jul-24,Reversal,399.59,00.00,"1,78,006.35",
27-Jul-24,ATM,00.00,"19,778.48","1,58,227.87",
27-Jul-24,Bill,750.7,00.00,"1,58,978.57",
27-Jul-24,Debit Card,00.00,"52,992.86","1,05,985.71",
27-Jul-24,Interest,00.00,"11,776.19","94,209.52",
27-Jul-24,Purchase,00.00,"94,209.52",00.00,
27-Jul-24,Commission,"6,718.10",00.00,"6,718.10",
27-Jul-24,Debit Card,"30,453.00",00.00,"37,171.10",
27-Jul-24,Transportellaneous,330.5,00.00,"37,501.60",
27-Jul-24,Cash,"1,564.20",00.00,"39,065.80",
27-Jul-24,Commission,05.00,00.00,"39,070.80",
27-Jul-24,Reversal,03.80,00.00,"39,074.60",
27-Jul-24,Interest,00.00,"4,341.62","34,732.98",
27-Jul-24,Commission,00.00,"4,961.85","29,771.13",
27-Jul-24,Interest,00.00,"3,307.90","26,463.23",
27-Jul-24,NEFT,00.00,"26,463.23",00.00,
27-Jul-24,ATM,"18,63,273.00",00.00,"18,63,273.00",
27-Jul-24,Debit Card,00.00,"2,66,181.86","15,97,091.14",
27-Jul-24,Transportellaneous,00.00,"1,59,709.11","14,37,382.03",
27-Jul-24,Interest,00.00,"3,59,345.51","10,78,036.52",
27-Jul-24,Interest,00.00,"1,34,754.57","9,43,281.96",
27-Jul-24,Transfer,03.20,00.00,"9,43,285.16",
27-Jul-24,Transportellaneous,"32,048.80",00.00,"9,75,333.96",
27-Jul-24,IMPS,"1,72,805.00",00.00,"11,48,138.96",
27-Jul-24,Debit Card,"1,237.00",00.00,"11,49,375.96",
27-Jul-24,Purchase,389.1,00.00,"11,49,765.06",
27-Jul-24,Bill,00.00,"11,49,765.06",00.00,
27-Jul-24,Purchase,"2,846.00",00.00,"2,846.00",
27-Jul-24,Tax,"2,43,301.20",00.00,"2,46,147.20",
27-Jul-24,Transportellaneous,"20,02,245.75",00.00,"22,48,392.95",
27-Jul-24,Commission,01.80,00.00,"22,48,394.75",
27-Jul-24,Commission,"1,52,501.41",00.00,"24,00,896.16",
27-Jul-24,NEFT,00.00,"2,40,089.62","21,60,806.54",
27-Jul-24,Transfer,"3,383.09",00.00,"21,64,189.63",
27-Jul-24,Commission,00.00,"5,41,047.41","16,23,142.22",
27-Jul-24,Bill,"15,78,734.00",00.00,"32,01,876.22",
27-Jul-24,Reversal,01.00,00.00,"32,01,877.22",
27-Jul-24,Bill,"6,19,212.00",00.00,"38,21,089.22",
27-Jul-24,Commission,00.00,"6,36,848.20","31,84,241.02",
28-Jul-24,Purchase,00.00,"10,61,413.67","21,22,827.35",
28-Jul-24,Cash,32.4,00.00,"21,22,859.75",
28-Jul-24,Debit Card,07.90,00.00,"21,22,867.65",
28-Jul-24,Bill,04.69,00.00,"21,22,872.34",
28-Jul-24,IMPS,"2,29,290.50",00.00,"23,52,162.84",
28-Jul-24,Interest,00.00,"23,52,162.84",00.00,
28-Jul-24,ATM,39,00.00,39,
28-Jul-24,Commission,166.7,00.00,205.7,
28-Jul-24,Tax,00.00,68.57,137.13,
28-Jul-24,Interest,00.00,45.71,91.42,
28-Jul-24,Reversal,265.1,00.00,356.52,
28-Jul-24,RTGS,"15,544.00",00.00,"15,900.52",
28-Jul-24,Cash,45,00.00,"15,945.52",
28-Jul-24,Cheque,"35,217.50",00.00,"51,163.02",
28-Jul-24,IMPS,00.00,"12,790.76","38,372.26",
28-Jul-24,Interest,00.00,"4,263.58","34,108.68",
28-Jul-24,RTGS,00.00,"4,872.67","29,236.01",
28-Jul-24,Purchase,02.00,00.00,"29,238.01",
28-Jul-24,NEFT,"14,01,227.00",00.00,"14,30,465.01",
28-Jul-24,Cheque,00.00,"7,15,232.51","7,15,232.50",
28-Jul-24,Commission,00.00,"3,57,616.25","3,57,616.25",
28-Jul-24,Commission,00.00,"51,088.04","3,06,528.21",
28-Jul-24,Tax,00.00,"1,02,176.07","2,04,352.14",
28-Jul-24,Transfer,00.00,"2,04,352.14",00.00,
28-Jul-24,RTGS,"2,885.05",00.00,"2,885.05",
28-Jul-24,RTGS,11.82,00.00,"2,896.87",
28-Jul-24,Commission,"3,137.90",00.00,"6,034.77",
28-Jul-24,Cash,00.00,"6,034.77",00.00,
28-Jul-24,Interest,"62,960.78",00.00,"62,960.78",
28-Jul-24,ATM,143.9,00.00,"63,104.68",
28-Jul-24,NEFT,106.1,00.00,"63,210.78",
28-Jul-24,Cheque,00.00,"7,901.35","55,309.43",
28-Jul-24,Bill,"5,77,641.25",00.00,"6,32,950.68",
28-Jul-24,Cash,"5,76,611.00",00.00,"12,09,561.68",
29-Jul-24,Cheque,"12,642.40",00.00,"12,22,204.08",
29-Jul-24,RTGS,00.00,"1,74,600.58","10,47,603.50",
29-Jul-24,Bill,00.00,"2,09,520.70","8,38,082.80",
30-Jul-24,Tax,07.70,00.00,"8,38,090.50",
30-Jul-24,Cash,"1,16,349.22",00.00,"9,54,439.72",
30-Jul-24,Commission,832.7,00.00,"9,55,272.42",
30-Jul-24,Transportellaneous,00.00,"3,18,424.14","6,36,848.28",
30-Jul-24,Cash,00.00,"6,36,848.28",00.00,
30-Jul-24,Transportellaneous,"1,439.90",00.00,"1,439.90",
30-Jul-24,Commission,00.00,159.99,"1,279.91",
30-Jul-24,Debit Card,00.00,255.98,"1,023.93",
30-Jul-24,Transfer,00.00,113.77,910.16,
30-Jul-24,Purchase,00.00,182.03,728.13,
31-Jul-24,Debit Card,"3,841.00",00.00,"4,569.13",
31-Jul-24,Tax,"7,545.00",00.00,"12,114.13",
31-Jul-24,Commission,00.00,"2,422.83","9,691.30",
31-Jul-24,Purchase,"3,021.00",00.00,"12,712.30",
31-Jul-24,Transfer,00.00,"1,589.04","11,123.26",
31-Jul-24,NEFT,"3,328.88",00.00,"14,452.14",
31-Jul-24,ATM,"7,84,602.00",00.00,"7,99,054.14",
31-Jul-24,RTGS,"2,08,878.72",00.00,"10,07,932.86",
31-Jul-24,RTGS,00.00,"1,43,990.41","8,63,942.45",
31-Jul-24,RTGS,00.00,"1,07,992.81","7,55,949.64",
31-Jul-24,NEFT,"77,729.00",00.00,"8,33,678.64",
31-Jul-24,IMPS,00.00,"92,630.96","7,41,047.68",
31-Jul-24,Cheque,49.07,00.00,"7,41,096.75",
31-Jul-24,ATM,00.00,"1,48,219.35","5,92,877.40",
31-Jul-24,RTGS,00.00,"2,96,438.70","2,96,438.70",
31-Jul-24,ATM,"18,403.93",00.00,"3,14,842.63",
31-Jul-24,IMPS,02.91,00.00,"3,14,845.54",
31-Jul-24,ATM,"2,539.00",00.00,"3,17,384.54",
31-Jul-24,Tax,02.00,00.00,"3,17,386.54",
31-Jul-24,Reversal,02.50,00.00,"3,17,389.04",
31-Jul-24,Debit Card,00.00,"63,477.81","2,53,911.23",
31-Jul-24,RTGS,00.00,"2,53,911.23",00.00,
31-Jul-24,ATM,02.00,00.00,02.00,
31-Jul-24,Transfer,00.00,00.20,01.80,
31-Jul-24,RTGS,00.00,00.60,01.20,
31-Jul-24,Reversal,00.00,00.15,01.05,
31-Jul-24,Cheque,00.00,00.53,00.52,
31-Jul-24,Cheque,"3,723.00",00.00,"3,723.52",
31-Jul-24,Bill,05.53,00.00,"3,729.05",
31-Jul-24,Bill,204.96,00.00,"3,934.01",
31-Jul-24,NEFT,00.00,562,"3,372.01",
31-Jul-24,Cash,135.22,00.00,"3,507.23",
31-Jul-24,Transportellaneous,"27,881.00",00.00,"31,388.23",
31-Jul-24,Interest,"17,631.21",00.00,"49,019.44",
31-Jul-24,Commission,"1,23,652.88",00.00,"1,72,672.32",
31-Jul-24,Cheque,00.00,"21,584.04","1,51,088.28",
31-Jul-24,Debit Card,00.00,"25,181.38","1,25,906.90",
31-Jul-24,Tax,03.40,00.00,"1,25,910.30",
31-Jul-24,Bill,"2,27,062.00",00.00,"3,52,972.30",
31-Jul-24,Debit Card,00.00,"88,243.08","2,64,729.22",
31-Jul-24,Transfer,"27,857.30",00.00,"2,92,586.52",
31-Jul-24,Purchase,"99,854.40",00.00,"3,92,440.92",
31-Jul-24,RTGS,07.55,00.00,"3,92,448.47",
31-Jul-24,NEFT,35,00.00,"3,92,483.47",
31-Jul-24,Tax,27.8,00.00,"3,92,511.27",
31-Jul-24,Reversal,00.00,"1,30,837.09","2,61,674.18",
31-Jul-24,Cash,04.44,00.00,"2,61,678.62",
31-Jul-24,ATM,444,00.00,"2,62,122.62",
31-Jul-24,IMPS,00.00,"87,374.21","1,74,748.41",
31-Jul-24,Transfer,00.00,"1,74,748.41",00.00,
31-Jul-24,Transfer,328,00.00,328,
31-Jul-24,NEFT,00.00,54.67,273.33,
31-Jul-24,Cash,00.00,27.33,246,
31-Jul-24,Bill,00.00,61.5,184.5,
01-Aug-24,Debit Card,00.00,26.36,158.14,
01-Aug-24,Reversal,"15,47,801.75",00.00,"15,47,959.89",
01-Aug-24,Purchase,02.10,00.00,"15,47,961.99",
01-Aug-24,ATM,00.00,"2,21,137.43","13,26,824.56",
01-Aug-24,Cash,00.00,"4,42,274.85","8,84,549.71",
01-Aug-24,Transfer,"19,71,213.00",00.00,"28,55,762.71",
01-Aug-24,Tax,"27,571.91",00.00,"28,83,334.62",
01-Aug-24,Bill,00.00,"9,61,111.54","19,22,223.08",
01-Aug-24,Bill,136,00.00,"19,22,359.08",
01-Aug-24,Interest,00.00,"2,74,622.73","16,47,736.35",
01-Aug-24,Commission,"1,01,170.69",00.00,"17,48,907.04",
01-Aug-24,RTGS,"10,981.60",00.00,"17,59,888.64",
01-Aug-24,Debit Card,817,00.00,"17,60,705.64",
01-Aug-24,Bill,"1,472.90",00.00,"17,62,178.54",
01-Aug-24,NEFT,"11,095.30",00.00,"17,73,273.84",
01-Aug-24,Commission,00.00,"1,97,030.43","15,76,243.41",
01-Aug-24,Interest,00.00,"1,75,138.16","14,01,105.25",
01-Aug-24,Cash,337.1,00.00,"14,01,442.35",
01-Aug-24,IMPS,176.9,00.00,"14,01,619.25",
01-Aug-24,IMPS,"21,872.20",00.00,"14,23,491.45",
01-Aug-24,Interest,05.70,00.00,"14,23,497.15",
01-Aug-24,Cash,"2,46,297.00",00.00,"16,69,794.15",
01-Aug-24,Transportellaneous,"15,84,422.50",00.00,"32,54,216.65",
01-Aug-24,IMPS,00.00,"8,13,554.16","24,40,662.49",
01-Aug-24,Interest,"2,47,936.00",00.00,"26,88,598.49",
01-Aug-24,Transfer,00.00,"4,48,099.75","22,40,498.74",
01-Aug-24,Interest,00.00,"11,20,249.37","11,20,249.37",
01-Aug-24,Interest,00.00,"2,24,049.87","8,96,199.50",
01-Aug-24,Cheque,"3,64,011.00",00.00,"12,60,210.50",
01-Aug-24,Debit Card,00.00,"1,57,526.31","11,02,684.19",
01-Aug-24,Transfer,44.6,00.00,"11,02,728.79",
01-Aug-24,Commission,00.49,00.00,"11,02,729.28",
01-Aug-24,Debit Card,"2,42,462.80",00.00,"13,45,192.08",
02-Aug-24,Commission,00.00,"1,68,149.01","11,77,043.07",
02-Aug-24,Commission,60.39,00.00,"11,77,103.46",
02-Aug-24,Tax,"1,43,898.90",00.00,"13,21,002.36",
02-Aug-24,NEFT,"2,60,788.10",00.00,"15,81,790.46",
02-Aug-24,Bill,"6,376.60",00.00,"15,88,167.06",
02-Aug-24,Commission,"42,834.50",00.00,"16,31,001.56",
02-Aug-24,Commission,00.00,"2,33,000.22","13,98,001.34",
02-Aug-24,Interest,00.00,"2,79,600.27","11,18,401.07",
02-Aug-24,ATM,00.00,"2,23,680.21","8,94,720.86",
02-Aug-24,Purchase,"6,14,638.00",00.00,"15,09,358.86",
02-Aug-24,RTGS,00.00,"3,77,339.72","11,32,019.14",
02-Aug-24,Bill,00.00,"2,83,004.79","8,49,014.36",
02-Aug-24,Transportellaneous,211.1,00.00,"8,49,225.46",
02-Aug-24,Transfer,53,00.00,"8,49,278.46",
02-Aug-24,IMPS,00.00,"8,49,278.46",00.00,
03-Aug-24,IMPS,"4,533.50",00.00,"4,533.50",
03-Aug-24,Cheque,03.77,00.00,"4,537.27",
03-Aug-24,ATM,00.00,453.73,"4,083.54",
03-Aug-24,Interest,00.00,"1,020.89","3,062.66",
03-Aug-24,Commission,"1,108.30",00.00,"4,170.96",
03-Aug-24,Purchase,00.00,521.37,"3,649.59",
03-Aug-24,Bill,30.71,00.00,"3,680.30",
03-Aug-24,RTGS,03.16,00.00,"3,683.46",
03-Aug-24,IMPS,"1,65,419.00",00.00,"1,69,102.46",
03-Aug-24,Cash,"16,33,859.80",00.00,"18,02,962.26",
03-Aug-24,RTGS,"24,430.00",00.00,"18,27,392.26",
03-Aug-24,ATM,02.71,00.00,"18,27,394.97",
03-Aug-24,Tax,00.00,00.00,"18,27,394.97",
03-Aug-24,Cheque,"2,16,862.84",00.00,"20,44,257.81",
03-Aug-24,Tax,"2,366.00",00.00,"20,46,623.81",
03-Aug-24,Reversal,842,00.00,"20,47,465.81",
03-Aug-24,Cheque,00.00,"2,27,496.20","18,19,969.61",
04-Aug-24,Cash,00.00,"3,03,328.27","15,16,641.34",
04-Aug-24,Transfer,243,00.00,"15,16,884.34",
04-Aug-24,Cheque,131.5,00.00,"15,17,015.84",
04-Aug-24,NEFT,00.00,"5,05,671.95","10,11,343.89",
04-Aug-24,RTGS,"1,732.12",00.00,"10,13,076.01",
04-Aug-24,Tax,"32,038.66",00.00,"10,45,114.67",
04-Aug-24,Cheque,04.40,00.00,"10,45,119.07",
04-Aug-24,Cash,"32,051.06",00.00,"10,77,170.13",
04-Aug-24,Bill,"5,00,943.75",00.00,"15,78,113.88",
04-Aug-24,Reversal,00.00,"3,94,528.47","11,83,585.41",
04-Aug-24,Bill,03.18,00.00,"11,83,588.59",
04-Aug-24,Cheque,00.00,"1,69,084.08","10,14,504.51",
04-Aug-24,Interest,00.00,"1,44,929.22","8,69,575.29",
04-Aug-24,NEFT,"25,754.00",00.00,"8,95,329.29",
04-Aug-24,Transfer,466.66,00.00,"8,95,795.95",
04-Aug-24,ATM,00.00,"1,79,159.19","7,16,636.76",
04-Aug-24,Commission,"17,679.34",00.00,"7,34,316.10",
04-Aug-24,Cash,00.00,"2,44,772.03","4,89,544.07",
04-Aug-24,Cash,"8,877.00",00.00,"4,98,421.07",
04-Aug-24,Purchase,00.00,"1,24,605.27","3,73,815.80",
04-Aug-24,Cash,00.00,"46,726.98","3,27,088.82",
04-Aug-24,IMPS,00.00,"81,772.21","2,45,316.62",
04-Aug-24,Transfer,00.00,"81,772.21","1,63,544.41",
04-Aug-24,Commission,432.1,00.00,"1,63,976.51",
04-Aug-24,Transfer,03.00,00.00,"1,63,979.51",
04-Aug-24,Debit Card,00.00,"18,219.95","1,45,759.56",
04-Aug-24,ATM,05.00,00.00,"1,45,764.56",
04-Aug-24,Bill,"16,134.42",00.00,"1,61,898.98",
04-Aug-24,Transfer,"8,45,070.80",00.00,"10,06,969.78",
04-Aug-24,Debit Card,00.00,"3,35,656.59","6,71,313.19",
04-Aug-24,RTGS,00.00,"67,131.32","6,04,181.87",
04-Aug-24,Bill,00.00,"3,02,090.94","3,02,090.94",
04-Aug-24,RTGS,00.00,"3,02,090.94",00.00,
04-Aug-24,Commission,"11,792.12",00.00,"11,792.12",
04-Aug-24,Debit Card,00.00,"1,965.35","9,826.77",
04-Aug-24,IMPS,00.00,"1,228.35","8,598.42",
04-Aug-24,Cash,"7,86,005.00",00.00,"7,94,603.42",
04-Aug-24,Transfer,"1,898.00",00.00,"7,96,501.42",
04-Aug-24,Transfer,"11,59,626.25",00.00,"19,56,127.67",
04-Aug-24,Cash,00.00,"3,26,021.28","16,30,106.39",
04-Aug-24,Interest,"18,14,504.00",00.00,"34,44,610.39",
04-Aug-24,Purchase,00.00,"11,48,203.46","22,96,406.93",
04-Aug-24,Bill,00.00,"11,48,203.47","11,48,203.47",
04-Aug-24,Debit Card,00.00,"1,27,578.16","10,20,625.31",
04-Aug-24,Reversal,00.00,"1,27,578.16","8,93,047.15",
04-Aug-24,Tax,"2,51,227.06",00.00,"11,44,274.21",
04-Aug-24,Tax,292.59,00.00,"11,44,566.80",
04-Aug-24,Cheque,"1,20,930.00",00.00,"12,65,496.80",
04-Aug-24,RTGS,"12,84,333.75",00.00,"25,49,830.55",
04-Aug-24,Bill,12.1,00.00,"25,49,842.65",
05-Aug-24,Cheque,00.00,"25,49,842.65",00.00,
05-Aug-24,Purchase,08.00,00.00,08.00,
05-Aug-24,Tax,"28,065.51",00.00,"28,073.51",
05-Aug-24,Transfer,568,00.00,"28,641.51",
05-Aug-24,Tax,00.00,"4,773.59","23,867.92",
05-Aug-24,Transportellaneous,00.00,"3,977.99","19,889.93",
05-Aug-24,Interest,"57,486.00",00.00,"77,375.93",
05-Aug-24,Purchase,00.00,"25,791.98","51,583.95",
05-Aug-24,Cash,"1,17,241.20",00.00,"1,68,825.15",
05-Aug-24,RTGS,891.72,00.00,"1,69,716.87",
05-Aug-24,RTGS,"69,413.00",00.00,"2,39,129.87",
05-Aug-24,ATM,00.00,"34,161.41","2,04,968.46",
05-Aug-24,Cash,00.00,"34,161.41","1,70,807.05",
05-Aug-24,RTGS,"20,581.97",00.00,"1,91,389.02",
05-Aug-24,Commission,00.00,"21,265.45","1,70,123.57",
05-Aug-24,Cheque,"19,493.00",00.00,"1,89,616.57",
05-Aug-24,Tax,"2,558.00",00.00,"1,92,174.57",
05-Aug-24,Cheque,00.00,"64,058.19","1,28,116.38",
05-Aug-24,ATM,00.00,"14,235.15","1,13,881.23",
05-Aug-24,Tax,00.00,"37,960.41","75,920.82",
05-Aug-24,Purchase,03.64,00.00,"75,924.46",
05-Aug-24,Cash,508,00.00,"76,432.46",
05-Aug-24,ATM,00.00,"76,432.46",00.00,
06-Aug-24,IMPS,"15,66,453.50",00.00,"15,66,453.50",
06-Aug-24,Debit Card,"1,09,049.00",00.00,"16,75,502.50",
06-Aug-24,Bill,00.00,"2,09,437.81","14,66,064.69",
06-Aug-24,Transfer,"17,608.79",00.00,"14,83,673.48",
06-Aug-24,Cheque,00.00,"14,83,673.48",00.00,
06-Aug-24,Cheque,03.00,00.00,03.00,
06-Aug-24,Tax,01.10,00.00,04.10,
06-Aug-24,Tax,"1,803.00",00.00,"1,807.10",
06-Aug-24,Bill,"13,836.18",00.00,"15,643.28",
06-Aug-24,Purchase,00.00,"2,607.21","13,036.07",
06-Aug-24,Tax,"31,216.00",00.00,"44,252.07",
06-Aug-24,Debit Card,00.00,"4,916.90","39,335.17",
06-Aug-24,IMPS,"1,50,225.00",00.00,"1,89,560.17",
06-Aug-24,ATM,115.73,00.00,"1,89,675.90",
06-Aug-24,Bill,00.00,"47,418.98","1,42,256.92",
06-Aug-24,NEFT,"20,50,955.80",00.00,"21,93,212.72",
06-Aug-24,Cash,00.00,"3,13,316.10","18,79,896.62",
06-Aug-24,Purchase,"1,375.78",00.00,"18,81,272.40",
06-Aug-24,ATM,00.00,"1,88,127.24","16,93,145.16",
06-Aug-24,Cash,00.00,"8,46,572.58","8,46,572.58",
06-Aug-24,Bill,"68,747.56",00.00,"9,15,320.14",
06-Aug-24,IMPS,00.00,"1,52,553.36","7,62,766.78",
06-Aug-24,Purchase,"31,825.00",00.00,"7,94,591.78",
06-Aug-24,Debit Card,00.00,"88,287.98","7,06,303.80",
06-Aug-24,Purchase,00.00,"1,17,717.30","5,88,586.50",
06-Aug-24,NEFT,"14,49,783.00",00.00,"20,38,369.50",
06-Aug-24,NEFT,00.00,"4,07,673.90","16,30,695.60",
07-Aug-24,Bill,28.8,00.00,"16,30,724.40",
07-Aug-24,IMPS,"5,142.30",00.00,"16,35,866.70",
07-Aug-24,NEFT,00.00,"16,35,866.70",00.00,
07-Aug-24,NEFT,"32,333.00",00.00,"32,333.00",
07-Aug-24,Transportellaneous,04.60,00.00,"32,337.60",
07-Aug-24,Transfer,05.00,00.00,"32,342.60",
08-Aug-24,Cheque,58.2,00.00,"32,400.80",
08-Aug-24,ATM,"32,103.00",00.00,"64,503.80",
08-Aug-24,Reversal,00.00,"8,062.98","56,440.82",
08-Aug-24,Debit Card,"31,150.00",00.00,"87,590.82",
08-Aug-24,Reversal,"12,793.50",00.00,"1,00,384.32",
08-Aug-24,Commission,00.00,"11,153.81","89,230.51",
08-Aug-24,IMPS,00.00,"11,153.81","78,076.70",
08-Aug-24,Debit Card,00.00,"9,759.59","68,317.11",
08-Aug-24,Purchase,00.00,"11,386.19","56,930.92",
08-Aug-24,Bill,00.00,"56,930.92",00.00,
08-Aug-24,Bill,03.00,00.00,03.00,
08-Aug-24,Transfer,"1,07,675.80",00.00,"1,07,678.80",
08-Aug-24,IMPS,00.00,"11,964.31","95,714.49",
08-Aug-24,IMPS,00.00,"47,857.25","47,857.24",
09-Aug-24,IMPS,03.43,00.00,"47,860.67",
09-Aug-24,Purchase,00.00,"5,982.58","41,878.09",
09-Aug-24,Cash,"7,540.60",00.00,"49,418.69",
09-Aug-24,Cash,00.00,"8,236.45","41,182.24",
09-Aug-24,RTGS,"17,75,958.75",00.00,"18,17,140.99",
09-Aug-24,Cheque,22.4,00.00,"18,17,163.39",
09-Aug-24,Debit Card,00.00,"2,01,907.04","16,15,256.35",
10-Aug-24,Cash,60.93,00.00,"16,15,317.28",
10-Aug-24,ATM,00.00,"2,01,914.66","14,13,402.62",
10-Aug-24,Reversal,"3,558.00",00.00,"14,16,960.62",
10-Aug-24,Reversal,00.00,"7,08,480.31","7,08,480.31",
10-Aug-24,Tax,00.00,"3,54,240.16","3,54,240.16",
10-Aug-24,IMPS,00.00,"3,54,240.16",00.00,
10-Aug-24,Interest,"19,340.20",00.00,"19,340.20",
10-Aug-24,Transfer,00.00,"1,934.02","17,406.18",
10-Aug-24,Tax,00.00,"4,351.55","13,054.64",
10-Aug-24,Purchase,00.00,"6,527.32","6,527.32",
10-Aug-24,NEFT,"1,72,981.00",00.00,"1,79,508.32",
10-Aug-24,Debit Card,00.00,"44,877.08","1,34,631.24",
10-Aug-24,Interest,00.00,"19,233.03","1,15,398.21",
10-Aug-24,NEFT,"1,95,170.80",00.00,"3,10,569.01",
10-Aug-24,Tax,"5,67,264.50",00.00,"8,77,833.51",
10-Aug-24,Reversal,"1,03,672.20",00.00,"9,81,505.71",
10-Aug-24,ATM,"21,822.40",00.00,"10,03,328.11",
10-Aug-24,Transfer,02.90,00.00,"10,03,331.01",
10-Aug-24,Transfer,07.00,00.00,"10,03,338.01",
10-Aug-24,Commission,00.00,"1,67,223.00","8,36,115.01",
10-Aug-24,ATM,00.00,"8,36,115.01",00.00,
10-Aug-24,Commission,"61,141.00",00.00,"61,141.00",
10-Aug-24,Commission,"8,42,550.00",00.00,"9,03,691.00",
10-Aug-24,Reversal,"78,492.00",00.00,"9,82,183.00",
10-Aug-24,Cheque,00.00,"1,40,311.86","8,41,871.14",
11-Aug-24,Tax,00.00,"2,10,467.79","6,31,403.36",
11-Aug-24,Bill,00.00,"1,57,850.84","4,73,552.52",
11-Aug-24,Commission,"10,24,705.20",00.00,"14,98,257.72",
11-Aug-24,Transportellaneous,05.30,00.00,"14,98,263.02",
11-Aug-24,Cash,00.00,"14,98,263.02",00.00,
11-Aug-24,IMPS,"12,36,236.50",00.00,"12,36,236.50",
11-Aug-24,Purchase,00.00,"12,36,236.50",00.00,
11-Aug-24,Transportellaneous,"84,032.80",00.00,"84,032.80",
11-Aug-24,Commission,"61,368.00",00.00,"1,45,400.80",
11-Aug-24,Reversal,00.00,"29,080.16","1,16,320.64",
11-Aug-24,Cheque,00.00,"1,16,320.64",00.00,
11-Aug-24,Cheque,00.00,00.00,00.00,
11-Aug-24,Debit Card,"1,715.00",00.00,"1,715.00",
11-Aug-24,Tax,00.00,245,"1,470.00",
11-Aug-24,Purchase,00.00,"1,470.00",00.00,
11-Aug-24,Cash,"2,874.00",00.00,"2,874.00",
11-Aug-24,Reversal,04.00,00.00,"2,878.00",
11-Aug-24,Reversal,"11,52,254.00",00.00,"11,55,132.00",
11-Aug-24,Transfer,"20,114.00",00.00,"11,75,246.00",
11-Aug-24,Reversal,00.00,"11,75,246.00",00.00,
11-Aug-24,Transfer,"11,881.90",00.00,"11,881.90",
11-Aug-24,Cash,"16,90,680.00",00.00,"17,02,561.90",
11-Aug-24,Commission,"10,866.03",00.00,"17,13,427.93",
11-Aug-24,Purchase,02.10,00.00,"17,13,430.03",
12-Aug-24,Bill,"3,902.65",00.00,"17,17,332.68",
12-Aug-24,Reversal,"15,740.00",00.00,"17,33,072.68",
12-Aug-24,Debit Card,318.8,00.00,"17,33,391.48",
12-Aug-24,Cheque,"2,427.80",00.00,"17,35,819.28",
12-Aug-24,Cash,02.00,00.00,"17,35,821.28",
12-Aug-24,Purchase,18.95,00.00,"17,35,840.23",
12-Aug-24,Purchase,"63,406.78",00.00,"17,99,247.01",
12-Aug-24,Purchase,00.00,"2,57,035.29","15,42,211.72",
12-Aug-24,Debit Card,00.00,"3,08,442.34","12,33,769.38",
12-Aug-24,RTGS,00.00,"6,16,884.69","6,16,884.69",
12-Aug-24,IMPS,55.1,00.00,"6,16,939.79",
12-Aug-24,RTGS,29.93,00.00,"6,16,969.72",
12-Aug-24,Transfer,"2,348.80",00.00,"6,19,318.52",
12-Aug-24,ATM,00.00,"77,414.82","5,41,903.71",
12-Aug-24,ATM,"45,532.00",00.00,"5,87,435.71",
12-Aug-24,Commission,00.00,"65,270.63","5,22,165.08",
12-Aug-24,Bill,"2,31,129.80",00.00,"7,53,294.88",
12-Aug-24,IMPS,07.00,00.00,"7,53,301.88",
12-Aug-24,Tax,02.73,00.00,"7,53,304.61",
12-Aug-24,Debit Card,08.00,00.00,"7,53,312.61",
12-Aug-24,Interest,00.00,"2,51,104.20","5,02,208.41",
12-Aug-24,Commission,271.86,00.00,"5,02,480.27",
12-Aug-24,Purchase,579,00.00,"5,03,059.27",
12-Aug-24,ATM,"30,215.30",00.00,"5,33,274.57",
12-Aug-24,Purchase,"10,64,799.80",00.00,"15,98,074.37",
12-Aug-24,Bill,04.00,00.00,"15,98,078.37",
12-Aug-24,RTGS,00.00,"3,99,519.59","11,98,558.78",
12-Aug-24,RTGS,"2,17,279.00",00.00,"14,15,837.78",
12-Aug-24,Tax,"6,15,058.75",00.00,"20,30,896.53",
12-Aug-24,Cheque,00.00,"5,07,724.13","15,23,172.40",
12-Aug-24,Cash,00.90,00.00,"15,23,173.30",
12-Aug-24,Tax,00.00,"3,80,793.33","11,42,379.98",
13-Aug-24,Commission,153.65,00.00,"11,42,533.63",
13-Aug-24,Bill,"9,48,332.00",00.00,"20,90,865.63",
13-Aug-24,NEFT,165.55,00.00,"20,91,031.18",
13-Aug-24,Cheque,00.00,"3,48,505.20","17,42,525.98",
13-Aug-24,ATM,00.00,"17,42,525.98",00.00,
13-Aug-24,Reversal,54,00.00,54,
13-Aug-24,Cheque,00.00,10.8,43.2,
13-Aug-24,IMPS,422.95,00.00,466.15,
13-Aug-24,IMPS,00.00,93.23,372.92,
13-Aug-24,Interest,141.5,00.00,514.42,
13-Aug-24,Transportellaneous,00.80,00.00,515.22,
13-Aug-24,Commission,"16,499.00",00.00,"17,014.22",
13-Aug-24,Transfer,00.00,"8,507.11","8,507.11",
13-Aug-24,Cash,"5,87,196.50",00.00,"5,95,703.61",
13-Aug-24,Transfer,26.85,00.00,"5,95,730.46",
13-Aug-24,Commission,00.00,"1,98,576.82","3,97,153.64",
13-Aug-24,Cash,00.00,"1,98,576.82","1,98,576.82",
13-Aug-24,Transportellaneous,00.00,"1,98,576.82",00.00,
13-Aug-24,RTGS,339,00.00,339,
13-Aug-24,Interest,00.00,48.43,290.57,
13-Aug-24,Transportellaneous,"74,076.60",00.00,"74,367.17",
13-Aug-24,Transfer,03.78,00.00,"74,370.95",
13-Aug-24,Commission,"13,57,146.00",00.00,"14,31,516.95",
13-Aug-24,Commission,"15,04,940.00",00.00,"29,36,456.95",
13-Aug-24,RTGS,06.00,00.00,"29,36,462.95",
13-Aug-24,ATM,483.73,00.00,"29,36,946.68",
13-Aug-24,NEFT,00.00,"9,78,982.23","19,57,964.45",
13-Aug-24,ATM,308.16,00.00,"19,58,272.61",
13-Aug-24,Debit Card,00.00,"2,79,753.23","16,78,519.38",
13-Aug-24,RTGS,"17,204.00",00.00,"16,95,723.38",
13-Aug-24,Purchase,00.00,"16,95,723.38",00.00,
13-Aug-24,NEFT,47,00.00,47,
13-Aug-24,Cash,78,00.00,125,
13-Aug-24,Commission,00.00,25,100,
13-Aug-24,Transportellaneous,00.00,20,80,
13-Aug-24,Reversal,00.00,13.33,66.67,
13-Aug-24,Transfer,00.00,13.33,53.34,
13-Aug-24,Bill,"2,08,328.00",00.00,"2,08,381.34",
13-Aug-24,NEFT,44.1,00.00,"2,08,425.44",
13-Aug-24,Cash,481.5,00.00,"2,08,906.94",
13-Aug-24,Cheque,"3,29,475.80",00.00,"5,38,382.74",
13-Aug-24,NEFT,00.00,"76,911.82","4,61,470.92",
13-Aug-24,ATM,00.00,"46,147.09","4,15,323.83",
13-Aug-24,Bill,"24,330.00",00.00,"4,39,653.83",
13-Aug-24,ATM,227.61,00.00,"4,39,881.44",
13-Aug-24,Tax,"18,59,092.50",00.00,"22,98,973.94",
13-Aug-24,Purchase,00.00,"22,98,973.94",00.00,
13-Aug-24,Interest,"8,266.00",00.00,"8,266.00",
13-Aug-24,Reversal,545.2,00.00,"8,811.20",
13-Aug-24,RTGS,"2,584.70",00.00,"11,395.90",
13-Aug-24,ATM,50.17,00.00,"11,446.07",
13-Aug-24,RTGS,"1,88,039.10",00.00,"1,99,485.17",
13-Aug-24,Purchase,"9,827.95",00.00,"2,09,313.12",
13-Aug-24,Transfer,00.00,"29,901.87","1,79,411.25",
13-Aug-24,Cheque,00.00,"25,630.18","1,53,781.07",
13-Aug-24,Transportellaneous,07.00,00.00,"1,53,788.07",
13-Aug-24,NEFT,01.00,00.00,"1,53,789.07",
13-Aug-24,Cash,00.00,"15,378.91","1,38,410.16",
13-Aug-24,ATM,01.70,00.00,"1,38,411.86",
13-Aug-24,Reversal,"1,102.00",00.00,"1,39,513.86",
14-Aug-24,Debit Card,00.00,"69,756.93","69,756.93",
14-Aug-24,NEFT,"54,568.10",00.00,"1,24,325.03",
14-Aug-24,Interest,00.00,"20,720.84","1,03,604.19",
14-Aug-24,Cheque,60,00.00,"1,03,664.19",
14-Aug-24,Cheque,00.00,"34,554.73","69,109.46",
14-Aug-24,IMPS,"6,80,731.50",00.00,"7,49,840.96",
14-Aug-24,Reversal,"1,97,887.41",00.00,"9,47,728.37",
14-Aug-24,IMPS,28.21,00.00,"9,47,756.58",
14-Aug-24,Purchase,144.9,00.00,"9,47,901.48",
14-Aug-24,RTGS,00.00,"1,05,322.39","8,42,579.09",
14-Aug-24,Commission,00.00,"1,20,368.44","7,22,210.65",
14-Aug-24,IMPS,48.3,00.00,"7,22,258.95",
15-Aug-24,Debit Card,"6,71,259.75",00.00,"13,93,518.70",
15-Aug-24,Commission,00.00,"1,74,189.84","12,19,328.86",
15-Aug-24,Transportellaneous,11,00.00,"12,19,339.86",
15-Aug-24,Interest,00.00,"2,03,223.31","10,16,116.55",
15-Aug-24,ATM,02.00,00.00,"10,16,118.55",
15-Aug-24,Interest,"87,501.60",00.00,"11,03,620.15",
15-Aug-24,Interest,00.00,"1,83,936.69","9,19,683.46",
15-Aug-24,ATM,00.00,"1,31,383.35","7,88,300.11",
15-Aug-24,Transportellaneous,00.00,"1,31,383.35","6,56,916.76",
15-Aug-24,Tax,26.1,00.00,"6,56,942.86",
15-Aug-24,Purchase,03.70,00.00,"6,56,946.56",
15-Aug-24,ATM,00.00,"6,56,946.56",00.00,
15-Aug-24,Debit Card,02.62,00.00,02.62,
15-Aug-24,RTGS,03.00,00.00,05.62,
15-Aug-24,Debit Card,"2,20,881.28",00.00,"2,20,886.90",
15-Aug-24,Cash,00.00,"2,20,886.90",00.00,
15-Aug-24,Commission,"6,32,999.80",00.00,"6,32,999.80",
15-Aug-24,Transportellaneous,06.60,00.00,"6,33,006.40",
15-Aug-24,Transfer,"2,34,334.00",00.00,"8,67,340.40",
15-Aug-24,Debit Card,00.00,"96,371.16","7,70,969.24",
15-Aug-24,Cash,00.00,"1,28,494.87","6,42,474.37",
15-Aug-24,IMPS,00.00,"3,21,237.19","3,21,237.18",
15-Aug-24,Transfer,02.72,00.00,"3,21,239.90",
15-Aug-24,Transportellaneous,"8,551.30",00.00,"3,29,791.20",
15-Aug-24,Bill,00.00,"82,447.80","2,47,343.40",
15-Aug-24,Reversal,00.00,"30,917.93","2,16,425.48",
15-Aug-24,Commission,00.00,"21,642.55","1,94,782.93",
15-Aug-24,Cheque,"2,45,471.62",00.00,"4,40,254.55",
15-Aug-24,RTGS,00.00,"2,20,127.28","2,20,127.28",
15-Aug-24,NEFT,"3,713.00",00.00,"2,23,840.28",
15-Aug-24,Purchase,00.00,"74,613.43","1,49,226.85",
15-Aug-24,Transfer,80.89,00.00,"1,49,307.74",
15-Aug-24,NEFT,00.00,"21,329.68","1,27,978.06",
15-Aug-24,Cheque,"1,65,129.50",00.00,"2,93,107.56",
15-Aug-24,Transportellaneous,"1,29,751.16",00.00,"4,22,858.72",
15-Aug-24,Reversal,00.00,"60,408.39","3,62,450.33",
15-Aug-24,Reversal,00.00,"72,490.07","2,89,960.26",
15-Aug-24,Cash,03.00,00.00,"2,89,963.26",
15-Aug-24,Debit Card,00.00,"32,218.14","2,57,745.12",
15-Aug-24,Cheque,936,00.00,"2,58,681.12",
15-Aug-24,ATM,00.00,"51,736.22","2,06,944.90",
16-Aug-24,NEFT,00.00,"1,03,472.45","1,03,472.45",
16-Aug-24,IMPS,00.00,"20,694.49","82,777.96",
16-Aug-24,Tax,00.00,"20,694.49","62,083.47",
16-Aug-24,Bill,16.4,00.00,"62,099.87",
16-Aug-24,ATM,23,00.00,"62,122.87",
16-Aug-24,Tax,"19,05,442.00",00.00,"19,67,564.87",
16-Aug-24,Transportellaneous,00.00,"19,67,564.87",00.00,
16-Aug-24,Interest,02.20,00.00,02.20,
16-Aug-24,Bill,168.11,00.00,170.31,
16-Aug-24,IMPS,04.00,00.00,174.31,
16-Aug-24,Commission,00.00,87.16,87.16,
16-Aug-24,Interest,321.18,00.00,408.34,
16-Aug-24,IMPS,"2,54,782.06",00.00,"2,55,190.40",
16-Aug-24,Reversal,01.97,00.00,"2,55,192.37",
16-Aug-24,Purchase,"30,082.66",00.00,"2,85,275.03",
16-Aug-24,Interest,"62,424.72",00.00,"3,47,699.75",
16-Aug-24,ATM,00.00,"69,539.95","2,78,159.80",
16-Aug-24,Bill,00.00,"30,906.64","2,47,253.16",
16-Aug-24,Transportellaneous,"2,06,682.60",00.00,"4,53,935.76",
16-Aug-24,Bill,00.00,"50,437.31","4,03,498.45",
16-Aug-24,Tax,00.00,"67,249.74","3,36,248.71",
16-Aug-24,Cheque,48,00.00,"3,36,296.71",
16-Aug-24,Cheque,03.88,00.00,"3,36,300.59",
16-Aug-24,ATM,00.00,"33,630.06","3,02,670.53",
16-Aug-24,Commission,00.00,"60,534.11","2,42,136.42",
16-Aug-24,Reversal,06.00,00.00,"2,42,142.42",
16-Aug-24,Commission,00.00,"30,267.80","2,11,874.62",
16-Aug-24,Transfer,41.42,00.00,"2,11,916.04",
16-Aug-24,Cash,"3,075.56",00.00,"2,14,991.60",
16-Aug-24,Tax,37.8,00.00,"2,15,029.40",
16-Aug-24,Cheque,00.00,"30,718.49","1,84,310.91",
16-Aug-24,Cash,"9,20,657.75",00.00,"11,04,968.66",
17-Aug-24,Cheque,"2,112.73",00.00,"11,07,081.39",
17-Aug-24,NEFT,236,00.00,"11,07,317.39",
17-Aug-24,Bill,00.00,"2,21,463.48","8,85,853.91",
17-Aug-24,Tax,"22,733.10",00.00,"9,08,587.01",
17-Aug-24,Transportellaneous,00.00,"2,27,146.75","6,81,440.26",
17-Aug-24,Cash,00.00,"97,348.61","5,84,091.65",
17-Aug-24,NEFT,"2,669.02",00.00,"5,86,760.67",
17-Aug-24,Reversal,00.00,"5,86,760.67",00.00,
17-Aug-24,Cheque,820.53,00.00,820.53,
17-Aug-24,Cheque,240.4,00.00,"1,060.93",
17-Aug-24,Tax,00.00,132.62,928.31,
17-Aug-24,Commission,00.00,464.16,464.16,
17-Aug-24,Transfer,00.00,77.36,386.8,
17-Aug-24,ATM,00.00,38.68,348.12,
17-Aug-24,Bill,429,00.00,777.12,
17-Aug-24,NEFT,"12,78,941.75",00.00,"12,79,718.87",
17-Aug-24,Debit Card,105,00.00,"12,79,823.87",
18-Aug-24,Reversal,00.00,"4,26,607.96","8,53,215.91",
18-Aug-24,Bill,00.00,"1,06,651.99","7,46,563.92",
18-Aug-24,Interest,00.00,"2,48,854.64","4,97,709.28",
18-Aug-24,Cash,40.4,00.00,"4,97,749.68",
18-Aug-24,NEFT,00.00,"55,305.52","4,42,444.16",
18-Aug-24,IMPS,00.00,"49,160.46","3,93,283.70",
18-Aug-24,Tax,"3,945.70",00.00,"3,97,229.40",
18-Aug-24,Interest,"2,090.00",00.00,"3,99,319.40",
18-Aug-24,Purchase,00.00,"79,863.88","3,19,455.52",
18-Aug-24,NEFT,05.10,00.00,"3,19,460.62",
18-Aug-24,ATM,"13,01,014.75",00.00,"16,20,475.37",
18-Aug-24,RTGS,"4,62,708.00",00.00,"20,83,183.37",
18-Aug-24,Cheque,00.00,"3,47,197.23","17,35,986.14",
18-Aug-24,Transportellaneous,386.87,00.00,"17,36,373.01",
18-Aug-24,Cash,02.76,00.00,"17,36,375.77",
18-Aug-24,Interest,00.00,"4,34,093.94","13,02,281.83",
18-Aug-24,Cheque,00.00,"4,34,093.94","8,68,187.89",
18-Aug-24,Interest,00.20,00.00,"8,68,188.09",
18-Aug-24,Transfer,00.00,"4,34,094.05","4,34,094.04",
18-Aug-24,RTGS,"3,66,026.50",00.00,"8,00,120.54",
18-Aug-24,ATM,00.00,"1,00,015.07","7,00,105.47",
18-Aug-24,Debit Card,"18,779.60",00.00,"7,18,885.07",
18-Aug-24,Reversal,00.00,"2,39,628.36","4,79,256.71",
18-Aug-24,ATM,12.4,00.00,"4,79,269.11",
18-Aug-24,Reversal,00.00,"53,252.12","4,26,016.99",
18-Aug-24,Cash,00.00,"60,859.57","3,65,157.42",
18-Aug-24,IMPS,"1,99,524.00",00.00,"5,64,681.42",
18-Aug-24,Debit Card,04.79,00.00,"5,64,686.21",
18-Aug-24,Interest,"81,207.03",00.00,"6,45,893.24",
18-Aug-24,Transportellaneous,00.00,"80,736.66","5,65,156.58",
18-Aug-24,Reversal,00.00,"1,88,385.53","3,76,771.05",
18-Aug-24,IMPS,00.00,"47,096.38","3,29,674.67",
18-Aug-24,RTGS,05.90,00.00,"3,29,680.57",
18-Aug-24,Reversal,"18,410.10",00.00,"3,48,090.67",
19-Aug-24,Bill,07.30,00.00,"3,48,097.97",
19-Aug-24,IMPS,"27,831.85",00.00,"3,75,929.82",
19-Aug-24,Reversal,"13,542.50",00.00,"3,89,472.32",
19-Aug-24,Purchase,"31,824.00",00.00,"4,21,296.32",
19-Aug-24,RTGS,00.00,"1,05,324.08","3,15,972.24",
19-Aug-24,Interest,00.00,"3,15,972.24",00.00,
19-Aug-24,Tax,"1,75,600.00",00.00,"1,75,600.00",
19-Aug-24,Transfer,00.00,"1,75,600.00",00.00,
19-Aug-24,IMPS,531.09,00.00,531.09,
19-Aug-24,IMPS,00.00,88.52,442.58,
19-Aug-24,Transportellaneous,"1,11,232.53",00.00,"1,11,675.11",
19-Aug-24,RTGS,"7,395.00",00.00,"1,19,070.11",
19-Aug-24,Reversal,07.00,00.00,"1,19,077.11",
19-Aug-24,Debit Card,"1,482.10",00.00,"1,20,559.21",
19-Aug-24,Bill,00.00,"17,222.74","1,03,336.47",
19-Aug-24,Reversal,00.00,"12,917.06","90,419.41",
19-Aug-24,RTGS,01.93,00.00,"90,421.34",
19-Aug-24,RTGS,32,00.00,"90,453.34",
19-Aug-24,Interest,00.00,"9,045.33","81,408.01",
19-Aug-24,IMPS,"18,670.90",00.00,"1,00,078.91",
19-Aug-24,Bill,70,00.00,"1,00,148.91",
19-Aug-24,Tax,00.00,"1,00,148.91",00.00,
19-Aug-24,Purchase,00.10,00.00,00.10,
19-Aug-24,Commission,00.00,00.03,00.08,
19-Aug-24,ATM,00.00,00.02,00.06,
19-Aug-24,RTGS,00.00,00.01,00.05,
19-Aug-24,ATM,00.00,00.01,00.05,
19-Aug-24,NEFT,00.00,00.01,00.04,
19-Aug-24,Cash,"2,27,521.70",00.00,"2,27,521.74",
19-Aug-24,Purchase,"2,41,978.00",00.00,"4,69,499.74",
19-Aug-24,Cheque,00.00,"2,34,749.87","2,34,749.87",
19-Aug-24,Purchase,00.00,"23,474.99","2,11,274.88",
19-Aug-24,Reversal,00.00,"30,182.13","1,81,092.75",
19-Aug-24,Debit Card,62.1,00.00,"1,81,154.85",
19-Aug-24,Purchase,"17,033.00",00.00,"1,98,187.85",
19-Aug-24,RTGS,00.00,"33,031.31","1,65,156.54",
19-Aug-24,IMPS,"5,426.50",00.00,"1,70,583.04",
19-Aug-24,Cash,59.5,00.00,"1,70,642.54",
19-Aug-24,Cheque,00.00,"17,064.25","1,53,578.29",
19-Aug-24,Interest,06.80,00.00,"1,53,585.09",
19-Aug-24,Cheque,"3,789.10",00.00,"1,57,374.19",
19-Aug-24,Commission,"1,13,412.56",00.00,"2,70,786.75",
19-Aug-24,ATM,00.00,"2,70,786.75",00.00,
19-Aug-24,IMPS,"17,47,870.00",00.00,"17,47,870.00",
19-Aug-24,Bill,"3,255.80",00.00,"17,51,125.80",
19-Aug-24,Transportellaneous,00.00,"4,37,781.45","13,13,344.35",
19-Aug-24,RTGS,02.80,00.00,"13,13,347.15",
19-Aug-24,Tax,33.96,00.00,"13,13,381.11",
19-Aug-24,Commission,00.00,"1,45,931.23","11,67,449.88",
19-Aug-24,Interest,00.00,"5,83,724.94","5,83,724.94",
19-Aug-24,Commission,08.00,00.00,"5,83,732.94",
19-Aug-24,Bill,00.00,"1,45,933.24","4,37,799.70",
19-Aug-24,Interest,05.00,00.00,"4,37,804.70",
19-Aug-24,NEFT,00.00,"72,967.45","3,64,837.25",
19-Aug-24,Commission,00.00,"52,119.61","3,12,717.64",
19-Aug-24,Bill,"3,359.75",00.00,"3,16,077.39",
19-Aug-24,Cheque,04.32,00.00,"3,16,081.71",
19-Aug-24,Interest,"1,87,216.50",00.00,"5,03,298.21",
20-Aug-24,Cash,00.00,"62,912.28","4,40,385.93",
20-Aug-24,Cash,344.75,00.00,"4,40,730.68",
20-Aug-24,Purchase,"66,660.70",00.00,"5,07,391.38",
20-Aug-24,Bill,"1,521.60",00.00,"5,08,912.98",
20-Aug-24,RTGS,"76,465.00",00.00,"5,85,377.98",
20-Aug-24,ATM,"3,117.10",00.00,"5,88,495.08",
20-Aug-24,IMPS,00.00,"1,47,123.77","4,41,371.31",
20-Aug-24,Bill,00.00,"55,171.41","3,86,199.90",
20-Aug-24,Debit Card,"2,35,098.00",00.00,"6,21,297.90",
20-Aug-24,Interest,00.00,"1,55,324.48","4,65,973.43",
20-Aug-24,Transportellaneous,"19,266.68",00.00,"4,85,240.11",
20-Aug-24,Purchase,48.7,00.00,"4,85,288.81",
20-Aug-24,Cash,441,00.00,"4,85,729.81",
20-Aug-24,NEFT,41.34,00.00,"4,85,771.15",
20-Aug-24,NEFT,06.05,00.00,"4,85,777.20",
20-Aug-24,Bill,00.00,"69,396.74","4,16,380.46",
20-Aug-24,RTGS,"1,88,724.25",00.00,"6,05,104.71",
20-Aug-24,NEFT,"86,222.80",00.00,"6,91,327.51",
20-Aug-24,NEFT,54,00.00,"6,91,381.51",
20-Aug-24,Reversal,484.4,00.00,"6,91,865.91",
20-Aug-24,Bill,00.00,"6,91,865.91",00.00,
20-Aug-24,Transfer,"37,665.00",00.00,"37,665.00",
20-Aug-24,Tax,"2,798.00",00.00,"40,463.00",
20-Aug-24,Cheque,47,00.00,"40,510.00",
20-Aug-24,Debit Card,00.00,"4,051.00","36,459.00",
20-Aug-24,Tax,50,00.00,"36,509.00",
20-Aug-24,Cheque,00.00,"7,301.80","29,207.20",
21-Aug-24,Tax,"13,402.00",00.00,"42,609.20",
21-Aug-24,Cash,00.00,"8,521.84","34,087.36",
21-Aug-24,Bill,00.00,"4,869.62","29,217.74",
21-Aug-24,Interest,01.40,00.00,"29,219.14",
21-Aug-24,Interest,00.00,"29,219.14",00.00,
21-Aug-24,Transfer,"9,078.00",00.00,"9,078.00",
21-Aug-24,Transportellaneous,"37,724.25",00.00,"46,802.25",
21-Aug-24,Transfer,00.00,"23,401.13","23,401.12",
21-Aug-24,ATM,00.00,"2,600.12","20,801.00",
21-Aug-24,Cash,00.00,"2,311.22","18,489.78",
21-Aug-24,Commission,"21,144.20",00.00,"39,633.98",
21-Aug-24,Commission,04.34,00.00,"39,638.32",
21-Aug-24,RTGS,59,00.00,"39,697.32",
21-Aug-24,IMPS,00.00,"13,232.44","26,464.88",
21-Aug-24,NEFT,00.50,00.00,"26,465.38",
21-Aug-24,Debit Card,"3,472.00",00.00,"29,937.38",
21-Aug-24,Transportellaneous,"7,08,889.50",00.00,"7,38,826.88",
21-Aug-24,RTGS,00.00,"82,091.88","6,56,735.00",
21-Aug-24,IMPS,00.00,"2,18,911.67","4,37,823.33",
21-Aug-24,Purchase,"1,533.23",00.00,"4,39,356.56",
21-Aug-24,RTGS,32,00.00,"4,39,388.56",
21-Aug-24,Bill,"11,791.19",00.00,"4,51,179.75",
21-Aug-24,Debit Card,30,00.00,"4,51,209.75",
21-Aug-24,Interest,06.10,00.00,"4,51,215.85",
21-Aug-24,Commission,497,00.00,"4,51,712.85",
21-Aug-24,Purchase,00.00,"64,530.41","3,87,182.44",
21-Aug-24,RTGS,"2,58,655.10",00.00,"6,45,837.54",
21-Aug-24,Reversal,250.6,00.00,"6,46,088.14",
21-Aug-24,Debit Card,74.95,00.00,"6,46,163.09",
21-Aug-24,Cash,451.35,00.00,"6,46,614.44",
21-Aug-24,IMPS,"16,745.10",00.00,"6,63,359.54",
21-Aug-24,NEFT,"90,826.00",00.00,"7,54,185.54",
21-Aug-24,Interest,"1,602.89",00.00,"7,55,788.43",
21-Aug-24,Debit Card,"11,320.00",00.00,"7,67,108.43",
21-Aug-24,RTGS,"22,572.70",00.00,"7,89,681.13",
21-Aug-24,Reversal,00.00,"78,968.11","7,10,713.02",
21-Aug-24,Debit Card,"9,28,768.00",00.00,"16,39,481.02",
21-Aug-24,Commission,03.46,00.00,"16,39,484.48",
21-Aug-24,Commission,00.00,"2,34,212.07","14,05,272.41",
21-Aug-24,Bill,149.3,00.00,"14,05,421.71",
21-Aug-24,Cheque,806.9,00.00,"14,06,228.61",
21-Aug-24,Tax,"18,067.00",00.00,"14,24,295.61",
21-Aug-24,Transportellaneous,"12,648.00",00.00,"14,36,943.61",
21-Aug-24,Transportellaneous,"2,45,704.75",00.00,"16,82,648.36",
21-Aug-24,Cash,129.5,00.00,"16,82,777.86",
21-Aug-24,Transportellaneous,"9,69,726.20",00.00,"26,52,504.06",
21-Aug-24,Interest,"10,03,440.00",00.00,"36,55,944.06",
21-Aug-24,Bill,00.00,"6,09,324.01","30,46,620.05",
21-Aug-24,IMPS,00.00,"6,09,324.01","24,37,296.04",
21-Aug-24,Transfer,00.00,"24,37,296.04",00.00,
21-Aug-24,Interest,"1,519.55",00.00,"1,519.55",
21-Aug-24,Interest,00.00,253.26,"1,266.29",
21-Aug-24,Debit Card,01.00,00.00,"1,267.29",
21-Aug-24,NEFT,00.00,211.22,"1,056.08",
21-Aug-24,Tax,"20,61,350.00",00.00,"20,62,406.08",
21-Aug-24,Tax,"10,476.00",00.00,"20,72,882.08",
21-Aug-24,IMPS,00.00,"6,90,960.69","13,81,921.39",
21-Aug-24,ATM,00.00,"1,72,740.17","12,09,181.22",
21-Aug-24,Transportellaneous,00.00,"6,04,590.61","6,04,590.61",
21-Aug-24,Debit Card,00.20,00.00,"6,04,590.81",
21-Aug-24,Interest,00.00,"6,04,590.81",00.00,
21-Aug-24,RTGS,28.46,00.00,28.46,
21-Aug-24,NEFT,00.00,07.12,21.34,
21-Aug-24,ATM,00.00,21.34,00.00,
21-Aug-24,Debit Card,"8,052.00",00.00,"8,052.00",
21-Aug-24,Tax,00.00,805.2,"7,246.80",
21-Aug-24,Transfer,"13,14,055.00",00.00,"13,21,301.80",
21-Aug-24,IMPS,"21,806.40",00.00,"13,43,108.20",
21-Aug-24,Commission,00.00,"13,43,108.20",00.00,
22-Aug-24,Purchase,58.9,00.00,58.9,
22-Aug-24,Bill,"3,576.30",00.00,"3,635.20",
22-Aug-24,Cheque,00.00,727.04,"2,908.16",
22-Aug-24,Transportellaneous,00.00,"2,908.16",00.00,
22-Aug-24,Reversal,"6,433.30",00.00,"6,433.30",
22-Aug-24,Cash,"3,002.90",00.00,"9,436.20",
22-Aug-24,Bill,00.00,"1,179.53","8,256.68",
22-Aug-24,NEFT,"1,994.80",00.00,"10,251.48",
22-Aug-24,Tax,00.00,"5,125.74","5,125.74",
23-Aug-24,Reversal,00.00,"1,281.44","3,844.30",
23-Aug-24,Debit Card,"1,16,414.47",00.00,"1,20,258.77",
23-Aug-24,Cash,00.00,"15,032.35","1,05,226.42",
23-Aug-24,Interest,15.78,00.00,"1,05,242.20",
23-Aug-24,Cheque,51.16,00.00,"1,05,293.36",
23-Aug-24,Bill,00.00,"10,529.34","94,764.02",
23-Aug-24,Cash,00.00,"9,476.40","85,287.62",
23-Aug-24,NEFT,00.00,"14,214.60","71,073.02",
23-Aug-24,RTGS,00.00,"10,153.29","60,919.73",
23-Aug-24,Commission,"66,687.22",00.00,"1,27,606.95",
23-Aug-24,NEFT,"1,19,771.94",00.00,"2,47,378.89",
23-Aug-24,NEFT,00.00,"1,23,689.45","1,23,689.44",
23-Aug-24,Debit Card,"7,72,777.00",00.00,"8,96,466.44",
23-Aug-24,NEFT,00.00,"8,96,466.44",00.00,
23-Aug-24,Purchase,02.00,00.00,02.00,
23-Aug-24,Cheque,00.00,00.29,01.71,
23-Aug-24,NEFT,"19,52,756.00",00.00,"19,52,757.71",
23-Aug-24,Purchase,"1,322.20",00.00,"19,54,079.91",
23-Aug-24,Bill,"1,89,327.00",00.00,"21,43,406.91",
23-Aug-24,Commission,01.00,00.00,"21,43,407.91",
23-Aug-24,Reversal,00.00,"7,14,469.30","14,28,938.61",
23-Aug-24,Interest,"7,798.30",00.00,"14,36,736.91",
23-Aug-24,IMPS,00.00,"2,05,248.13","12,31,488.78",
23-Aug-24,Transfer,"16,101.10",00.00,"12,47,589.88",
23-Aug-24,Debit Card,40.4,00.00,"12,47,630.28",
23-Aug-24,Debit Card,"1,427.80",00.00,"12,49,058.08",
23-Aug-24,Tax,00.00,"4,16,352.69","8,32,705.39",
23-Aug-24,Transportellaneous,"2,121.96",00.00,"8,34,827.35",
23-Aug-24,Transfer,00.00,"1,66,965.47","6,67,861.88",
23-Aug-24,Cash,02.50,00.00,"6,67,864.38",
23-Aug-24,Commission,00.00,"1,66,966.10","5,00,898.28",
23-Aug-24,NEFT,00.90,00.00,"5,00,899.18",
23-Aug-24,Cash,03.29,00.00,"5,00,902.47",
23-Aug-24,RTGS,00.00,"1,66,967.49","3,33,934.98",
23-Aug-24,Transfer,00.40,00.00,"3,33,935.38",
23-Aug-24,RTGS,00.00,"83,483.85","2,50,451.54",
23-Aug-24,NEFT,"71,257.38",00.00,"3,21,708.92",
23-Aug-24,Reversal,00.00,"64,341.78","2,57,367.14",
23-Aug-24,Transfer,00.00,"2,57,367.14",00.00,
23-Aug-24,IMPS,"30,062.32",00.00,"30,062.32",
23-Aug-24,RTGS,"49,210.80",00.00,"79,273.12",
23-Aug-24,Transfer,00.00,"19,818.28","59,454.84",
23-Aug-24,Cash,00.00,"14,863.71","44,591.13",
23-Aug-24,RTGS,00.00,"7,431.86","37,159.27",
23-Aug-24,Commission,"73,808.10",00.00,"1,10,967.37",
23-Aug-24,Transfer,"8,208.07",00.00,"1,19,175.44",
23-Aug-24,Cash,00.00,"19,862.57","99,312.87",
23-Aug-24,Reversal,00.00,"16,552.15","82,760.72",
23-Aug-24,Cheque,00.00,"41,380.36","41,380.36",
23-Aug-24,Cheque,00.00,"4,138.04","37,242.32",
23-Aug-24,Transportellaneous,"11,97,005.50",00.00,"12,34,247.82",
23-Aug-24,IMPS,00.00,"3,08,561.96","9,25,685.86",
23-Aug-24,Transportellaneous,00.00,"3,08,561.95","6,17,123.91",
23-Aug-24,Transfer,06.40,00.00,"6,17,130.31",
23-Aug-24,Tax,"3,960.52",00.00,"6,21,090.83",
23-Aug-24,Reversal,00.00,"69,010.09","5,52,080.74",
23-Aug-24,ATM,"2,675.13",00.00,"5,54,755.87",
23-Aug-24,Purchase,06.07,00.00,"5,54,761.94",
23-Aug-24,Transportellaneous,"2,077.00",00.00,"5,56,838.94",
23-Aug-24,Purchase,"5,58,979.00",00.00,"11,15,817.94",
23-Aug-24,Cash,"64,685.62",00.00,"11,80,503.56",
23-Aug-24,ATM,03.00,00.00,"11,80,506.56",
23-Aug-24,Tax,00.00,"1,68,643.79","10,11,862.77",
23-Aug-24,Purchase,00.00,"10,11,862.77",00.00,
23-Aug-24,Debit Card,"1,12,199.00",00.00,"1,12,199.00",
23-Aug-24,Cash,415,00.00,"1,12,614.00",
23-Aug-24,Commission,07.60,00.00,"1,12,621.60",
23-Aug-24,Transportellaneous,"2,523.00",00.00,"1,15,144.60",
23-Aug-24,Transportellaneous,04.30,00.00,"1,15,148.90",
23-Aug-24,NEFT,361.7,00.00,"1,15,510.60",
23-Aug-24,Tax,00.00,"38,503.53","77,007.07",
23-Aug-24,ATM,00.00,"12,834.51","64,172.56",
23-Aug-24,IMPS,"1,522.34",00.00,"65,694.90",
23-Aug-24,Reversal,"8,632.70",00.00,"74,327.60",
23-Aug-24,RTGS,"20,870.20",00.00,"95,197.80",
23-Aug-24,Bill,402,00.00,"95,599.80",
23-Aug-24,Tax,"14,17,817.00",00.00,"15,13,416.80",
23-Aug-24,Cheque,00.00,"3,02,683.36","12,10,733.44",
23-Aug-24,Transfer,00.00,"2,01,788.91","10,08,944.53",
23-Aug-24,Interest,00.00,"1,12,104.95","8,96,839.58",
23-Aug-24,RTGS,"1,70,932.50",00.00,"10,67,772.08",
23-Aug-24,Purchase,36.4,00.00,"10,67,808.48",
23-Aug-24,Transportellaneous,"17,740.59",00.00,"10,85,549.07",
23-Aug-24,Transportellaneous,05.20,00.00,"10,85,554.27",
23-Aug-24,Transportellaneous,00.00,"2,17,110.85","8,68,443.42",
23-Aug-24,Interest,380,00.00,"8,68,823.42",
23-Aug-24,Cash,00.00,"1,08,602.93","7,60,220.49",
23-Aug-24,Transportellaneous,452,00.00,"7,60,672.49",
23-Aug-24,Purchase,00.00,"1,08,667.50","6,52,004.99",
23-Aug-24,Cheque,217.61,00.00,"6,52,222.60",
23-Aug-24,RTGS,00.00,"1,08,703.77","5,43,518.83",
23-Aug-24,Cash,785.6,00.00,"5,44,304.43",
23-Aug-24,Cash,00.00,"54,430.44","4,89,873.99",
23-Aug-24,Tax,"18,90,344.75",00.00,"23,80,218.74",
23-Aug-24,Interest,448,00.00,"23,80,666.74",
23-Aug-24,Debit Card,00.00,"2,64,518.53","21,16,148.21",
23-Aug-24,Commission,74,00.00,"21,16,222.21",
23-Aug-24,Bill,06.30,00.00,"21,16,228.51",
23-Aug-24,Bill,"14,29,970.00",00.00,"35,46,198.51",
23-Aug-24,Reversal,00.00,"17,73,099.26","17,73,099.26",
23-Aug-24,Reversal,"7,30,747.00",00.00,"25,03,846.26",
23-Aug-24,Purchase,00.00,"4,17,307.71","20,86,538.55",
23-Aug-24,Debit Card,00.00,"6,95,512.85","13,91,025.70",
23-Aug-24,Tax,00.00,"13,91,025.70",00.00,
23-Aug-24,Commission,"3,863.76",00.00,"3,863.76",
23-Aug-24,NEFT,"17,56,994.00",00.00,"17,60,857.76",
23-Aug-24,ATM,00.00,"8,80,428.88","8,80,428.88",
23-Aug-24,Cash,"2,376.00",00.00,"8,82,804.88",
23-Aug-24,RTGS,00.00,"2,20,701.22","6,62,103.66",
23-Aug-24,Debit Card,24.1,00.00,"6,62,127.76",
23-Aug-24,Debit Card,00.00,"3,31,063.88","3,31,063.88",
23-Aug-24,IMPS,00.00,"1,10,354.63","2,20,709.25",
23-Aug-24,Debit Card,00.00,"73,569.75","1,47,139.50",
23-Aug-24,Tax,03.00,00.00,"1,47,142.50",
23-Aug-24,NEFT,"1,00,688.00",00.00,"2,47,830.50",
23-Aug-24,Cash,359.9,00.00,"2,48,190.40",
23-Aug-24,Bill,"18,577.61",00.00,"2,66,768.01",
23-Aug-24,Interest,38,00.00,"2,66,806.01",
23-Aug-24,IMPS,"1,91,031.00",00.00,"4,57,837.01",
23-Aug-24,Transfer,00.00,"1,52,612.34","3,05,224.67",
23-Aug-24,Reversal,00.00,"61,044.93","2,44,179.74",
23-Aug-24,Purchase,00.00,"2,44,179.74",00.00,
23-Aug-24,Cheque,"3,73,907.50",00.00,"3,73,907.50",
23-Aug-24,IMPS,00.00,"3,73,907.50",00.00,
23-Aug-24,Interest,01.00,00.00,01.00,
23-Aug-24,Bill,00.00,00.20,00.80,
23-Aug-24,Bill,29.2,00.00,30,
23-Aug-24,Reversal,00.00,15,15,
23-Aug-24,ATM,159.74,00.00,174.74,
23-Aug-24,Commission,00.00,17.47,157.27,
23-Aug-24,Debit Card,"10,31,465.50",00.00,"10,31,622.77",
23-Aug-24,Transfer,"7,64,377.20",00.00,"17,95,999.97",
23-Aug-24,Reversal,00.00,"3,59,199.99","14,36,799.98",
23-Aug-24,RTGS,37.7,00.00,"14,36,837.68",
23-Aug-24,ATM,"19,15,620.50",00.00,"33,52,458.18",
23-Aug-24,RTGS,00.00,"8,38,114.55","25,14,343.64",
23-Aug-24,Bill,00.00,"3,59,191.95","21,55,151.69",
23-Aug-24,Reversal,"25,953.00",00.00,"21,81,104.69",
23-Aug-24,IMPS,00.00,"3,63,517.45","18,17,587.24",
23-Aug-24,Bill,"22,174.00",00.00,"18,39,761.24",
23-Aug-24,Transfer,"3,725.00",00.00,"18,43,486.24",
23-Aug-24,Debit Card,"2,02,953.60",00.00,"20,46,439.84",
23-Aug-24,Purchase,488.33,00.00,"20,46,928.17",
23-Aug-24,Cash,281.64,00.00,"20,47,209.81",
23-Aug-24,Reversal,43.1,00.00,"20,47,252.91",
23-Aug-24,ATM,00.00,"20,47,252.91",00.00,
23-Aug-24,Tax,06.80,00.00,06.80,
23-Aug-24,Cash,123.98,00.00,130.78,
23-Aug-24,Bill,02.80,00.00,133.58,
23-Aug-24,Commission,"3,216.30",00.00,"3,349.88",
23-Aug-24,ATM,"2,799.03",00.00,"6,148.91",
23-Aug-24,Tax,00.00,878.42,"5,270.49",
23-Aug-24,Transportellaneous,00.00,658.81,"4,611.68",
23-Aug-24,Purchase,"10,92,582.00",00.00,"10,97,193.68",
23-Aug-24,Cash,00.83,00.00,"10,97,194.51",
23-Aug-24,Transfer,"18,761.20",00.00,"11,15,955.71",
23-Aug-24,ATM,52,00.00,"11,16,007.71",
23-Aug-24,Commission,56.66,00.00,"11,16,064.37",
23-Aug-24,ATM,00.00,"2,23,212.87","8,92,851.50",
23-Aug-24,RTGS,00.00,"1,27,550.21","7,65,301.29",
23-Aug-24,Transfer,00.00,"1,09,328.76","6,55,972.53",
23-Aug-24,Reversal,"1,08,907.80",00.00,"7,64,880.33",
23-Aug-24,Debit Card,00.00,"2,54,960.11","5,09,920.22",
23-Aug-24,Debit Card,00.00,"1,01,984.04","4,07,936.18",
23-Aug-24,Bill,04.81,00.00,"4,07,940.99",
23-Aug-24,Commission,00.00,"50,992.62","3,56,948.37",
23-Aug-24,Bill,"3,613.62",00.00,"3,60,561.99",
23-Aug-24,NEFT,00.00,"3,60,561.99",00.00,
23-Aug-24,Bill,"5,23,574.00",00.00,"5,23,574.00",
23-Aug-24,Purchase,00.00,"58,174.89","4,65,399.11",
23-Aug-24,Tax,00.00,"66,485.59","3,98,913.52",
23-Aug-24,Transfer,422.44,00.00,"3,99,335.96",
23-Aug-24,Cheque,"1,016.90",00.00,"4,00,352.86",
23-Aug-24,Tax,"1,03,820.59",00.00,"5,04,173.45",
23-Aug-24,Transportellaneous,415.97,00.00,"5,04,589.42",
23-Aug-24,Interest,00.00,"84,098.24","4,20,491.18",
23-Aug-24,Cash,00.00,"60,070.17","3,60,421.01",
23-Aug-24,Transportellaneous,00.00,"72,084.20","2,88,336.81",
23-Aug-24,Transportellaneous,00.00,"41,190.97","2,47,145.84",
23-Aug-24,Commission,"43,325.00",00.00,"2,90,470.84",
23-Aug-24,Commission,00.00,"48,411.81","2,42,059.03",
23-Aug-24,Bill,00.00,"2,42,059.03",00.00,
23-Aug-24,Commission,"1,449.20",00.00,"1,449.20",
23-Aug-24,Reversal,00.00,161.02,"1,288.18",
24-Aug-24,RTGS,00.00,322.05,966.14,
24-Aug-24,Transportellaneous,00.00,193.23,772.91,
24-Aug-24,IMPS,00.00,772.91,00.00,
24-Aug-24,ATM,"17,303.55",00.00,"17,303.55",
24-Aug-24,RTGS,00.00,"2,883.93","14,419.62",
24-Aug-24,Reversal,58,00.00,"14,477.62",
24-Aug-24,Debit Card,00.00,"1,608.62","12,869.00",
24-Aug-24,Interest,109,00.00,"12,978.00",
24-Aug-24,Transfer,00.00,"1,297.80","11,680.20",
24-Aug-24,RTGS,"27,874.06",00.00,"39,554.26",
24-Aug-24,Cash,"27,951.40",00.00,"67,505.66",
25-Aug-24,Transfer,00.00,"33,752.83","33,752.83",
25-Aug-24,Transportellaneous,"1,42,336.00",00.00,"1,76,088.83",
25-Aug-24,NEFT,39.5,00.00,"1,76,128.33",
25-Aug-24,Cheque,00.00,"17,612.83","1,58,515.50",
25-Aug-24,Transportellaneous,00.00,"1,58,515.50",00.00,
25-Aug-24,Cash,"10,15,822.00",00.00,"10,15,822.00",
25-Aug-24,Reversal,00.00,"1,12,869.11","9,02,952.89",
25-Aug-24,Reversal,"55,518.00",00.00,"9,58,470.89",
25-Aug-24,NEFT,"3,175.30",00.00,"9,61,646.19",
25-Aug-24,NEFT,"17,975.10",00.00,"9,79,621.29",
25-Aug-24,Purchase,"2,59,920.00",00.00,"12,39,541.29",
25-Aug-24,Cheque,00.00,"2,47,908.26","9,91,633.03",
25-Aug-24,Cheque,"28,206.00",00.00,"10,19,839.03",
25-Aug-24,Purchase,64,00.00,"10,19,903.03",
25-Aug-24,Bill,55.62,00.00,"10,19,958.65",
25-Aug-24,Reversal,"13,51,814.00",00.00,"23,71,772.65",
25-Aug-24,IMPS,00.00,"2,96,471.58","20,75,301.07",
25-Aug-24,Reversal,00.00,"2,07,530.11","18,67,770.96",
25-Aug-24,Reversal,00.00,"18,67,770.96",00.00,
25-Aug-24,Commission,31.37,00.00,31.37,
25-Aug-24,ATM,00.00,04.48,26.89,
25-Aug-24,NEFT,"19,92,826.00",00.00,"19,92,852.89",
25-Aug-24,Cash,00.00,"2,84,693.27","17,08,159.62",
25-Aug-24,Bill,56,00.00,"17,08,215.62",
25-Aug-24,Interest,00.00,"2,44,030.80","14,64,184.82",
25-Aug-24,IMPS,00.00,"7,32,092.41","7,32,092.41",
25-Aug-24,Interest,02.00,00.00,"7,32,094.41",
25-Aug-24,ATM,27,00.00,"7,32,121.41",
25-Aug-24,Cash,34.88,00.00,"7,32,156.29",
25-Aug-24,Reversal,"30,320.00",00.00,"7,62,476.29",
25-Aug-24,Cash,00.00,"7,62,476.29",00.00,
25-Aug-24,Bill,"2,37,030.00",00.00,"2,37,030.00",
25-Aug-24,IMPS,09.77,00.00,"2,37,039.77",
25-Aug-24,RTGS,00.23,00.00,"2,37,040.00",
25-Aug-24,Bill,03.80,00.00,"2,37,043.80",
25-Aug-24,IMPS,431,00.00,"2,37,474.80",
25-Aug-24,Debit Card,00.00,"26,386.09","2,11,088.71",
25-Aug-24,Reversal,07.00,00.00,"2,11,095.71",
25-Aug-24,Interest,"1,13,780.22",00.00,"3,24,875.93",
25-Aug-24,Commission,"3,858.00",00.00,"3,28,733.93",
25-Aug-24,ATM,"72,648.90",00.00,"4,01,382.83",
25-Aug-24,RTGS,00.00,"2,00,691.42","2,00,691.42",
25-Aug-24,RTGS,"1,272.00",00.00,"2,01,963.42",
25-Aug-24,Interest,"2,518.13",00.00,"2,04,481.55",
25-Aug-24,ATM,184,00.00,"2,04,665.55",
25-Aug-24,Transportellaneous,00.00,"51,166.39","1,53,499.16",
25-Aug-24,Transportellaneous,00.00,"76,749.58","76,749.58",
25-Aug-24,Cheque,03.80,00.00,"76,753.38",
25-Aug-24,Tax,"6,19,629.20",00.00,"6,96,382.58",
25-Aug-24,Bill,00.00,"2,32,127.53","4,64,255.05",
25-Aug-24,RTGS,00.00,"4,64,255.05",00.00,
25-Aug-24,Cheque,"3,449.55",00.00,"3,449.55",
25-Aug-24,RTGS,00.00,383.28,"3,066.27",
25-Aug-24,Cheque,00.00,"1,022.09","2,044.18",
25-Aug-24,Commission,00.00,227.13,"1,817.05",
25-Aug-24,Reversal,965,00.00,"2,782.05",
25-Aug-24,NEFT,00.00,347.76,"2,434.29",
25-Aug-24,Purchase,00.00,608.57,"1,825.72",
25-Aug-24,Transfer,"2,973.00",00.00,"4,798.72",
25-Aug-24,Debit Card,"28,834.00",00.00,"33,632.72",
25-Aug-24,Debit Card,"13,029.00",00.00,"46,661.72",
25-Aug-24,RTGS,00.00,"9,332.34","37,329.38",
25-Aug-24,IMPS,00.00,"6,221.56","31,107.82",
25-Aug-24,Bill,00.00,"10,369.27","20,738.55",
25-Aug-24,Reversal,19.9,00.00,"20,758.45",
25-Aug-24,Cheque,"26,510.80",00.00,"47,269.25",
25-Aug-24,Bill,00.00,"5,908.66","41,360.59",
26-Aug-24,ATM,00.00,"10,340.15","31,020.44",
26-Aug-24,Tax,255.4,00.00,"31,275.84",
26-Aug-24,Interest,"3,550.90",00.00,"34,826.74",
26-Aug-24,Commission,26.1,00.00,"34,852.84",
26-Aug-24,Debit Card,"12,72,224.00",00.00,"13,07,076.84",
26-Aug-24,Purchase,"1,69,439.25",00.00,"14,76,516.09",
26-Aug-24,Cash,"40,237.12",00.00,"15,16,753.21",
26-Aug-24,NEFT,00.00,"7,58,376.61","7,58,376.60",
26-Aug-24,Tax,00.00,"7,58,376.60",00.00,
26-Aug-24,Commission,385.79,00.00,385.79,
26-Aug-24,Cash,00.00,55.11,330.68,
26-Aug-24,Tax,00.00,33.07,297.61,
26-Aug-24,RTGS,475.5,00.00,773.11,
26-Aug-24,Bill,"76,480.70",00.00,"77,253.81",
26-Aug-24,Commission,00.00,"38,626.91","38,626.90",
26-Aug-24,Debit Card,"24,402.00",00.00,"63,028.90",
26-Aug-24,ATM,10,00.00,"63,038.90",
26-Aug-24,RTGS,00.00,"63,038.90",00.00,
26-Aug-24,Bill,"41,413.20",00.00,"41,413.20",
26-Aug-24,Commission,"16,17,990.00",00.00,"16,59,403.20",
26-Aug-24,Transportellaneous,"3,682.00",00.00,"16,63,085.20",
27-Aug-24,Bill,29,00.00,"16,63,114.20",
27-Aug-24,Reversal,57.44,00.00,"16,63,171.64",
27-Aug-24,RTGS,18.8,00.00,"16,63,190.44",
27-Aug-24,Interest,00.00,"1,66,319.04","14,96,871.40",
27-Aug-24,Commission,33.3,00.00,"14,96,904.70",
28-Aug-24,Purchase,00.00,"7,48,452.35","7,48,452.35",
28-Aug-24,Cheque,07.00,00.00,"7,48,459.35",
28-Aug-24,Transfer,00.00,"1,49,691.87","5,98,767.48",
28-Aug-24,Cash,00.00,"1,49,691.87","4,49,075.61",
28-Aug-24,RTGS,00.00,"64,153.66","3,84,921.95",
28-Aug-24,Cheque,"2,268.00",00.00,"3,87,189.95",
28-Aug-24,Cash,00.00,"1,93,594.98","1,93,594.98",
28-Aug-24,IMPS,00.00,"32,265.83","1,61,329.15",
28-Aug-24,Tax,00.00,"26,888.19","1,34,440.96",
28-Aug-24,Reversal,"10,72,593.75",00.00,"12,07,034.71",
28-Aug-24,Bill,"2,50,590.90",00.00,"14,57,625.61",
28-Aug-24,Cheque,00.00,"1,45,762.56","13,11,863.05",
28-Aug-24,Interest,00.00,"1,31,186.31","11,80,676.75",
28-Aug-24,Tax,01.00,00.00,"11,80,677.75",
28-Aug-24,Tax,271.6,00.00,"11,80,949.35",
28-Aug-24,Tax,"3,249.00",00.00,"11,84,198.35",
28-Aug-24,Interest,00.00,"2,36,839.67","9,47,358.68",
28-Aug-24,Bill,"1,697.00",00.00,"9,49,055.68",
28-Aug-24,Tax,"3,087.28",00.00,"9,52,142.96",
28-Aug-24,Transportellaneous,00.00,"1,58,690.49","7,93,452.47",
28-Aug-24,Cheque,"17,885.86",00.00,"8,11,338.33",
28-Aug-24,RTGS,00.00,"90,148.70","7,21,189.63",
29-Aug-24,Debit Card,"4,06,472.50",00.00,"11,27,662.13",
29-Aug-24,Reversal,"3,826.50",00.00,"11,31,488.63",
29-Aug-24,Tax,00.00,"3,77,162.88","7,54,325.75",
29-Aug-24,Debit Card,00.00,"2,51,441.92","5,02,883.83",
29-Aug-24,Purchase,00.00,"71,840.55","4,31,043.28",
29-Aug-24,RTGS,00.00,"61,577.61","3,69,465.67",
29-Aug-24,Transfer,286,00.00,"3,69,751.67",
29-Aug-24,Transportellaneous,484,00.00,"3,70,235.67",
29-Aug-24,Interest,00.00,"61,705.95","3,08,529.72",
29-Aug-24,Cheque,00.00,"44,075.67","2,64,454.05",
29-Aug-24,Interest,06.00,00.00,"2,64,460.05",
29-Aug-24,Cash,"2,54,108.50",00.00,"5,18,568.55",
29-Aug-24,Tax,04.00,00.00,"5,18,572.55",
29-Aug-24,Tax,08.00,00.00,"5,18,580.55",
29-Aug-24,Cash,00.00,"1,72,860.18","3,45,720.37",
29-Aug-24,Bill,54,00.00,"3,45,774.37",
29-Aug-24,Tax,06.00,00.00,"3,45,780.37",
29-Aug-24,Interest,00.00,"38,420.04","3,07,360.33",
29-Aug-24,RTGS,"2,09,774.00",00.00,"5,17,134.33",
29-Aug-24,Tax,00.00,"1,03,426.87","4,13,707.46",
29-Aug-24,Transfer,00.00,"51,713.43","3,61,994.03",
29-Aug-24,RTGS,04.75,00.00,"3,61,998.78",
29-Aug-24,IMPS,672.55,00.00,"3,62,671.33",
29-Aug-24,Cash,00.00,"1,81,335.67","1,81,335.66",
29-Aug-24,IMPS,"16,37,194.00",00.00,"18,18,529.66",
29-Aug-24,Purchase,934.9,00.00,"18,19,464.56",
29-Aug-24,Purchase,00.00,"3,03,244.09","15,16,220.47",
29-Aug-24,RTGS,"64,878.00",00.00,"15,81,098.47",
29-Aug-24,RTGS,00.00,"1,97,637.31","13,83,461.16",
29-Aug-24,NEFT,00.00,"1,72,932.65","12,10,528.51",
29-Aug-24,NEFT,00.00,"12,10,528.51",00.00,
29-Aug-24,Cash,17.79,00.00,17.79,
29-Aug-24,RTGS,00.00,02.54,15.25,
29-Aug-24,RTGS,393,00.00,408.25,
29-Aug-24,Transportellaneous,00.00,81.65,326.6,
29-Aug-24,Bill,474.15,00.00,800.75,
29-Aug-24,Cash,01.20,00.00,801.95,
29-Aug-24,Tax,00.00,80.2,721.76,
29-Aug-24,Interest,316.01,00.00,"1,037.77",
29-Aug-24,Cheque,00.00,345.92,691.85,
29-Aug-24,Reversal,93.2,00.00,785.05,
29-Aug-24,Interest,00.00,130.84,654.21,
29-Aug-24,Transportellaneous,00.00,654.21,00.00,
29-Aug-24,Transfer,30.72,00.00,30.72,
29-Aug-24,IMPS,00.00,30.72,00.00,
29-Aug-24,Cash,496.6,00.00,496.6,
29-Aug-24,Bill,00.00,99.32,397.28,
29-Aug-24,Cheque,02.00,00.00,399.28,
29-Aug-24,Commission,00.00,44.36,354.92,
29-Aug-24,Interest,02.98,00.00,357.9,
29-Aug-24,Transportellaneous,242,00.00,599.9,
29-Aug-24,Transfer,07.00,00.00,606.9,
29-Aug-24,Cheque,"14,85,223.50",00.00,"14,85,830.40",
29-Aug-24,Bill,410.79,00.00,"14,86,241.19",
29-Aug-24,Transportellaneous,"1,68,222.12",00.00,"16,54,463.31",
29-Aug-24,Debit Card,"2,15,838.59",00.00,"18,70,301.90",
29-Aug-24,Bill,00.00,"3,11,716.98","15,58,584.92",
29-Aug-24,ATM,00.00,"1,73,176.10","13,85,408.82",
29-Aug-24,Interest,00.00,"1,73,176.10","12,12,232.72",
29-Aug-24,Transfer,00.00,"4,04,077.57","8,08,155.15",
29-Aug-24,Tax,266.33,00.00,"8,08,421.48",
29-Aug-24,Purchase,"15,01,901.20",00.00,"23,10,322.68",
29-Aug-24,Debit Card,"2,281.60",00.00,"23,12,604.28",
29-Aug-24,Bill,00.00,"11,56,302.14","11,56,302.14",
29-Aug-24,Transfer,00.00,"2,31,260.43","9,25,041.71",
29-Aug-24,Transfer,"24,647.30",00.00,"9,49,689.01",
29-Aug-24,NEFT,00.00,"2,37,422.25","7,12,266.76",
29-Aug-24,Transportellaneous,00.00,"1,01,752.39","6,10,514.37",
29-Aug-24,IMPS,00.00,"2,03,504.79","4,07,009.58",
29-Aug-24,Reversal,00.00,"1,35,669.86","2,71,339.72",
29-Aug-24,Commission,00.00,"90,446.57","1,80,893.15",
29-Aug-24,Tax,"1,47,040.00",00.00,"3,27,933.15",
29-Aug-24,Reversal,00.00,"40,991.64","2,86,941.51",
30-Aug-24,Purchase,00.10,00.00,"2,86,941.61",
30-Aug-24,Interest,"17,94,728.00",00.00,"20,81,669.61",
30-Aug-24,Tax,93.7,00.00,"20,81,763.31",
30-Aug-24,Interest,00.00,"2,31,307.03","18,50,456.28",
30-Aug-24,IMPS,00.00,"18,50,456.28",00.00,
30-Aug-24,Commission,"18,21,459.00",00.00,"18,21,459.00",
30-Aug-24,Debit Card,289.74,00.00,"18,21,748.74",
30-Aug-24,RTGS,01.70,00.00,"18,21,750.44",
30-Aug-24,Transfer,00.00,"1,82,175.04","16,39,575.40",
30-Aug-24,Interest,"5,96,254.00",00.00,"22,35,829.40",
30-Aug-24,Purchase,00.00,"11,17,914.70","11,17,914.70",
30-Aug-24,Purchase,"20,028.00",00.00,"11,37,942.70",
30-Aug-24,Cheque,00.00,"2,84,485.68","8,53,457.02",
30-Aug-24,ATM,00.00,"4,26,728.51","4,26,728.51",
30-Aug-24,Commission,348.2,00.00,"4,27,076.71",
30-Aug-24,Cheque,00.00,"61,010.96","3,66,065.75",
30-Aug-24,IMPS,00.00,"1,22,021.92","2,44,043.83",
30-Aug-24,Transportellaneous,00.00,"30,505.48","2,13,538.35",
30-Aug-24,Transfer,"17,63,743.80",00.00,"19,77,282.15",
30-Aug-24,Transportellaneous,"31,506.34",00.00,"20,08,788.49",
30-Aug-24,Cash,00.00,"10,04,394.25","10,04,394.24",
30-Aug-24,Cash,00.00,"1,43,484.89","8,60,909.35",
30-Aug-24,Commission,"20,32,850.75",00.00,"28,93,760.10",
30-Aug-24,RTGS,00.00,"28,93,760.10",00.00,
30-Aug-24,NEFT,52.4,00.00,52.4,
30-Aug-24,NEFT,371.6,00.00,424,
30-Aug-24,Reversal,00.00,212,212,
30-Aug-24,Cheque,00.00,30.29,181.71,
30-Aug-24,Commission,01.30,00.00,183.01,
30-Aug-24,Transportellaneous,00.00,26.14,156.87,
30-Aug-24,Purchase,"25,108.39",00.00,"25,265.26",
31-Aug-24,Purchase,00.00,"2,526.53","22,738.73",
31-Aug-24,Debit Card,46,00.00,"22,784.73",
31-Aug-24,Transfer,00.00,"2,531.64","20,253.09",
31-Aug-24,Debit Card,00.00,"2,250.34","18,002.75",
31-Aug-24,Bill,00.00,"2,571.82","15,430.93",
31-Aug-24,NEFT,00.00,"15,430.93",00.00,
31-Aug-24,Commission,"7,72,331.00",00.00,"7,72,331.00",
31-Aug-24,Bill,"20,45,919.00",00.00,"28,18,250.00",
31-Aug-24,Cash,462,00.00,"28,18,712.00",
31-Aug-24,Cash,00.00,"7,04,678.00","21,14,034.00",
31-Aug-24,Tax,00.00,"2,11,403.40","19,02,630.60",
31-Aug-24,Cheque,"58,950.00",00.00,"19,61,580.60",
31-Aug-24,ATM,"6,513.00",00.00,"19,68,093.60",
31-Aug-24,Interest,00.00,"2,18,677.07","17,49,416.53",
31-Aug-24,Transportellaneous,149,00.00,"17,49,565.53",
31-Aug-24,Transfer,"13,813.00",00.00,"17,63,378.53",
01-Sep-24,Bill,"22,985.29",00.00,"17,86,363.82",
01-Sep-24,Tax,26,00.00,"17,86,389.82",
01-Sep-24,Transportellaneous,23.6,00.00,"17,86,413.42",
01-Sep-24,Debit Card,"3,026.40",00.00,"17,89,439.82",
01-Sep-24,Cheque,00.00,"2,23,679.98","15,65,759.84",
01-Sep-24,Purchase,00.00,"1,73,973.32","13,91,786.52",
01-Sep-24,Commission,00.00,"4,63,928.84","9,27,857.68",
01-Sep-24,Interest,01.40,00.00,"9,27,859.08",
01-Sep-24,Tax,00.00,"1,85,571.82","7,42,287.26",
01-Sep-24,Transfer,"1,88,640.03",00.00,"9,30,927.29",
01-Sep-24,Commission,00.00,"2,32,731.82","6,98,195.47",
01-Sep-24,Debit Card,284.9,00.00,"6,98,480.37",
01-Sep-24,IMPS,00.00,"3,49,240.19","3,49,240.18",
01-Sep-24,IMPS,34,00.00,"3,49,274.18",
01-Sep-24,Transportellaneous,"70,769.60",00.00,"4,20,043.78",
01-Sep-24,NEFT,"1,49,478.00",00.00,"5,69,521.78",
01-Sep-24,Bill,"2,515.20",00.00,"5,72,036.98",
01-Sep-24,RTGS,00.00,"1,14,407.40","4,57,629.58",
01-Sep-24,RTGS,"24,369.00",00.00,"4,81,998.58",
01-Sep-24,Debit Card,85,00.00,"4,82,083.58",
01-Sep-24,Tax,00.00,"2,41,041.79","2,41,041.79",
01-Sep-24,Reversal,00.00,"34,434.54","2,06,607.25",
01-Sep-24,NEFT,00.00,"29,515.32","1,77,091.93",
01-Sep-24,NEFT,"5,615.86",00.00,"1,82,707.79",
01-Sep-24,RTGS,00.00,"26,101.11","1,56,606.68",
01-Sep-24,Bill,00.00,"15,660.67","1,40,946.01",
02-Sep-24,RTGS,00.00,"35,236.50","1,05,709.51",
02-Sep-24,IMPS,14.6,00.00,"1,05,724.11",
02-Sep-24,Commission,01.80,00.00,"1,05,725.91",
02-Sep-24,NEFT,00.00,"35,241.97","70,483.94",
02-Sep-24,Reversal,"20,19,449.00",00.00,"20,89,932.94",
02-Sep-24,Purchase,"26,412.90",00.00,"21,16,345.84",
02-Sep-24,Reversal,00.00,"3,52,724.31","17,63,621.53",
03-Sep-24,Cheque,00.00,"1,76,362.15","15,87,259.38",
03-Sep-24,Purchase,"77,048.00",00.00,"16,64,307.38",
03-Sep-24,ATM,00.00,"2,08,038.42","14,56,268.96",
03-Sep-24,Commission,00.00,"1,82,033.62","12,74,235.34",
03-Sep-24,Reversal,00.00,"2,12,372.56","10,61,862.78",
03-Sep-24,Debit Card,494.5,00.00,"10,62,357.28",
03-Sep-24,NEFT,00.00,"1,77,059.55","8,85,297.73",
03-Sep-24,NEFT,"1,433.00",00.00,"8,86,730.73",
03-Sep-24,Reversal,12.98,00.00,"8,86,743.71",
03-Sep-24,Bill,05.50,00.00,"8,86,749.21",
03-Sep-24,Bill,00.00,"2,95,583.07","5,91,166.14",
03-Sep-24,Transportellaneous,"7,95,483.50",00.00,"13,86,649.64",
03-Sep-24,Debit Card,"21,447.41",00.00,"14,08,097.05",
03-Sep-24,Purchase,00.00,"1,76,012.13","12,32,084.92",
03-Sep-24,Commission,00.00,"1,54,010.62","10,78,074.30",
03-Sep-24,Interest,00.00,"2,69,518.58","8,08,555.73",
03-Sep-24,Debit Card,00.00,"80,855.57","7,27,700.16",
03-Sep-24,Reversal,"95,142.00",00.00,"8,22,842.16",
03-Sep-24,RTGS,"2,48,075.50",00.00,"10,70,917.66",
03-Sep-24,Interest,"6,824.00",00.00,"10,77,741.66",
03-Sep-24,Transfer,00.00,"1,53,963.09","9,23,778.57",
03-Sep-24,Cheque,"16,370.00",00.00,"9,40,148.57",
03-Sep-24,Commission,07.20,00.00,"9,40,155.77",
03-Sep-24,Cash,"82,646.00",00.00,"10,22,801.77",
03-Sep-24,IMPS,00.00,"1,70,466.96","8,52,334.81",
03-Sep-24,Transportellaneous,00.00,"8,52,334.81",00.00,
03-Sep-24,Cheque,"3,526.20",00.00,"3,526.20",
03-Sep-24,Cheque,00.00,705.24,"2,820.96",
03-Sep-24,Purchase,637.5,00.00,"3,458.46",
03-Sep-24,Commission,00.00,384.27,"3,074.19",
03-Sep-24,Debit Card,468.1,00.00,"3,542.29",
03-Sep-24,Bill,00.00,354.23,"3,188.06",
03-Sep-24,ATM,00.00,531.34,"2,656.72",
03-Sep-24,Cash,02.40,00.00,"2,659.12",
03-Sep-24,Transportellaneous,00.00,531.82,"2,127.30",
03-Sep-24,Reversal,"16,970.00",00.00,"19,097.30",
03-Sep-24,Transfer,00.00,"1,909.73","17,187.57",
03-Sep-24,Cheque,"2,485.26",00.00,"19,672.83",
03-Sep-24,Transfer,00.00,"2,185.87","17,486.96",
03-Sep-24,Debit Card,"1,754.90",00.00,"19,241.86",
03-Sep-24,Tax,00.00,"19,241.86",00.00,
03-Sep-24,IMPS,274,00.00,274,
03-Sep-24,Reversal,"10,96,686.00",00.00,"10,96,960.00",
03-Sep-24,Purchase,00.00,"3,65,653.33","7,31,306.67",
03-Sep-24,Transfer,35.51,00.00,"7,31,342.18",
03-Sep-24,Purchase,391.2,00.00,"7,31,733.38",
03-Sep-24,Interest,62,00.00,"7,31,795.38",
03-Sep-24,Commission,"22,374.00",00.00,"7,54,169.38",
03-Sep-24,Transportellaneous,"3,919.04",00.00,"7,58,088.42",
03-Sep-24,Transfer,"1,771.00",00.00,"7,59,859.42",
03-Sep-24,Commission,"19,27,027.80",00.00,"26,86,887.22",
04-Sep-24,Purchase,00.00,"5,37,377.44","21,49,509.78",
04-Sep-24,IMPS,00.00,"3,07,072.83","18,42,436.95",
04-Sep-24,Transportellaneous,05.00,00.00,"18,42,441.95",
04-Sep-24,Transportellaneous,00.00,"1,84,244.20","16,58,197.76",
04-Sep-24,Reversal,00.00,"2,76,366.29","13,81,831.47",
04-Sep-24,Cash,00.00,"1,72,728.93","12,09,102.54",
04-Sep-24,Interest,00.00,"1,20,910.25","10,88,192.29",
04-Sep-24,Cheque,55.92,00.00,"10,88,248.21",
04-Sep-24,Interest,00.00,"1,81,374.70","9,06,873.51",
04-Sep-24,Debit Card,"97,875.90",00.00,"10,04,749.41",
04-Sep-24,RTGS,00.00,"1,25,593.68","8,79,155.73",
04-Sep-24,Bill,00.00,"1,75,831.15","7,03,324.58",
04-Sep-24,Tax,05.00,00.00,"7,03,329.58",
04-Sep-24,Reversal,00.00,"3,51,664.79","3,51,664.79",
04-Sep-24,Cash,00.00,"1,75,832.40","1,75,832.40",
04-Sep-24,Debit Card,00.00,"19,536.93","1,56,295.47",
04-Sep-24,Debit Card,"19,87,061.50",00.00,"21,43,356.97",
04-Sep-24,Interest,00.00,"2,38,150.77","19,05,206.20",
04-Sep-24,RTGS,00.00,"1,90,520.62","17,14,685.58",
04-Sep-24,Commission,49.4,00.00,"17,14,734.98",
04-Sep-24,Transportellaneous,00.00,"3,42,947.00","13,71,787.98",
04-Sep-24,ATM,00.00,"1,37,178.80","12,34,609.18",
04-Sep-24,Reversal,00.00,"2,46,921.84","9,87,687.34",
04-Sep-24,Interest,"1,32,896.70",00.00,"11,20,584.04",
04-Sep-24,Transportellaneous,00.00,"2,80,146.01","8,40,438.03",
04-Sep-24,Bill,00.00,"1,05,054.75","7,35,383.28",
04-Sep-24,Purchase,00.00,"3,67,691.64","3,67,691.64",
04-Sep-24,Reversal,04.73,00.00,"3,67,696.37",
04-Sep-24,Purchase,27.26,00.00,"3,67,723.63",
04-Sep-24,Bill,02.00,00.00,"3,67,725.63",
04-Sep-24,RTGS,00.00,"45,965.70","3,21,759.93",
04-Sep-24,Transfer,00.00,"35,751.10","2,86,008.83",
04-Sep-24,Reversal,00.00,"35,751.10","2,50,257.73",
04-Sep-24,Tax,04.99,00.00,"2,50,262.72",
04-Sep-24,Purchase,413,00.00,"2,50,675.72",
04-Sep-24,Purchase,00.00,"25,067.57","2,25,608.15",
04-Sep-24,Tax,00.00,"2,25,608.15",00.00,
04-Sep-24,Bill,"2,082.54",00.00,"2,082.54",
04-Sep-24,Tax,05.00,00.00,"2,087.54",
04-Sep-24,Cheque,00.00,"2,087.54",00.00,
04-Sep-24,Bill,"12,934.90",00.00,"12,934.90",
04-Sep-24,Transportellaneous,00.00,"1,847.84","11,087.06",
04-Sep-24,Purchase,188,00.00,"11,275.06",
04-Sep-24,Tax,19.29,00.00,"11,294.35",
04-Sep-24,Interest,"10,670.79",00.00,"21,965.14",
04-Sep-24,Commission,"7,30,618.20",00.00,"7,52,583.34",
04-Sep-24,Debit Card,266.9,00.00,"7,52,850.24",
04-Sep-24,RTGS,00.00,"1,25,475.04","6,27,375.20",
04-Sep-24,Debit Card,06.00,00.00,"6,27,381.20",
04-Sep-24,Commission,00.00,"6,27,381.20",00.00,
04-Sep-24,Transfer,"21,145.00",00.00,"21,145.00",
04-Sep-24,IMPS,00.00,"10,572.50","10,572.50",
04-Sep-24,Cash,00.00,"3,524.17","7,048.33",
04-Sep-24,Debit Card,00.00,"1,006.90","6,041.43",
04-Sep-24,Transportellaneous,00.00,755.18,"5,286.25",
04-Sep-24,Transfer,"20,88,477.75",00.00,"20,93,764.00",
05-Sep-24,Transportellaneous,00.00,"3,48,960.67","17,44,803.33",
05-Sep-24,Commission,00.00,"5,81,601.11","11,63,202.22",
05-Sep-24,Cash,00.00,"1,66,171.75","9,97,030.47",
05-Sep-24,Transfer,49,00.00,"9,97,079.47",
05-Sep-24,Bill,00.00,"4,98,539.74","4,98,539.74",
05-Sep-24,Transportellaneous,00.00,"83,089.96","4,15,449.78",
06-Sep-24,ATM,00.00,"41,544.98","3,73,904.80",
06-Sep-24,Interest,"1,15,636.47",00.00,"4,89,541.27",
06-Sep-24,Cash,"2,02,879.20",00.00,"6,92,420.47",
06-Sep-24,Interest,00.00,"3,46,210.24","3,46,210.24",
06-Sep-24,Tax,00.00,"43,276.28","3,02,933.96",
06-Sep-24,NEFT,"17,11,190.80",00.00,"20,14,124.76",
06-Sep-24,Purchase,"15,54,356.50",00.00,"35,68,481.26",
07-Sep-24,Purchase,28.1,00.00,"35,68,509.36",
07-Sep-24,RTGS,00.00,00.00,"35,68,509.36",
07-Sep-24,Commission,00.00,"35,68,509.36",00.00,
07-Sep-24,IMPS,42,00.00,42,
07-Sep-24,Tax,00.00,05.25,36.75,
07-Sep-24,Reversal,03.70,00.00,40.45,
07-Sep-24,Transfer,"21,107.60",00.00,"21,148.05",
07-Sep-24,Purchase,"3,287.00",00.00,"24,435.05",
07-Sep-24,Tax,"19,87,218.00",00.00,"20,11,653.05",
07-Sep-24,RTGS,00.00,"6,70,551.02","13,41,102.03",
07-Sep-24,Interest,"5,00,783.80",00.00,"18,41,885.83",
07-Sep-24,Commission,"1,76,404.69",00.00,"20,18,290.52",
07-Sep-24,Transfer,"5,368.00",00.00,"20,23,658.52",
07-Sep-24,Cash,34.8,00.00,"20,23,693.32",
07-Sep-24,Cash,05.00,00.00,"20,23,698.32",
07-Sep-24,IMPS,"9,63,296.50",00.00,"29,86,994.82",
07-Sep-24,IMPS,"20,25,464.00",00.00,"50,12,458.82",
07-Sep-24,ATM,00.00,"5,01,245.88","45,11,212.94",
08-Sep-24,Cash,00.00,"5,63,901.62","39,47,311.32",
08-Sep-24,Debit Card,"1,46,199.40",00.00,"40,93,510.72",
08-Sep-24,ATM,00.00,"40,93,510.72",00.00,
08-Sep-24,Reversal,"1,755.08",00.00,"1,755.08",
08-Sep-24,Commission,00.00,195.01,"1,560.07",
08-Sep-24,Reversal,00.00,"1,560.07",00.00,
08-Sep-24,Bill,"13,20,926.20",00.00,"13,20,926.20",
08-Sep-24,Commission,00.00,"1,46,769.58","11,74,156.62",
08-Sep-24,Interest,03.93,00.00,"11,74,160.55",
08-Sep-24,Reversal,"9,501.30",00.00,"11,83,661.85",
08-Sep-24,ATM,"1,85,793.00",00.00,"13,69,454.85",
08-Sep-24,Cheque,02.30,00.00,"13,69,457.15",
08-Sep-24,Reversal,00.00,"6,84,728.58","6,84,728.58",
08-Sep-24,ATM,118.5,00.00,"6,84,847.08",
08-Sep-24,Cheque,00.00,"1,71,211.77","5,13,635.31",
08-Sep-24,Reversal,417.81,00.00,"5,14,053.12",
08-Sep-24,Transfer,44.26,00.00,"5,14,097.38",
08-Sep-24,Interest,00.00,"2,57,048.69","2,57,048.69",
08-Sep-24,Cheque,"7,06,919.20",00.00,"9,63,967.89",
08-Sep-24,ATM,00.00,"1,20,495.99","8,43,471.90",
08-Sep-24,RTGS,04.67,00.00,"8,43,476.57",
08-Sep-24,Reversal,"3,308.19",00.00,"8,46,784.76",
08-Sep-24,IMPS,00.00,"1,20,969.25","7,25,815.51",
08-Sep-24,Cheque,25,00.00,"7,25,840.51",
08-Sep-24,Interest,"25,917.12",00.00,"7,51,757.63",
08-Sep-24,Reversal,00.00,"1,50,351.53","6,01,406.10",
08-Sep-24,Transfer,03.00,00.00,"6,01,409.10",
08-Sep-24,RTGS,23.01,00.00,"6,01,432.11",
08-Sep-24,Interest,01.00,00.00,"6,01,433.11",
08-Sep-24,RTGS,00.00,"60,143.31","5,41,289.80",
08-Sep-24,Cash,00.00,"77,327.11","4,63,962.69",
08-Sep-24,Cash,00.00,"46,396.27","4,17,566.42",
08-Sep-24,Tax,00.00,"83,513.28","3,34,053.14",
08-Sep-24,RTGS,00.00,"1,67,026.57","1,67,026.57",
09-Sep-24,Interest,00.00,"20,878.32","1,46,148.25",
09-Sep-24,Tax,00.00,"1,46,148.25",00.00,
09-Sep-24,Cheque,"2,53,048.09",00.00,"2,53,048.09",
09-Sep-24,Transportellaneous,"28,434.20",00.00,"2,81,482.29",
09-Sep-24,RTGS,"7,489.80",00.00,"2,88,972.09",
10-Sep-24,Debit Card,00.00,"96,324.03","1,92,648.06",
10-Sep-24,Commission,00.00,"24,081.01","1,68,567.05",
10-Sep-24,Debit Card,217.33,00.00,"1,68,784.38",
10-Sep-24,Transportellaneous,00.00,"84,392.19","84,392.19",
10-Sep-24,Purchase,00.00,"84,392.19",00.00,
10-Sep-24,Debit Card,07.00,00.00,07.00,
10-Sep-24,RTGS,20,00.00,27,
10-Sep-24,Transportellaneous,00.00,02.70,24.3,
10-Sep-24,Tax,"2,983.93",00.00,"3,008.23",
10-Sep-24,RTGS,00.00,376.03,"2,632.20",
10-Sep-24,Bill,00.00,526.44,"2,105.76",
10-Sep-24,Commission,00.00,701.92,"1,403.84",
10-Sep-24,ATM,00.00,701.92,701.92,
10-Sep-24,Interest,"11,73,452.75",00.00,"11,74,154.67",
10-Sep-24,RTGS,00.00,"11,74,154.67",00.00,
10-Sep-24,Purchase,"1,361.88",00.00,"1,361.88",
10-Sep-24,Commission,00.00,194.55,"1,167.33",
10-Sep-24,Cheque,"2,38,667.97",00.00,"2,39,835.30",
10-Sep-24,Transfer,56.7,00.00,"2,39,892.00",
10-Sep-24,Tax,00.00,"47,978.40","1,91,913.60",
10-Sep-24,Transfer,00.00,"21,323.73","1,70,589.87",
10-Sep-24,Debit Card,"5,014.00",00.00,"1,75,603.87",
10-Sep-24,Purchase,00.00,"43,900.97","1,31,702.90",
10-Sep-24,ATM,"11,317.00",00.00,"1,43,019.90",
10-Sep-24,RTGS,00.00,"28,603.98","1,14,415.92",
10-Sep-24,Purchase,00.00,"11,441.59","1,02,974.33",
10-Sep-24,Purchase,00.00,"1,02,974.33",00.00,
10-Sep-24,Transfer,01.00,00.00,01.00,
10-Sep-24,Purchase,00.00,00.25,00.75,
10-Sep-24,Bill,"2,51,579.09",00.00,"2,51,579.84",
11-Sep-24,Interest,00.00,"62,894.96","1,88,684.88",
11-Sep-24,Debit Card,"25,633.80",00.00,"2,14,318.68",
11-Sep-24,Reversal,00.00,"26,789.84","1,87,528.84",
11-Sep-24,Tax,469.68,00.00,"1,87,998.52",
11-Sep-24,Commission,"3,331.00",00.00,"1,91,329.52",
11-Sep-24,Tax,"2,846.16",00.00,"1,94,175.68",
11-Sep-24,Interest,00.00,"19,417.57","1,74,758.11",
11-Sep-24,Commission,35,00.00,"1,74,793.11",
11-Sep-24,Cheque,00.00,"21,849.14","1,52,943.97",
11-Sep-24,Commission,"31,998.00",00.00,"1,84,941.97",
11-Sep-24,Bill,270.67,00.00,"1,85,212.64",
11-Sep-24,Reversal,00.00,"20,579.18","1,64,633.46",
11-Sep-24,Bill,"2,227.55",00.00,"1,66,861.01",
12-Sep-24,Commission,976.3,00.00,"1,67,837.31",
12-Sep-24,Tax,01.20,00.00,"1,67,838.51",
12-Sep-24,Bill,"15,92,805.00",00.00,"17,60,643.51",
12-Sep-24,Cheque,03.00,00.00,"17,60,646.51",
12-Sep-24,Transportellaneous,"2,532.00",00.00,"17,63,178.51",
12-Sep-24,NEFT,"2,29,941.50",00.00,"19,93,120.01",
12-Sep-24,Tax,00.00,"4,98,280.00","14,94,840.01",
12-Sep-24,Transfer,346.42,00.00,"14,95,186.43",
12-Sep-24,Bill,523,00.00,"14,95,709.43",
12-Sep-24,Bill,384,00.00,"14,96,093.43",
12-Sep-24,NEFT,00.00,"2,13,727.63","12,82,365.80",
12-Sep-24,IMPS,"14,175.63",00.00,"12,96,541.43",
12-Sep-24,Cash,"29,807.00",00.00,"13,26,348.43",
13-Sep-24,Transportellaneous,"5,15,874.00",00.00,"18,42,222.43",
14-Sep-24,Interest,00.00,"18,42,222.43",00.00,
14-Sep-24,ATM,60.3,00.00,60.3,
14-Sep-24,Commission,"3,503.69",00.00,"3,563.99",
14-Sep-24,NEFT,06.00,00.00,"3,569.99",
14-Sep-24,Transfer,"11,59,153.00",00.00,"11,62,722.99",
14-Sep-24,Reversal,00.00,"5,81,361.50","5,81,361.50",
14-Sep-24,RTGS,"2,58,868.78",00.00,"8,40,230.28",
14-Sep-24,Commission,"1,242.00",00.00,"8,41,472.28",
14-Sep-24,Debit Card,00.00,"1,05,184.04","7,36,288.24",
14-Sep-24,Commission,00.00,"1,84,072.06","5,52,216.18",
14-Sep-24,Cheque,00.00,"92,036.03","4,60,180.15",
14-Sep-24,RTGS,38,00.00,"4,60,218.15",
14-Sep-24,Bill,158,00.00,"4,60,376.15",
14-Sep-24,Interest,00.00,"1,53,458.72","3,06,917.43",
14-Sep-24,Purchase,"7,816.19",00.00,"3,14,733.62",
14-Sep-24,Cash,"31,670.22",00.00,"3,46,403.84",
14-Sep-24,Cheque,07.43,00.00,"3,46,411.27",
14-Sep-24,Purchase,22,00.00,"3,46,433.27",
14-Sep-24,Bill,00.10,00.00,"3,46,433.37",
14-Sep-24,IMPS,05.36,00.00,"3,46,438.73",
14-Sep-24,Commission,00.00,"34,643.87","3,11,794.86",
14-Sep-24,Cash,00.00,"62,358.97","2,49,435.89",
14-Sep-24,IMPS,"1,226.50",00.00,"2,50,662.39",
14-Sep-24,IMPS,"1,655.00",00.00,"2,52,317.39",
14-Sep-24,Debit Card,00.00,"28,035.27","2,24,282.12",
14-Sep-24,Purchase,00.00,"37,380.35","1,86,901.77",
14-Sep-24,Tax,"12,83,157.20",00.00,"14,70,058.97",
14-Sep-24,Debit Card,00.00,"1,63,339.89","13,06,719.08",
14-Sep-24,Reversal,00.00,"3,26,679.77","9,80,039.31",
14-Sep-24,Bill,00.00,"9,80,039.31",00.00,
14-Sep-24,Reversal,233,00.00,233,
14-Sep-24,Interest,00.00,233,00.00,
14-Sep-24,Cheque,17,00.00,17,
14-Sep-24,Cheque,"1,80,675.44",00.00,"1,80,692.44",
14-Sep-24,Reversal,00.00,"20,076.94","1,60,615.50",
14-Sep-24,Bill,00.00,"1,60,615.50",00.00,
14-Sep-24,Debit Card,"10,36,808.75",00.00,"10,36,808.75",
14-Sep-24,Debit Card,00.00,"5,18,404.38","5,18,404.38",
14-Sep-24,ATM,"2,653.12",00.00,"5,21,057.50",
14-Sep-24,Tax,00.00,"86,842.92","4,34,214.58",
14-Sep-24,Reversal,"2,37,851.80",00.00,"6,72,066.38",
14-Sep-24,Tax,00.00,"1,68,016.60","5,04,049.78",
14-Sep-24,Transfer,00.00,"1,26,012.45","3,78,037.34",
14-Sep-24,Purchase,00.00,"47,254.67","3,30,782.67",
14-Sep-24,NEFT,00.00,"3,30,782.67",00.00,
14-Sep-24,NEFT,307.59,00.00,307.59,
14-Sep-24,Reversal,00.00,61.52,246.07,
14-Sep-24,Commission,50.7,00.00,296.77,
14-Sep-24,Interest,"19,669.00",00.00,"19,965.77",
14-Sep-24,Debit Card,05.80,00.00,"19,971.57",
14-Sep-24,Debit Card,00.00,"4,992.89","14,978.68",
14-Sep-24,Transfer,03.40,00.00,"14,982.08",
14-Sep-24,Debit Card,00.00,"1,664.68","13,317.40",
14-Sep-24,IMPS,07.14,00.00,"13,324.54",
14-Sep-24,Purchase,01.01,00.00,"13,325.55",
14-Sep-24,Interest,00.00,"13,325.55",00.00,
14-Sep-24,NEFT,709.83,00.00,709.83,
14-Sep-24,Purchase,00.00,177.46,532.37,
14-Sep-24,Bill,484.87,00.00,"1,017.24",
14-Sep-24,IMPS,"2,13,801.00",00.00,"2,14,818.24",
14-Sep-24,Commission,450.9,00.00,"2,15,269.14",
14-Sep-24,Transfer,"27,106.40",00.00,"2,42,375.54",
14-Sep-24,ATM,00.00,"40,395.92","2,01,979.62",
14-Sep-24,RTGS,"2,394.00",00.00,"2,04,373.62",
14-Sep-24,NEFT,04.00,00.00,"2,04,377.62",
14-Sep-24,Cheque,00.00,"20,437.76","1,83,939.86",
14-Sep-24,Transfer,00.00,"22,992.48","1,60,947.38",
14-Sep-24,NEFT,511,00.00,"1,61,458.38",
14-Sep-24,Commission,"2,190.06",00.00,"1,63,648.44",
14-Sep-24,IMPS,"2,16,558.50",00.00,"3,80,206.94",
14-Sep-24,Transfer,00.00,"42,245.22","3,37,961.72",
14-Sep-24,NEFT,"6,387.12",00.00,"3,44,348.84",
14-Sep-24,Bill,00.00,"49,192.69","2,95,156.15",
14-Sep-24,IMPS,00.00,"49,192.69","2,45,963.46",
14-Sep-24,Debit Card,00.00,"61,490.87","1,84,472.60",
14-Sep-24,Purchase,"8,709.00",00.00,"1,93,181.60",
14-Sep-24,Bill,02.90,00.00,"1,93,184.50",
14-Sep-24,IMPS,00.00,"32,197.42","1,60,987.08",
14-Sep-24,RTGS,"1,584.00",00.00,"1,62,571.08",
14-Sep-24,Bill,"24,749.00",00.00,"1,87,320.08",
14-Sep-24,Tax,00.00,"26,760.01","1,60,560.07",
14-Sep-24,ATM,00.00,"40,140.02","1,20,420.05",
14-Sep-24,Cheque,501,00.00,"1,20,921.05",
14-Sep-24,IMPS,00.00,"60,460.53","60,460.52",
14-Sep-24,ATM,00.00,"20,153.51","40,307.01",
14-Sep-24,RTGS,01.00,00.00,"40,308.01",
15-Sep-24,NEFT,00.00,"4,478.67","35,829.34",
15-Sep-24,Debit Card,"14,209.00",00.00,"50,038.34",
15-Sep-24,Reversal,00.50,00.00,"50,038.84",
15-Sep-24,Bill,"3,190.40",00.00,"53,229.24",
15-Sep-24,Debit Card,"25,278.00",00.00,"78,507.24",
15-Sep-24,Transportellaneous,00.00,"15,701.45","62,805.79",
15-Sep-24,Interest,07.17,00.00,"62,812.96",
15-Sep-24,Cash,00.00,"10,468.83","52,344.13",
15-Sep-24,NEFT,"3,294.00",00.00,"55,638.13",
15-Sep-24,Transportellaneous,00.00,"7,948.30","47,689.83",
15-Sep-24,Cheque,00.00,"7,948.31","39,741.52",
15-Sep-24,Commission,04.90,00.00,"39,746.42",
15-Sep-24,Transportellaneous,17.08,00.00,"39,763.50",
15-Sep-24,Transfer,"5,38,069.00",00.00,"5,77,832.50",
15-Sep-24,Bill,"1,735.10",00.00,"5,79,567.60",
15-Sep-24,Debit Card,00.00,"82,795.37","4,96,772.23",
15-Sep-24,Interest,00.00,"1,65,590.74","3,31,181.49",
15-Sep-24,NEFT,"17,332.00",00.00,"3,48,513.49",
15-Sep-24,ATM,"1,65,708.00",00.00,"5,14,221.49",
15-Sep-24,RTGS,00.00,"57,135.72","4,57,085.77",
15-Sep-24,NEFT,"4,74,961.00",00.00,"9,32,046.77",
15-Sep-24,Cash,00.00,"1,16,505.85","8,15,540.92",
15-Sep-24,IMPS,05.68,00.00,"8,15,546.60",
15-Sep-24,Tax,00.00,"90,616.29","7,24,930.31",
15-Sep-24,Debit Card,"2,02,554.50",00.00,"9,27,484.81",
15-Sep-24,RTGS,00.00,"1,32,497.83","7,94,986.98",
15-Sep-24,Purchase,06.67,00.00,"7,94,993.65",
15-Sep-24,Cash,00.00,"1,13,570.52","6,81,423.13",
15-Sep-24,Debit Card,00.00,"97,346.16","5,84,076.97",
15-Sep-24,ATM,"20,603.02",00.00,"6,04,679.99",
15-Sep-24,Transportellaneous,00.00,"75,585.00","5,29,094.99",
15-Sep-24,Bill,00.00,"52,909.50","4,76,185.49",
15-Sep-24,ATM,00.00,"1,58,728.50","3,17,456.99",
15-Sep-24,Cash,"1,786.52",00.00,"3,19,243.51",
15-Sep-24,Tax,00.00,"1,06,414.50","2,12,829.01",
15-Sep-24,RTGS,00.00,"35,471.50","1,77,357.51",
15-Sep-24,Transfer,00.00,"19,706.39","1,57,651.12",
15-Sep-24,Interest,00.00,"26,275.19","1,31,375.93",
15-Sep-24,RTGS,48,00.00,"1,31,423.93",
15-Sep-24,Purchase,00.00,"1,31,423.93",00.00,
15-Sep-24,Interest,"2,035.06",00.00,"2,035.06",
15-Sep-24,Transportellaneous,62,00.00,"2,097.06",
16-Sep-24,NEFT,00.00,"2,097.06",00.00,
16-Sep-24,Debit Card,148,00.00,148,
16-Sep-24,Cash,16,00.00,164,
16-Sep-24,Bill,00.00,23.43,140.57,
16-Sep-24,IMPS,"29,857.00",00.00,"29,997.57",
16-Sep-24,NEFT,00.00,"4,285.37","25,712.20",
16-Sep-24,Debit Card,00.00,"3,214.03","22,498.18",
16-Sep-24,Cash,00.00,"2,499.80","19,998.38",
16-Sep-24,IMPS,00.00,"6,666.13","13,332.25",
16-Sep-24,Reversal,"2,14,999.19",00.00,"2,28,331.44",
16-Sep-24,Cheque,353.8,00.00,"2,28,685.24",
16-Sep-24,Interest,"29,852.38",00.00,"2,58,537.62",
16-Sep-24,ATM,06.72,00.00,"2,58,544.34",
16-Sep-24,ATM,"6,761.80",00.00,"2,65,306.14",
16-Sep-24,Tax,"7,69,132.00",00.00,"10,34,438.14",
16-Sep-24,NEFT,00.00,"10,34,438.14",00.00,
16-Sep-24,ATM,"3,668.21",00.00,"3,668.21",
16-Sep-24,RTGS,"1,568.90",00.00,"5,237.11",
16-Sep-24,Debit Card,00.00,"2,618.56","2,618.55",
16-Sep-24,ATM,"1,51,507.10",00.00,"1,54,125.65",
16-Sep-24,Transfer,"1,490.20",00.00,"1,55,615.85",
16-Sep-24,Purchase,05.10,00.00,"1,55,620.95",
16-Sep-24,Debit Card,"20,53,970.20",00.00,"22,09,591.15",
16-Sep-24,ATM,48.9,00.00,"22,09,640.05",
16-Sep-24,IMPS,00.00,"3,68,273.34","18,41,366.71",
16-Sep-24,Transfer,00.00,"3,68,273.34","14,73,093.37",
16-Sep-24,Transfer,00.00,"1,63,677.04","13,09,416.33",
16-Sep-24,Cash,52,00.00,"13,09,468.33",
16-Sep-24,Interest,00.00,"2,18,244.72","10,91,223.61",
16-Sep-24,Cheque,00.00,"10,91,223.61",00.00,
16-Sep-24,RTGS,03.81,00.00,03.81,
16-Sep-24,ATM,00.00,00.95,02.86,
16-Sep-24,Purchase,07.00,00.00,09.86,
16-Sep-24,Interest,"25,357.90",00.00,"25,367.76",
16-Sep-24,Debit Card,00.00,"5,073.55","20,294.21",
16-Sep-24,Commission,00.00,"2,254.91","18,039.30",
16-Sep-24,Reversal,00.00,"2,254.91","15,784.39",
16-Sep-24,Bill,00.00,"1,973.05","13,811.34",
16-Sep-24,Reversal,00.00,"1,381.13","12,430.21",
16-Sep-24,Purchase,00.00,"2,486.04","9,944.17",
16-Sep-24,Commission,"3,334.70",00.00,"13,278.87",
16-Sep-24,ATM,00.00,"3,319.72","9,959.15",
16-Sep-24,IMPS,33,00.00,"9,992.15",
16-Sep-24,Cash,00.00,999.22,"8,992.94",
16-Sep-24,Transfer,"10,59,118.75",00.00,"10,68,111.69",
16-Sep-24,RTGS,00.00,"2,13,622.34","8,54,489.35",
16-Sep-24,Interest,"2,40,864.53",00.00,"10,95,353.88",
16-Sep-24,Tax,00.00,"1,09,535.39","9,85,818.49",
16-Sep-24,IMPS,"1,53,904.00",00.00,"11,39,722.49",
16-Sep-24,NEFT,"1,247.60",00.00,"11,40,970.09",
16-Sep-24,Commission,00.00,"5,70,485.05","5,70,485.05",
16-Sep-24,ATM,"15,90,897.00",00.00,"21,61,382.05",
16-Sep-24,Cheque,00.00,"3,08,768.86","18,52,613.19",
16-Sep-24,Transportellaneous,444.7,00.00,"18,53,057.89",
16-Sep-24,Commission,00.00,"2,05,895.32","16,47,162.57",
16-Sep-24,NEFT,00.00,"8,23,581.29","8,23,581.28",
16-Sep-24,Interest,41,00.00,"8,23,622.28",
16-Sep-24,Reversal,"7,530.96",00.00,"8,31,153.24",
16-Sep-24,Commission,00.00,"1,18,736.18","7,12,417.06",
16-Sep-24,Tax,07.80,00.00,"7,12,424.86",
16-Sep-24,ATM,00.00,"2,37,474.95","4,74,949.91",
16-Sep-24,Commission,"4,32,632.00",00.00,"9,07,581.91",
16-Sep-24,Cheque,50.46,00.00,"9,07,632.37",
16-Sep-24,RTGS,00.00,"1,81,526.47","7,26,105.90",
16-Sep-24,Tax,00.00,"1,03,729.41","6,22,376.49",
16-Sep-24,Cash,"2,14,682.00",00.00,"8,37,058.49",
16-Sep-24,Reversal,00.00,"1,39,509.75","6,97,548.74",
16-Sep-24,IMPS,00.00,"99,649.82","5,97,898.92",
16-Sep-24,Commission,349.28,00.00,"5,98,248.20",
16-Sep-24,Reversal,00.00,"74,781.03","5,23,467.17",
16-Sep-24,Tax,00.00,"65,433.40","4,58,033.77",
16-Sep-24,IMPS,24.38,00.00,"4,58,058.15",
16-Sep-24,NEFT,00.00,"76,343.03","3,81,715.12",
16-Sep-24,IMPS,00.00,"3,81,715.12",00.00,
16-Sep-24,Reversal,"9,70,777.20",00.00,"9,70,777.20",
16-Sep-24,Cheque,00.00,"4,85,388.60","4,85,388.60",
16-Sep-24,Cash,00.00,"97,077.72","3,88,310.88",
17-Sep-24,IMPS,945.6,00.00,"3,89,256.48",
17-Sep-24,Debit Card,00.00,"1,94,628.24","1,94,628.24",
17-Sep-24,Cash,07.90,00.00,"1,94,636.14",
17-Sep-24,Tax,"2,697.30",00.00,"1,97,333.44",
17-Sep-24,RTGS,10,00.00,"1,97,343.44",
17-Sep-24,Reversal,"17,142.99",00.00,"2,14,486.43",
17-Sep-24,Transportellaneous,00.00,"21,448.64","1,93,037.79",
17-Sep-24,Cheque,00.00,"38,607.56","1,54,430.23",
17-Sep-24,Tax,00.00,"38,607.56","1,15,822.67",
17-Sep-24,Cheque,00.00,"16,546.10","99,276.57",
17-Sep-24,RTGS,00.00,"24,819.14","74,457.43",
17-Sep-24,Purchase,02.00,00.00,"74,459.43",
17-Sep-24,Reversal,"1,63,651.00",00.00,"2,38,110.43",
17-Sep-24,ATM,00.00,"23,811.04","2,14,299.39",
17-Sep-24,Cash,06.50,00.00,"2,14,305.89",
17-Sep-24,Interest,"13,61,490.80",00.00,"15,75,796.69",
17-Sep-24,RTGS,00.00,"3,93,949.17","11,81,847.52",
17-Sep-24,Cash,"6,023.63",00.00,"11,87,871.15",
17-Sep-24,Cash,00.00,"11,87,871.15",00.00,
17-Sep-24,RTGS,803.07,00.00,803.07,
17-Sep-24,Commission,711,00.00,"1,514.07",
17-Sep-24,RTGS,00.00,504.69,"1,009.38",
18-Sep-24,Transportellaneous,"2,23,911.00",00.00,"2,24,920.38",
18-Sep-24,Transportellaneous,"1,907.30",00.00,"2,26,827.68",
18-Sep-24,Interest,00.00,"45,365.54","1,81,462.14",
18-Sep-24,RTGS,00.00,"22,682.77","1,58,779.37",
18-Sep-24,Purchase,00.00,"26,463.23","1,32,316.14",
18-Sep-24,Purchase,00.00,"33,079.04","99,237.11",
18-Sep-24,Reversal,"3,232.00",00.00,"1,02,469.11",
18-Sep-24,Cash,00.00,"34,156.37","68,312.74",
18-Sep-24,Purchase,"11,161.70",00.00,"79,474.44",
18-Sep-24,NEFT,00.00,"15,894.89","63,579.55",
18-Sep-24,Purchase,00.00,"15,894.89","47,684.66",
18-Sep-24,Bill,00.00,"5,298.30","42,386.36",
18-Sep-24,IMPS,00.00,"4,709.60","37,676.76",
18-Sep-24,Cheque,"3,522.00",00.00,"41,198.76",
18-Sep-24,Commission,359.1,00.00,"41,557.86",
18-Sep-24,Debit Card,00.00,"4,155.79","37,402.07",
18-Sep-24,Debit Card,"17,07,553.00",00.00,"17,44,955.07",
18-Sep-24,Bill,00.00,"3,48,991.01","13,95,964.06",
18-Sep-24,IMPS,00.00,"1,39,596.41","12,56,367.65",
18-Sep-24,RTGS,72.8,00.00,"12,56,440.45",
18-Sep-24,RTGS,812.21,00.00,"12,57,252.66",
18-Sep-24,RTGS,00.00,"4,19,084.22","8,38,168.44",
18-Sep-24,Tax,00.00,"2,09,542.11","6,28,626.33",
18-Sep-24,Transfer,00.00,"1,25,725.27","5,02,901.06",
18-Sep-24,NEFT,"1,42,423.00",00.00,"6,45,324.06",
18-Sep-24,Cheque,00.00,"1,29,064.81","5,16,259.25",
18-Sep-24,Reversal,00.00,"2,58,129.63","2,58,129.62",
18-Sep-24,ATM,00.00,"51,625.92","2,06,503.70",
18-Sep-24,Transportellaneous,00.00,"20,650.37","1,85,853.33",
18-Sep-24,Bill,02.00,00.00,"1,85,855.33",
18-Sep-24,Commission,"2,408.00",00.00,"1,88,263.33",
18-Sep-24,Purchase,00.00,"37,652.67","1,50,610.66",
18-Sep-24,Cash,74,00.00,"1,50,684.66",
18-Sep-24,Cheque,"27,778.76",00.00,"1,78,463.42",
18-Sep-24,Transportellaneous,04.45,00.00,"1,78,467.87",
18-Sep-24,Commission,00.00,"19,829.76","1,58,638.11",
18-Sep-24,Transportellaneous,00.00,"22,662.59","1,35,975.52",
18-Sep-24,Cash,00.00,"16,996.94","1,18,978.58",
18-Sep-24,Tax,00.00,"39,659.53","79,319.05",
18-Sep-24,Bill,00.00,"11,331.29","67,987.76",
18-Sep-24,RTGS,00.00,"16,996.94","50,990.82",
18-Sep-24,ATM,"4,58,102.80",00.00,"5,09,093.62",
18-Sep-24,Commission,00.00,"72,727.66","4,36,365.96",
18-Sep-24,Reversal,06.58,00.00,"4,36,372.54",
18-Sep-24,Cheque,00.00,"87,274.51","3,49,098.03",
18-Sep-24,Debit Card,"30,835.00",00.00,"3,79,933.03",
18-Sep-24,Debit Card,00.00,"54,276.15","3,25,656.88",
18-Sep-24,NEFT,"3,475.74",00.00,"3,29,132.62",
18-Sep-24,Purchase,96.87,00.00,"3,29,229.49",
18-Sep-24,RTGS,00.00,"82,307.37","2,46,922.12",
18-Sep-24,Commission,00.00,"82,307.37","1,64,614.75",
18-Sep-24,Transfer,63.2,00.00,"1,64,677.95",
18-Sep-24,Transfer,20.92,00.00,"1,64,698.87",
18-Sep-24,Cash,"1,277.00",00.00,"1,65,975.87",
18-Sep-24,Debit Card,"73,240.69",00.00,"2,39,216.56",
18-Sep-24,Reversal,"2,60,130.70",00.00,"4,99,347.26",
18-Sep-24,Transfer,252.4,00.00,"4,99,599.66",
18-Sep-24,Reversal,"1,575.30",00.00,"5,01,174.96",
18-Sep-24,Tax,00.00,"83,529.16","4,17,645.80",
18-Sep-24,Debit Card,00.00,"1,39,215.27","2,78,430.53",
18-Sep-24,Tax,00.00,"34,803.82","2,43,626.71",
19-Sep-24,Reversal,"17,889.30",00.00,"2,61,516.01",
19-Sep-24,Cheque,00.00,"29,057.33","2,32,458.68",
19-Sep-24,Transportellaneous,06.90,00.00,"2,32,465.58",
19-Sep-24,RTGS,00.00,"77,488.53","1,54,977.05",
19-Sep-24,Reversal,00.00,"25,829.51","1,29,147.54",
19-Sep-24,IMPS,00.00,"16,143.44","1,13,004.10",
19-Sep-24,Purchase,00.00,"16,143.44","96,860.66",
19-Sep-24,IMPS,00.00,"19,372.13","77,488.53",
19-Sep-24,Purchase,"19,431.00",00.00,"96,919.53",
19-Sep-24,RTGS,00.00,"32,306.51","64,613.02",
19-Sep-24,NEFT,244.55,00.00,"64,857.57",
19-Sep-24,Interest,00.00,"7,206.40","57,651.17",
19-Sep-24,Cheque,"2,165.00",00.00,"59,816.17",
19-Sep-24,Reversal,"1,83,173.60",00.00,"2,42,989.77",
19-Sep-24,Tax,00.00,"30,373.72","2,12,616.05",
19-Sep-24,RTGS,00.00,"53,154.01","1,59,462.04",
19-Sep-24,Interest,00.00,"22,780.29","1,36,681.75",
19-Sep-24,Cheque,00.00,"15,186.86","1,21,494.89",
19-Sep-24,Cheque,00.00,"13,499.43","1,07,995.46",
19-Sep-24,Transportellaneous,00.00,"13,499.43","94,496.03",
19-Sep-24,Cash,00.00,"94,496.03",00.00,
19-Sep-24,Commission,01.00,00.00,01.00,
19-Sep-24,ATM,"2,56,457.28",00.00,"2,56,458.28",
19-Sep-24,Commission,00.00,"42,743.05","2,13,715.23",
19-Sep-24,Transportellaneous,00.00,"1,06,857.62","1,06,857.62",
19-Sep-24,Transportellaneous,00.00,"1,06,857.62",00.00,
19-Sep-24,Purchase,"5,06,541.25",00.00,"5,06,541.25",
19-Sep-24,RTGS,53.56,00.00,"5,06,594.81",
19-Sep-24,Transportellaneous,00.00,"1,68,864.94","3,37,729.87",
19-Sep-24,Interest,"10,091.06",00.00,"3,47,820.93",
19-Sep-24,Cheque,00.00,"86,955.23","2,60,865.70",
19-Sep-24,Cash,"1,830.00",00.00,"2,62,695.70",
19-Sep-24,Transportellaneous,"2,23,661.72",00.00,"4,86,357.42",
19-Sep-24,Cash,00.00,"81,059.57","4,05,297.85",
19-Sep-24,IMPS,"3,42,867.25",00.00,"7,48,165.10",
19-Sep-24,Reversal,23,00.00,"7,48,188.10",
19-Sep-24,Debit Card,208.8,00.00,"7,48,396.90",
19-Sep-24,Bill,00.00,"74,839.69","6,73,557.21",
19-Sep-24,RTGS,"3,315.00",00.00,"6,76,872.21",
19-Sep-24,IMPS,00.00,"84,609.03","5,92,263.18",
19-Sep-24,Interest,00.00,"84,609.03","5,07,654.15",
19-Sep-24,Transportellaneous,"10,10,377.50",00.00,"15,18,031.65",
19-Sep-24,ATM,193.4,00.00,"15,18,225.05",
19-Sep-24,Transfer,00.00,"1,89,778.13","13,28,446.92",
19-Sep-24,Bill,"4,086.60",00.00,"13,32,533.52",
19-Sep-24,Purchase,00.00,"3,33,133.38","9,99,400.14",
19-Sep-24,Reversal,00.00,"3,33,133.38","6,66,266.76",
19-Sep-24,ATM,"1,09,632.00",00.00,"7,75,898.76",
19-Sep-24,Purchase,"15,58,266.00",00.00,"23,34,164.76",
19-Sep-24,Cash,"19,52,223.50",00.00,"42,86,388.26",
20-Sep-24,NEFT,00.00,"4,76,265.36","38,10,122.90",
20-Sep-24,Cheque,00.00,"9,52,530.73","28,57,592.18",
20-Sep-24,ATM,112.06,00.00,"28,57,704.24",
20-Sep-24,Cheque,00.00,"9,52,568.08","19,05,136.16",
20-Sep-24,Transportellaneous,00.00,"2,11,681.80","16,93,454.36",
20-Sep-24,Interest,"18,331.80",00.00,"17,11,786.16",
21-Sep-24,Transportellaneous,"1,57,423.97",00.00,"18,69,210.13",
21-Sep-24,Reversal,00.00,"3,73,842.03","14,95,368.10",
21-Sep-24,Reversal,"20,55,237.00",00.00,"35,50,605.10",
21-Sep-24,NEFT,00.00,"3,94,511.68","31,56,093.42",
21-Sep-24,Cheque,00.00,"3,94,511.68","27,61,581.74",
21-Sep-24,Interest,00.00,"4,60,263.62","23,01,318.12",
21-Sep-24,Tax,00.00,"3,83,553.02","19,17,765.10",
21-Sep-24,Reversal,00.00,"2,73,966.44","16,43,798.66",
21-Sep-24,Tax,00.00,"1,64,379.87","14,79,418.79",
21-Sep-24,Purchase,00.00,"2,11,345.54","12,68,073.25",
21-Sep-24,Purchase,"4,635.68",00.00,"12,72,708.93",
22-Sep-24,IMPS,79.29,00.00,"12,72,788.22",
22-Sep-24,Bill,351,00.00,"12,73,139.22",
22-Sep-24,Purchase,00.00,"1,59,142.40","11,13,996.82",
22-Sep-24,ATM,00.00,"1,59,142.40","9,54,854.42",
22-Sep-24,Commission,02.00,00.00,"9,54,856.42",
22-Sep-24,Interest,00.00,"1,36,408.06","8,18,448.36",
22-Sep-24,Transportellaneous,00.00,"1,02,306.05","7,16,142.32",
22-Sep-24,Debit Card,09.10,00.00,"7,16,151.42",
22-Sep-24,Cheque,303,00.00,"7,16,454.42",
22-Sep-24,RTGS,48.5,00.00,"7,16,502.92",
22-Sep-24,Purchase,00.00,"1,79,125.73","5,37,377.19",
22-Sep-24,Cheque,"1,431.29",00.00,"5,38,808.48",
22-Sep-24,Debit Card,00.00,"1,34,702.12","4,04,106.36",
22-Sep-24,Cash,00.00,"40,410.64","3,63,695.72",
22-Sep-24,Transfer,363.45,00.00,"3,64,059.17",
22-Sep-24,Tax,00.00,"36,405.92","3,27,653.25",
22-Sep-24,Bill,00.00,"40,956.66","2,86,696.59",
22-Sep-24,Purchase,00.00,"40,956.66","2,45,739.93",
22-Sep-24,IMPS,181,00.00,"2,45,920.93",
22-Sep-24,Reversal,"12,989.90",00.00,"2,58,910.83",
22-Sep-24,RTGS,00.00,"1,29,455.42","1,29,455.42",
22-Sep-24,Debit Card,177,00.00,"1,29,632.42",
22-Sep-24,Bill,00.00,"64,816.21","64,816.21",
22-Sep-24,Purchase,00.00,"6,481.62","58,334.59",
22-Sep-24,NEFT,"5,90,775.00",00.00,"6,49,109.59",
22-Sep-24,Transportellaneous,00.00,"92,729.94","5,56,379.65",
22-Sep-24,Cash,"1,96,481.10",00.00,"7,52,860.75",
22-Sep-24,Tax,00.00,"1,07,551.54","6,45,309.21",
22-Sep-24,Commission,00.00,"6,45,309.21",00.00,
22-Sep-24,Interest,03.90,00.00,03.90,
22-Sep-24,ATM,00.00,00.43,03.47,
22-Sep-24,NEFT,"1,43,184.41",00.00,"1,43,187.88",
22-Sep-24,Tax,00.00,"35,796.97","1,07,390.91",
22-Sep-24,Cheque,"11,876.26",00.00,"1,19,267.17",
22-Sep-24,Commission,00.00,"11,926.72","1,07,340.45",
22-Sep-24,Bill,00.00,"35,780.15","71,560.30",
22-Sep-24,RTGS,340.8,00.00,"71,901.10",
22-Sep-24,NEFT,00.00,"17,975.28","53,925.82",
22-Sep-24,ATM,00.00,"7,703.69","46,222.13",
22-Sep-24,Interest,"2,132.83",00.00,"48,354.96",
22-Sep-24,Tax,17,00.00,"48,371.96",
22-Sep-24,Purchase,00.00,"24,185.98","24,185.98",
22-Sep-24,Bill,"1,982.60",00.00,"26,168.58",
22-Sep-24,Cheque,00.00,"3,738.37","22,430.21",
22-Sep-24,Reversal,00.00,"2,243.02","20,187.19",
22-Sep-24,Transportellaneous,33.07,00.00,"20,220.26",
22-Sep-24,RTGS,00.00,"2,022.03","18,198.23",
22-Sep-24,Transportellaneous,00.00,"2,022.03","16,176.20",
22-Sep-24,Cash,00.00,"2,696.03","13,480.17",
22-Sep-24,NEFT,00.00,"1,348.02","12,132.15",
22-Sep-24,IMPS,"74,353.30",00.00,"86,485.45",
22-Sep-24,Reversal,00.00,"21,621.36","64,864.09",
22-Sep-24,Interest,00.00,"64,864.09",00.00,
22-Sep-24,NEFT,"3,33,231.75",00.00,"3,33,231.75",
22-Sep-24,Transfer,00.00,00.00,"3,33,231.75",
22-Sep-24,NEFT,00.00,"33,323.18","2,99,908.58",
22-Sep-24,Debit Card,00.00,"33,323.18","2,66,585.40",
22-Sep-24,IMPS,00.00,"33,323.18","2,33,262.23",
22-Sep-24,Purchase,00.00,"46,652.45","1,86,609.78",
22-Sep-24,Transportellaneous,00.00,"62,203.26","1,24,406.52",
22-Sep-24,Cheque,00.00,"24,881.30","99,525.22",
22-Sep-24,Transfer,"79,766.70",00.00,"1,79,291.92",
22-Sep-24,Debit Card,"3,287.12",00.00,"1,82,579.04",
22-Sep-24,IMPS,00.00,"91,289.52","91,289.52",
22-Sep-24,Bill,"9,30,885.00",00.00,"10,22,174.52",
22-Sep-24,ATM,00.00,"1,02,217.45","9,19,957.07",
22-Sep-24,ATM,"1,125.90",00.00,"9,21,082.97",
22-Sep-24,IMPS,00.00,"1,31,583.28","7,89,499.69",
22-Sep-24,Cheque,00.00,"98,687.46","6,90,812.23",
22-Sep-24,Debit Card,230,00.00,"6,91,042.23",
22-Sep-24,Cash,606.41,00.00,"6,91,648.64",
22-Sep-24,Commission,00.00,"2,30,549.55","4,61,099.09",
22-Sep-24,Purchase,"1,968.70",00.00,"4,63,067.79",
22-Sep-24,RTGS,08.00,00.00,"4,63,075.79",
22-Sep-24,Purchase,00.00,"92,615.16","3,70,460.63",
22-Sep-24,Interest,"3,373.88",00.00,"3,73,834.51",
22-Sep-24,ATM,480.66,00.00,"3,74,315.17",
22-Sep-24,Transfer,"2,08,456.20",00.00,"5,82,771.37",
22-Sep-24,Purchase,00.00,"1,45,692.84","4,37,078.53",
22-Sep-24,Transportellaneous,00.00,"1,09,269.63","3,27,808.90",
22-Sep-24,Debit Card,04.30,00.00,"3,27,813.20",
22-Sep-24,Transfer,00.00,"3,27,813.20",00.00,
22-Sep-24,Reversal,379.9,00.00,379.9,
22-Sep-24,Bill,"8,31,658.00",00.00,"8,32,037.90",
22-Sep-24,IMPS,00.78,00.00,"8,32,038.68",
22-Sep-24,Transfer,50.5,00.00,"8,32,089.18",
22-Sep-24,Interest,411,00.00,"8,32,500.18",
22-Sep-24,Reversal,00.00,"1,18,928.60","7,13,571.58",
22-Sep-24,Tax,03.20,00.00,"7,13,574.78",
22-Sep-24,Transfer,00.00,"89,196.85","6,24,377.93",
22-Sep-24,Reversal,21,00.00,"6,24,398.93",
22-Sep-24,Cheque,00.00,"2,08,132.98","4,16,265.95",
22-Sep-24,NEFT,05.46,00.00,"4,16,271.41",
22-Sep-24,Cheque,00.00,"2,08,135.71","2,08,135.70",
22-Sep-24,Debit Card,20.75,00.00,"2,08,156.45",
22-Sep-24,IMPS,00.00,"29,736.64","1,78,419.81",
22-Sep-24,Commission,00.98,00.00,"1,78,420.79",
22-Sep-24,Commission,"2,915.00",00.00,"1,81,335.79",
22-Sep-24,Purchase,33.8,00.00,"1,81,369.59",
22-Sep-24,NEFT,00.00,"30,228.27","1,51,141.33",
22-Sep-24,IMPS,"7,59,528.00",00.00,"9,10,669.33",
22-Sep-24,Transfer,"16,15,188.00",00.00,"25,25,857.33",
22-Sep-24,IMPS,"3,540.08",00.00,"25,29,397.41",
22-Sep-24,Debit Card,62,00.00,"25,29,459.41",
22-Sep-24,Cash,08.00,00.00,"25,29,467.41",
22-Sep-24,Cheque,00.00,"6,32,366.85","18,97,100.56",
22-Sep-24,Transfer,"2,52,093.00",00.00,"21,49,193.56",
23-Sep-24,Bill,00.00,"2,68,649.20","18,80,544.36",
23-Sep-24,Transfer,"14,251.80",00.00,"18,94,796.16",
23-Sep-24,NEFT,00.00,"1,89,479.62","17,05,316.54",
23-Sep-24,Debit Card,00.00,"2,43,616.65","14,61,699.89",
23-Sep-24,NEFT,00.00,"14,61,699.89",00.00,
23-Sep-24,Purchase,35.2,00.00,35.2,
24-Sep-24,Tax,00.00,05.87,29.33,
24-Sep-24,Tax,00.00,05.87,23.46,
24-Sep-24,Reversal,00.00,05.87,17.6,
24-Sep-24,Transportellaneous,07.42,00.00,25.02,
24-Sep-24,NEFT,07.89,00.00,32.91,
24-Sep-24,Purchase,"5,715.00",00.00,"5,747.91",
24-Sep-24,Debit Card,00.00,638.66,"5,109.25",
24-Sep-24,Bill,00.00,851.54,"4,257.71",
24-Sep-24,Tax,00.00,851.54,"3,406.17",
24-Sep-24,ATM,00.00,"1,703.09","1,703.08",
24-Sep-24,Transportellaneous,21.43,00.00,"1,724.51",
24-Sep-24,ATM,03.00,00.00,"1,727.51",
24-Sep-24,Interest,"1,86,844.70",00.00,"1,88,572.21",
24-Sep-24,Transportellaneous,79.56,00.00,"1,88,651.77",
24-Sep-24,ATM,00.00,"20,961.31","1,67,690.46",
24-Sep-24,ATM,00.00,"83,845.23","83,845.23",
24-Sep-24,Bill,"9,309.00",00.00,"93,154.23",
24-Sep-24,Purchase,00.00,"18,630.85","74,523.38",
24-Sep-24,Cheque,00.00,"9,315.42","65,207.96",
24-Sep-24,Transfer,"4,447.00",00.00,"69,654.96",
24-Sep-24,Interest,"68,716.00",00.00,"1,38,370.96",
24-Sep-24,Interest,"2,365.75",00.00,"1,40,736.71",
24-Sep-24,Cash,"3,449.20",00.00,"1,44,185.91",
24-Sep-24,Cheque,"17,876.67",00.00,"1,62,062.58",
24-Sep-24,Transfer,00.00,"23,151.80","1,38,910.78",
24-Sep-24,Commission,"3,427.00",00.00,"1,42,337.78",
24-Sep-24,Bill,00.00,"71,168.89","71,168.89",
24-Sep-24,Reversal,00.00,"71,168.89",00.00,
25-Sep-24,Purchase,09.35,00.00,09.35,
25-Sep-24,Commission,43,00.00,52.35,
25-Sep-24,Commission,"18,90,839.25",00.00,"18,90,891.60",
25-Sep-24,RTGS,"77,212.00",00.00,"19,68,103.60",
25-Sep-24,Commission,190.96,00.00,"19,68,294.56",
25-Sep-24,RTGS,00.00,"6,56,098.19","13,12,196.37",
25-Sep-24,Cash,"2,56,571.28",00.00,"15,68,767.65",
25-Sep-24,Cash,02.70,00.00,"15,68,770.35",
25-Sep-24,Bill,04.00,00.00,"15,68,774.35",
25-Sep-24,NEFT,"2,40,517.69",00.00,"18,09,292.04",
25-Sep-24,Tax,"1,070.10",00.00,"18,10,362.14",
25-Sep-24,Interest,00.00,"9,05,181.07","9,05,181.07",
25-Sep-24,Debit Card,"17,500.70",00.00,"9,22,681.77",
25-Sep-24,ATM,"15,96,776.00",00.00,"25,19,457.77",
25-Sep-24,NEFT,14.54,00.00,"25,19,472.31",
25-Sep-24,Tax,"98,708.00",00.00,"26,18,180.31",
25-Sep-24,Commission,00.00,"3,27,272.54","22,90,907.77",
25-Sep-24,NEFT,"96,835.50",00.00,"23,87,743.27",
25-Sep-24,Bill,"14,179.55",00.00,"24,01,922.82",
25-Sep-24,IMPS,00.00,"6,00,480.71","18,01,442.11",
25-Sep-24,Cash,"9,54,736.80",00.00,"27,56,178.91",
25-Sep-24,Reversal,00.00,"3,44,522.36","24,11,656.55",
26-Sep-24,RTGS,06.20,00.00,"24,11,662.75",
26-Sep-24,Transportellaneous,00.00,"2,67,962.53","21,43,700.22",
26-Sep-24,Transfer,"20,71,428.00",00.00,"42,15,128.22",
26-Sep-24,Cash,00.00,"42,15,128.22",00.00,
26-Sep-24,Cash,01.40,00.00,01.40,
26-Sep-24,NEFT,"18,74,691.00",00.00,"18,74,692.40",
26-Sep-24,Debit Card,00.00,"2,34,336.55","16,40,355.85",
26-Sep-24,Tax,06.42,00.00,"16,40,362.27",
26-Sep-24,Cash,00.00,"2,05,045.28","14,35,316.99",
27-Sep-24,Bill,"2,861.50",00.00,"14,38,178.49",
27-Sep-24,Purchase,"8,726.15",00.00,"14,46,904.64",
27-Sep-24,RTGS,01.00,00.00,"14,46,905.64",
27-Sep-24,ATM,00.00,"2,41,150.94","12,05,754.70",
27-Sep-24,Bill,00.00,"2,00,959.12","10,04,795.58",
27-Sep-24,IMPS,"4,086.00",00.00,"10,08,881.58",
27-Sep-24,Transfer,402.81,00.00,"10,09,284.39",
27-Sep-24,Reversal,"4,047.00",00.00,"10,13,331.39",
27-Sep-24,Cash,00.00,"10,13,331.39",00.00,
27-Sep-24,Transportellaneous,00.70,00.00,00.70,
27-Sep-24,Purchase,"3,206.00",00.00,"3,206.70",
27-Sep-24,IMPS,44,00.00,"3,250.70",
27-Sep-24,Tax,00.00,325.07,"2,925.63",
27-Sep-24,Debit Card,"3,160.00",00.00,"6,085.63",
27-Sep-24,Bill,00.00,676.18,"5,409.45",
27-Sep-24,Interest,"14,73,496.00",00.00,"14,78,905.45",
27-Sep-24,Cash,"12,045.90",00.00,"14,90,951.35",
27-Sep-24,Transportellaneous,00.00,"7,45,475.68","7,45,475.68",
27-Sep-24,Reversal,00.00,"93,184.46","6,52,291.22",
27-Sep-24,NEFT,00.00,"2,17,430.41","4,34,860.81",
27-Sep-24,Debit Card,00.00,"1,44,953.60","2,89,907.21",
27-Sep-24,Reversal,00.00,"28,990.72","2,60,916.49",
27-Sep-24,IMPS,13.4,00.00,"2,60,929.89",
27-Sep-24,NEFT,00.00,00.00,"2,60,929.89",
27-Sep-24,Interest,02.27,00.00,"2,60,932.16",
27-Sep-24,Purchase,"1,00,947.47",00.00,"3,61,879.63",
27-Sep-24,Transfer,"4,077.10",00.00,"3,65,956.73",
27-Sep-24,Transportellaneous,"18,40,545.20",00.00,"22,06,501.93",
28-Sep-24,Commission,00.00,"2,75,812.74","19,30,689.19",
28-Sep-24,ATM,02.50,00.00,"19,30,691.69",
28-Sep-24,IMPS,"2,495.46",00.00,"19,33,187.15",
28-Sep-24,Commission,"8,793.00",00.00,"19,41,980.15",
28-Sep-24,Transportellaneous,372.37,00.00,"19,42,352.52",
28-Sep-24,Cheque,00.00,"19,42,352.52",00.00,
28-Sep-24,Commission,"15,93,160.00",00.00,"15,93,160.00",
28-Sep-24,IMPS,00.00,"2,27,594.29","13,65,565.71",
28-Sep-24,Interest,501.3,00.00,"13,66,067.01",
28-Sep-24,Transfer,"19,662.00",00.00,"13,85,729.01",
28-Sep-24,Debit Card,06.87,00.00,"13,85,735.88",
28-Sep-24,Debit Card,00.00,"6,92,867.94","6,92,867.94",
28-Sep-24,Interest,00.00,"76,985.33","6,15,882.61",
28-Sep-24,Transportellaneous,"1,26,885.00",00.00,"7,42,767.61",
28-Sep-24,ATM,"17,035.50",00.00,"7,59,803.11",
28-Sep-24,Commission,06.80,00.00,"7,59,809.91",
28-Sep-24,IMPS,"21,979.11",00.00,"7,81,789.02",
28-Sep-24,Cash,00.00,"78,178.90","7,03,610.12",
28-Sep-24,NEFT,00.50,00.00,"7,03,610.62",
28-Sep-24,ATM,00.00,"1,17,268.44","5,86,342.18",
28-Sep-24,Cheque,00.00,"2,93,171.09","2,93,171.09",
28-Sep-24,Transportellaneous,04.00,00.00,"2,93,175.09",
28-Sep-24,Purchase,00.00,"2,93,175.09",00.00,
28-Sep-24,Transfer,"30,688.30",00.00,"30,688.30",
28-Sep-24,NEFT,00.00,"3,068.83","27,619.47",
28-Sep-24,Commission,"1,55,572.00",00.00,"1,83,191.47",
28-Sep-24,Interest,00.00,"30,531.91","1,52,659.56",
29-Sep-24,Debit Card,33,00.00,"1,52,692.56",
29-Sep-24,NEFT,00.00,"76,346.28","76,346.28",
29-Sep-24,Debit Card,499.11,00.00,"76,845.39",
29-Sep-24,Cash,00.00,"38,422.70","38,422.70",
29-Sep-24,Bill,00.00,"5,488.96","32,933.74",
29-Sep-24,NEFT,00.00,"3,293.37","29,640.37",
29-Sep-24,Reversal,00.00,"14,820.19","14,820.18",
29-Sep-24,Tax,00.00,"14,820.18",00.00,
29-Sep-24,Purchase,"17,186.90",00.00,"17,186.90",
29-Sep-24,Tax,00.00,"1,909.66","15,277.24",
29-Sep-24,Commission,00.00,"7,638.62","7,638.62",
29-Sep-24,Purchase,169.3,00.00,"7,807.92",
29-Sep-24,Commission,00.00,"3,903.96","3,903.96",
29-Sep-24,Purchase,"13,713.64",00.00,"17,617.60",
29-Sep-24,Cash,00.00,"2,936.27","14,681.33",
29-Sep-24,RTGS,00.00,"4,893.78","9,787.55",
29-Sep-24,Transportellaneous,"50,676.30",00.00,"60,463.85",
29-Sep-24,Debit Card,"1,30,486.50",00.00,"1,90,950.35",
29-Sep-24,IMPS,"9,46,239.80",00.00,"11,37,190.15",
30-Sep-24,Transportellaneous,00.00,"1,26,354.46","10,10,835.69",
30-Sep-24,Transportellaneous,00.00,"1,68,472.62","8,42,363.08",
30-Sep-24,Cash,144.31,00.00,"8,42,507.39",
30-Sep-24,Tax,00.00,"1,05,313.42","7,37,193.97",
30-Sep-24,Reversal,00.00,"2,45,731.32","4,91,462.65",
30-Sep-24,IMPS,"8,44,040.20",00.00,"13,35,502.85",
01-Oct-24,Purchase,"12,708.66",00.00,"13,48,211.51",
01-Oct-24,Bill,"12,33,734.00",00.00,"25,81,945.51",
01-Oct-24,Transfer,00.00,"4,30,324.25","21,51,621.26",
01-Oct-24,RTGS,00.00,"5,37,905.32","16,13,715.94",
01-Oct-24,RTGS,00.00,"1,79,301.77","14,34,414.17",
01-Oct-24,Transportellaneous,"1,26,904.75",00.00,"15,61,318.92",
01-Oct-24,Interest,"1,56,473.00",00.00,"17,17,791.92",
01-Oct-24,Transportellaneous,"9,459.72",00.00,"17,27,251.64",
01-Oct-24,ATM,949.6,00.00,"17,28,201.24",
01-Oct-24,Bill,32,00.00,"17,28,233.24",
01-Oct-24,ATM,"1,644.00",00.00,"17,29,877.24",
01-Oct-24,IMPS,02.96,00.00,"17,29,880.20",
01-Oct-24,Purchase,00.00,"5,76,626.73","11,53,253.47",
01-Oct-24,Transportellaneous,00.00,"5,76,626.74","5,76,626.74",
01-Oct-24,ATM,00.00,"72,078.34","5,04,548.40",
01-Oct-24,NEFT,"5,00,564.00",00.00,"10,05,112.40",
01-Oct-24,Purchase,"3,881.79",00.00,"10,08,994.19",
01-Oct-24,Purchase,00.00,"2,01,798.84","8,07,195.35",
01-Oct-24,Cash,37.5,00.00,"8,07,232.85",
02-Oct-24,RTGS,00.00,"1,15,318.98","6,91,913.87",
02-Oct-24,Commission,"2,414.10",00.00,"6,94,327.97",
02-Oct-24,RTGS,"15,13,413.00",00.00,"22,07,740.97",
02-Oct-24,Commission,00.00,"3,67,956.83","18,39,784.14",
02-Oct-24,Transportellaneous,00.00,"2,04,420.46","16,35,363.68",
02-Oct-24,IMPS,"14,75,212.00",00.00,"31,10,575.68",
02-Oct-24,Transportellaneous,00.00,"3,88,821.96","27,21,753.72",
02-Oct-24,Purchase,04.88,00.00,"27,21,758.60",
03-Oct-24,IMPS,00.00,"6,80,439.65","20,41,318.95",
03-Oct-24,Bill,00.00,"2,26,813.22","18,14,505.73",
03-Oct-24,Interest,00.00,"1,81,450.57","16,33,055.16",
03-Oct-24,Debit Card,00.00,"5,44,351.72","10,88,703.44",
03-Oct-24,Transportellaneous,"4,158.50",00.00,"10,92,861.94",
03-Oct-24,Purchase,07.00,00.00,"10,92,868.94",
03-Oct-24,Bill,00.00,"5,46,434.47","5,46,434.47",
03-Oct-24,Transfer,00.00,"1,82,144.82","3,64,289.65",
03-Oct-24,RTGS,"3,09,059.00",00.00,"6,73,348.65",
03-Oct-24,Purchase,00.00,"67,334.87","6,06,013.78",
04-Oct-24,Cheque,08.00,00.00,"6,06,021.78",
04-Oct-24,Debit Card,84,00.00,"6,06,105.78",
04-Oct-24,Cash,00.00,"6,06,105.78",00.00,
04-Oct-24,IMPS,"5,37,592.00",00.00,"5,37,592.00",
04-Oct-24,Purchase,05.90,00.00,"5,37,597.90",
05-Oct-24,NEFT,00.00,"1,34,399.48","4,03,198.43",
05-Oct-24,Interest,00.00,"57,599.78","3,45,598.65",
05-Oct-24,Cash,"7,433.50",00.00,"3,53,032.15",
05-Oct-24,Debit Card,00.00,"39,225.79","3,13,806.36",
05-Oct-24,Transportellaneous,00.00,"52,301.06","2,61,505.30",
05-Oct-24,Reversal,00.00,"1,30,752.65","1,30,752.65",
05-Oct-24,NEFT,"2,619.00",00.00,"1,33,371.65",
05-Oct-24,Transfer,"17,895.70",00.00,"1,51,267.35",
05-Oct-24,ATM,00.00,"50,422.45","1,00,844.90",
05-Oct-24,Cheque,"3,896.03",00.00,"1,04,740.93",
05-Oct-24,IMPS,00.00,"34,913.64","69,827.29",
05-Oct-24,Commission,00.00,"7,758.59","62,068.70",
05-Oct-24,Transportellaneous,00.00,"7,758.59","54,310.11",
05-Oct-24,Transportellaneous,"4,016.41",00.00,"58,326.52",
05-Oct-24,Cheque,"4,91,364.00",00.00,"5,49,690.52",
05-Oct-24,RTGS,00.00,"5,49,690.52",00.00,
05-Oct-24,Commission,"9,73,029.50",00.00,"9,73,029.50",
05-Oct-24,Transportellaneous,"1,122.10",00.00,"9,74,151.60",
05-Oct-24,Interest,00.00,"1,21,768.95","8,52,382.65",
05-Oct-24,NEFT,21,00.00,"8,52,403.65",
05-Oct-24,Reversal,00.00,"1,21,771.95","7,30,631.70",
05-Oct-24,Tax,00.00,"1,46,126.34","5,84,505.36",
05-Oct-24,Tax,00.00,"1,16,901.07","4,67,604.29",
05-Oct-24,Interest,"1,16,085.75",00.00,"5,83,690.04",
05-Oct-24,IMPS,00.00,"83,384.29","5,00,305.75",
05-Oct-24,Commission,00.00,"2,50,152.88","2,50,152.88",
05-Oct-24,Debit Card,00.00,"27,794.76","2,22,358.12",
05-Oct-24,Reversal,"2,213.95",00.00,"2,24,572.07",
05-Oct-24,Tax,"2,447.00",00.00,"2,27,019.07",
05-Oct-24,ATM,00.00,"32,431.30","1,94,587.77",
05-Oct-24,Cash,00.00,"19,458.78","1,75,128.99",
05-Oct-24,Commission,"8,35,323.75",00.00,"10,10,452.74",
05-Oct-24,IMPS,00.00,"1,26,306.59","8,84,146.15",
05-Oct-24,Bill,00.00,"2,21,036.54","6,63,109.61",
05-Oct-24,RTGS,"2,08,391.38",00.00,"8,71,500.99",
05-Oct-24,ATM,00.50,00.00,"8,71,501.49",
05-Oct-24,Cash,02.00,00.00,"8,71,503.49",
05-Oct-24,Transfer,00.00,"8,71,503.49",00.00,
05-Oct-24,Bill,"2,945.00",00.00,"2,945.00",
05-Oct-24,Transportellaneous,00.00,736.25,"2,208.75",
05-Oct-24,Tax,00.00,"1,104.38","1,104.38",
05-Oct-24,IMPS,"26,751.00",00.00,"27,855.38",
05-Oct-24,Commission,64.2,00.00,"27,919.58",
05-Oct-24,NEFT,47.2,00.00,"27,966.78",
05-Oct-24,Bill,219.04,00.00,"28,185.82",
05-Oct-24,Interest,"4,56,042.20",00.00,"4,84,228.02",
05-Oct-24,Debit Card,00.00,"53,803.11","4,30,424.91",
05-Oct-24,Tax,"5,39,015.80",00.00,"9,69,440.71",
05-Oct-24,IMPS,02.00,00.00,"9,69,442.71",
05-Oct-24,IMPS,57,00.00,"9,69,499.71",
05-Oct-24,RTGS,00.00,"1,38,499.96","8,30,999.75",
05-Oct-24,Debit Card,00.00,"1,18,714.25","7,12,285.50",
05-Oct-24,Commission,00.00,"2,37,428.50","4,74,857.00",
05-Oct-24,Cash,00.00,"4,74,857.00",00.00,
05-Oct-24,Reversal,"2,00,118.20",00.00,"2,00,118.20",
05-Oct-24,Interest,00.00,"20,011.82","1,80,106.38",
05-Oct-24,Tax,"21,033.30",00.00,"2,01,139.68",
05-Oct-24,Debit Card,00.52,00.00,"2,01,140.20",
05-Oct-24,Debit Card,"1,01,852.00",00.00,"3,02,992.20",
05-Oct-24,Debit Card,03.42,00.00,"3,02,995.62",
05-Oct-24,Cheque,00.00,"3,02,995.62",00.00,
05-Oct-24,Debit Card,"1,96,567.00",00.00,"1,96,567.00",
05-Oct-24,Debit Card,00.00,"98,283.50","98,283.50",
05-Oct-24,Debit Card,132,00.00,"98,415.50",
05-Oct-24,Debit Card,00.00,"19,683.10","78,732.40",
05-Oct-24,Tax,46.6,00.00,"78,779.00",
05-Oct-24,Bill,00.00,"11,254.14","67,524.86",
05-Oct-24,Transfer,"19,579.00",00.00,"87,103.86",
05-Oct-24,RTGS,32.3,00.00,"87,136.16",
05-Oct-24,RTGS,00.00,"12,448.02","74,688.14",
05-Oct-24,IMPS,00.00,"7,468.81","67,219.33",
05-Oct-24,Debit Card,"9,75,897.80",00.00,"10,43,117.13",
05-Oct-24,Bill,00.00,"1,04,311.71","9,38,805.42",
05-Oct-24,Transportellaneous,"2,57,767.90",00.00,"11,96,573.32",
05-Oct-24,Transfer,00.00,"1,19,657.33","10,76,915.99",
06-Oct-24,Purchase,05.20,00.00,"10,76,921.19",
06-Oct-24,RTGS,00.00,"2,69,230.30","8,07,690.89",
06-Oct-24,Transfer,"91,712.30",00.00,"8,99,403.19",
06-Oct-24,NEFT,"8,900.30",00.00,"9,08,303.49",
06-Oct-24,NEFT,"4,070.31",00.00,"9,12,373.80",
06-Oct-24,Cheque,274.97,00.00,"9,12,648.77",
06-Oct-24,IMPS,00.00,"9,12,648.77",00.00,
07-Oct-24,Tax,"47,871.90",00.00,"47,871.90",
07-Oct-24,Transportellaneous,00.00,"7,978.65","39,893.25",
07-Oct-24,Interest,07.00,00.00,"39,900.25",
07-Oct-24,Commission,"3,269.70",00.00,"43,169.95",
07-Oct-24,Commission,297.28,00.00,"43,467.23",
07-Oct-24,IMPS,00.00,"7,244.54","36,222.69",
07-Oct-24,Commission,00.00,"3,622.27","32,600.42",
07-Oct-24,NEFT,"2,721.00",00.00,"35,321.42",
07-Oct-24,ATM,"72,279.00",00.00,"1,07,600.42",
07-Oct-24,Bill,"1,700.00",00.00,"1,09,300.42",
07-Oct-24,Debit Card,108.2,00.00,"1,09,408.62",
07-Oct-24,Transportellaneous,"3,645.00",00.00,"1,13,053.62",
07-Oct-24,IMPS,"17,402.00",00.00,"1,30,455.62",
08-Oct-24,ATM,00.00,"1,30,455.62",00.00,
08-Oct-24,Cash,731,00.00,731,
08-Oct-24,Interest,00.00,91.38,639.62,
08-Oct-24,RTGS,00.00,106.6,533.02,
08-Oct-24,Debit Card,669.4,00.00,"1,202.42",
08-Oct-24,Reversal,"3,491.95",00.00,"4,694.37",
08-Oct-24,Transfer,346,00.00,"5,040.37",
09-Oct-24,ATM,00.00,"5,040.37",00.00,
09-Oct-24,IMPS,"3,051.00",00.00,"3,051.00",
09-Oct-24,Tax,29.06,00.00,"3,080.06",
09-Oct-24,Commission,00.00,"1,026.69","2,053.37",
09-Oct-24,Bill,00.00,342.23,"1,711.14",
09-Oct-24,Cash,"2,656.10",00.00,"4,367.24",
09-Oct-24,Cash,195.8,00.00,"4,563.04",
09-Oct-24,Purchase,"4,186.00",00.00,"8,749.04",
09-Oct-24,ATM,00.00,"2,916.35","5,832.69",
09-Oct-24,Cheque,00.00,"5,832.69",00.00,
09-Oct-24,Bill,"1,051.00",00.00,"1,051.00",
09-Oct-24,Tax,00.00,262.75,788.25,
09-Oct-24,Transportellaneous,00.00,394.13,394.12,
09-Oct-24,Bill,"2,47,549.34",00.00,"2,47,943.46",
09-Oct-24,IMPS,"37,893.10",00.00,"2,85,836.56",
09-Oct-24,Tax,00.00,"71,459.14","2,14,377.42",
09-Oct-24,NEFT,00.00,"30,625.35","1,83,752.07",
09-Oct-24,NEFT,"13,99,998.00",00.00,"15,83,750.07",
09-Oct-24,RTGS,00.00,"3,95,937.52","11,87,812.55",
09-Oct-24,Transfer,00.00,"1,69,687.51","10,18,125.04",
09-Oct-24,Debit Card,02.20,00.00,"10,18,127.24",
09-Oct-24,Cheque,"98,374.09",00.00,"11,16,501.33",
09-Oct-24,Bill,00.00,"1,39,562.67","9,76,938.66",
09-Oct-24,Cash,"16,159.60",00.00,"9,93,098.26",
09-Oct-24,Tax,"28,061.38",00.00,"10,21,159.64",
09-Oct-24,Reversal,00.00,"1,70,193.27","8,50,966.37",
09-Oct-24,Transportellaneous,39,00.00,"8,51,005.37",
09-Oct-24,Purchase,00.00,"85,100.54","7,65,904.83",
09-Oct-24,Transportellaneous,"5,51,363.00",00.00,"13,17,267.83",
09-Oct-24,Cash,00.00,"2,19,544.64","10,97,723.19",
09-Oct-24,IMPS,00.00,"1,37,215.40","9,60,507.79",
09-Oct-24,IMPS,00.00,"96,050.78","8,64,457.01",
09-Oct-24,Transportellaneous,00.00,"1,08,057.13","7,56,399.88",
09-Oct-24,NEFT,57.86,00.00,"7,56,457.74",
09-Oct-24,Tax,00.00,"1,89,114.44","5,67,343.30",
09-Oct-24,RTGS,00.00,"1,89,114.43","3,78,228.87",
09-Oct-24,RTGS,"13,95,577.00",00.00,"17,73,805.87",
09-Oct-24,Bill,00.00,"8,86,902.94","8,86,902.94",
09-Oct-24,Cheque,00.00,"4,43,451.47","4,43,451.47",
09-Oct-24,Debit Card,"1,233.60",00.00,"4,44,685.07",
09-Oct-24,Tax,"12,78,660.00",00.00,"17,23,345.07",
09-Oct-24,Commission,10.83,00.00,"17,23,355.90",
09-Oct-24,Interest,50.39,00.00,"17,23,406.29",
09-Oct-24,Cheque,00.00,"2,46,200.90","14,77,205.39",
09-Oct-24,ATM,"8,846.73",00.00,"14,86,052.12",
09-Oct-24,Interest,00.00,"2,97,210.42","11,88,841.70",
09-Oct-24,IMPS,00.00,"1,18,884.17","10,69,957.53",
09-Oct-24,Tax,04.00,00.00,"10,69,961.53",
09-Oct-24,Transportellaneous,385.6,00.00,"10,70,347.13",
09-Oct-24,IMPS,00.00,"10,70,347.13",00.00,
09-Oct-24,RTGS,"2,023.18",00.00,"2,023.18",
09-Oct-24,Transportellaneous,"2,34,023.40",00.00,"2,36,046.58",
09-Oct-24,Bill,489,00.00,"2,36,535.58",
09-Oct-24,ATM,"14,34,696.80",00.00,"16,71,232.38",
10-Oct-24,Debit Card,00.00,"3,34,246.48","13,36,985.90",
11-Oct-24,NEFT,00.00,"1,90,997.99","11,45,987.91",
11-Oct-24,Transfer,451.51,00.00,"11,46,439.42",
11-Oct-24,Reversal,00.00,"2,29,287.88","9,17,151.54",
11-Oct-24,Cash,"2,250.47",00.00,"9,19,402.01",
12-Oct-24,Reversal,00.00,"1,53,233.67","7,66,168.34",
12-Oct-24,Bill,00.00,"1,27,694.72","6,38,473.62",
12-Oct-24,Bill,00.00,"1,27,694.72","5,10,778.90",
12-Oct-24,Tax,00.00,"1,27,694.73","3,83,084.18",
12-Oct-24,NEFT,"37,212.50",00.00,"4,20,296.68",
12-Oct-24,NEFT,07.30,00.00,"4,20,303.98",
12-Oct-24,Tax,00.00,"60,043.43","3,60,260.55",
12-Oct-24,IMPS,00.00,"72,052.11","2,88,208.44",
12-Oct-24,Reversal,"16,66,567.20",00.00,"19,54,775.64",
12-Oct-24,IMPS,00.00,"1,95,477.56","17,59,298.08",
12-Oct-24,Reversal,00.00,"3,51,859.62","14,07,438.46",
12-Oct-24,ATM,03.60,00.00,"14,07,442.06",
12-Oct-24,Cash,00.00,"2,01,063.15","12,06,378.91",
12-Oct-24,RTGS,"4,339.50",00.00,"12,10,718.41",
12-Oct-24,ATM,"28,349.00",00.00,"12,39,067.41",
12-Oct-24,NEFT,00.00,"1,37,674.16","11,01,393.25",
12-Oct-24,Cash,00.00,"1,37,674.16","9,63,719.09",
12-Oct-24,Cheque,00.00,"2,40,929.77","7,22,789.32",
12-Oct-24,Debit Card,58.13,00.00,"7,22,847.45",
12-Oct-24,Bill,460.1,00.00,"7,23,307.55",
12-Oct-24,Tax,"2,53,414.03",00.00,"9,76,721.58",
12-Oct-24,Tax,"12,76,178.00",00.00,"22,52,899.58",
12-Oct-24,NEFT,00.00,"4,50,579.92","18,02,319.66",
12-Oct-24,RTGS,118,00.00,"18,02,437.66",
12-Oct-24,Transportellaneous,00.00,"18,02,437.66",00.00,
12-Oct-24,RTGS,"1,50,983.62",00.00,"1,50,983.62",
12-Oct-24,Commission,00.00,"1,50,983.62",00.00,
13-Oct-24,Bill,00.00,00.00,00.00,
13-Oct-24,ATM,163.07,00.00,163.07,
13-Oct-24,Transfer,"1,465.00",00.00,"1,628.07",
13-Oct-24,Reversal,"12,97,011.75",00.00,"12,98,639.82",
13-Oct-24,Bill,06.00,00.00,"12,98,645.82",
13-Oct-24,IMPS,163,00.00,"12,98,808.82",
13-Oct-24,IMPS,182.72,00.00,"12,98,991.54",
13-Oct-24,RTGS,00.00,"2,16,498.59","10,82,492.95",
13-Oct-24,Purchase,"14,952.07",00.00,"10,97,445.02",
13-Oct-24,RTGS,00.00,"10,97,445.02",00.00,
13-Oct-24,Transportellaneous,93,00.00,93,
13-Oct-24,IMPS,"2,26,063.22",00.00,"2,26,156.22",
13-Oct-24,Cash,"1,42,315.90",00.00,"3,68,472.12",
13-Oct-24,Tax,00.00,"52,638.87","3,15,833.25",
13-Oct-24,Reversal,00.00,"1,05,277.75","2,10,555.50",
13-Oct-24,Transfer,00.00,"1,05,277.75","1,05,277.75",
13-Oct-24,Tax,"56,410.00",00.00,"1,61,687.75",
13-Oct-24,ATM,00.00,"17,965.31","1,43,722.44",
13-Oct-24,IMPS,"5,21,332.00",00.00,"6,65,054.44",
13-Oct-24,Cheque,"1,61,056.00",00.00,"8,26,110.44",
13-Oct-24,Reversal,00.00,"4,13,055.22","4,13,055.22",
13-Oct-24,NEFT,02.68,00.00,"4,13,057.90",
13-Oct-24,IMPS,"69,471.00",00.00,"4,82,528.90",
13-Oct-24,Bill,"1,798.30",00.00,"4,84,327.20",
13-Oct-24,Commission,"2,22,630.06",00.00,"7,06,957.26",
13-Oct-24,IMPS,00.00,"1,17,826.21","5,89,131.05",
13-Oct-24,Cheque,00.00,"58,913.11","5,30,217.95",
13-Oct-24,Reversal,04.59,00.00,"5,30,222.54",
13-Oct-24,IMPS,00.00,"1,76,740.85","3,53,481.69",
13-Oct-24,Interest,00.00,"39,275.74","3,14,205.95",
13-Oct-24,Cash,00.00,"78,551.49","2,35,654.46",
13-Oct-24,Bill,03.00,00.00,"2,35,657.46",
13-Oct-24,Interest,00.00,"78,552.49","1,57,104.97",
13-Oct-24,Cheque,00.00,"52,368.32","1,04,736.65",
13-Oct-24,Cash,00.00,00.00,"1,04,736.65",
13-Oct-24,Interest,00.00,"14,962.38","89,774.27",
13-Oct-24,IMPS,00.00,"8,977.43","80,796.84",
13-Oct-24,Commission,"29,846.27",00.00,"1,10,643.11",
13-Oct-24,Reversal,00.00,"15,806.16","94,836.95",
13-Oct-24,Tax,00.00,"11,854.62","82,982.33",
13-Oct-24,Interest,00.00,"8,298.23","74,684.10",
13-Oct-24,Commission,"1,15,458.50",00.00,"1,90,142.60",
13-Oct-24,Commission,"1,381.00",00.00,"1,91,523.60",
13-Oct-24,Transportellaneous,10.32,00.00,"1,91,533.92",
13-Oct-24,Bill,00.00,"63,844.64","1,27,689.28",
13-Oct-24,Bill,"1,55,814.91",00.00,"2,83,504.19",
13-Oct-24,Reversal,00.00,"94,501.40","1,89,002.79",
13-Oct-24,Tax,00.00,"94,501.40","94,501.40",
14-Oct-24,Debit Card,"2,587.30",00.00,"97,088.70",
14-Oct-24,NEFT,"2,844.50",00.00,"99,933.20",
14-Oct-24,Transfer,00.00,"99,933.20",00.00,
14-Oct-24,Cheque,"9,18,552.00",00.00,"9,18,552.00",
14-Oct-24,IMPS,"17,95,149.50",00.00,"27,13,701.50",
14-Oct-24,Purchase,00.00,"13,56,850.75","13,56,850.75",
14-Oct-24,Commission,86.08,00.00,"13,56,936.83",
14-Oct-24,Commission,00.00,"2,26,156.14","11,30,780.69",
14-Oct-24,Tax,264.1,00.00,"11,31,044.79",
14-Oct-24,RTGS,"19,09,856.00",00.00,"30,40,900.79",
14-Oct-24,Transfer,00.00,"4,34,414.40","26,06,486.39",
14-Oct-24,Interest,897,00.00,"26,07,383.39",
14-Oct-24,Tax,"12,521.55",00.00,"26,19,904.94",
14-Oct-24,Transfer,250,00.00,"26,20,154.94",
14-Oct-24,Debit Card,00.00,"6,55,038.74","19,65,116.20",
14-Oct-24,IMPS,103.7,00.00,"19,65,219.90",
14-Oct-24,NEFT,"3,805.00",00.00,"19,69,024.90",
14-Oct-24,Purchase,"4,73,670.25",00.00,"24,42,695.15",
14-Oct-24,Transfer,00.00,"3,48,956.45","20,93,738.70",
14-Oct-24,Cheque,00.00,"4,18,747.74","16,74,990.96",
14-Oct-24,ATM,"2,18,591.19",00.00,"18,93,582.15",
14-Oct-24,Transfer,08.00,00.00,"18,93,590.15",
14-Oct-24,Transportellaneous,00.00,00.00,"18,93,590.15",
14-Oct-24,Cheque,"16,46,422.80",00.00,"35,40,012.95",
14-Oct-24,Transfer,30.5,00.00,"35,40,043.45",
14-Oct-24,Transportellaneous,13.7,00.00,"35,40,057.15",
14-Oct-24,Purchase,00.00,"17,70,028.58","17,70,028.58",
14-Oct-24,IMPS,"1,393.00",00.00,"17,71,421.58",
14-Oct-24,Commission,"9,26,224.00",00.00,"26,97,645.58",
14-Oct-24,RTGS,03.00,00.00,"26,97,648.58",
14-Oct-24,Debit Card,406,00.00,"26,98,054.58",
14-Oct-24,Interest,00.70,00.00,"26,98,055.28",
14-Oct-24,IMPS,00.00,"26,98,055.28",00.00,
14-Oct-24,IMPS,60.79,00.00,60.79,
14-Oct-24,ATM,00.00,30.4,30.4,
14-Oct-24,Transfer,21,00.00,51.4,
14-Oct-24,Cash,00.00,07.34,44.06,
14-Oct-24,Reversal,59.9,00.00,103.96,
14-Oct-24,Debit Card,"15,468.20",00.00,"15,572.16",
14-Oct-24,Purchase,01.50,00.00,"15,573.66",
14-Oct-24,Transfer,00.00,"2,224.81","13,348.85",
14-Oct-24,Interest,"18,50,104.00",00.00,"18,63,452.85",
14-Oct-24,Debit Card,02.01,00.00,"18,63,454.86",
14-Oct-24,Commission,00.00,"9,31,727.43","9,31,727.43",
14-Oct-24,IMPS,"1,217.90",00.00,"9,32,945.33",
14-Oct-24,Bill,00.00,"1,86,589.07","7,46,356.26",
15-Oct-24,Purchase,"2,759.08",00.00,"7,49,115.34",
15-Oct-24,Commission,"13,299.00",00.00,"7,62,414.34",
15-Oct-24,Reversal,00.00,"95,301.79","6,67,112.55",
15-Oct-24,IMPS,00.00,"66,711.26","6,00,401.30",
15-Oct-24,Purchase,"2,58,418.00",00.00,"8,58,819.30",
15-Oct-24,Commission,"13,82,331.75",00.00,"22,41,151.05",
15-Oct-24,Debit Card,00.00,"7,47,050.35","14,94,100.70",
15-Oct-24,Tax,06.00,00.00,"14,94,106.70",
15-Oct-24,ATM,59,00.00,"14,94,165.70",
15-Oct-24,IMPS,00.00,"3,73,541.43","11,20,624.27",
15-Oct-24,Cheque,00.00,"1,24,513.81","9,96,110.46",
15-Oct-24,Bill,00.00,"1,66,018.41","8,30,092.05",
15-Oct-24,Commission,00.00,"2,07,523.01","6,22,569.04",
15-Oct-24,ATM,00.00,"3,11,284.52","3,11,284.52",
15-Oct-24,Bill,406,00.00,"3,11,690.52",
15-Oct-24,Transfer,00.00,"44,527.22","2,67,163.30",
15-Oct-24,NEFT,00.00,"44,527.22","2,22,636.08",
15-Oct-24,Commission,00.00,"27,829.51","1,94,806.57",
15-Oct-24,Cheque,474.2,00.00,"1,95,280.77",
15-Oct-24,Debit Card,00.00,"48,820.19","1,46,460.58",
15-Oct-24,Commission,00.00,"36,615.15","1,09,845.44",
15-Oct-24,Bill,00.00,"1,09,845.44",00.00,
15-Oct-24,Commission,"8,13,822.00",00.00,"8,13,822.00",
15-Oct-24,Cheque,00.00,"1,62,764.40","6,51,057.60",
15-Oct-24,Cheque,00.00,"93,008.23","5,58,049.37",
15-Oct-24,Purchase,"3,152.24",00.00,"5,61,201.61",
16-Oct-24,Purchase,00.00,"56,120.16","5,05,081.45",
16-Oct-24,Transfer,96,00.00,"5,05,177.45",
16-Oct-24,IMPS,00.00,"72,168.21","4,33,009.24",
16-Oct-24,Tax,00.00,"4,33,009.24",00.00,
16-Oct-24,Transfer,49.41,00.00,49.41,
16-Oct-24,NEFT,52,00.00,101.41,
16-Oct-24,NEFT,00.00,20.28,81.13,
16-Oct-24,Interest,00.00,10.14,70.99,
16-Oct-24,Cash,04.00,00.00,74.99,
16-Oct-24,IMPS,00.00,25,49.99,
16-Oct-24,Interest,"24,977.60",00.00,"25,027.59",
16-Oct-24,Purchase,04.00,00.00,"25,031.59",
16-Oct-24,Commission,"3,790.83",00.00,"28,822.42",
16-Oct-24,Purchase,"7,83,961.25",00.00,"8,12,783.67",
16-Oct-24,Bill,00.00,"4,06,391.84","4,06,391.84",
16-Oct-24,ATM,00.00,"2,03,195.92","2,03,195.92",
16-Oct-24,Interest,00.00,"22,577.32","1,80,618.60",
17-Oct-24,Bill,00.00,"20,068.73","1,60,549.87",
17-Oct-24,Purchase,"2,581.00",00.00,"1,63,130.87",
17-Oct-24,IMPS,00.00,"40,782.72","1,22,348.15",
17-Oct-24,Reversal,"2,578.99",00.00,"1,24,927.14",
17-Oct-24,Transportellaneous,00.00,"62,463.57","62,463.57",
17-Oct-24,ATM,00.00,"20,821.19","41,642.38",
17-Oct-24,Interest,00.00,"4,626.93","37,015.45",
17-Oct-24,Cheque,59.36,00.00,"37,074.81",
17-Oct-24,RTGS,331,00.00,"37,405.81",
18-Oct-24,IMPS,00.00,"7,481.16","29,924.65",
18-Oct-24,Bill,"10,261.50",00.00,"40,186.15",
18-Oct-24,IMPS,00.00,"5,023.27","35,162.88",
18-Oct-24,Commission,00.00,"7,032.58","28,130.30",
18-Oct-24,RTGS,00.00,"4,688.38","23,441.92",
18-Oct-24,Purchase,06.54,00.00,"23,448.46",
18-Oct-24,Cheque,00.00,"5,862.12","17,586.34",
18-Oct-24,Transportellaneous,36.75,00.00,"17,623.09",
18-Oct-24,NEFT,00.00,"2,937.18","14,685.91",
18-Oct-24,ATM,00.00,"2,097.99","12,587.92",
18-Oct-24,Purchase,284.9,00.00,"12,872.82",
18-Oct-24,Tax,00.00,"1,430.31","11,442.51",
18-Oct-24,Cheque,00.00,"3,814.17","7,628.34",
18-Oct-24,Transportellaneous,00.00,847.59,"6,780.75",
18-Oct-24,Purchase,06.40,00.00,"6,787.15",
18-Oct-24,ATM,"3,034.00",00.00,"9,821.15",
18-Oct-24,Cash,00.00,"1,227.64","8,593.51",
18-Oct-24,Cheque,"1,04,381.47",00.00,"1,12,974.98",
18-Oct-24,Transportellaneous,"19,396.00",00.00,"1,32,370.98",
19-Oct-24,Cash,472.7,00.00,"1,32,843.68",
19-Oct-24,Tax,"8,23,979.00",00.00,"9,56,822.68",
19-Oct-24,Purchase,07.90,00.00,"9,56,830.58",
19-Oct-24,Interest,00.00,"4,78,415.29","4,78,415.29",
19-Oct-24,Tax,00.00,"79,735.88","3,98,679.41",
19-Oct-24,IMPS,"2,19,318.80",00.00,"6,17,998.21",
19-Oct-24,Cash,335.9,00.00,"6,18,334.11",
19-Oct-24,NEFT,00.00,"6,18,334.11",00.00,
19-Oct-24,Cheque,"26,702.00",00.00,"26,702.00",
19-Oct-24,Bill,00.00,"3,814.57","22,887.43",
19-Oct-24,NEFT,00.00,"7,629.14","15,258.29",
19-Oct-24,Debit Card,00.00,"3,814.57","11,443.72",
19-Oct-24,Cheque,37.71,00.00,"11,481.43",
19-Oct-24,Commission,00.00,"11,481.43",00.00,
19-Oct-24,Reversal,58,00.00,58,
19-Oct-24,Interest,209.1,00.00,267.1,
19-Oct-24,Transportellaneous,"24,790.96",00.00,"25,058.06",
19-Oct-24,Cheque,57.44,00.00,"25,115.50",
19-Oct-24,IMPS,00.00,"3,587.93","21,527.57",
19-Oct-24,NEFT,00.00,"5,381.89","16,145.68",
19-Oct-24,IMPS,06.40,00.00,"16,152.08",
19-Oct-24,Tax,"1,98,468.00",00.00,"2,14,620.08",
19-Oct-24,Cheque,00.00,"23,846.68","1,90,773.40",
19-Oct-24,Purchase,"8,39,619.50",00.00,"10,30,392.90",
19-Oct-24,Tax,"5,45,379.00",00.00,"15,75,771.90",
19-Oct-24,Tax,"1,653.20",00.00,"15,77,425.10",
19-Oct-24,Transfer,38.9,00.00,"15,77,464.00",
19-Oct-24,Debit Card,00.00,"2,62,910.67","13,14,553.33",
19-Oct-24,Tax,00.00,"4,38,184.44","8,76,368.89",
19-Oct-24,NEFT,"1,74,531.00",00.00,"10,50,899.89",
19-Oct-24,Debit Card,"1,767.00",00.00,"10,52,666.89",
19-Oct-24,NEFT,00.00,"10,52,666.89",00.00,
19-Oct-24,Transfer,44.6,00.00,44.6,
19-Oct-24,IMPS,00.00,08.92,35.68,
19-Oct-24,Transfer,"2,591.90",00.00,"2,627.58",
19-Oct-24,Reversal,00.00,375.37,"2,252.21",
19-Oct-24,Purchase,00.00,450.44,"1,801.77",
20-Oct-24,Cheque,"22,306.20",00.00,"24,107.97",
20-Oct-24,NEFT,"3,500.00",00.00,"27,607.97",
20-Oct-24,Tax,03.60,00.00,"27,611.57",
20-Oct-24,Cheque,"5,23,055.20",00.00,"5,50,666.77",
20-Oct-24,ATM,00.00,"78,666.68","4,72,000.09",
20-Oct-24,Debit Card,"2,319.00",00.00,"4,74,319.09",
20-Oct-24,Reversal,00.00,"1,18,579.77","3,55,739.32",
20-Oct-24,Tax,00.00,"35,573.93","3,20,165.39",
20-Oct-24,Interest,00.00,"32,016.54","2,88,148.85",
20-Oct-24,Transfer,00.00,"48,024.81","2,40,124.04",
20-Oct-24,Interest,14.51,00.00,"2,40,138.55",
20-Oct-24,ATM,00.00,"2,40,138.55",00.00,
20-Oct-24,RTGS,193.2,00.00,193.2,
20-Oct-24,Bill,30.9,00.00,224.1,
20-Oct-24,Reversal,"2,19,112.00",00.00,"2,19,336.10",
20-Oct-24,Transportellaneous,"19,605.40",00.00,"2,38,941.50",
20-Oct-24,IMPS,"19,95,002.00",00.00,"22,33,943.50",
20-Oct-24,Cheque,00.00,"7,44,647.83","14,89,295.67",
20-Oct-24,Reversal,220.6,00.00,"14,89,516.27",
20-Oct-24,Transportellaneous,00.00,"1,65,501.81","13,24,014.46",
20-Oct-24,Transportellaneous,385.1,00.00,"13,24,399.56",
20-Oct-24,Commission,"2,890.50",00.00,"13,27,290.06",
20-Oct-24,Commission,"15,722.40",00.00,"13,43,012.46",
20-Oct-24,Purchase,"12,64,958.25",00.00,"26,07,970.71",
20-Oct-24,Cheque,00.00,"8,69,323.57","17,38,647.14",
20-Oct-24,Purchase,00.00,"1,73,864.71","15,64,782.43",
20-Oct-24,Bill,"30,014.80",00.00,"15,94,797.23",
20-Oct-24,Cheque,00.00,"2,27,828.18","13,66,969.05",
20-Oct-24,NEFT,00.00,"13,66,969.05",00.00,
20-Oct-24,IMPS,"16,98,766.75",00.00,"16,98,766.75",
20-Oct-24,Interest,00.00,"1,88,751.86","15,10,014.89",
20-Oct-24,Transfer,00.00,"3,77,503.72","11,32,511.17",
20-Oct-24,IMPS,00.00,"1,13,251.12","10,19,260.05",
20-Oct-24,Bill,43.7,00.00,"10,19,303.75",
20-Oct-24,Tax,00.00,"10,19,303.75",00.00,
20-Oct-24,Interest,120.67,00.00,120.67,
20-Oct-24,Interest,"2,05,378.00",00.00,"2,05,498.67",
20-Oct-24,Cheque,00.00,"29,356.95","1,76,141.72",
20-Oct-24,Debit Card,55,00.00,"1,76,196.72",
20-Oct-24,Transfer,00.00,"35,239.34","1,40,957.38",
20-Oct-24,Transfer,"2,56,459.50",00.00,"3,97,416.88",
20-Oct-24,Commission,00.00,"3,97,416.88",00.00,
20-Oct-24,Debit Card,469.5,00.00,469.5,
20-Oct-24,NEFT,00.00,469.5,00.00,
20-Oct-24,Bill,"2,03,400.88",00.00,"2,03,400.88",
20-Oct-24,ATM,"4,38,490.75",00.00,"6,41,891.63",
20-Oct-24,Interest,"1,43,475.10",00.00,"7,85,366.73",
20-Oct-24,RTGS,"15,41,104.20",00.00,"23,26,470.93",
20-Oct-24,Transfer,00.00,"2,32,647.09","20,93,823.84",
21-Oct-24,Transportellaneous,00.00,"2,99,117.69","17,94,706.15",
21-Oct-24,NEFT,"5,59,731.50",00.00,"23,54,437.65",
21-Oct-24,ATM,"1,10,130.41",00.00,"24,64,568.06",
21-Oct-24,RTGS,00.00,"24,64,568.06",00.00,
21-Oct-24,Cheque,461.9,00.00,461.9,
21-Oct-24,IMPS,"1,228.47",00.00,"1,690.37",
21-Oct-24,Purchase,00.00,338.07,"1,352.30",
21-Oct-24,Purchase,00.00,338.08,"1,014.22",
21-Oct-24,Transportellaneous,04.60,00.00,"1,018.82",
22-Oct-24,Tax,00.60,00.00,"1,019.42",
22-Oct-24,IMPS,00.00,339.81,679.61,
22-Oct-24,NEFT,00.00,67.96,611.65,
22-Oct-24,IMPS,"71,676.80",00.00,"72,288.45",
22-Oct-24,ATM,00.00,"9,036.06","63,252.39",
22-Oct-24,Commission,00.00,"6,325.24","56,927.15",
22-Oct-24,Cheque,"73,927.80",00.00,"1,30,854.95",
22-Oct-24,Debit Card,00.00,"14,539.44","1,16,315.51",
22-Oct-24,Cheque,290.6,00.00,"1,16,606.11",
22-Oct-24,Commission,"1,37,291.91",00.00,"2,53,898.02",
22-Oct-24,Transfer,"19,41,993.00",00.00,"21,95,891.02",
22-Oct-24,Reversal,09.40,00.00,"21,95,900.42",
22-Oct-24,Interest,00.00,"3,13,700.06","18,82,200.36",
22-Oct-24,Reversal,00.00,"2,35,275.05","16,46,925.32",
22-Oct-24,IMPS,06.50,00.00,"16,46,931.82",
22-Oct-24,Cheque,00.72,00.00,"16,46,932.54",
22-Oct-24,Bill,00.00,"5,48,977.51","10,97,955.03",
22-Oct-24,Transportellaneous,04.00,00.00,"10,97,959.03",
22-Oct-24,Cheque,00.00,"1,21,995.45","9,75,963.58",
22-Oct-24,Commission,00.00,"1,62,660.60","8,13,302.98",
22-Oct-24,Purchase,00.00,"2,71,100.99","5,42,201.99",
22-Oct-24,Tax,00.00,"54,220.20","4,87,981.79",
22-Oct-24,Cash,00.00,"1,21,995.45","3,65,986.34",
22-Oct-24,Cash,00.00,"40,665.15","3,25,321.19",
22-Oct-24,Cash,00.00,"40,665.15","2,84,656.04",
22-Oct-24,NEFT,00.00,"40,665.15","2,43,990.89",
22-Oct-24,Debit Card,05.80,00.00,"2,43,996.69",
22-Oct-24,Purchase,00.00,"24,399.67","2,19,597.02",
22-Oct-24,Bill,00.00,"27,449.63","1,92,147.39",
22-Oct-24,Cash,00.00,"32,024.57","1,60,122.83",
22-Oct-24,Cash,"2,652.00",00.00,"1,62,774.83",
22-Oct-24,ATM,"6,057.18",00.00,"1,68,832.01",
23-Oct-24,ATM,"7,481.52",00.00,"1,76,313.53",
23-Oct-24,Bill,"25,033.30",00.00,"2,01,346.83",
23-Oct-24,Transfer,07.00,00.00,"2,01,353.83",
23-Oct-24,Interest,00.00,"25,169.23","1,76,184.60",
23-Oct-24,Transfer,"2,38,500.00",00.00,"4,14,684.60",
23-Oct-24,Bill,488.8,00.00,"4,15,173.40",
23-Oct-24,Reversal,"2,208.50",00.00,"4,17,381.90",
23-Oct-24,Interest,117.14,00.00,"4,17,499.04",
23-Oct-24,Tax,397.47,00.00,"4,17,896.51",
23-Oct-24,Cheque,"2,26,366.90",00.00,"6,44,263.41",
23-Oct-24,Interest,"3,276.90",00.00,"6,47,540.31",
24-Oct-24,ATM,07.00,00.00,"6,47,547.31",
24-Oct-24,NEFT,03.90,00.00,"6,47,551.21",
24-Oct-24,Transportellaneous,00.00,"71,950.13","5,75,601.08",
24-Oct-24,RTGS,904,00.00,"5,76,505.08",
24-Oct-24,RTGS,04.00,00.00,"5,76,509.08",
24-Oct-24,Reversal,00.00,"57,650.91","5,18,858.17",
24-Oct-24,Transfer,"6,576.00",00.00,"5,25,434.17",
24-Oct-24,Interest,"86,526.90",00.00,"6,11,961.07",
24-Oct-24,ATM,202.6,00.00,"6,12,163.67",
24-Oct-24,Transfer,00.00,"87,451.95","5,24,711.72",
24-Oct-24,IMPS,"14,624.00",00.00,"5,39,335.72",
24-Oct-24,NEFT,00.00,"2,69,667.86","2,69,667.86",
24-Oct-24,ATM,"2,276.93",00.00,"2,71,944.79",
24-Oct-24,Debit Card,00.00,"67,986.20","2,03,958.59",
24-Oct-24,Reversal,"75,288.40",00.00,"2,79,246.99",
24-Oct-24,Tax,"2,030.30",00.00,"2,81,277.29",
25-Oct-24,Transfer,00.00,"46,879.55","2,34,397.74",
25-Oct-24,ATM,00.00,"33,485.39","2,00,912.35",
25-Oct-24,Transportellaneous,"2,768.00",00.00,"2,03,680.35",
25-Oct-24,RTGS,00.00,"22,631.15","1,81,049.20",
25-Oct-24,Transfer,00.00,"36,209.84","1,44,839.36",
25-Oct-24,Transfer,"2,72,825.50",00.00,"4,17,664.86",
25-Oct-24,Bill,"18,55,465.00",00.00,"22,73,129.86",
25-Oct-24,NEFT,"19,328.00",00.00,"22,92,457.86",
25-Oct-24,NEFT,00.00,"22,92,457.86",00.00,
25-Oct-24,Reversal,12.3,00.00,12.3,
25-Oct-24,NEFT,00.00,04.10,08.20,
25-Oct-24,Purchase,"14,223.70",00.00,"14,231.90",
25-Oct-24,Transfer,"9,36,809.75",00.00,"9,51,041.65",
25-Oct-24,ATM,"1,718.40",00.00,"9,52,760.05",
25-Oct-24,NEFT,00.00,"9,52,760.05",00.00,
25-Oct-24,Tax,09.90,00.00,09.90,
25-Oct-24,Transportellaneous,00.00,01.41,08.49,
25-Oct-24,Bill,00.00,08.49,00.00,
25-Oct-24,Cheque,949.2,00.00,949.2,
25-Oct-24,ATM,00.00,94.92,854.28,
25-Oct-24,Commission,00.00,94.92,759.36,
25-Oct-24,Commission,00.00,94.92,664.44,
25-Oct-24,Cheque,00.00,66.44,598,
25-Oct-24,IMPS,00.00,59.8,538.2,
25-Oct-24,Cheque,00.00,134.55,403.65,
25-Oct-24,Transportellaneous,244.04,00.00,647.69,
25-Oct-24,Debit Card,00.00,92.53,555.16,
26-Oct-24,RTGS,54.7,00.00,609.86,
26-Oct-24,Debit Card,00.00,121.97,487.89,
26-Oct-24,Debit Card,"25,017.93",00.00,"25,505.82",
26-Oct-24,Interest,"29,067.41",00.00,"54,573.23",
26-Oct-24,Interest,"2,58,181.00",00.00,"3,12,754.23",
26-Oct-24,Debit Card,299,00.00,"3,13,053.23",
26-Oct-24,Transportellaneous,05.40,00.00,"3,13,058.63",
26-Oct-24,Commission,00.00,"52,176.44","2,60,882.19",
26-Oct-24,Purchase,"26,313.25",00.00,"2,87,195.44",
26-Oct-24,Cheque,00.00,"95,731.81","1,91,463.63",
26-Oct-24,Interest,"17,332.27",00.00,"2,08,795.90",
26-Oct-24,Cheque,00.00,"52,198.98","1,56,596.92",
26-Oct-24,Commission,"28,214.92",00.00,"1,84,811.84",
26-Oct-24,Tax,00.00,"20,534.65","1,64,277.19",
26-Oct-24,Bill,00.00,"41,069.30","1,23,207.89",
27-Oct-24,Purchase,"8,66,820.20",00.00,"9,90,028.09",
27-Oct-24,Reversal,00.00,"1,23,753.51","8,66,274.58",
27-Oct-24,Commission,"1,206.00",00.00,"8,67,480.58",
27-Oct-24,Cash,"1,013.00",00.00,"8,68,493.58",
27-Oct-24,Cheque,"1,83,076.91",00.00,"10,51,570.49",
27-Oct-24,Bill,"15,56,849.00",00.00,"26,08,419.49",
27-Oct-24,Tax,"2,294.00",00.00,"26,10,713.49",
27-Oct-24,RTGS,971.1,00.00,"26,11,684.59",
27-Oct-24,Reversal,"2,08,861.28",00.00,"28,20,545.87",
27-Oct-24,ATM,"2,00,247.50",00.00,"30,20,793.37",
27-Oct-24,Reversal,"2,73,160.00",00.00,"32,93,953.37",
27-Oct-24,Cheque,00.00,"8,23,488.34","24,70,465.03",
28-Oct-24,Cheque,"11,741.21",00.00,"24,82,206.24",
29-Oct-24,Purchase,35.84,00.00,"24,82,242.08",
29-Oct-24,NEFT,928.61,00.00,"24,83,170.69",
29-Oct-24,Debit Card,35.29,00.00,"24,83,205.98",
29-Oct-24,Transportellaneous,39,00.00,"24,83,244.98",
29-Oct-24,Bill,00.00,"6,20,811.25","18,62,433.74",
29-Oct-24,Transfer,"1,798.00",00.00,"18,64,231.74",
29-Oct-24,ATM,"1,87,386.40",00.00,"20,51,618.14",
29-Oct-24,Tax,00.00,"2,27,957.57","18,23,660.57",
29-Oct-24,Debit Card,00.00,"4,55,915.14","13,67,745.43",
29-Oct-24,Interest,00.00,"1,95,392.20","11,72,353.23",
29-Oct-24,Purchase,"2,513.00",00.00,"11,74,866.23",
29-Oct-24,Reversal,00.00,"1,17,486.62","10,57,379.61",
29-Oct-24,ATM,741.6,00.00,"10,58,121.21",
29-Oct-24,ATM,"5,566.00",00.00,"10,63,687.21",
29-Oct-24,ATM,"45,837.19",00.00,"11,09,524.40",
29-Oct-24,Interest,07.75,00.00,"11,09,532.15",
29-Oct-24,Cash,"1,11,730.40",00.00,"12,21,262.55",
29-Oct-24,Commission,08.00,00.00,"12,21,270.55",
29-Oct-24,Reversal,00.00,"12,21,270.55",00.00,
29-Oct-24,Cheque,02.60,00.00,02.60,
29-Oct-24,Purchase,70,00.00,72.6,
30-Oct-24,Commission,"2,138.80",00.00,"2,211.40",
30-Oct-24,Transfer,00.60,00.00,"2,212.00",
30-Oct-24,NEFT,00.00,316,"1,896.00",
30-Oct-24,NEFT,00.00,474,"1,422.00",
30-Oct-24,NEFT,"20,79,629.00",00.00,"20,81,051.00",
30-Oct-24,Purchase,"1,71,279.31",00.00,"22,52,330.31",
30-Oct-24,NEFT,00.00,"7,50,776.77","15,01,553.54",
30-Oct-24,NEFT,00.00,"3,75,388.39","11,26,165.16",
30-Oct-24,NEFT,60.49,00.00,"11,26,225.65",
31-Oct-24,RTGS,00.00,"1,60,889.38","9,65,336.27",
31-Oct-24,Tax,00.00,"3,21,778.76","6,43,557.51",
31-Oct-24,Debit Card,00.00,"71,506.39","5,72,051.12",
31-Oct-24,Cash,00.00,"71,506.39","5,00,544.73",
31-Oct-24,ATM,00.00,"83,424.12","4,17,120.61",
31-Oct-24,Cash,00.00,"59,588.66","3,57,531.95",
31-Oct-24,RTGS,00.00,"89,382.99","2,68,148.96",
31-Oct-24,Cash,09.00,00.00,"2,68,157.96",
31-Oct-24,Cheque,00.00,"26,815.80","2,41,342.16",
31-Oct-24,Cash,"9,454.00",00.00,"2,50,796.16",
31-Oct-24,Tax,00.00,"25,079.62","2,25,716.54",
31-Oct-24,Purchase,00.00,"32,245.22","1,93,471.32",
01-Nov-24,Commission,"4,20,006.50",00.00,"6,13,477.82",
01-Nov-24,Interest,"1,78,969.78",00.00,"7,92,447.60",
01-Nov-24,IMPS,00.00,"99,055.95","6,93,391.65",
02-Nov-24,Debit Card,00.00,00.00,"6,93,391.65",
02-Nov-24,ATM,00.00,"77,043.52","6,16,348.13",
02-Nov-24,Cash,00.00,"1,23,269.63","4,93,078.50",
02-Nov-24,Interest,00.00,"4,93,078.50",00.00,
02-Nov-24,NEFT,08.50,00.00,08.50,
02-Nov-24,RTGS,01.00,00.00,09.50,
02-Nov-24,Tax,00.00,01.19,08.31,
02-Nov-24,IMPS,228,00.00,236.31,
02-Nov-24,Commission,"2,30,614.22",00.00,"2,30,850.53",
02-Nov-24,Interest,00.00,"46,170.11","1,84,680.42",
02-Nov-24,Tax,379.02,00.00,"1,85,059.44",
02-Nov-24,IMPS,"12,80,289.00",00.00,"14,65,348.44",
02-Nov-24,RTGS,70,00.00,"14,65,418.44",
02-Nov-24,Tax,"3,211.29",00.00,"14,68,629.73",
02-Nov-24,Reversal,23.25,00.00,"14,68,652.98",
02-Nov-24,ATM,00.00,"2,09,807.57","12,58,845.41",
02-Nov-24,Transportellaneous,00.00,"12,58,845.41",00.00,
02-Nov-24,Interest,191,00.00,191,
02-Nov-24,Bill,03.78,00.00,194.78,
02-Nov-24,Transportellaneous,03.70,00.00,198.48,
02-Nov-24,Cash,00.00,24.81,173.67,
02-Nov-24,Transfer,00.00,43.42,130.25,
02-Nov-24,IMPS,00.00,21.71,108.54,
02-Nov-24,Reversal,"1,74,620.25",00.00,"1,74,728.79",
02-Nov-24,ATM,00.00,"43,682.20","1,31,046.59",
02-Nov-24,Cash,00.00,"43,682.20","87,364.39",
02-Nov-24,Tax,00.00,"43,682.20","43,682.20",
02-Nov-24,Cheque,00.00,"6,240.31","37,441.89",
02-Nov-24,NEFT,00.00,"18,720.95","18,720.94",
02-Nov-24,RTGS,00.00,"9,360.47","9,360.47",
02-Nov-24,NEFT,00.00,"2,340.12","7,020.35",
03-Nov-24,Tax,00.00,"2,340.12","4,680.23",
03-Nov-24,Tax,"2,546.90",00.00,"7,227.13",
03-Nov-24,Cash,00.00,"2,409.04","4,818.09",
03-Nov-24,Commission,00.00,803.02,"4,015.08",
03-Nov-24,Bill,00.00,803.02,"3,212.06",
03-Nov-24,Reversal,00.00,"3,212.06",00.00,
03-Nov-24,Debit Card,01.83,00.00,01.83,
03-Nov-24,Cheque,00.00,00.61,01.22,
03-Nov-24,Transfer,"8,19,022.00",00.00,"8,19,023.22",
03-Nov-24,Bill,07.50,00.00,"8,19,030.72",
03-Nov-24,RTGS,"88,645.94",00.00,"9,07,676.66",
03-Nov-24,Transfer,"1,54,365.91",00.00,"10,62,042.57",
03-Nov-24,Tax,"8,21,497.00",00.00,"18,83,539.57",
03-Nov-24,Transfer,00.00,"6,27,846.52","12,55,693.05",
03-Nov-24,Purchase,00.00,"3,13,923.26","9,41,769.79",
03-Nov-24,Purchase,"18,13,682.25",00.00,"27,55,452.04",
03-Nov-24,Bill,00.00,"13,77,726.02","13,77,726.02",
03-Nov-24,RTGS,02.22,00.00,"13,77,728.24",
03-Nov-24,Bill,01.30,00.00,"13,77,729.54",
03-Nov-24,Bill,"13,40,437.25",00.00,"27,18,166.79",
03-Nov-24,Bill,00.00,"9,06,055.60","18,12,111.19",
04-Nov-24,Reversal,00.00,"2,01,345.69","16,10,765.50",
04-Nov-24,NEFT,00.00,"2,68,460.92","13,42,304.58",
04-Nov-24,RTGS,"3,907.00",00.00,"13,46,211.58",
04-Nov-24,Purchase,"31,518.90",00.00,"13,77,730.48",
04-Nov-24,Cheque,00.00,"1,53,081.16","12,24,649.32",
04-Nov-24,Debit Card,00.00,"2,44,929.86","9,79,719.46",
04-Nov-24,ATM,00.00,"4,89,859.73","4,89,859.73",
04-Nov-24,Transfer,00.00,"2,44,929.87","2,44,929.86",
04-Nov-24,Interest,00.00,"2,44,929.86",00.00,
04-Nov-24,ATM,"6,99,734.00",00.00,"6,99,734.00",
05-Nov-24,ATM,07.00,00.00,"6,99,741.00",
05-Nov-24,Transportellaneous,"10,82,800.00",00.00,"17,82,541.00",
05-Nov-24,RTGS,00.00,"2,54,648.71","15,27,892.29",
05-Nov-24,Bill,00.00,"15,27,892.29",00.00,
05-Nov-24,Bill,"2,49,724.20",00.00,"2,49,724.20",
05-Nov-24,Interest,"1,578.55",00.00,"2,51,302.75",
05-Nov-24,Cash,00.00,"41,883.79","2,09,418.96",
05-Nov-24,Tax,00.00,"69,806.32","1,39,612.64",
05-Nov-24,Cheque,00.00,"15,512.52","1,24,100.12",
05-Nov-24,NEFT,00.00,"15,512.52","1,08,587.60",
05-Nov-24,Commission,00.00,"10,858.76","97,728.84",
05-Nov-24,Commission,00.00,"19,545.77","78,183.07",
05-Nov-24,Transportellaneous,"4,051.76",00.00,"82,234.83",
05-Nov-24,Transportellaneous,"13,251.00",00.00,"95,485.83",
05-Nov-24,Bill,"2,06,293.00",00.00,"3,01,778.83",
05-Nov-24,Transportellaneous,36.97,00.00,"3,01,815.80",
05-Nov-24,Reversal,32.76,00.00,"3,01,848.56",
05-Nov-24,Cash,"15,78,268.00",00.00,"18,80,116.56",
05-Nov-24,Interest,150.5,00.00,"18,80,267.06",
05-Nov-24,Commission,00.00,"2,08,918.56","16,71,348.50",
05-Nov-24,RTGS,00.00,"2,78,558.08","13,92,790.42",
05-Nov-24,Transportellaneous,00.00,"13,92,790.42",00.00,
05-Nov-24,Bill,52.6,00.00,52.6,
05-Nov-24,Tax,00.00,52.6,00.00,
05-Nov-24,Purchase,"3,340.30",00.00,"3,340.30",
05-Nov-24,Debit Card,666,00.00,"4,006.30",
06-Nov-24,Reversal,00.00,"1,335.43","2,670.87",
06-Nov-24,Reversal,00.00,"1,335.44","1,335.44",
06-Nov-24,Commission,08.40,00.00,"1,343.84",
06-Nov-24,IMPS,23,00.00,"1,366.84",
06-Nov-24,Tax,104,00.00,"1,470.84",
06-Nov-24,Transportellaneous,03.00,00.00,"1,473.84",
06-Nov-24,ATM,06.99,00.00,"1,480.83",
06-Nov-24,Reversal,99.91,00.00,"1,580.74",
06-Nov-24,IMPS,"2,21,054.50",00.00,"2,22,635.24",
06-Nov-24,Purchase,117,00.00,"2,22,752.24",
06-Nov-24,Tax,"16,677.89",00.00,"2,39,430.13",
06-Nov-24,Transportellaneous,40,00.00,"2,39,470.13",
06-Nov-24,Purchase,00.00,"79,823.38","1,59,646.75",
06-Nov-24,Interest,"2,07,856.60",00.00,"3,67,503.35",
06-Nov-24,Cash,"19,679.53",00.00,"3,87,182.88",
06-Nov-24,Transportellaneous,12.5,00.00,"3,87,195.38",
07-Nov-24,IMPS,01.90,00.00,"3,87,197.28",
07-Nov-24,Bill,03.00,00.00,"3,87,200.28",
07-Nov-24,IMPS,05.50,00.00,"3,87,205.78",
07-Nov-24,Transportellaneous,25.5,00.00,"3,87,231.28",
07-Nov-24,Cheque,00.00,"77,446.26","3,09,785.02",
07-Nov-24,Purchase,"26,683.31",00.00,"3,36,468.33",
07-Nov-24,Interest,"14,268.30",00.00,"3,50,736.63",
07-Nov-24,ATM,96,00.00,"3,50,832.63",
07-Nov-24,IMPS,"18,41,792.00",00.00,"21,92,624.63",
07-Nov-24,Debit Card,00.00,"10,96,312.32","10,96,312.32",
07-Nov-24,Transportellaneous,00.00,"1,09,631.23","9,86,681.09",
07-Nov-24,Tax,00.00,"1,97,336.22","7,89,344.87",
07-Nov-24,IMPS,"10,46,962.80",00.00,"18,36,307.67",
07-Nov-24,Cheque,03.30,00.00,"18,36,310.97",
07-Nov-24,NEFT,"2,863.60",00.00,"18,39,174.57",
07-Nov-24,Purchase,"2,422.70",00.00,"18,41,597.27",
07-Nov-24,NEFT,03.90,00.00,"18,41,601.17",
07-Nov-24,IMPS,00.00,"9,20,800.59","9,20,800.58",
07-Nov-24,Debit Card,00.00,"1,15,100.07","8,05,700.51",
07-Nov-24,Tax,"2,28,850.62",00.00,"10,34,551.13",
07-Nov-24,Commission,00.00,"1,14,950.13","9,19,601.00",
07-Nov-24,ATM,00.00,"9,19,601.00",00.00,
07-Nov-24,Debit Card,74.7,00.00,74.7,
07-Nov-24,ATM,04.70,00.00,79.4,
07-Nov-24,Transportellaneous,08.00,00.00,87.4,
07-Nov-24,Transportellaneous,"94,500.00",00.00,"94,587.40",
07-Nov-24,Interest,00.00,"9,458.74","85,128.66",
07-Nov-24,Transportellaneous,"2,38,873.40",00.00,"3,24,002.06",
07-Nov-24,Debit Card,00.00,"3,24,002.06",00.00,
07-Nov-24,Debit Card,05.69,00.00,05.69,
07-Nov-24,Commission,00.00,00.71,04.98,
07-Nov-24,Interest,"2,267.90",00.00,"2,272.88",
07-Nov-24,Commission,"12,76,689.75",00.00,"12,78,962.63",
07-Nov-24,Purchase,00.00,"12,78,962.63",00.00,
07-Nov-24,Reversal,28.49,00.00,28.49,
07-Nov-24,Cash,00.00,14.25,14.24,
07-Nov-24,Cheque,00.00,01.42,12.82,
07-Nov-24,ATM,00.00,06.41,06.41,
07-Nov-24,Transportellaneous,00.00,02.14,04.27,
07-Nov-24,Commission,"4,15,436.00",00.00,"4,15,440.27",
07-Nov-24,ATM,"2,04,467.00",00.00,"6,19,907.27",
07-Nov-24,NEFT,00.00,"77,488.41","5,42,418.86",
08-Nov-24,Interest,"1,50,299.66",00.00,"6,92,718.52",
08-Nov-24,Purchase,00.00,"1,73,179.63","5,19,538.89",
09-Nov-24,Reversal,"1,53,913.00",00.00,"6,73,451.89",
09-Nov-24,ATM,34,00.00,"6,73,485.89",
09-Nov-24,RTGS,00.00,"1,34,697.18","5,38,788.71",
10-Nov-24,Cash,"1,11,496.00",00.00,"6,50,284.71",
10-Nov-24,Transfer,00.00,"2,16,761.57","4,33,523.14",
10-Nov-24,Cash,"3,64,515.50",00.00,"7,98,038.64",
10-Nov-24,Transfer,"27,062.00",00.00,"8,25,100.64",
10-Nov-24,Transportellaneous,"16,238.00",00.00,"8,41,338.64",
10-Nov-24,Transportellaneous,00.00,"2,80,446.21","5,60,892.43",
10-Nov-24,Transportellaneous,00.00,"2,80,446.22","2,80,446.22",
10-Nov-24,Tax,00.00,"56,089.24","2,24,356.98",
10-Nov-24,Commission,00.00,"22,435.70","2,01,921.28",
10-Nov-24,Debit Card,00.00,"22,435.70","1,79,485.58",
10-Nov-24,Purchase,00.00,"59,828.53","1,19,657.05",
10-Nov-24,Purchase,61.72,00.00,"1,19,718.77",
10-Nov-24,Cash,63.4,00.00,"1,19,782.17",
10-Nov-24,Commission,41,00.00,"1,19,823.17",
10-Nov-24,Bill,00.00,"14,977.90","1,04,845.27",
10-Nov-24,Transfer,"1,82,406.00",00.00,"2,87,251.27",
10-Nov-24,Cash,00.00,"47,875.21","2,39,376.06",
10-Nov-24,Transfer,00.00,"26,597.34","2,12,778.72",
10-Nov-24,Cash,01.70,00.00,"2,12,780.42",
10-Nov-24,NEFT,202,00.00,"2,12,982.42",
10-Nov-24,Cheque,00.00,"53,245.61","1,59,736.82",
10-Nov-24,RTGS,"15,328.45",00.00,"1,75,065.27",
10-Nov-24,Tax,00.00,"17,506.53","1,57,558.74",
10-Nov-24,Cheque,00.00,"17,506.53","1,40,052.21",
10-Nov-24,Transfer,273,00.00,"1,40,325.21",
10-Nov-24,Transportellaneous,"24,546.75",00.00,"1,64,871.96",
10-Nov-24,Cheque,00.00,"27,478.66","1,37,393.30",
11-Nov-24,Tax,00.00,"68,696.65","68,696.65",
11-Nov-24,IMPS,02.50,00.00,"68,699.15",
11-Nov-24,Transportellaneous,"3,424.90",00.00,"72,124.05",
11-Nov-24,Interest,00.94,00.00,"72,124.99",
11-Nov-24,Reversal,45.78,00.00,"72,170.77",
11-Nov-24,Purchase,00.00,"24,056.92","48,113.85",
11-Nov-24,Reversal,00.00,"24,056.93","24,056.92",
11-Nov-24,Commission,00.00,"24,056.92",00.00,
11-Nov-24,ATM,"16,675.00",00.00,"16,675.00",
11-Nov-24,Interest,499,00.00,"17,174.00",
11-Nov-24,Interest,00.00,"17,174.00",00.00,
11-Nov-24,Interest,225,00.00,225,
11-Nov-24,Bill,"2,050.00",00.00,"2,275.00",
11-Nov-24,NEFT,00.00,455,"1,820.00",
11-Nov-24,Tax,00.00,910,910,
11-Nov-24,Debit Card,00.00,130,780,
11-Nov-24,Interest,"1,489.13",00.00,"2,269.13",
11-Nov-24,ATM,00.00,324.16,"1,944.97",
11-Nov-24,Cash,00.00,243.12,"1,701.85",
11-Nov-24,Transportellaneous,291.5,00.00,"1,993.35",
11-Nov-24,Interest,"11,91,620.25",00.00,"11,93,613.60",
11-Nov-24,Tax,478.3,00.00,"11,94,091.90",
11-Nov-24,Tax,00.00,"1,49,261.49","10,44,830.41",
11-Nov-24,Transportellaneous,"16,852.00",00.00,"10,61,682.41",
11-Nov-24,Cash,00.00,"5,30,841.21","5,30,841.20",
11-Nov-24,Interest,00.00,"66,355.15","4,64,486.05",
11-Nov-24,Reversal,00.00,"58,060.76","4,06,425.29",
11-Nov-24,Bill,"94,492.31",00.00,"5,00,917.60",
11-Nov-24,Transportellaneous,00.00,"83,486.27","4,17,431.33",
11-Nov-24,RTGS,"3,868.00",00.00,"4,21,299.33",
11-Nov-24,Cash,00.00,"70,216.56","3,51,082.78",
11-Nov-24,ATM,"58,384.00",00.00,"4,09,466.78",
11-Nov-24,Cash,00.00,"68,244.46","3,41,222.32",
11-Nov-24,Commission,122,00.00,"3,41,344.32",
11-Nov-24,NEFT,08.00,00.00,"3,41,352.32",
11-Nov-24,RTGS,00.00,"34,135.23","3,07,217.09",
11-Nov-24,ATM,"11,404.25",00.00,"3,18,621.34",
11-Nov-24,Tax,56,00.00,"3,18,677.34",
11-Nov-24,Bill,"5,459.21",00.00,"3,24,136.55",
11-Nov-24,ATM,00.00,"64,827.31","2,59,309.24",
11-Nov-24,Cash,01.80,00.00,"2,59,311.04",
11-Nov-24,Transportellaneous,00.00,00.00,"2,59,311.04",
11-Nov-24,Transfer,"2,50,120.09",00.00,"5,09,431.13",
11-Nov-24,RTGS,00.00,"72,775.88","4,36,655.25",
11-Nov-24,Tax,01.00,00.00,"4,36,656.25",
12-Nov-24,RTGS,"1,688.95",00.00,"4,38,345.20",
12-Nov-24,ATM,"19,489.30",00.00,"4,57,834.50",
12-Nov-24,RTGS,00.00,"1,52,611.50","3,05,223.00",
12-Nov-24,ATM,"28,735.39",00.00,"3,33,958.39",
12-Nov-24,Transfer,33.89,00.00,"3,33,992.28",
12-Nov-24,Tax,00.00,"1,66,996.14","1,66,996.14",
12-Nov-24,Commission,"2,589.00",00.00,"1,69,585.14",
12-Nov-24,Commission,608.68,00.00,"1,70,193.82",
12-Nov-24,IMPS,00.00,"34,038.76","1,36,155.06",
12-Nov-24,Bill,00.00,"1,36,155.06",00.00,
12-Nov-24,Reversal,"15,79,583.50",00.00,"15,79,583.50",
12-Nov-24,Transportellaneous,33,00.00,"15,79,616.50",
13-Nov-24,Cheque,00.00,"7,89,808.25","7,89,808.25",
13-Nov-24,Debit Card,00.00,"1,57,961.65","6,31,846.60",
13-Nov-24,Commission,00.00,"6,31,846.60",00.00,
13-Nov-24,IMPS,01.44,00.00,01.44,
13-Nov-24,Transfer,"3,78,196.00",00.00,"3,78,197.44",
13-Nov-24,NEFT,455,00.00,"3,78,652.44",
13-Nov-24,Cash,04.00,00.00,"3,78,656.44",
13-Nov-24,Commission,00.00,"75,731.29","3,02,925.15",
13-Nov-24,Bill,"2,18,248.00",00.00,"5,21,173.15",
13-Nov-24,Bill,06.50,00.00,"5,21,179.65",
13-Nov-24,ATM,"2,810.00",00.00,"5,23,989.65",
13-Nov-24,ATM,00.00,"5,23,989.65",00.00,
13-Nov-24,Purchase,793.25,00.00,793.25,
13-Nov-24,Transportellaneous,00.00,79.33,713.92,
13-Nov-24,Cash,"6,799.68",00.00,"7,513.60",
13-Nov-24,Cash,00.00,"7,513.60",00.00,
13-Nov-24,Debit Card,32.1,00.00,32.1,
13-Nov-24,RTGS,43.7,00.00,75.8,
13-Nov-24,Reversal,"1,08,397.00",00.00,"1,08,472.80",
13-Nov-24,Bill,"2,45,682.00",00.00,"3,54,154.80",
13-Nov-24,Cheque,"1,55,224.00",00.00,"5,09,378.80",
13-Nov-24,Bill,00.00,"5,09,378.80",00.00,
13-Nov-24,IMPS,"17,95,713.50",00.00,"17,95,713.50",
13-Nov-24,Tax,00.00,"5,98,571.17","11,97,142.33",
13-Nov-24,Purchase,251.01,00.00,"11,97,393.34",
13-Nov-24,NEFT,"1,53,508.00",00.00,"13,50,901.34",
13-Nov-24,Transfer,00.00,"1,68,862.67","11,82,038.67",
13-Nov-24,Transportellaneous,12,00.00,"11,82,050.67",
13-Nov-24,Debit Card,00.00,"1,31,338.96","10,50,711.71",
13-Nov-24,Purchase,"1,09,038.20",00.00,"11,59,749.91",
13-Nov-24,Transfer,"2,771.80",00.00,"11,62,521.71",
13-Nov-24,Bill,"4,006.50",00.00,"11,66,528.21",
13-Nov-24,Transportellaneous,02.73,00.00,"11,66,530.94",
13-Nov-24,Transfer,00.00,"2,91,632.74","8,74,898.20",
13-Nov-24,Transfer,00.00,"1,24,985.46","7,49,912.74",
13-Nov-24,Transfer,00.00,"1,49,982.55","5,99,930.19",
13-Nov-24,Cash,00.00,"59,993.02","5,39,937.17",
13-Nov-24,IMPS,00.00,"89,989.53","4,49,947.64",
13-Nov-24,Purchase,00.00,"2,24,973.82","2,24,973.82",
13-Nov-24,RTGS,00.00,"37,495.64","1,87,478.18",
13-Nov-24,Bill,06.77,00.00,"1,87,484.95",
13-Nov-24,Interest,00.00,"1,87,484.95",00.00,
13-Nov-24,Bill,692.2,00.00,692.2,
13-Nov-24,Tax,05.00,00.00,697.2,
13-Nov-24,Transportellaneous,03.10,00.00,700.3,
13-Nov-24,Bill,00.00,350.15,350.15,
13-Nov-24,Debit Card,00.30,00.00,350.45,
13-Nov-24,Transfer,"11,056.00",00.00,"11,406.45",
13-Nov-24,NEFT,"13,145.60",00.00,"24,552.05",
13-Nov-24,Reversal,337.8,00.00,"24,889.85",
13-Nov-24,Bill,00.00,"3,555.69","21,334.16",
13-Nov-24,Debit Card,00.00,"2,370.46","18,963.70",
13-Nov-24,Reversal,46,00.00,"19,009.70",
14-Nov-24,Purchase,08.00,00.00,"19,017.70",
14-Nov-24,Cash,"58,427.19",00.00,"77,444.89",
14-Nov-24,Reversal,00.00,"25,814.96","51,629.93",
14-Nov-24,Tax,00.00,"17,209.98","34,419.95",
14-Nov-24,Cheque,"3,297.00",00.00,"37,716.95",
14-Nov-24,NEFT,05.31,00.00,"37,722.26",
14-Nov-24,Transportellaneous,00.00,"7,544.45","30,177.81",
14-Nov-24,Interest,00.00,"3,017.78","27,160.03",
14-Nov-24,ATM,"2,836.27",00.00,"29,996.30",
14-Nov-24,Cheque,00.00,"29,996.30",00.00,
14-Nov-24,ATM,15,00.00,15,
14-Nov-24,Transportellaneous,498,00.00,513,
14-Nov-24,ATM,"1,056.20",00.00,"1,569.20",
14-Nov-24,Transfer,00.00,784.6,784.6,
14-Nov-24,Tax,472.72,00.00,"1,257.32",
14-Nov-24,IMPS,00.00,628.66,628.66,
14-Nov-24,NEFT,"6,27,983.80",00.00,"6,28,612.46",
14-Nov-24,ATM,00.00,"62,861.25","5,65,751.21",
14-Nov-24,IMPS,00.00,"94,291.87","4,71,459.34",
14-Nov-24,Purchase,00.00,"4,71,459.34",00.00,
14-Nov-24,Cash,28,00.00,28,
15-Nov-24,Cash,00.00,14,14,
15-Nov-24,IMPS,"24,379.00",00.00,"24,393.00",
15-Nov-24,Purchase,"3,215.20",00.00,"27,608.20",
15-Nov-24,RTGS,00.00,"3,944.03","23,664.17",
15-Nov-24,Debit Card,"1,60,211.44",00.00,"1,83,875.61",
15-Nov-24,Commission,400.47,00.00,"1,84,276.08",
15-Nov-24,Transportellaneous,00.00,"36,855.22","1,47,420.86",
15-Nov-24,Transfer,00.00,"21,060.12","1,26,360.74",
15-Nov-24,RTGS,00.00,"1,26,360.74",00.00,
15-Nov-24,Debit Card,"9,56,094.25",00.00,"9,56,094.25",
15-Nov-24,Bill,00.00,"1,59,349.04","7,96,745.21",
15-Nov-24,Interest,347,00.00,"7,97,092.21",
15-Nov-24,Cash,00.69,00.00,"7,97,092.90",
15-Nov-24,RTGS,00.00,"1,13,870.41","6,83,222.49",
15-Nov-24,Cheque,"2,225.90",00.00,"6,85,448.39",
15-Nov-24,Interest,00.00,"1,14,241.40","5,71,206.99",
16-Nov-24,IMPS,00.00,"1,42,801.75","4,28,405.24",
16-Nov-24,RTGS,40.82,00.00,"4,28,446.06",
16-Nov-24,Transfer,00.00,"1,07,111.52","3,21,334.54",
16-Nov-24,Cash,"12,55,841.80",00.00,"15,77,176.34",
16-Nov-24,Commission,36.96,00.00,"15,77,213.30",
16-Nov-24,Cash,00.00,"15,77,213.30",00.00,
16-Nov-24,Transfer,"27,454.30",00.00,"27,454.30",
16-Nov-24,RTGS,"2,33,171.00",00.00,"2,60,625.30",
16-Nov-24,RTGS,00.00,"1,30,312.65","1,30,312.65",
16-Nov-24,Cheque,"30,360.00",00.00,"1,60,672.65",
16-Nov-24,Purchase,00.00,"40,168.16","1,20,504.49",
16-Nov-24,Transportellaneous,00.00,"13,389.39","1,07,115.10",
16-Nov-24,NEFT,289,00.00,"1,07,404.10",
16-Nov-24,Transportellaneous,00.00,"21,480.82","85,923.28",
16-Nov-24,Cheque,01.00,00.00,"85,924.28",
16-Nov-24,NEFT,06.00,00.00,"85,930.28",
16-Nov-24,RTGS,00.00,"28,643.43","57,286.85",
16-Nov-24,Transportellaneous,"6,837.75",00.00,"64,124.60",
16-Nov-24,Debit Card,07.56,00.00,"64,132.16",
16-Nov-24,Debit Card,"38,693.70",00.00,"1,02,825.86",
16-Nov-24,NEFT,398,00.00,"1,03,223.86",
16-Nov-24,Tax,09.84,00.00,"1,03,233.70",
16-Nov-24,Transportellaneous,"15,274.00",00.00,"1,18,507.70",
16-Nov-24,Bill,30,00.00,"1,18,537.70",
16-Nov-24,NEFT,"8,953.73",00.00,"1,27,491.43",
16-Nov-24,ATM,00.00,"18,213.06","1,09,278.37",
16-Nov-24,Transfer,00.00,"12,142.04","97,136.33",
16-Nov-24,Transfer,03.00,00.00,"97,139.33",
16-Nov-24,ATM,00.00,"48,569.67","48,569.66",
16-Nov-24,IMPS,00.00,"48,569.66",00.00,
16-Nov-24,RTGS,01.09,00.00,01.09,
16-Nov-24,Cheque,"12,61,927.00",00.00,"12,61,928.09",
16-Nov-24,Cheque,00.00,"1,80,275.44","10,81,652.65",
16-Nov-24,IMPS,"11,53,980.20",00.00,"22,35,632.85",
16-Nov-24,Tax,00.00,"2,23,563.29","20,12,069.57",
16-Nov-24,Commission,"18,56,186.00",00.00,"38,68,255.57",
16-Nov-24,Reversal,00.00,"38,68,255.57",00.00,
16-Nov-24,Cheque,"44,924.00",00.00,"44,924.00",
16-Nov-24,Interest,00.00,"6,417.71","38,506.29",
16-Nov-24,Purchase,00.00,"3,850.63","34,655.66",
16-Nov-24,ATM,00.00,"8,663.92","25,991.75",
17-Nov-24,Transfer,324,00.00,"26,315.75",
17-Nov-24,Commission,"98,582.00",00.00,"1,24,897.75",
17-Nov-24,Transfer,00.00,"12,489.78","1,12,407.98",
17-Nov-24,RTGS,00.00,"12,489.78","99,918.20",
17-Nov-24,ATM,"23,280.10",00.00,"1,23,198.30",
17-Nov-24,Cheque,00.00,"12,319.83","1,10,878.47",
17-Nov-24,ATM,00.00,"13,859.81","97,018.66",
17-Nov-24,RTGS,211.34,00.00,"97,230.00",
17-Nov-24,ATM,06.10,00.00,"97,236.10",
17-Nov-24,RTGS,"2,530.08",00.00,"99,766.18",
17-Nov-24,Cash,"8,49,477.80",00.00,"9,49,243.98",
17-Nov-24,Debit Card,00.00,"3,16,414.66","6,32,829.32",
17-Nov-24,IMPS,00.00,"2,10,943.11","4,21,886.21",
17-Nov-24,Cheque,"3,415.00",00.00,"4,25,301.21",
17-Nov-24,Cash,"2,762.89",00.00,"4,28,064.10",
18-Nov-24,Tax,00.00,"2,14,032.05","2,14,032.05",
18-Nov-24,Debit Card,00.00,"2,14,032.05",00.00,
18-Nov-24,Reversal,"82,116.00",00.00,"82,116.00",
18-Nov-24,Cheque,07.20,00.00,"82,123.20",
18-Nov-24,Cash,02.44,00.00,"82,125.64",
18-Nov-24,ATM,00.00,"16,425.13","65,700.51",
18-Nov-24,Tax,00.00,"8,212.56","57,487.95",
18-Nov-24,Commission,00.00,"8,212.56","49,275.39",
18-Nov-24,Cheque,00.00,"12,318.85","36,956.54",
18-Nov-24,ATM,00.00,"3,695.65","33,260.89",
18-Nov-24,Cash,00.00,"8,315.22","24,945.67",
18-Nov-24,Debit Card,19.28,00.00,"24,964.95",
18-Nov-24,ATM,"7,091.90",00.00,"32,056.85",
18-Nov-24,Transportellaneous,00.00,"8,014.21","24,042.64",
18-Nov-24,Reversal,"68,328.12",00.00,"92,370.76",
18-Nov-24,NEFT,"10,603.00",00.00,"1,02,973.76",
18-Nov-24,Transfer,00.00,"14,710.54","88,263.22",
18-Nov-24,ATM,08.00,00.00,"88,271.22",
18-Nov-24,Transportellaneous,00.00,"8,827.12","79,444.10",
18-Nov-24,NEFT,03.00,00.00,"79,447.10",
18-Nov-24,RTGS,00.00,"15,889.42","63,557.68",
18-Nov-24,Commission,00.00,"21,185.89","42,371.79",
18-Nov-24,Debit Card,00.00,"42,371.79",00.00,
18-Nov-24,Transportellaneous,"23,889.34",00.00,"23,889.34",
18-Nov-24,Debit Card,00.00,"7,963.11","15,926.23",
19-Nov-24,Transportellaneous,00.00,"7,963.12","7,963.12",
19-Nov-24,IMPS,"2,265.50",00.00,"10,228.62",
19-Nov-24,Cheque,00.00,"5,114.31","5,114.31",
19-Nov-24,Purchase,00.00,639.29,"4,475.02",
19-Nov-24,RTGS,00.00,639.29,"3,835.73",
19-Nov-24,Transfer,00.00,958.93,"2,876.80",
19-Nov-24,Debit Card,19.6,00.00,"2,896.40",
19-Nov-24,RTGS,"17,356.00",00.00,"20,252.40",
19-Nov-24,Interest,33,00.00,"20,285.40",
19-Nov-24,Reversal,"1,95,039.00",00.00,"2,15,324.40",
19-Nov-24,Tax,"2,021.40",00.00,"2,17,345.80",
19-Nov-24,Transportellaneous,81.95,00.00,"2,17,427.75",
19-Nov-24,Interest,03.00,00.00,"2,17,430.75",
19-Nov-24,Cash,"4,25,315.00",00.00,"6,42,745.75",
19-Nov-24,Tax,00.00,"1,07,124.29","5,35,621.46",
19-Nov-24,Debit Card,00.00,"5,35,621.46",00.00,
19-Nov-24,Transfer,"1,30,845.50",00.00,"1,30,845.50",
19-Nov-24,Cheque,04.00,00.00,"1,30,849.50",
19-Nov-24,NEFT,00.00,"21,808.25","1,09,041.25",
19-Nov-24,Cash,"2,13,065.90",00.00,"3,22,107.15",
19-Nov-24,Tax,00.00,"80,526.79","2,41,580.36",
19-Nov-24,NEFT,163.44,00.00,"2,41,743.80",
19-Nov-24,NEFT,00.00,"34,534.83","2,07,208.97",
19-Nov-24,Purchase,00.00,"25,901.12","1,81,307.85",
19-Nov-24,Cash,"24,015.30",00.00,"2,05,323.15",
20-Nov-24,Bill,"19,40,068.00",00.00,"21,45,391.15",
20-Nov-24,Cash,"2,43,246.00",00.00,"23,88,637.15",
20-Nov-24,Cheque,00.00,"7,96,212.38","15,92,424.77",
20-Nov-24,Purchase,00.00,"1,99,053.10","13,93,371.67",
20-Nov-24,Debit Card,00.00,"2,78,674.33","11,14,697.34",
20-Nov-24,Debit Card,00.00,"1,59,242.48","9,55,454.86",
20-Nov-24,IMPS,"11,97,600.50",00.00,"21,53,055.36",
20-Nov-24,Reversal,00.00,"10,76,527.68","10,76,527.68",
20-Nov-24,RTGS,00.00,"1,79,421.28","8,97,106.40",
20-Nov-24,Reversal,00.00,"4,48,553.20","4,48,553.20",
20-Nov-24,ATM,00.00,"2,24,276.60","2,24,276.60",
20-Nov-24,Transfer,00.00,"56,069.15","1,68,207.45",
20-Nov-24,Bill,00.00,"24,029.64","1,44,177.81",
20-Nov-24,Tax,"28,731.60",00.00,"1,72,909.41",
21-Nov-24,Cash,"3,374.81",00.00,"1,76,284.22",
21-Nov-24,Tax,06.00,00.00,"1,76,290.22",
21-Nov-24,Reversal,00.00,"19,587.80","1,56,702.42",
21-Nov-24,Bill,"1,297.00",00.00,"1,57,999.42",
21-Nov-24,Cash,32.8,00.00,"1,58,032.22",
21-Nov-24,Commission,00.00,"22,576.03","1,35,456.19",
21-Nov-24,Cash,"5,804.92",00.00,"1,41,261.11",
21-Nov-24,Cash,00.00,"14,126.11","1,27,135.00",
21-Nov-24,Transfer,00.00,"18,162.14","1,08,972.86",
21-Nov-24,NEFT,18,00.00,"1,08,990.86",
21-Nov-24,IMPS,"2,52,809.00",00.00,"3,61,799.86",
21-Nov-24,Reversal,"1,37,152.22",00.00,"4,98,952.08",
21-Nov-24,IMPS,"1,55,636.90",00.00,"6,54,588.98",
21-Nov-24,Cheque,00.00,"72,732.11","5,81,856.87",
21-Nov-24,Tax,00.00,"83,122.41","4,98,734.46",
21-Nov-24,Cash,"2,671.00",00.00,"5,01,405.46",
21-Nov-24,Purchase,00.00,"1,67,135.15","3,34,270.31",
21-Nov-24,IMPS,"1,64,109.30",00.00,"4,98,379.61",
21-Nov-24,Purchase,00.00,"49,837.96","4,48,541.65",
21-Nov-24,NEFT,00.00,"1,49,513.88","2,99,027.77",
21-Nov-24,Cheque,00.00,"33,225.31","2,65,802.46",
21-Nov-24,Cheque,37.05,00.00,"2,65,839.51",
21-Nov-24,Commission,00.00,"33,229.94","2,32,609.57",
21-Nov-24,Bill,05.00,00.00,"2,32,614.57",
21-Nov-24,Tax,00.00,"2,32,614.57",00.00,
21-Nov-24,Interest,"13,023.00",00.00,"13,023.00",
21-Nov-24,Purchase,13.57,00.00,"13,036.57",
21-Nov-24,RTGS,00.00,"4,345.52","8,691.05",
21-Nov-24,Transfer,02.40,00.00,"8,693.45",
21-Nov-24,RTGS,00.00,869.35,"7,824.10",
21-Nov-24,RTGS,"12,06,749.00",00.00,"12,14,573.10",
21-Nov-24,Purchase,00.00,"2,02,428.85","10,12,144.25",
21-Nov-24,NEFT,00.00,"2,53,036.06","7,59,108.19",
21-Nov-24,Commission,"1,992.86",00.00,"7,61,101.05",
21-Nov-24,Purchase,00.00,"1,52,220.21","6,08,880.84",
21-Nov-24,Purchase,21,00.00,"6,08,901.84",
21-Nov-24,Purchase,07.10,00.00,"6,08,908.94",
21-Nov-24,Cheque,00.00,"6,08,908.94",00.00,
21-Nov-24,Cash,"14,596.30",00.00,"14,596.30",
21-Nov-24,Commission,"13,19,366.80",00.00,"13,33,963.10",
21-Nov-24,Purchase,00.00,"1,48,218.12","11,85,744.98",
21-Nov-24,Reversal,00.00,"3,95,248.33","7,90,496.65",
21-Nov-24,Transportellaneous,300.94,00.00,"7,90,797.59",
21-Nov-24,Interest,00.00,"87,866.40","7,02,931.19",
21-Nov-24,Bill,"10,132.00",00.00,"7,13,063.19",
21-Nov-24,Reversal,"1,71,336.00",00.00,"8,84,399.19",
21-Nov-24,Interest,00.00,"98,266.58","7,86,132.61",
21-Nov-24,IMPS,"39,841.59",00.00,"8,25,974.20",
21-Nov-24,Reversal,"43,455.30",00.00,"8,69,429.50",
21-Nov-24,Interest,212.31,00.00,"8,69,641.81",
21-Nov-24,Bill,"2,03,138.00",00.00,"10,72,779.81",
21-Nov-24,Purchase,00.00,"5,36,389.91","5,36,389.90",
21-Nov-24,ATM,00.90,00.00,"5,36,390.80",
21-Nov-24,NEFT,"27,465.58",00.00,"5,63,856.38",
21-Nov-24,Transportellaneous,"14,13,887.00",00.00,"19,77,743.38",
21-Nov-24,Debit Card,00.00,"9,88,871.69","9,88,871.69",
21-Nov-24,Transportellaneous,"1,55,354.00",00.00,"11,44,225.69",
21-Nov-24,IMPS,"2,03,725.00",00.00,"13,47,950.69",
21-Nov-24,Cash,00.00,"2,69,590.14","10,78,360.55",
21-Nov-24,Interest,00.00,"1,07,836.06","9,70,524.50",
21-Nov-24,Purchase,"5,28,044.00",00.00,"14,98,568.50",
21-Nov-24,Commission,01.00,00.00,"14,98,569.50",
21-Nov-24,Cash,"3,558.85",00.00,"15,02,128.35",
21-Nov-24,Tax,04.09,00.00,"15,02,132.44",
21-Nov-24,Interest,"14,393.00",00.00,"15,16,525.44",
21-Nov-24,Interest,32,00.00,"15,16,557.44",
21-Nov-24,Bill,00.00,"5,05,519.15","10,11,038.29",
21-Nov-24,IMPS,00.00,"3,37,012.76","6,74,025.53",
21-Nov-24,NEFT,45,00.00,"6,74,070.53",
21-Nov-24,NEFT,00.00,"1,68,517.63","5,05,552.90",
21-Nov-24,ATM,"24,827.70",00.00,"5,30,380.60",
21-Nov-24,Bill,02.81,00.00,"5,30,383.41",
21-Nov-24,IMPS,"6,52,284.50",00.00,"11,82,667.91",
21-Nov-24,Bill,"32,195.00",00.00,"12,14,862.91",
21-Nov-24,Interest,00.00,"12,14,862.91",00.00,
21-Nov-24,Bill,135.5,00.00,135.5,
21-Nov-24,Cheque,"1,85,930.90",00.00,"1,86,066.40",
21-Nov-24,Commission,271,00.00,"1,86,337.40",
21-Nov-24,IMPS,00.00,"20,704.16","1,65,633.24",
21-Nov-24,Commission,00.00,"18,403.69","1,47,229.55",
21-Nov-24,ATM,04.10,00.00,"1,47,233.65",
21-Nov-24,RTGS,00.00,"16,359.29","1,30,874.36",
21-Nov-24,Cash,00.00,"65,437.18","65,437.18",
21-Nov-24,Transfer,00.00,"16,359.30","49,077.88",
21-Nov-24,Debit Card,378.1,00.00,"49,455.98",
21-Nov-24,Interest,00.00,"5,495.11","43,960.87",
22-Nov-24,Debit Card,00.00,"43,960.87",00.00,
22-Nov-24,Cash,364,00.00,364,
22-Nov-24,Transportellaneous,00.00,40.44,323.56,
22-Nov-24,IMPS,00.00,32.36,291.2,
22-Nov-24,Interest,00.00,29.12,262.08,
22-Nov-24,IMPS,135.98,00.00,398.06,
22-Nov-24,Bill,00.00,66.34,331.72,
22-Nov-24,Bill,"2,21,460.00",00.00,"2,21,791.72",
22-Nov-24,NEFT,"1,100.80",00.00,"2,22,892.52",
22-Nov-24,Commission,"47,270.00",00.00,"2,70,162.52",
22-Nov-24,Purchase,07.06,00.00,"2,70,169.58",
22-Nov-24,Cash,00.00,"45,028.26","2,25,141.32",
22-Nov-24,Reversal,00.00,"22,514.13","2,02,627.19",
22-Nov-24,Tax,00.00,"20,262.72","1,82,364.47",
22-Nov-24,Debit Card,00.40,00.00,"1,82,364.87",
23-Nov-24,ATM,"9,663.14",00.00,"1,92,028.01",
23-Nov-24,Purchase,00.00,"21,336.45","1,70,691.56",
23-Nov-24,Bill,00.00,"18,965.73","1,51,725.83",
23-Nov-24,ATM,00.00,"15,172.58","1,36,553.25",
23-Nov-24,Cheque,00.00,"15,172.58","1,21,380.67",
23-Nov-24,IMPS,126.8,00.00,"1,21,507.47",
23-Nov-24,ATM,00.00,"20,251.25","1,01,256.22",
23-Nov-24,RTGS,00.00,"16,876.04","84,380.18",
23-Nov-24,Tax,13.1,00.00,"84,393.28",
23-Nov-24,Cheque,00.00,"21,098.32","63,294.96",
23-Nov-24,Tax,00.00,"10,549.16","52,745.80",
24-Nov-24,NEFT,"15,51,018.50",00.00,"16,03,764.30",
24-Nov-24,Debit Card,"22,232.80",00.00,"16,25,997.10",
24-Nov-24,Commission,00.00,"1,62,599.71","14,63,397.39",
24-Nov-24,Cash,00.00,"2,09,056.77","12,54,340.62",
24-Nov-24,Tax,00.00,"2,50,868.12","10,03,472.50",
24-Nov-24,IMPS,"2,19,570.70",00.00,"12,23,043.20",
24-Nov-24,NEFT,"1,50,486.00",00.00,"13,73,529.20",
24-Nov-24,ATM,00.00,"3,43,382.30","10,30,146.90",
24-Nov-24,Cash,00.00,"2,06,029.38","8,24,117.52",
24-Nov-24,Purchase,"16,47,512.00",00.00,"24,71,629.52",
24-Nov-24,IMPS,00.00,"4,94,325.90","19,77,303.62",
24-Nov-24,Cheque,00.00,"2,19,700.40","17,57,603.22",
24-Nov-24,Transfer,00.00,"2,51,086.17","15,06,517.05",
24-Nov-24,Interest,"1,84,455.40",00.00,"16,90,972.45",
24-Nov-24,Tax,269,00.00,"16,91,241.45",
24-Nov-24,Bill,41.31,00.00,"16,91,282.76",
24-Nov-24,Purchase,"15,691.00",00.00,"17,06,973.76",
24-Nov-24,IMPS,00.00,"4,26,743.44","12,80,230.32",
24-Nov-24,Cheque,"1,05,062.00",00.00,"13,85,292.32",
24-Nov-24,NEFT,00.00,"13,85,292.32",00.00,
24-Nov-24,Cheque,456,00.00,456,
24-Nov-24,Tax,00.00,76,380,
24-Nov-24,Debit Card,00.00,63.33,316.67,
24-Nov-24,Cash,00.00,31.67,285,
24-Nov-24,Reversal,00.00,71.25,213.75,
24-Nov-24,Debit Card,00.00,26.72,187.03,
24-Nov-24,Bill,00.00,23.38,163.65,
24-Nov-24,NEFT,00.00,27.28,136.38,
24-Nov-24,Purchase,"2,306.50",00.00,"2,442.88",
24-Nov-24,NEFT,00.00,488.58,"1,954.30",
25-Nov-24,Commission,"2,745.27",00.00,"4,699.57",
25-Nov-24,Bill,00.00,469.96,"4,229.61",
25-Nov-24,Reversal,"19,79,650.00",00.00,"19,83,879.61",
25-Nov-24,Bill,"1,71,353.00",00.00,"21,55,232.61",
25-Nov-24,Purchase,"3,025.30",00.00,"21,58,257.91",
25-Nov-24,RTGS,06.00,00.00,"21,58,263.91",
25-Nov-24,Bill,00.00,"10,79,131.96","10,79,131.96",
26-Nov-24,Commission,05.00,00.00,"10,79,136.96",
26-Nov-24,Cheque,"57,479.00",00.00,"11,36,615.96",
26-Nov-24,NEFT,"4,041.55",00.00,"11,40,657.51",
26-Nov-24,Cheque,00.00,"2,85,164.38","8,55,493.13",
26-Nov-24,Tax,00.00,"85,549.31","7,69,943.82",
26-Nov-24,Transportellaneous,00.00,"1,09,991.97","6,59,951.85",
26-Nov-24,Tax,00.00,"1,64,987.96","4,94,963.89",
26-Nov-24,RTGS,00.00,"1,64,987.96","3,29,975.93",
26-Nov-24,Reversal,"1,28,250.00",00.00,"4,58,225.93",
26-Nov-24,Cash,00.00,"1,14,556.48","3,43,669.45",
26-Nov-24,Reversal,00.00,"1,14,556.48","2,29,112.97",
27-Nov-24,RTGS,501,00.00,"2,29,613.97",
28-Nov-24,RTGS,00.00,"32,802.00","1,96,811.97",
28-Nov-24,Transfer,00.00,"65,603.99","1,31,207.98",
28-Nov-24,Transfer,00.00,"32,802.00","98,405.99",
28-Nov-24,Tax,"20,50,889.50",00.00,"21,49,295.49",
28-Nov-24,IMPS,00.00,"2,14,929.55","19,34,365.94",
28-Nov-24,Commission,00.00,"3,86,873.19","15,47,492.75",
28-Nov-24,Transportellaneous,00.00,"5,15,830.92","10,31,661.83",
29-Nov-24,ATM,00.00,"2,57,915.46","7,73,746.37",
29-Nov-24,Purchase,"88,591.53",00.00,"8,62,337.90",
29-Nov-24,ATM,29.3,00.00,"8,62,367.20",
29-Nov-24,Purchase,00.00,"95,818.58","7,66,548.62",
29-Nov-24,Transfer,"2,117.19",00.00,"7,68,665.81",
29-Nov-24,ATM,00.00,"76,866.58","6,91,799.23",
29-Nov-24,NEFT,"16,37,929.00",00.00,"23,29,728.23",
29-Nov-24,Cash,07.10,00.00,"23,29,735.33",
29-Nov-24,Tax,00.00,"4,65,947.07","18,63,788.26",
29-Nov-24,Purchase,268.5,00.00,"18,64,056.76",
29-Nov-24,NEFT,00.00,"4,66,014.19","13,98,042.57",
29-Nov-24,Transportellaneous,00.00,"3,49,510.64","10,48,531.93",
29-Nov-24,Bill,00.00,"2,62,132.98","7,86,398.95",
29-Nov-24,Commission,50.8,00.00,"7,86,449.75",
29-Nov-24,ATM,00.00,"3,93,224.88","3,93,224.88",
29-Nov-24,Cash,15.5,00.00,"3,93,240.38",
29-Nov-24,Tax,"7,392.80",00.00,"4,00,633.18",
29-Nov-24,RTGS,00.00,"2,00,316.59","2,00,316.59",
29-Nov-24,NEFT,00.00,"40,063.32","1,60,253.27",
29-Nov-24,Transportellaneous,00.00,"22,893.32","1,37,359.95",
29-Nov-24,Tax,834,00.00,"1,38,193.95",
29-Nov-24,Commission,00.00,"13,819.40","1,24,374.56",
29-Nov-24,NEFT,310.82,00.00,"1,24,685.38",
29-Nov-24,IMPS,00.00,"17,812.20","1,06,873.18",
29-Nov-24,Transportellaneous,"34,545.00",00.00,"1,41,418.18",
29-Nov-24,RTGS,00.00,"47,139.39","94,278.79",
29-Nov-24,IMPS,00.00,"23,569.70","70,709.09",
29-Nov-24,RTGS,00.00,"11,784.85","58,924.24",
29-Nov-24,Interest,00.00,"58,924.24",00.00,
29-Nov-24,Transportellaneous,01.60,00.00,01.60,
29-Nov-24,ATM,"1,827.15",00.00,"1,828.75",
29-Nov-24,Commission,00.00,261.25,"1,567.50",
29-Nov-24,Commission,00.00,195.94,"1,371.56",
29-Nov-24,Transfer,03.00,00.00,"1,374.56",
29-Nov-24,Transportellaneous,"42,326.00",00.00,"43,700.56",
30-Nov-24,Reversal,02.40,00.00,"43,702.96",
30-Nov-24,Tax,"3,25,559.50",00.00,"3,69,262.46",
30-Nov-24,IMPS,"1,43,110.91",00.00,"5,12,373.37",
30-Nov-24,ATM,"6,872.00",00.00,"5,19,245.37",
30-Nov-24,Interest,00.00,"5,19,245.37",00.00,
30-Nov-24,Purchase,480.11,00.00,480.11,
30-Nov-24,Commission,"84,986.25",00.00,"85,466.36",
30-Nov-24,Reversal,00.00,"14,244.39","71,221.97",
01-Dec-24,Bill,"7,80,055.75",00.00,"8,51,277.72",
01-Dec-24,RTGS,"20,19,149.50",00.00,"28,70,427.22",
01-Dec-24,ATM,"5,37,181.25",00.00,"34,07,608.47",
01-Dec-24,Purchase,44.22,00.00,"34,07,652.69",
01-Dec-24,NEFT,00.00,"3,40,765.27","30,66,887.42",
01-Dec-24,Transportellaneous,00.00,"3,83,360.93","26,83,526.49",
01-Dec-24,Interest,00.00,"13,41,763.25","13,41,763.25",
01-Dec-24,Cheque,00.00,"2,68,352.65","10,73,410.60",
01-Dec-24,RTGS,00.00,"2,14,682.12","8,58,728.48",
01-Dec-24,Cash,110,00.00,"8,58,838.48",
01-Dec-24,NEFT,00.00,"95,426.50","7,63,411.98",
01-Dec-24,Transportellaneous,00.00,"76,341.20","6,87,070.78",
01-Dec-24,Interest,00.00,"98,152.97","5,88,917.81",
01-Dec-24,Reversal,00.00,"84,131.12","5,04,786.69",
01-Dec-24,Cheque,00.00,"50,478.67","4,54,308.02",
01-Dec-24,Commission,"13,015.00",00.00,"4,67,323.02",
01-Dec-24,RTGS,00.00,"93,464.60","3,73,858.42",
01-Dec-24,Cheque,"2,34,303.00",00.00,"6,08,161.42",
01-Dec-24,NEFT,00.00,"6,08,161.42",00.00,
01-Dec-24,Debit Card,"7,473.00",00.00,"7,473.00",
01-Dec-24,Commission,"15,81,655.00",00.00,"15,89,128.00",
01-Dec-24,RTGS,00.00,"5,29,709.33","10,59,418.67",
01-Dec-24,NEFT,00.00,"1,51,345.52","9,08,073.15",
01-Dec-24,Purchase,00.00,"3,02,691.05","6,05,382.10",
01-Dec-24,Reversal,"1,68,117.00",00.00,"7,73,499.10",
01-Dec-24,NEFT,934.53,00.00,"7,74,433.63",
01-Dec-24,IMPS,"2,43,706.00",00.00,"10,18,139.63",
01-Dec-24,IMPS,00.00,"5,09,069.82","5,09,069.82",
01-Dec-24,Cash,00.00,"5,09,069.82",00.00,
01-Dec-24,ATM,14.53,00.00,14.53,
01-Dec-24,Transfer,"3,900.30",00.00,"3,914.83",
01-Dec-24,Transfer,00.00,"1,957.42","1,957.42",
01-Dec-24,ATM,00.00,391.48,"1,565.94",
01-Dec-24,Transportellaneous,"22,906.60",00.00,"24,472.54",
01-Dec-24,Interest,00.00,"3,059.07","21,413.47",
01-Dec-24,Commission,00.00,"4,282.69","17,130.78",
01-Dec-24,Bill,47,00.00,"17,177.78",
01-Dec-24,Tax,"27,428.00",00.00,"44,605.78",
01-Dec-24,ATM,"16,74,744.25",00.00,"17,19,350.03",
01-Dec-24,Debit Card,00.00,"2,86,558.34","14,32,791.69",
02-Dec-24,ATM,"16,324.84",00.00,"14,49,116.53",
02-Dec-24,RTGS,02.37,00.00,"14,49,118.90",
02-Dec-24,Cheque,"3,713.30",00.00,"14,52,832.20",
02-Dec-24,ATM,00.00,"7,26,416.10","7,26,416.10",
02-Dec-24,Reversal,00.00,"72,641.61","6,53,774.49",
02-Dec-24,Reversal,25,00.00,"6,53,799.49",
02-Dec-24,Cheque,00.00,"2,17,933.16","4,35,866.33",
02-Dec-24,NEFT,66.4,00.00,"4,35,932.73",
02-Dec-24,Commission,00.00,"48,436.97","3,87,495.76",
02-Dec-24,Cash,910.7,00.00,"3,88,406.46",
02-Dec-24,Debit Card,18.47,00.00,"3,88,424.93",
02-Dec-24,Cash,00.00,"64,737.49","3,23,687.44",
02-Dec-24,Interest,00.00,"64,737.49","2,58,949.95",
02-Dec-24,Transfer,00.00,"43,158.33","2,15,791.62",
02-Dec-24,Debit Card,"3,340.00",00.00,"2,19,131.62",
02-Dec-24,Commission,00.00,"24,347.96","1,94,783.66",
02-Dec-24,Cash,00.00,"27,826.24","1,66,957.42",
02-Dec-24,RTGS,04.00,00.00,"1,66,961.42",
02-Dec-24,Transfer,"18,14,375.25",00.00,"19,81,336.67",
02-Dec-24,Cash,00.00,"6,60,445.56","13,20,891.11",
02-Dec-24,ATM,58.37,00.00,"13,20,949.48",
02-Dec-24,IMPS,00.00,"13,20,949.48",00.00,
03-Dec-24,Transfer,308.66,00.00,308.66,
03-Dec-24,RTGS,"15,58,012.00",00.00,"15,58,320.66",
03-Dec-24,RTGS,00.00,"5,19,440.22","10,38,880.44",
03-Dec-24,Commission,00.00,"2,59,720.11","7,79,160.33",
03-Dec-24,Cheque,07.00,00.00,"7,79,167.33",
03-Dec-24,Interest,"63,463.00",00.00,"8,42,630.33",
03-Dec-24,NEFT,"9,92,122.80",00.00,"18,34,753.13",
03-Dec-24,Tax,00.00,"18,34,753.13",00.00,
03-Dec-24,Bill,48.6,00.00,48.6,
03-Dec-24,NEFT,23,00.00,71.6,
03-Dec-24,Interest,"11,73,070.00",00.00,"11,73,141.60",
03-Dec-24,Bill,00.00,"2,34,628.32","9,38,513.28",
03-Dec-24,Reversal,58,00.00,"9,38,571.28",
03-Dec-24,Commission,"18,94,557.00",00.00,"28,33,128.28",
03-Dec-24,RTGS,00.00,"5,66,625.66","22,66,502.62",
03-Dec-24,Commission,45.28,00.00,"22,66,547.90",
03-Dec-24,ATM,00.00,"7,55,515.97","15,11,031.93",
03-Dec-24,Cash,00.00,"3,77,757.98","11,33,273.95",
03-Dec-24,ATM,196,00.00,"11,33,469.95",
03-Dec-24,RTGS,00.00,"1,41,683.74","9,91,786.21",
03-Dec-24,Debit Card,00.00,"1,41,683.74","8,50,102.47",
03-Dec-24,Bill,00.00,"4,25,051.24","4,25,051.24",
03-Dec-24,IMPS,00.00,"85,010.25","3,40,040.99",
03-Dec-24,Cheque,03.30,00.00,"3,40,044.29",
03-Dec-24,NEFT,"15,18,300.25",00.00,"18,58,344.54",
03-Dec-24,Cash,"2,178.93",00.00,"18,60,523.47",
03-Dec-24,ATM,61,00.00,"18,60,584.47",
03-Dec-24,Debit Card,00.00,"2,65,797.78","15,94,786.69",
03-Dec-24,Debit Card,00.00,"7,97,393.35","7,97,393.34",
03-Dec-24,NEFT,"1,00,785.00",00.00,"8,98,178.34",
03-Dec-24,Commission,"6,583.20",00.00,"9,04,761.54",
03-Dec-24,Interest,00.00,"4,52,380.77","4,52,380.77",
03-Dec-24,RTGS,00.00,"45,238.08","4,07,142.69",
03-Dec-24,Transportellaneous,"47,706.50",00.00,"4,54,849.19",
03-Dec-24,Debit Card,00.00,"56,856.15","3,97,993.04",
03-Dec-24,Interest,00.00,"66,332.17","3,31,660.87",
03-Dec-24,Transfer,05.00,00.00,"3,31,665.87",
03-Dec-24,Transfer,00.00,"82,916.47","2,48,749.40",
03-Dec-24,Transportellaneous,"18,29,778.80",00.00,"20,78,528.20",
04-Dec-24,Purchase,00.00,"5,19,632.05","15,58,896.15",
04-Dec-24,Interest,"2,10,533.00",00.00,"17,69,429.15",
04-Dec-24,Cheque,00.00,"2,52,775.59","15,16,653.56",
04-Dec-24,Reversal,"1,537.70",00.00,"15,18,191.26",
04-Dec-24,RTGS,06.95,00.00,"15,18,198.21",
04-Dec-24,Cash,00.00,"2,53,033.04","12,65,165.18",
04-Dec-24,Purchase,00.00,"12,65,165.18",00.00,
04-Dec-24,NEFT,"1,98,523.10",00.00,"1,98,523.10",
04-Dec-24,Cash,"9,092.00",00.00,"2,07,615.10",
04-Dec-24,NEFT,00.00,"51,903.78","1,55,711.33",
04-Dec-24,Transportellaneous,356,00.00,"1,56,067.33",
04-Dec-24,Cash,00.00,"17,340.81","1,38,726.52",
05-Dec-24,Transfer,00.00,"34,681.63","1,04,044.89",
05-Dec-24,ATM,07.00,00.00,"1,04,051.89",
05-Dec-24,Tax,00.00,"11,561.32","92,490.57",
05-Dec-24,NEFT,"1,12,596.00",00.00,"2,05,086.57",
05-Dec-24,RTGS,329.42,00.00,"2,05,415.99",
05-Dec-24,Purchase,00.00,"2,05,415.99",00.00,
05-Dec-24,Debit Card,74,00.00,74,
05-Dec-24,Transportellaneous,"1,744.00",00.00,"1,818.00",
05-Dec-24,Transfer,00.00,303,"1,515.00",
05-Dec-24,IMPS,"12,826.40",00.00,"14,341.40",
05-Dec-24,Purchase,"7,829.52",00.00,"22,170.92",
05-Dec-24,Transportellaneous,45.66,00.00,"22,216.58",
05-Dec-24,Debit Card,00.00,"7,405.53","14,811.05",
05-Dec-24,ATM,"1,46,891.28",00.00,"1,61,702.33",
05-Dec-24,NEFT,00.00,"80,851.17","80,851.16",
05-Dec-24,Transfer,00.00,"16,170.23","64,680.93",
05-Dec-24,Purchase,00.00,"32,340.47","32,340.46",
05-Dec-24,NEFT,00.00,"6,468.09","25,872.37",
05-Dec-24,RTGS,00.00,00.00,"25,872.37",
05-Dec-24,Cash,43.7,00.00,"25,916.07",
05-Dec-24,Debit Card,"1,015.00",00.00,"26,931.07",
05-Dec-24,NEFT,00.00,"3,847.30","23,083.77",
05-Dec-24,Cash,"1,099.00",00.00,"24,182.77",
05-Dec-24,Cash,356.53,00.00,"24,539.30",
05-Dec-24,Transportellaneous,"2,25,112.44",00.00,"2,49,651.74",
05-Dec-24,Purchase,00.00,"35,664.53","2,13,987.21",
05-Dec-24,Cheque,19.19,00.00,"2,14,006.40",
05-Dec-24,Transfer,00.00,"30,572.34","1,83,434.06",
05-Dec-24,IMPS,60.62,00.00,"1,83,494.68",
05-Dec-24,Reversal,00.00,"30,582.45","1,52,912.23",
05-Dec-24,Interest,"59,672.00",00.00,"2,12,584.23",
05-Dec-24,Debit Card,04.38,00.00,"2,12,588.61",
05-Dec-24,Interest,00.00,"30,369.80","1,82,218.81",
05-Dec-24,Transportellaneous,00.00,"26,031.26","1,56,187.55",
05-Dec-24,ATM,00.00,"52,062.52","1,04,125.03",
05-Dec-24,Cash,00.00,"34,708.34","69,416.69",
05-Dec-24,Transportellaneous,00.00,"6,941.67","62,475.02",
06-Dec-24,Purchase,05.30,00.00,"62,480.32",
06-Dec-24,Interest,00.00,"15,620.08","46,860.24",
06-Dec-24,Cash,00.00,"5,857.53","41,002.71",
06-Dec-24,Interest,"18,15,152.00",00.00,"18,56,154.71",
06-Dec-24,Purchase,"1,26,406.00",00.00,"19,82,560.71",
06-Dec-24,Transfer,00.00,"3,30,426.79","16,52,133.92",
06-Dec-24,RTGS,"4,18,300.75",00.00,"20,70,434.67",
06-Dec-24,IMPS,00.00,"10,35,217.34","10,35,217.34",
06-Dec-24,Transportellaneous,284,00.00,"10,35,501.34",
06-Dec-24,Debit Card,00.00,"1,72,583.56","8,62,917.78",
06-Dec-24,Commission,00.00,"2,87,639.26","5,75,278.52",
06-Dec-24,Transportellaneous,55.3,00.00,"5,75,333.82",
06-Dec-24,Tax,00.00,"1,15,066.76","4,60,267.06",
06-Dec-24,Commission,00.00,"46,026.71","4,14,240.35",
06-Dec-24,IMPS,"2,682.00",00.00,"4,16,922.35",
06-Dec-24,ATM,00.00,"59,560.34","3,57,362.01",
06-Dec-24,Transfer,"36,619.00",00.00,"3,93,981.01",
06-Dec-24,Transportellaneous,00.00,"43,775.67","3,50,205.34",
06-Dec-24,Cheque,00.00,"1,16,735.11","2,33,470.23",
06-Dec-24,Tax,214.3,00.00,"2,33,684.53",
06-Dec-24,Transportellaneous,"30,723.93",00.00,"2,64,408.46",
06-Dec-24,ATM,"1,670.00",00.00,"2,66,078.46",
06-Dec-24,RTGS,00.00,"26,607.85","2,39,470.61",
06-Dec-24,RTGS,00.00,"29,933.83","2,09,536.78",
06-Dec-24,Transportellaneous,00.00,"34,922.80","1,74,613.98",
06-Dec-24,Cash,04.00,00.00,"1,74,617.98",
06-Dec-24,ATM,06.00,00.00,"1,74,623.98",
06-Dec-24,RTGS,00.00,"29,104.00","1,45,519.98",
06-Dec-24,Debit Card,00.00,"16,168.89","1,29,351.09",
06-Dec-24,Cheque,00.00,"43,117.03","86,234.06",
06-Dec-24,Cash,36,00.00,"86,270.06",
06-Dec-24,NEFT,00.00,"43,135.03","43,135.03",
07-Dec-24,Debit Card,00.00,"21,567.52","21,567.52",
07-Dec-24,Transportellaneous,17,00.00,"21,584.52",
07-Dec-24,Cash,"16,04,385.75",00.00,"16,25,970.27",
07-Dec-24,Debit Card,00.00,"4,06,492.57","12,19,477.70",
07-Dec-24,IMPS,00.00,"6,09,738.85","6,09,738.85",
08-Dec-24,RTGS,"4,660.27",00.00,"6,14,399.12",
08-Dec-24,Cheque,209.5,00.00,"6,14,608.62",
08-Dec-24,Transfer,00.00,"1,02,434.77","5,12,173.85",
08-Dec-24,Cash,00.00,"73,167.69","4,39,006.16",
08-Dec-24,IMPS,00.00,"43,900.62","3,95,105.54",
08-Dec-24,NEFT,00.00,"39,510.55","3,55,594.99",
08-Dec-24,Tax,00.00,"71,119.00","2,84,475.99",
08-Dec-24,Transportellaneous,217.96,00.00,"2,84,693.95",
08-Dec-24,Commission,00.00,"35,586.74","2,49,107.21",
08-Dec-24,Bill,00.00,"41,517.87","2,07,589.34",
08-Dec-24,RTGS,00.00,"69,196.45","1,38,392.89",
08-Dec-24,Tax,"2,44,446.00",00.00,"3,82,838.89",
08-Dec-24,Purchase,00.00,"1,27,612.96","2,55,225.93",
08-Dec-24,Bill,"3,493.30",00.00,"2,58,719.23",
08-Dec-24,RTGS,"1,40,974.40",00.00,"3,99,693.63",
08-Dec-24,Cash,"2,87,891.00",00.00,"6,87,584.63",
08-Dec-24,Tax,00.00,"3,43,792.32","3,43,792.32",
08-Dec-24,Cash,17.27,00.00,"3,43,809.59",
08-Dec-24,Cash,00.00,"68,761.92","2,75,047.67",
08-Dec-24,Cheque,00.41,00.00,"2,75,048.08",
08-Dec-24,Interest,34.9,00.00,"2,75,082.98",
08-Dec-24,NEFT,00.00,"45,847.16","2,29,235.82",
08-Dec-24,Transportellaneous,00.00,"38,205.97","1,91,029.85",
09-Dec-24,Bill,"36,343.00",00.00,"2,27,372.85",
09-Dec-24,Transportellaneous,00.00,"37,895.48","1,89,477.38",
09-Dec-24,Cheque,00.00,"94,738.69","94,738.69",
09-Dec-24,Debit Card,"2,33,721.00",00.00,"3,28,459.69",
09-Dec-24,Cheque,04.00,00.00,"3,28,463.69",
09-Dec-24,Purchase,"16,96,062.00",00.00,"20,24,525.69",
09-Dec-24,Tax,00.00,"10,12,262.85","10,12,262.84",
09-Dec-24,Transfer,405.3,00.00,"10,12,668.14",
09-Dec-24,Bill,04.40,00.00,"10,12,672.54",
09-Dec-24,Tax,00.00,"1,44,667.51","8,68,005.03",
09-Dec-24,Purchase,00.00,"8,68,005.03",00.00,
09-Dec-24,Transfer,157.6,00.00,157.6,
09-Dec-24,Cash,"15,26,818.25",00.00,"15,26,975.85",
09-Dec-24,Purchase,00.00,"7,63,487.93","7,63,487.92",
09-Dec-24,ATM,00.94,00.00,"7,63,488.86",
09-Dec-24,Bill,"1,78,263.00",00.00,"9,41,751.86",
09-Dec-24,Interest,97,00.00,"9,41,848.86",
09-Dec-24,ATM,00.00,"3,13,949.62","6,27,899.24",
09-Dec-24,Reversal,00.00,"6,27,899.24",00.00,
09-Dec-24,Tax,07.00,00.00,07.00,
09-Dec-24,Cheque,00.00,00.78,06.22,
09-Dec-24,Commission,00.00,03.11,03.11,
09-Dec-24,Interest,96.49,00.00,99.6,
09-Dec-24,Transfer,00.00,09.96,89.64,
09-Dec-24,Bill,"28,715.20",00.00,"28,804.84",
09-Dec-24,NEFT,12.34,00.00,"28,817.18",
09-Dec-24,Purchase,"1,23,527.10",00.00,"1,52,344.28",
09-Dec-24,Cheque,00.00,"16,927.14","1,35,417.14",
09-Dec-24,Debit Card,06.52,00.00,"1,35,423.66",
09-Dec-24,Purchase,00.00,"45,141.22","90,282.44",
09-Dec-24,Debit Card,00.00,"30,094.15","60,188.29",
09-Dec-24,Transportellaneous,"1,65,676.00",00.00,"2,25,864.29",
09-Dec-24,Transfer,00.00,"56,466.07","1,69,398.22",
09-Dec-24,Bill,00.00,"16,939.82","1,52,458.40",
09-Dec-24,Debit Card,00.00,"16,939.82","1,35,518.58",
09-Dec-24,IMPS,00.00,"13,551.86","1,21,966.72",
09-Dec-24,Cheque,"2,86,676.20",00.00,"4,08,642.92",
09-Dec-24,NEFT,03.78,00.00,"4,08,646.70",
10-Dec-24,Reversal,"2,554.66",00.00,"4,11,201.36",
10-Dec-24,Transfer,00.00,"41,120.14","3,70,081.22",
10-Dec-24,Transfer,00.00,"3,70,081.22",00.00,
10-Dec-24,NEFT,497.3,00.00,497.3,
10-Dec-24,Purchase,00.00,49.73,447.57,
10-Dec-24,Transportellaneous,00.00,447.57,00.00,
10-Dec-24,Tax,"1,672.40",00.00,"1,672.40",
10-Dec-24,Bill,21.5,00.00,"1,693.90",
10-Dec-24,NEFT,326,00.00,"2,019.90",
10-Dec-24,NEFT,00.00,673.3,"1,346.60",
10-Dec-24,Transportellaneous,00.00,224.43,"1,122.17",
10-Dec-24,Commission,"26,974.88",00.00,"28,097.05",
10-Dec-24,Reversal,00.00,"28,097.05",00.00,
10-Dec-24,Purchase,77,00.00,77,
11-Dec-24,Reversal,264.76,00.00,341.76,
11-Dec-24,Tax,01.97,00.00,343.73,
11-Dec-24,ATM,00.00,343.73,00.00,
11-Dec-24,Debit Card,29.13,00.00,29.13,
11-Dec-24,Cash,162.24,00.00,191.37,
11-Dec-24,Tax,00.00,47.84,143.53,
11-Dec-24,Bill,"1,111.16",00.00,"1,254.69",
11-Dec-24,Cheque,05.00,00.00,"1,259.69",
11-Dec-24,Commission,38,00.00,"1,297.69",
11-Dec-24,Purchase,"3,534.23",00.00,"4,831.92",
11-Dec-24,Bill,06.00,00.00,"4,837.92",
11-Dec-24,Cheque,04.00,00.00,"4,841.92",
11-Dec-24,Debit Card,321.46,00.00,"5,163.38",
11-Dec-24,Interest,00.00,"5,163.38",00.00,
11-Dec-24,NEFT,"1,137.54",00.00,"1,137.54",
11-Dec-24,Bill,00.00,568.77,568.77,
11-Dec-24,Transportellaneous,"1,417.69",00.00,"1,986.46",
11-Dec-24,Reversal,00.00,248.31,"1,738.15",
11-Dec-24,Commission,"4,087.21",00.00,"5,825.36",
11-Dec-24,Reversal,00.00,"1,165.07","4,660.29",
11-Dec-24,IMPS,00.00,517.81,"4,142.48",
11-Dec-24,Debit Card,"24,018.40",00.00,"28,160.88",
12-Dec-24,Reversal,"28,841.00",00.00,"57,001.88",
12-Dec-24,Tax,00.00,"9,500.31","47,501.57",
12-Dec-24,Transportellaneous,00.00,"9,500.31","38,001.26",
12-Dec-24,ATM,74,00.00,"38,075.26",
12-Dec-24,NEFT,00.00,"12,691.75","25,383.51",
12-Dec-24,Bill,00.00,"2,538.35","22,845.16",
12-Dec-24,ATM,"3,816.00",00.00,"26,661.16",
12-Dec-24,NEFT,84.3,00.00,"26,745.46",
12-Dec-24,RTGS,"3,20,546.80",00.00,"3,47,292.26",
12-Dec-24,Reversal,00.00,"34,729.23","3,12,563.03",
12-Dec-24,Reversal,00.00,"34,729.23","2,77,833.80",
12-Dec-24,Tax,00.00,"69,458.45","2,08,375.35",
12-Dec-24,Commission,07.95,00.00,"2,08,383.30",
12-Dec-24,Purchase,"24,677.90",00.00,"2,33,061.20",
12-Dec-24,Cash,51,00.00,"2,33,112.20",
12-Dec-24,Tax,25.8,00.00,"2,33,138.00",
12-Dec-24,Cash,00.00,"46,627.60","1,86,510.40",
12-Dec-24,ATM,00.00,"31,085.07","1,55,425.33",
12-Dec-24,Commission,"3,24,254.00",00.00,"4,79,679.33",
12-Dec-24,RTGS,806.7,00.00,"4,80,486.03",
13-Dec-24,IMPS,"1,70,607.50",00.00,"6,51,093.53",
13-Dec-24,NEFT,"15,62,642.00",00.00,"22,13,735.53",
13-Dec-24,Interest,00.00,"7,37,911.84","14,75,823.69",
13-Dec-24,ATM,"15,58,715.00",00.00,"30,34,538.69",
13-Dec-24,Cash,"5,36,366.80",00.00,"35,70,905.49",
13-Dec-24,Interest,00.00,"11,90,301.83","23,80,603.66",
13-Dec-24,NEFT,07.00,00.00,"23,80,610.66",
13-Dec-24,Cheque,00.00,"4,76,122.13","19,04,488.53",
13-Dec-24,NEFT,00.12,00.00,"19,04,488.65",
13-Dec-24,RTGS,779,00.00,"19,05,267.65",
13-Dec-24,NEFT,00.00,"6,35,089.22","12,70,178.43",
13-Dec-24,Transfer,00.00,"1,58,772.30","11,11,406.13",
13-Dec-24,NEFT,00.00,"2,22,281.23","8,89,124.90",
13-Dec-24,Transportellaneous,"1,58,756.30",00.00,"10,47,881.20",
13-Dec-24,Transportellaneous,06.00,00.00,"10,47,887.20",
13-Dec-24,Debit Card,00.00,"2,61,971.80","7,85,915.40",
13-Dec-24,Transportellaneous,"1,64,288.97",00.00,"9,50,204.37",
14-Dec-24,IMPS,00.00,"1,58,367.40","7,91,836.98",
14-Dec-24,IMPS,00.00,"7,91,836.98",00.00,
14-Dec-24,Cash,74,00.00,74,
14-Dec-24,NEFT,00.00,37,37,
14-Dec-24,RTGS,00.00,04.11,32.89,
14-Dec-24,Commission,00.00,06.58,26.31,
14-Dec-24,Interest,159.39,00.00,185.7,
14-Dec-24,NEFT,00.00,61.9,123.8,
14-Dec-24,Transfer,"1,60,090.40",00.00,"1,60,214.20",
14-Dec-24,Purchase,00.00,"53,404.73","1,06,809.47",
14-Dec-24,Transfer,00.00,"1,06,809.47",00.00,
14-Dec-24,Tax,342,00.00,342,
14-Dec-24,ATM,28,00.00,370,
14-Dec-24,Transfer,00.00,123.33,246.67,
14-Dec-24,Cheque,00.00,24.67,222,
14-Dec-24,Debit Card,00.00,27.75,194.25,
14-Dec-24,Debit Card,"6,23,465.50",00.00,"6,23,659.75",
14-Dec-24,Bill,30.4,00.00,"6,23,690.15",
14-Dec-24,Tax,00.00,"77,961.27","5,45,728.88",
14-Dec-24,Debit Card,"10,90,375.00",00.00,"16,36,103.88",
14-Dec-24,Cash,00.00,"1,81,789.32","14,54,314.56",
14-Dec-24,Transfer,00.00,"2,90,862.91","11,63,451.65",
14-Dec-24,Bill,"9,458.47",00.00,"11,72,910.12",
14-Dec-24,Transportellaneous,"1,580.00",00.00,"11,74,490.12",
14-Dec-24,RTGS,55,00.00,"11,74,545.12",
14-Dec-24,Tax,00.00,"1,30,505.01","10,44,040.11",
14-Dec-24,Purchase,"22,961.14",00.00,"10,67,001.25",
14-Dec-24,Purchase,00.00,"1,77,833.54","8,89,167.71",
14-Dec-24,Cash,"19,46,490.50",00.00,"28,35,658.21",
14-Dec-24,RTGS,"3,367.30",00.00,"28,39,025.51",
14-Dec-24,Debit Card,00.00,"5,67,805.10","22,71,220.41",
14-Dec-24,Cheque,38.3,00.00,"22,71,258.71",
14-Dec-24,Debit Card,397.01,00.00,"22,71,655.72",
14-Dec-24,Cheque,00.00,"3,24,522.25","19,47,133.47",
14-Dec-24,Transportellaneous,00.00,"2,43,391.68","17,03,741.79",
14-Dec-24,Cheque,"2,27,722.00",00.00,"19,31,463.79",
14-Dec-24,Transportellaneous,00.00,"2,14,607.09","17,16,856.70",
14-Dec-24,RTGS,00.00,"8,58,428.35","8,58,428.35",
14-Dec-24,Purchase,00.00,"1,07,303.54","7,51,124.81",
14-Dec-24,IMPS,00.00,"7,51,124.81",00.00,
14-Dec-24,NEFT,"3,186.08",00.00,"3,186.08",
14-Dec-24,Cash,"9,402.20",00.00,"12,588.28",
14-Dec-24,Cash,00.00,"12,588.28",00.00,
14-Dec-24,Debit Card,"16,00,664.80",00.00,"16,00,664.80",
14-Dec-24,Reversal,"30,414.60",00.00,"16,31,079.40",
14-Dec-24,Cheque,00.00,"2,71,846.57","13,59,232.83",
14-Dec-24,Debit Card,00.00,"1,35,923.28","12,23,309.55",
14-Dec-24,Interest,00.00,"1,52,913.69","10,70,395.86",
14-Dec-24,Purchase,06.77,00.00,"10,70,402.63",
14-Dec-24,Cash,38.1,00.00,"10,70,440.73",
14-Dec-24,Transportellaneous,00.00,"1,33,805.09","9,36,635.64",
14-Dec-24,NEFT,00.00,"1,04,070.63","8,32,565.01",
14-Dec-24,Cash,00.00,"1,04,070.63","7,28,494.38",
14-Dec-24,Interest,00.00,"1,21,415.73","6,07,078.65",
14-Dec-24,IMPS,00.00,00.00,"6,07,078.65",
14-Dec-24,Bill,07.20,00.00,"6,07,085.85",
14-Dec-24,Tax,867.92,00.00,"6,07,953.77",
14-Dec-24,ATM,"18,573.40",00.00,"6,26,527.17",
15-Dec-24,Purchase,"8,53,025.00",00.00,"14,79,552.17",
15-Dec-24,Cash,00.00,"1,64,394.69","13,15,157.48",
15-Dec-24,Transportellaneous,00.00,"4,38,385.83","8,76,771.65",
15-Dec-24,NEFT,00.00,"1,46,128.61","7,30,643.04",
15-Dec-24,Transportellaneous,00.00,"7,30,643.04",00.00,
15-Dec-24,IMPS,07.09,00.00,07.09,
15-Dec-24,Interest,"11,614.00",00.00,"11,621.09",
15-Dec-24,Debit Card,00.00,"2,324.22","9,296.87",
15-Dec-24,Bill,00.00,"1,032.99","8,263.88",
16-Dec-24,Interest,"31,729.70",00.00,"39,993.58",
16-Dec-24,Debit Card,00.00,"6,665.60","33,327.98",
16-Dec-24,Purchase,349,00.00,"33,676.98",
16-Dec-24,Reversal,00.00,"6,735.40","26,941.58",
16-Dec-24,Commission,"9,21,917.80",00.00,"9,48,859.38",
16-Dec-24,Cheque,150.05,00.00,"9,49,009.43",
16-Dec-24,Commission,00.00,"1,18,626.18","8,30,383.25",
16-Dec-24,Tax,"3,00,813.00",00.00,"11,31,196.25",
16-Dec-24,Purchase,"15,002.76",00.00,"11,46,199.01",
16-Dec-24,Transportellaneous,00.00,"1,27,355.45","10,18,843.56",
16-Dec-24,Interest,00.00,"1,01,884.36","9,16,959.20",
16-Dec-24,IMPS,461,00.00,"9,17,420.20",
16-Dec-24,Transportellaneous,"2,084.40",00.00,"9,19,504.60",
16-Dec-24,Debit Card,00.00,"4,59,752.30","4,59,752.30",
16-Dec-24,Transportellaneous,"10,789.00",00.00,"4,70,541.30",
16-Dec-24,Interest,00.00,"78,423.55","3,92,117.75",
16-Dec-24,Purchase,"29,709.86",00.00,"4,21,827.61",
16-Dec-24,RTGS,"2,20,218.56",00.00,"6,42,046.17",
16-Dec-24,IMPS,06.00,00.00,"6,42,052.17",
16-Dec-24,Transportellaneous,23,00.00,"6,42,075.17",
16-Dec-24,Transfer,"76,889.00",00.00,"7,18,964.17",
16-Dec-24,Commission,00.00,"71,896.42","6,47,067.75",
16-Dec-24,Tax,00.00,"6,47,067.75",00.00,
16-Dec-24,Interest,"2,434.00",00.00,"2,434.00",
16-Dec-24,Bill,71,00.00,"2,505.00",
16-Dec-24,ATM,26,00.00,"2,531.00",
16-Dec-24,Cheque,00.00,316.38,"2,214.62",
16-Dec-24,NEFT,"31,405.00",00.00,"33,619.62",
16-Dec-24,Purchase,"63,466.00",00.00,"97,085.62",
16-Dec-24,Transfer,227,00.00,"97,312.62",
16-Dec-24,IMPS,"5,99,829.20",00.00,"6,97,141.82",
17-Dec-24,ATM,"26,502.00",00.00,"7,23,643.82",
17-Dec-24,Commission,00.00,"2,41,214.61","4,82,429.21",
17-Dec-24,Commission,"1,66,304.00",00.00,"6,48,733.21",
17-Dec-24,Commission,51.6,00.00,"6,48,784.81",
17-Dec-24,Cash,08.00,00.00,"6,48,792.81",
17-Dec-24,IMPS,00.44,00.00,"6,48,793.25",
17-Dec-24,Debit Card,"10,715.44",00.00,"6,59,508.69",
17-Dec-24,RTGS,31,00.00,"6,59,539.69",
17-Dec-24,Purchase,"3,372.00",00.00,"6,62,911.69",
17-Dec-24,Tax,256.5,00.00,"6,63,168.19",
17-Dec-24,Debit Card,"28,641.00",00.00,"6,91,809.19",
17-Dec-24,Commission,00.00,"6,91,809.19",00.00,
17-Dec-24,Purchase,"1,40,310.00",00.00,"1,40,310.00",
17-Dec-24,Cash,00.00,"20,044.29","1,20,265.71",
17-Dec-24,Interest,00.00,"12,026.57","1,08,239.14",
17-Dec-24,Transportellaneous,218.93,00.00,"1,08,458.07",
18-Dec-24,Commission,00.00,"12,050.90","96,407.17",
18-Dec-24,Interest,"1,38,738.00",00.00,"2,35,145.17",
18-Dec-24,Cash,00.00,"29,393.15","2,05,752.02",
18-Dec-24,RTGS,"2,48,045.00",00.00,"4,53,797.02",
18-Dec-24,Debit Card,00.00,"4,53,797.02",00.00,
18-Dec-24,Transportellaneous,20.3,00.00,20.3,
18-Dec-24,Purchase,00.00,02.03,18.27,
18-Dec-24,Commission,65.7,00.00,83.97,
18-Dec-24,Transportellaneous,00.00,83.97,00.00,
18-Dec-24,Reversal,"2,88,981.00",00.00,"2,88,981.00",
18-Dec-24,Transfer,"2,154.00",00.00,"2,91,135.00",
18-Dec-24,Bill,00.00,"2,91,135.00",00.00,
18-Dec-24,Transportellaneous,62.4,00.00,62.4,
18-Dec-24,RTGS,27,00.00,89.4,
18-Dec-24,Bill,"20,600.00",00.00,"20,689.40",
18-Dec-24,IMPS,00.00,"2,298.82","18,390.58",
18-Dec-24,Cash,00.00,"6,130.19","12,260.39",
18-Dec-24,ATM,00.00,"2,452.08","9,808.31",
18-Dec-24,Tax,"4,008.70",00.00,"13,817.01",
18-Dec-24,Transfer,00.00,"4,605.67","9,211.34",
18-Dec-24,Transportellaneous,"1,55,698.25",00.00,"1,64,909.59",
18-Dec-24,Commission,00.00,"23,558.51","1,41,351.08",
18-Dec-24,NEFT,00.00,"20,193.01","1,21,158.07",
18-Dec-24,ATM,401,00.00,"1,21,559.07",
18-Dec-24,Interest,05.00,00.00,"1,21,564.07",
18-Dec-24,NEFT,00.00,"17,366.30","1,04,197.77",
18-Dec-24,ATM,00.00,"11,577.53","92,620.24",
18-Dec-24,Transfer,"3,014.80",00.00,"95,635.04",
18-Dec-24,IMPS,"13,00,872.00",00.00,"13,96,507.04",
18-Dec-24,Reversal,00.00,"13,96,507.04",00.00,
18-Dec-24,Cheque,"32,003.15",00.00,"32,003.15",
18-Dec-24,ATM,"13,42,585.25",00.00,"13,74,588.40",
19-Dec-24,Reversal,00.00,"2,29,098.07","11,45,490.33",
19-Dec-24,Purchase,"1,793.80",00.00,"11,47,284.13",
19-Dec-24,Reversal,885.26,00.00,"11,48,169.39",
19-Dec-24,Transportellaneous,"17,84,316.20",00.00,"29,32,485.59",
19-Dec-24,Tax,"31,839.97",00.00,"29,64,325.56",
19-Dec-24,Cheque,46.1,00.00,"29,64,371.66",
19-Dec-24,Interest,56,00.00,"29,64,427.66",
19-Dec-24,IMPS,00.00,"5,92,885.53","23,71,542.13",
19-Dec-24,Reversal,00.00,"4,74,308.43","18,97,233.70",
19-Dec-24,Transportellaneous,00.00,"2,71,033.39","16,26,200.31",
19-Dec-24,Cheque,00.00,00.00,"16,26,200.31",
19-Dec-24,Bill,01.95,00.00,"16,26,202.26",
19-Dec-24,Tax,07.00,00.00,"16,26,209.26",
20-Dec-24,Interest,00.00,"8,13,104.63","8,13,104.63",
20-Dec-24,IMPS,"17,27,862.00",00.00,"25,40,966.63",
20-Dec-24,Transfer,00.00,"2,82,329.63","22,58,637.00",
20-Dec-24,Cheque,"2,719.00",00.00,"22,61,356.00",
20-Dec-24,Tax,00.00,"7,53,785.33","15,07,570.67",
20-Dec-24,RTGS,00.00,"5,02,523.56","10,05,047.11",
20-Dec-24,Transportellaneous,00.00,"1,11,671.90","8,93,375.21",
20-Dec-24,ATM,05.00,00.00,"8,93,380.21",
21-Dec-24,Commission,"1,02,534.00",00.00,"9,95,914.21",
21-Dec-24,ATM,35,00.00,"9,95,949.21",
21-Dec-24,Interest,"1,01,789.00",00.00,"10,97,738.21",
22-Dec-24,Cheque,00.00,"1,82,956.37","9,14,781.84",
22-Dec-24,Cheque,00.00,"1,30,683.12","7,84,098.72",
22-Dec-24,Transportellaneous,"9,08,550.50",00.00,"16,92,649.22",
22-Dec-24,Cheque,"2,719.09",00.00,"16,95,368.31",
22-Dec-24,Tax,00.00,"1,69,536.83","15,25,831.48",
22-Dec-24,ATM,00.00,"3,81,457.87","11,44,373.61",
22-Dec-24,Reversal,00.00,"11,44,373.61",00.00,
22-Dec-24,Cash,45.9,00.00,45.9,
22-Dec-24,Interest,118.24,00.00,164.14,
22-Dec-24,Interest,"12,543.00",00.00,"12,707.14",
22-Dec-24,Tax,00.00,"12,707.14",00.00,
22-Dec-24,RTGS,13.7,00.00,13.7,
22-Dec-24,Cash,00.00,01.71,11.99,
22-Dec-24,ATM,130,00.00,141.99,
22-Dec-24,Cheque,00.00,28.4,113.59,
22-Dec-24,Transfer,"29,382.86",00.00,"29,496.45",
22-Dec-24,ATM,00.00,"4,916.08","24,580.38",
22-Dec-24,Bill,02.45,00.00,"24,582.83",
22-Dec-24,Debit Card,08.00,00.00,"24,590.83",
22-Dec-24,Transportellaneous,00.00,"24,590.83",00.00,
22-Dec-24,ATM,15,00.00,15,
22-Dec-24,NEFT,00.00,05.00,10,
22-Dec-24,Transportellaneous,25.04,00.00,35.04,
22-Dec-24,Transportellaneous,12.1,00.00,47.14,
22-Dec-24,Reversal,"1,341.00",00.00,"1,388.14",
22-Dec-24,Reversal,00.00,277.63,"1,110.51",
22-Dec-24,Transportellaneous,00.00,277.63,832.88,
22-Dec-24,NEFT,11,00.00,843.88,
22-Dec-24,Transfer,00.00,93.76,750.12,
22-Dec-24,ATM,00.00,75.01,675.11,
22-Dec-24,Tax,04.10,00.00,679.21,
22-Dec-24,Commission,00.00,339.61,339.6,
22-Dec-24,ATM,00.00,48.51,291.09,
22-Dec-24,Commission,00.00,97.03,194.06,
22-Dec-24,Cheque,00.00,38.81,155.25,
22-Dec-24,Interest,"2,507.39",00.00,"2,662.64",
22-Dec-24,Debit Card,577.6,00.00,"3,240.24",
22-Dec-24,Cheque,"11,348.60",00.00,"14,588.84",
22-Dec-24,Reversal,"3,271.70",00.00,"17,860.54",
22-Dec-24,IMPS,03.27,00.00,"17,863.81",
22-Dec-24,Debit Card,00.00,"2,232.98","15,630.83",
22-Dec-24,Cheque,00.00,"7,815.42","7,815.42",
22-Dec-24,Bill,61.2,00.00,"7,876.62",
22-Dec-24,Reversal,401.4,00.00,"8,278.02",
22-Dec-24,Transportellaneous,"36,533.75",00.00,"44,811.77",
22-Dec-24,Cheque,00.00,"6,401.68","38,410.09",
22-Dec-24,IMPS,00.00,"7,682.02","30,728.07",
22-Dec-24,Bill,00.00,"15,364.04","15,364.04",
22-Dec-24,Commission,"3,32,633.00",00.00,"3,47,997.04",
22-Dec-24,Bill,499.7,00.00,"3,48,496.74",
22-Dec-24,Transfer,"2,900.77",00.00,"3,51,397.51",
22-Dec-24,ATM,00.00,"87,849.38","2,63,548.13",
22-Dec-24,NEFT,00.00,"26,354.81","2,37,193.32",
22-Dec-24,Tax,00.00,"59,298.33","1,77,894.99",
22-Dec-24,Debit Card,00.00,"1,77,894.99",00.00,
22-Dec-24,Transfer,"15,349.83",00.00,"15,349.83",
23-Dec-24,Purchase,"15,53,295.00",00.00,"15,68,644.83",
23-Dec-24,Purchase,00.00,"1,74,293.87","13,94,350.96",
23-Dec-24,Transportellaneous,"3,303.00",00.00,"13,97,653.96",
23-Dec-24,Commission,00.00,"6,98,826.98","6,98,826.98",
24-Dec-24,Cheque,00.00,"6,98,826.98",00.00,
24-Dec-24,Interest,32.17,00.00,32.17,
24-Dec-24,RTGS,00.00,10.72,21.45,
24-Dec-24,Debit Card,00.00,02.15,19.3,
24-Dec-24,Transportellaneous,"10,59,397.00",00.00,"10,59,416.30",
24-Dec-24,NEFT,00.00,"5,29,708.15","5,29,708.15",
24-Dec-24,NEFT,00.00,"75,672.59","4,54,035.56",
24-Dec-24,Reversal,00.00,"1,13,508.89","3,40,526.67",
24-Dec-24,RTGS,314,00.00,"3,40,840.67",
24-Dec-24,ATM,00.00,"42,605.08","2,98,235.59",
24-Dec-24,Transportellaneous,00.00,"2,98,235.59",00.00,
24-Dec-24,Interest,04.00,00.00,04.00,
24-Dec-24,Commission,"24,413.90",00.00,"24,417.90",
24-Dec-24,IMPS,"99,837.80",00.00,"1,24,255.70",
24-Dec-24,NEFT,45.5,00.00,"1,24,301.20",
25-Dec-24,Interest,00.00,"31,075.30","93,225.90",
25-Dec-24,Debit Card,476,00.00,"93,701.90",
25-Dec-24,Cash,00.00,"11,712.74","81,989.16",
25-Dec-24,NEFT,"14,82,728.00",00.00,"15,64,717.16",
25-Dec-24,Reversal,00.00,"1,73,857.46","13,90,859.70",
25-Dec-24,IMPS,14,00.00,"13,90,873.70",
25-Dec-24,Interest,00.00,"3,47,718.43","10,43,155.27",
25-Dec-24,IMPS,63,00.00,"10,43,218.27",
25-Dec-24,NEFT,00.00,"1,30,402.28","9,12,815.99",
25-Dec-24,Tax,"2,07,471.50",00.00,"11,20,287.49",
25-Dec-24,Commission,00.00,"3,73,429.16","7,46,858.33",
25-Dec-24,Tax,41,00.00,"7,46,899.33",
25-Dec-24,Transportellaneous,00.00,"1,49,379.87","5,97,519.46",
25-Dec-24,Reversal,"19,116.88",00.00,"6,16,636.34",
25-Dec-24,Purchase,00.00,"3,08,318.17","3,08,318.17",
25-Dec-24,Cheque,04.00,00.00,"3,08,322.17",
25-Dec-24,NEFT,"8,82,192.20",00.00,"11,90,514.37",
25-Dec-24,Cheque,326.5,00.00,"11,90,840.87",
25-Dec-24,Debit Card,103.5,00.00,"11,90,944.37",
25-Dec-24,NEFT,00.00,"1,70,134.91","10,20,809.46",
25-Dec-24,RTGS,"3,359.85",00.00,"10,24,169.31",
25-Dec-24,Transfer,08.00,00.00,"10,24,177.31",
25-Dec-24,Debit Card,"4,12,481.00",00.00,"14,36,658.31",
25-Dec-24,Cash,05.38,00.00,"14,36,663.69",
25-Dec-24,Cheque,"2,336.00",00.00,"14,38,999.69",
25-Dec-24,Bill,03.70,00.00,"14,39,003.39",
25-Dec-24,Cash,00.00,"2,87,800.68","11,51,202.71",
25-Dec-24,Tax,00.00,"1,64,457.53","9,86,745.18",
25-Dec-24,IMPS,05.10,00.00,"9,86,750.28",
25-Dec-24,Purchase,00.00,"9,86,750.28",00.00,
25-Dec-24,NEFT,59.78,00.00,59.78,
25-Dec-24,Bill,"15,228.56",00.00,"15,288.34",
25-Dec-24,Transfer,"18,001.00",00.00,"33,289.34",
25-Dec-24,Tax,00.00,"3,698.82","29,590.52",
25-Dec-24,Transfer,68,00.00,"29,658.52",
25-Dec-24,Tax,00.00,"3,295.39","26,363.13",
25-Dec-24,Purchase,00.00,"2,636.31","23,726.82",
25-Dec-24,Bill,00.00,"2,636.31","21,090.51",
25-Dec-24,Tax,00.00,"7,030.17","14,060.34",
25-Dec-24,Transportellaneous,00.00,"2,343.39","11,716.95",
25-Dec-24,Commission,00.00,"1,171.70","10,545.26",
25-Dec-24,Debit Card,"1,13,674.50",00.00,"1,24,219.76",
25-Dec-24,NEFT,00.00,"15,527.47","1,08,692.29",
25-Dec-24,NEFT,00.00,"12,076.92","96,615.37",
25-Dec-24,RTGS,"32,610.60",00.00,"1,29,225.97",
25-Dec-24,Bill,"2,429.00",00.00,"1,31,654.97",
25-Dec-24,Purchase,00.00,"65,827.49","65,827.48",
25-Dec-24,Debit Card,00.00,"32,913.74","32,913.74",
25-Dec-24,RTGS,406,00.00,"33,319.74",
25-Dec-24,Reversal,00.00,"4,759.96","28,559.78",
25-Dec-24,Debit Card,00.00,"28,559.78",00.00,
25-Dec-24,Reversal,"5,44,492.00",00.00,"5,44,492.00",
25-Dec-24,Tax,20.3,00.00,"5,44,512.30",
25-Dec-24,Debit Card,"2,21,503.00",00.00,"7,66,015.30",
25-Dec-24,NEFT,00.00,"7,66,015.30",00.00,
25-Dec-24,ATM,"12,826.00",00.00,"12,826.00",
25-Dec-24,Debit Card,"1,68,078.25",00.00,"1,80,904.25",
25-Dec-24,Debit Card,00.00,"1,80,904.25",00.00,
25-Dec-24,RTGS,"2,60,685.00",00.00,"2,60,685.00",
25-Dec-24,Reversal,00.00,"1,30,342.50","1,30,342.50",
25-Dec-24,Transportellaneous,"1,74,862.16",00.00,"3,05,204.66",
25-Dec-24,Transfer,"9,12,171.00",00.00,"12,17,375.66",
25-Dec-24,Purchase,00.00,"2,02,895.94","10,14,479.72",
25-Dec-24,ATM,00.00,"1,26,809.97","8,87,669.76",
25-Dec-24,IMPS,00.00,"2,95,889.92","5,91,779.84",
25-Dec-24,Cash,05.00,00.00,"5,91,784.84",
25-Dec-24,Bill,00.00,"84,540.69","5,07,244.15",
25-Dec-24,ATM,"1,78,771.00",00.00,"6,86,015.15",
25-Dec-24,Cash,00.40,00.00,"6,86,015.55",
25-Dec-24,IMPS,198.2,00.00,"6,86,213.75",
25-Dec-24,Debit Card,00.00,"1,71,553.44","5,14,660.31",
25-Dec-24,Purchase,"27,666.31",00.00,"5,42,326.62",
25-Dec-24,Tax,"19,31,226.25",00.00,"24,73,552.87",
25-Dec-24,Cash,"13,65,292.00",00.00,"38,38,844.87",
25-Dec-24,Transfer,00.00,"5,48,406.41","32,90,438.46",
25-Dec-24,Commission,"99,909.70",00.00,"33,90,348.16",
26-Dec-24,IMPS,00.00,"4,23,793.52","29,66,554.64",
26-Dec-24,Purchase,00.00,"5,93,310.93","23,73,243.71",
26-Dec-24,IMPS,00.00,"3,95,540.62","19,77,703.09",
26-Dec-24,Transportellaneous,00.00,"3,29,617.18","16,48,085.91",
26-Dec-24,Cheque,"20,91,840.25",00.00,"37,39,926.16",
26-Dec-24,Debit Card,00.00,"9,34,981.54","28,04,944.62",
27-Dec-24,RTGS,04.00,00.00,"28,04,948.62",
27-Dec-24,Transfer,00.00,"2,80,494.86","25,24,453.76",
27-Dec-24,IMPS,00.00,"8,41,484.59","16,82,969.17",
27-Dec-24,Debit Card,00.00,"2,10,371.15","14,72,598.02",
27-Dec-24,Cash,00.00,"2,45,433.00","12,27,165.02",
27-Dec-24,IMPS,00.00,"2,04,527.50","10,22,637.52",
27-Dec-24,Reversal,00.00,"1,46,091.07","8,76,546.45",
27-Dec-24,Commission,00.00,"1,46,091.08","7,30,455.38",
27-Dec-24,Transfer,00.00,"2,43,485.13","4,86,970.25",
27-Dec-24,IMPS,00.00,"97,394.05","3,89,576.20",
27-Dec-24,NEFT,"6,61,001.20",00.00,"10,50,577.40",
27-Dec-24,Transfer,00.00,"1,75,096.23","8,75,481.17",
27-Dec-24,Transfer,00.00,"97,275.69","7,78,205.48",
27-Dec-24,Reversal,00.00,"1,29,700.91","6,48,504.57",
27-Dec-24,Cash,00.00,"3,24,252.29","3,24,252.28",
27-Dec-24,Transportellaneous,00.00,"1,62,126.14","1,62,126.14",
27-Dec-24,Reversal,00.00,"81,063.07","81,063.07",
27-Dec-24,Tax,"2,48,062.00",00.00,"3,29,125.07",
27-Dec-24,Debit Card,00.00,"32,912.51","2,96,212.56",
27-Dec-24,IMPS,27,00.00,"2,96,239.56",
27-Dec-24,Transfer,"1,601.70",00.00,"2,97,841.26",
27-Dec-24,Transportellaneous,"1,889.50",00.00,"2,99,730.76",
27-Dec-24,RTGS,124.3,00.00,"2,99,855.06",
27-Dec-24,ATM,"4,06,020.00",00.00,"7,05,875.06",
27-Dec-24,Bill,"1,34,914.00",00.00,"8,40,789.06",
27-Dec-24,Transportellaneous,00.00,"8,40,789.06",00.00,
27-Dec-24,NEFT,"10,04,501.20",00.00,"10,04,501.20",
27-Dec-24,IMPS,00.00,"10,04,501.20",00.00,
27-Dec-24,Bill,"2,43,011.00",00.00,"2,43,011.00",
27-Dec-24,ATM,"1,13,144.06",00.00,"3,56,155.06",
27-Dec-24,Transportellaneous,00.00,"44,519.38","3,11,635.68",
27-Dec-24,Tax,104,00.00,"3,11,739.68",
27-Dec-24,Transportellaneous,00.00,"1,55,869.84","1,55,869.84",
27-Dec-24,RTGS,00.00,"31,173.97","1,24,695.87",
27-Dec-24,IMPS,22,00.00,"1,24,717.87",
27-Dec-24,Interest,00.00,"17,816.84","1,06,901.03",
27-Dec-24,Debit Card,00.00,"26,725.26","80,175.77",
27-Dec-24,Tax,00.00,"10,021.97","70,153.80",
27-Dec-24,Transfer,00.00,"7,015.38","63,138.42",
27-Dec-24,RTGS,00.00,"7,015.38","56,123.04",
27-Dec-24,Reversal,"20,37,916.00",00.00,"20,94,039.04",
27-Dec-24,Commission,00.00,"10,47,019.52","10,47,019.52",
27-Dec-24,Cheque,167.7,00.00,"10,47,187.22",
27-Dec-24,IMPS,00.00,"2,61,796.81","7,85,390.42",
27-Dec-24,IMPS,"2,12,490.00",00.00,"9,97,880.42",
27-Dec-24,Cash,586.5,00.00,"9,98,466.92",
27-Dec-24,Debit Card,00.00,"9,98,466.92",00.00,
27-Dec-24,Debit Card,"3,965.90",00.00,"3,965.90",
27-Dec-24,Interest,01.00,00.00,"3,966.90",
27-Dec-24,Interest,00.00,991.73,"2,975.18",
27-Dec-24,Purchase,00.00,595.04,"2,380.14",
27-Dec-24,ATM,00.00,340.02,"2,040.12",
27-Dec-24,Transportellaneous,01.00,00.00,"2,041.12",
27-Dec-24,Commission,22.1,00.00,"2,063.22",
27-Dec-24,Transfer,00.00,257.9,"1,805.32",
27-Dec-24,IMPS,00.00,200.59,"1,604.73",
27-Dec-24,Transportellaneous,00.00,534.91,"1,069.82",
27-Dec-24,Cash,00.00,152.83,916.99,
27-Dec-24,Debit Card,00.00,91.7,825.29,
27-Dec-24,Commission,00.00,137.55,687.74,
27-Dec-24,ATM,05.00,00.00,692.74,
27-Dec-24,Tax,00.00,115.46,577.28,
27-Dec-24,Tax,07.00,00.00,584.28,
27-Dec-24,Debit Card,00.00,73.04,511.24,
27-Dec-24,NEFT,"3,310.09",00.00,"3,821.33",
27-Dec-24,Transportellaneous,"17,963.80",00.00,"21,785.13",
27-Dec-24,IMPS,00.00,"5,446.28","16,338.85",
27-Dec-24,Tax,"7,344.00",00.00,"23,682.85",
27-Dec-24,Cash,"1,346.00",00.00,"25,028.85",
27-Dec-24,Commission,"2,54,253.80",00.00,"2,79,282.65",
27-Dec-24,ATM,375,00.00,"2,79,657.65",
27-Dec-24,Interest,00.00,"46,609.61","2,33,048.04",
27-Dec-24,Commission,"18,32,884.00",00.00,"20,65,932.04",
27-Dec-24,Transfer,00.00,"10,32,966.02","10,32,966.02",
27-Dec-24,Cheque,00.00,"2,06,593.20","8,26,372.82",
27-Dec-24,Tax,00.00,"2,75,457.61","5,50,915.21",
27-Dec-24,NEFT,00.53,00.00,"5,50,915.74",
27-Dec-24,RTGS,00.00,"1,37,728.94","4,13,186.80",
27-Dec-24,Debit Card,36.9,00.00,"4,13,223.70",
27-Dec-24,Tax,484.9,00.00,"4,13,708.60",
27-Dec-24,Interest,319.36,00.00,"4,14,027.96",
27-Dec-24,NEFT,00.00,"51,753.50","3,62,274.46",
27-Dec-24,IMPS,"56,796.00",00.00,"4,19,070.46",
27-Dec-24,Reversal,00.00,"41,907.05","3,77,163.41",
27-Dec-24,Tax,03.50,00.00,"3,77,166.91",
27-Dec-24,Transfer,00.00,"62,861.15","3,14,305.76",
27-Dec-24,Debit Card,"19,124.30",00.00,"3,33,430.06",
27-Dec-24,Purchase,00.00,"1,11,143.35","2,22,286.71",
28-Dec-24,Tax,"10,62,463.75",00.00,"12,84,750.46",
28-Dec-24,Transportellaneous,00.00,"1,60,593.81","11,24,156.65",
28-Dec-24,Purchase,00.00,"1,12,415.67","10,11,740.98",
28-Dec-24,Tax,"3,147.31",00.00,"10,14,888.29",
28-Dec-24,Interest,"22,902.00",00.00,"10,37,790.29",
28-Dec-24,Cheque,00.00,"1,72,965.05","8,64,825.24",
28-Dec-24,Debit Card,00.00,"4,32,412.62","4,32,412.62",
28-Dec-24,Cash,00.00,"48,045.85","3,84,366.77",
28-Dec-24,NEFT,00.00,"1,28,122.26","2,56,244.51",
28-Dec-24,ATM,00.00,"25,624.45","2,30,620.06",
28-Dec-24,Debit Card,00.00,"2,30,620.06",00.00,
28-Dec-24,Tax,51.3,00.00,51.3,
28-Dec-24,Reversal,06.90,00.00,58.2,
28-Dec-24,Tax,06.00,00.00,64.2,
28-Dec-24,IMPS,00.00,07.13,57.07,
28-Dec-24,Purchase,00.00,14.27,42.8,
29-Dec-24,Purchase,00.00,05.35,37.45,
29-Dec-24,Bill,"54,748.20",00.00,"54,785.65",
29-Dec-24,Cheque,00.00,"10,957.13","43,828.52",
29-Dec-24,Interest,00.00,"10,957.13","32,871.39",
29-Dec-24,Tax,"63,504.00",00.00,"96,375.39",
29-Dec-24,Reversal,00.00,"9,637.54","86,737.85",
29-Dec-24,ATM,05.00,00.00,"86,742.85",
29-Dec-24,IMPS,00.00,"9,638.09","77,104.76",
29-Dec-24,Commission,"4,11,345.80",00.00,"4,88,450.56",
29-Dec-24,Transfer,06.80,00.00,"4,88,457.36",
29-Dec-24,IMPS,"85,623.20",00.00,"5,74,080.56",
29-Dec-24,Transportellaneous,00.00,"57,408.06","5,16,672.50",
29-Dec-24,Cheque,474,00.00,"5,17,146.50",
29-Dec-24,Debit Card,00.00,"73,878.07","4,43,268.43",
29-Dec-24,RTGS,00.00,"4,43,268.43",00.00,
29-Dec-24,Purchase,"5,71,532.00",00.00,"5,71,532.00",
30-Dec-24,Purchase,00.00,"2,85,766.00","2,85,766.00",
30-Dec-24,Cash,"1,327.80",00.00,"2,87,093.80",
30-Dec-24,NEFT,00.00,"1,43,546.90","1,43,546.90",
30-Dec-24,Tax,23.32,00.00,"1,43,570.22",
30-Dec-24,Debit Card,118.8,00.00,"1,43,689.02",
30-Dec-24,ATM,"76,441.06",00.00,"2,20,130.08",
30-Dec-24,Transfer,00.00,"1,10,065.04","1,10,065.04",
30-Dec-24,ATM,"3,96,802.00",00.00,"5,06,867.04",
30-Dec-24,Purchase,00.00,"2,53,433.52","2,53,433.52",
30-Dec-24,Transfer,03.00,00.00,"2,53,436.52",
30-Dec-24,RTGS,00.00,"84,478.84","1,68,957.68",
30-Dec-24,Purchase,00.00,"24,136.81","1,44,820.87",
30-Dec-24,NEFT,03.89,00.00,"1,44,824.76",
30-Dec-24,Reversal,00.00,"1,44,824.76",00.00,
30-Dec-24,Cheque,479.72,00.00,479.72,
30-Dec-24,RTGS,948.98,00.00,"1,428.70",
30-Dec-24,Commission,"67,004.50",00.00,"68,433.20",
30-Dec-24,Purchase,00.00,"6,843.32","61,589.88",
30-Dec-24,Commission,03.20,00.00,"61,593.08",
30-Dec-24,IMPS,00.00,"30,796.54","30,796.54",
30-Dec-24,ATM,"1,074.29",00.00,"31,870.83",
30-Dec-24,IMPS,"2,235.00",00.00,"34,105.83",
30-Dec-24,Cheque,00.00,"3,789.54","30,316.29",
30-Dec-24,Reversal,"83,342.00",00.00,"1,13,658.29",
30-Dec-24,Bill,"2,656.00",00.00,"1,16,314.29",
30-Dec-24,Bill,22,00.00,"1,16,336.29",
30-Dec-24,ATM,"2,731.00",00.00,"1,19,067.29",
30-Dec-24,NEFT,00.00,"29,766.82","89,300.47",
30-Dec-24,Interest,00.00,"22,325.12","66,975.35",
30-Dec-24,Cheque,"1,74,985.31",00.00,"2,41,960.66",
30-Dec-24,Commission,"15,899.29",00.00,"2,57,859.95",
30-Dec-24,Debit Card,05.00,00.00,"2,57,864.95",
31-Dec-24,Cash,00.00,"32,233.12","2,25,631.83",
31-Dec-24,Cash,506.9,00.00,"2,26,138.73",
31-Dec-24,Debit Card,162.6,00.00,"2,26,301.33",
31-Dec-24,Bill,00.00,"1,13,150.67","1,13,150.66",
31-Dec-24,Transfer,00.00,"11,315.07","1,01,835.59",
31-Dec-24,Interest,"2,088.60",00.00,"1,03,924.19",
31-Dec-24,Cheque,"3,142.11",00.00,"1,07,066.30",
31-Dec-24,ATM,00.00,"17,844.38","89,221.92",
31-Dec-24,Transfer,00.00,"22,305.48","66,916.44",
31-Dec-24,Debit Card,"2,551.50",00.00,"69,467.94",
31-Dec-24,Debit Card,00.00,"11,577.99","57,889.95",
31-Dec-24,Transfer,00.00,"11,577.99","46,311.96",
31-Dec-24,Cash,"55,869.00",00.00,"1,02,180.96",
31-Dec-24,ATM,"8,98,166.50",00.00,"10,00,347.46",
31-Dec-24,ATM,06.60,00.00,"10,00,354.06",
31-Dec-24,IMPS,00.00,"1,25,044.26","8,75,309.80",
31-Dec-24,Cash,15,00.00,"8,75,324.80",
31-Dec-24,Cash,00.00,"2,91,774.93","5,83,549.87",
31-Dec-24,Transfer,"41,473.25",00.00,"6,25,023.12",
31-Dec-24,NEFT,00.00,"1,04,170.52","5,20,852.60",
31-Dec-24,Bill,00.00,"57,872.51","4,62,980.09",
31-Dec-24,Tax,14.39,00.00,"4,62,994.48",
31-Dec-24,Purchase,00.00,"4,62,994.48",00.00,
31-Dec-24,Transfer,"4,40,134.00",00.00,"4,40,134.00",
31-Dec-24,Reversal,00.00,"55,016.75","3,85,117.25",
31-Dec-24,Transportellaneous,00.00,"3,85,117.25",00.00,
31-Dec-24,Commission,54.04,00.00,54.04,
31-Dec-24,Purchase,00.00,54.04,00.00,
31-Dec-24,RTGS,"1,48,542.59",00.00,"1,48,542.59",
31-Dec-24,Purchase,"5,403.00",00.00,"1,53,945.59",
31-Dec-24,Reversal,00.00,"1,53,945.59",00.00,
31-Dec-24,Transfer,"9,032.00",00.00,"9,032.00",
31-Dec-24,Reversal,"1,024.00",00.00,"10,056.00",
31-Dec-24,Commission,00.00,"1,676.00","8,380.00",
31-Dec-24,Reversal,"8,207.20",00.00,"16,587.20",
31-Dec-24,ATM,52,00.00,"16,639.20",
31-Dec-24,Debit Card,272.4,00.00,"16,911.60",
31-Dec-24,RTGS,"2,47,471.06",00.00,"2,64,382.66",
31-Dec-24,Debit Card,06.00,00.00,"2,64,388.66",
31-Dec-24,ATM,00.00,"37,769.81","2,26,618.85",
31-Dec-24,NEFT,00.00,"45,323.77","1,81,295.08",
31-Dec-24,IMPS,00.00,"36,259.02","1,45,036.06",
31-Dec-24,Commission,"3,070.23",00.00,"1,48,106.29",
31-Dec-24,Commission,00.00,"18,513.29","1,29,593.00",
31-Dec-24,Transfer,00.00,"1,29,593.00",00.00,
31-Dec-24,Cash,"15,12,142.00",00.00,"15,12,142.00",
31-Dec-24,RTGS,00.00,"5,04,047.33","10,08,094.67",
31-Dec-24,Reversal,00.00,"1,26,011.83","8,82,082.84",
31-Dec-24,Transfer,26.03,00.00,"8,82,108.87",
31-Dec-24,Transfer,"15,38,282.00",00.00,"24,20,390.87",
31-Dec-24,Cash,00.00,"12,10,195.44","12,10,195.44",
31-Dec-24,ATM,00.00,"4,03,398.48","8,06,796.96",
31-Dec-24,Tax,00.00,"1,15,256.71","6,91,540.25",
31-Dec-24,Purchase,00.00,"3,45,770.13","3,45,770.12",
31-Dec-24,IMPS,00.00,"34,577.01","3,11,193.11",
31-Dec-24,Purchase,02.00,00.00,"3,11,195.11",
31-Dec-24,IMPS,"4,03,993.75",00.00,"7,15,188.86",
31-Dec-24,Tax,05.00,00.00,"7,15,193.86",
31-Dec-24,Interest,00.00,"1,78,798.47","5,36,395.40",
31-Dec-24,Purchase,00.00,"67,049.43","4,69,345.98",
31-Dec-24,Cheque,114,00.00,"4,69,459.98",
31-Dec-24,NEFT,"3,852.50",00.00,"4,73,312.48",
31-Dec-24,RTGS,00.00,"94,662.50","3,78,649.98",
31-Dec-24,Transportellaneous,00.00,"1,26,216.66","2,52,433.32",
31-Dec-24,Commission,"9,802.00",00.00,"2,62,235.32",
31-Dec-24,NEFT,"14,43,221.50",00.00,"17,05,456.82",
31-Dec-24,Debit Card,00.00,"2,43,636.69","14,61,820.13",
31-Dec-24,Debit Card,00.00,"7,30,910.07","7,30,910.06",
31-Dec-24,IMPS,00.00,"91,363.76","6,39,546.30",
01-Jan-25,ATM,00.00,"1,59,886.58","4,79,659.72",
01-Jan-25,Commission,00.00,"59,957.47","4,19,702.26",
01-Jan-25,Transportellaneous,"1,189.00",00.00,"4,20,891.26",
01-Jan-25,ATM,00.00,"84,178.25","3,36,713.01",
01-Jan-25,NEFT,"2,268.80",00.00,"3,38,981.81",
01-Jan-25,NEFT,"2,708.00",00.00,"3,41,689.81",
01-Jan-25,Tax,00.00,"68,337.96","2,73,351.85",
01-Jan-25,Commission,00.00,"34,168.98","2,39,182.87",
01-Jan-25,IMPS,00.00,"34,168.98","2,05,013.89",
01-Jan-25,Bill,"29,397.00",00.00,"2,34,410.89",
01-Jan-25,Reversal,483.28,00.00,"2,34,894.17",
01-Jan-25,RTGS,00.00,"39,149.03","1,95,745.14",
01-Jan-25,Cheque,01.90,00.00,"1,95,747.04",
01-Jan-25,Commission,"1,07,825.25",00.00,"3,03,572.29",
01-Jan-25,Transportellaneous,"3,901.00",00.00,"3,07,473.29",
01-Jan-25,Debit Card,"17,667.00",00.00,"3,25,140.29",
01-Jan-25,Interest,04.00,00.00,"3,25,144.29",
01-Jan-25,ATM,00.00,"1,08,381.43","2,16,762.86",
01-Jan-25,ATM,"3,28,950.00",00.00,"5,45,712.86",
01-Jan-25,Reversal,00.00,"68,214.11","4,77,498.75",
01-Jan-25,Purchase,494,00.00,"4,77,992.75",
01-Jan-25,Reversal,55,00.00,"4,78,047.75",
01-Jan-25,Transfer,"3,77,249.00",00.00,"8,55,296.75",
01-Jan-25,NEFT,00.00,"4,27,648.38","4,27,648.38",
01-Jan-25,Transportellaneous,"15,61,426.50",00.00,"19,89,074.88",
01-Jan-25,IMPS,00.00,"3,31,512.48","16,57,562.40",
01-Jan-25,Tax,06.00,00.00,"16,57,568.40",
01-Jan-25,Transportellaneous,05.00,00.00,"16,57,573.40",
01-Jan-25,Tax,02.00,00.00,"16,57,575.40",
01-Jan-25,Commission,00.00,"4,14,393.85","12,43,181.55",
01-Jan-25,NEFT,"30,719.40",00.00,"12,73,900.95",
01-Jan-25,NEFT,00.00,"2,54,780.19","10,19,120.76",
01-Jan-25,Bill,29.4,00.00,"10,19,150.16",
01-Jan-25,Transfer,05.00,00.00,"10,19,155.16",
01-Jan-25,ATM,00.00,"5,09,577.58","5,09,577.58",
02-Jan-25,RTGS,"2,26,391.70",00.00,"7,35,969.28",
02-Jan-25,Interest,00.00,"91,996.16","6,43,973.12",
02-Jan-25,ATM,00.00,"64,397.31","5,79,575.81",
02-Jan-25,Cash,00.00,"1,93,191.94","3,86,383.87",
02-Jan-25,Purchase,00.00,"38,638.39","3,47,745.48",
02-Jan-25,Purchase,00.00,"3,47,745.48",00.00,
02-Jan-25,IMPS,04.70,00.00,04.70,
02-Jan-25,Cheque,00.00,04.70,00.00,
02-Jan-25,Cash,"6,86,659.75",00.00,"6,86,659.75",
02-Jan-25,Cash,00.00,"1,37,331.95","5,49,327.80",
02-Jan-25,Reversal,00.00,"78,475.40","4,70,852.40",
03-Jan-25,Debit Card,"1,21,848.40",00.00,"5,92,700.80",
03-Jan-25,Interest,00.00,"1,97,566.93","3,95,133.87",
03-Jan-25,Cheque,83.7,00.00,"3,95,217.57",
03-Jan-25,Commission,00.00,"43,913.06","3,51,304.51",
03-Jan-25,Interest,45.6,00.00,"3,51,350.11",
03-Jan-25,Cheque,131.27,00.00,"3,51,481.38",
03-Jan-25,IMPS,00.00,"43,935.17","3,07,546.21",
03-Jan-25,Transportellaneous,"3,94,351.25",00.00,"7,01,897.46",
03-Jan-25,Tax,00.60,00.00,"7,01,898.06",
03-Jan-25,Interest,00.00,"70,189.81","6,31,708.25",
03-Jan-25,RTGS,"85,685.31",00.00,"7,17,393.56",
03-Jan-25,ATM,00.00,"7,17,393.56",00.00,
03-Jan-25,Transportellaneous,124,00.00,124,
03-Jan-25,Transfer,408,00.00,532,
03-Jan-25,Bill,"18,34,054.00",00.00,"18,34,586.00",
03-Jan-25,Bill,00.00,"1,83,458.60","16,51,127.40",
03-Jan-25,IMPS,00.00,"1,83,458.60","14,67,668.80",
03-Jan-25,Tax,00.00,"3,66,917.20","11,00,751.60",
03-Jan-25,RTGS,"10,832.06",00.00,"11,11,583.66",
03-Jan-25,IMPS,"20,179.00",00.00,"11,31,762.66",
03-Jan-25,Tax,00.00,"11,31,762.66",00.00,
03-Jan-25,Reversal,"2,280.00",00.00,"2,280.00",
03-Jan-25,Purchase,00.00,285,"1,995.00",
03-Jan-25,RTGS,"1,34,887.00",00.00,"1,36,882.00",
03-Jan-25,Interest,00.00,"13,688.20","1,23,193.80",
03-Jan-25,Transfer,"19,881.00",00.00,"1,43,074.80",
04-Jan-25,Transportellaneous,"10,88,982.50",00.00,"12,32,057.30",
04-Jan-25,RTGS,00.00,"12,32,057.30",00.00,
04-Jan-25,ATM,59,00.00,59,
04-Jan-25,Interest,00.00,09.83,49.17,
04-Jan-25,Tax,14.84,00.00,64.01,
04-Jan-25,RTGS,00.00,10.67,53.34,
04-Jan-25,Tax,00.00,08.89,44.45,
04-Jan-25,ATM,00.00,08.89,35.56,
04-Jan-25,Debit Card,"11,998.70",00.00,"12,034.26",
04-Jan-25,Cheque,00.00,"3,008.57","9,025.70",
04-Jan-25,Transportellaneous,"21,450.59",00.00,"30,476.29",
04-Jan-25,Commission,"1,466.70",00.00,"31,942.99",
05-Jan-25,Commission,00.00,"4,563.28","27,379.71",
05-Jan-25,Bill,"2,384.10",00.00,"29,763.81",
05-Jan-25,IMPS,12,00.00,"29,775.81",
05-Jan-25,IMPS,00.00,"4,962.64","24,813.18",
05-Jan-25,RTGS,00.00,"4,962.64","19,850.54",
05-Jan-25,Commission,"1,80,153.28",00.00,"2,00,003.82",
05-Jan-25,Bill,00.00,"40,000.76","1,60,003.06",
05-Jan-25,Interest,00.00,"40,000.77","1,20,002.30",
05-Jan-25,Transportellaneous,25.7,00.00,"1,20,028.00",
05-Jan-25,ATM,"1,533.10",00.00,"1,21,561.10",
05-Jan-25,Transfer,00.00,"15,195.14","1,06,365.96",
05-Jan-25,Cash,"17,091.34",00.00,"1,23,457.30",
05-Jan-25,Purchase,00.00,"13,717.48","1,09,739.82",
05-Jan-25,Bill,00.00,"12,193.31","97,546.51",
05-Jan-25,ATM,48,00.00,"97,594.51",
05-Jan-25,Debit Card,00.00,"32,531.50","65,063.01",
05-Jan-25,Cash,"8,918.80",00.00,"73,981.81",
05-Jan-25,Commission,00.00,"7,398.18","66,583.63",
05-Jan-25,IMPS,102.3,00.00,"66,685.93",
05-Jan-25,Reversal,00.00,"16,671.48","50,014.45",
05-Jan-25,NEFT,"30,321.00",00.00,"80,335.45",
05-Jan-25,Interest,"87,830.00",00.00,"1,68,165.45",
05-Jan-25,Transfer,851.52,00.00,"1,69,016.97",
05-Jan-25,Cheque,00.00,"1,69,016.97",00.00,
05-Jan-25,Interest,"59,081.20",00.00,"59,081.20",
05-Jan-25,NEFT,00.00,"9,846.87","49,234.33",
05-Jan-25,ATM,00.00,"5,470.48","43,763.85",
05-Jan-25,Cash,00.00,"4,862.65","38,901.20",
05-Jan-25,Reversal,155,00.00,"39,056.20",
05-Jan-25,Bill,39,00.00,"39,095.20",
05-Jan-25,Cash,00.00,"4,886.90","34,208.30",
05-Jan-25,Commission,06.70,00.00,"34,215.00",
05-Jan-25,Tax,00.00,"6,843.00","27,372.00",
05-Jan-25,Interest,00.00,"9,124.00","18,248.00",
05-Jan-25,Tax,02.40,00.00,"18,250.40",
05-Jan-25,Interest,"1,52,845.60",00.00,"1,71,096.00",
05-Jan-25,Interest,"27,081.41",00.00,"1,98,177.41",
05-Jan-25,Transportellaneous,02.00,00.00,"1,98,179.41",
06-Jan-25,NEFT,258.7,00.00,"1,98,438.11",
06-Jan-25,Reversal,00.00,"99,219.06","99,219.06",
06-Jan-25,IMPS,00.00,"16,536.51","82,682.55",
06-Jan-25,Cash,00.00,"27,560.85","55,121.70",
06-Jan-25,Debit Card,00.00,"18,373.90","36,747.80",
06-Jan-25,ATM,"1,24,870.30",00.00,"1,61,618.10",
06-Jan-25,Purchase,"2,465.59",00.00,"1,64,083.69",
06-Jan-25,Bill,00.00,"20,510.46","1,43,573.23",
06-Jan-25,RTGS,"2,45,437.00",00.00,"3,89,010.23",
06-Jan-25,Transfer,00.00,"48,626.28","3,40,383.95",
06-Jan-25,Transfer,00.00,"1,70,191.98","1,70,191.98",
06-Jan-25,Reversal,00.00,"1,70,191.98",00.00,
06-Jan-25,Debit Card,53,00.00,53,
06-Jan-25,Transfer,00.00,05.89,47.11,
06-Jan-25,Debit Card,63.02,00.00,110.13,
06-Jan-25,Reversal,00.00,36.71,73.42,
06-Jan-25,ATM,00.00,10.49,62.93,
06-Jan-25,ATM,25.68,00.00,88.61,
06-Jan-25,ATM,00.00,29.54,59.07,
06-Jan-25,Cheque,"15,918.30",00.00,"15,977.37",
06-Jan-25,Purchase,"1,088.65",00.00,"17,066.02",
06-Jan-25,Transportellaneous,00.00,"3,413.20","13,652.82",
06-Jan-25,Reversal,37,00.00,"13,689.82",
06-Jan-25,ATM,00.00,"3,422.46","10,267.36",
06-Jan-25,Cheque,45,00.00,"10,312.36",
06-Jan-25,Interest,00.00,"2,062.47","8,249.89",
06-Jan-25,Interest,"1,163.00",00.00,"9,412.89",
06-Jan-25,Transfer,00.00,"1,882.58","7,530.31",
06-Jan-25,Purchase,00.00,"3,765.16","3,765.16",
06-Jan-25,Interest,55,00.00,"3,820.16",
06-Jan-25,Transfer,00.00,"1,273.39","2,546.77",
06-Jan-25,NEFT,00.00,636.69,"1,910.08",
07-Jan-25,Interest,"32,746.00",00.00,"34,656.08",
07-Jan-25,Debit Card,"6,41,559.75",00.00,"6,76,215.83",
07-Jan-25,Bill,00.00,"6,76,215.83",00.00,
07-Jan-25,Transportellaneous,"97,452.00",00.00,"97,452.00",
07-Jan-25,IMPS,"4,48,311.00",00.00,"5,45,763.00",
07-Jan-25,Tax,00.00,"1,81,921.00","3,63,842.00",
07-Jan-25,ATM,00.65,00.00,"3,63,842.65",
07-Jan-25,Cheque,220.65,00.00,"3,64,063.30",
07-Jan-25,ATM,"7,95,842.00",00.00,"11,59,905.30",
07-Jan-25,ATM,00.00,"1,65,700.76","9,94,204.54",
07-Jan-25,ATM,00.39,00.00,"9,94,204.93",
07-Jan-25,Purchase,39.7,00.00,"9,94,244.63",
07-Jan-25,Tax,00.00,"1,65,707.44","8,28,537.19",
07-Jan-25,Cheque,00.00,"8,28,537.19",00.00,
07-Jan-25,RTGS,28.63,00.00,28.63,
07-Jan-25,Tax,"1,50,536.78",00.00,"1,50,565.41",
07-Jan-25,Tax,"4,419.00",00.00,"1,54,984.41",
07-Jan-25,Reversal,00.00,"30,996.88","1,23,987.53",
07-Jan-25,Transportellaneous,00.00,"12,398.75","1,11,588.78",
07-Jan-25,Bill,"10,537.25",00.00,"1,22,126.03",
07-Jan-25,Cash,00.00,"24,425.21","97,700.82",
07-Jan-25,Bill,"15,16,886.75",00.00,"16,14,587.57",
07-Jan-25,Transportellaneous,00.00,"1,61,458.76","14,53,128.81",
07-Jan-25,Tax,00.00,"4,84,376.27","9,68,752.54",
07-Jan-25,Bill,"6,47,982.00",00.00,"16,16,734.54",
07-Jan-25,RTGS,00.00,"1,61,673.45","14,55,061.09",
07-Jan-25,Interest,00.94,00.00,"14,55,062.03",
07-Jan-25,Debit Card,"17,611.20",00.00,"14,72,673.23",
07-Jan-25,Purchase,00.00,"2,94,534.65","11,78,138.58",
07-Jan-25,Debit Card,00.00,"5,89,069.29","5,89,069.29",
07-Jan-25,Transfer,00.00,"1,17,813.86","4,71,255.43",
07-Jan-25,Tax,"2,50,226.00",00.00,"7,21,481.43",
07-Jan-25,Commission,00.00,"7,21,481.43",00.00,
08-Jan-25,Cash,"1,33,542.00",00.00,"1,33,542.00",
08-Jan-25,Purchase,"23,334.60",00.00,"1,56,876.60",
08-Jan-25,Bill,00.00,"31,375.32","1,25,501.28",
08-Jan-25,Purchase,00.00,"31,375.32","94,125.96",
08-Jan-25,Interest,144.4,00.00,"94,270.36",
08-Jan-25,IMPS,00.00,"94,270.36",00.00,
08-Jan-25,Tax,"14,99,384.20",00.00,"14,99,384.20",
08-Jan-25,Debit Card,00.00,"1,66,598.24","13,32,785.96",
08-Jan-25,Purchase,"3,594.00",00.00,"13,36,379.96",
08-Jan-25,Tax,"16,28,604.00",00.00,"29,64,983.96",
08-Jan-25,RTGS,"11,222.43",00.00,"29,76,206.39",
08-Jan-25,Reversal,00.00,"14,88,103.20","14,88,103.20",
08-Jan-25,Reversal,00.00,"2,48,017.20","12,40,086.00",
08-Jan-25,Transportellaneous,00.00,"12,40,086.00",00.00,
08-Jan-25,Reversal,"2,544.43",00.00,"2,544.43",
08-Jan-25,Transfer,"5,73,840.00",00.00,"5,76,384.43",
08-Jan-25,Reversal,00.00,"57,638.44","5,18,745.99",
08-Jan-25,Tax,772.16,00.00,"5,19,518.15",
08-Jan-25,Purchase,56.9,00.00,"5,19,575.05",
08-Jan-25,Purchase,00.00,"2,59,787.53","2,59,787.52",
08-Jan-25,ATM,00.00,"43,297.92","2,16,489.60",
08-Jan-25,Reversal,644.5,00.00,"2,17,134.10",
08-Jan-25,Tax,30.7,00.00,"2,17,164.80",
08-Jan-25,Interest,"9,912.10",00.00,"2,27,076.90",
08-Jan-25,Bill,"2,087.00",00.00,"2,29,163.90",
08-Jan-25,IMPS,00.00,"1,14,581.95","1,14,581.95",
08-Jan-25,Transfer,00.00,"57,290.98","57,290.98",
08-Jan-25,Purchase,00.00,"5,729.10","51,561.88",
08-Jan-25,Purchase,"20,054.59",00.00,"71,616.47",
08-Jan-25,Purchase,10,00.00,"71,626.47",
09-Jan-25,Commission,00.00,"10,232.35","61,394.12",
09-Jan-25,Debit Card,"23,583.50",00.00,"84,977.62",
10-Jan-25,IMPS,33.9,00.00,"85,011.52",
10-Jan-25,Interest,"4,75,390.00",00.00,"5,60,401.52",
10-Jan-25,Cheque,"10,690.21",00.00,"5,71,091.73",
10-Jan-25,IMPS,00.00,"1,42,772.93","4,28,318.80",
10-Jan-25,Cheque,00.00,"2,14,159.40","2,14,159.40",
10-Jan-25,Interest,"6,113.00",00.00,"2,20,272.40",
10-Jan-25,ATM,"6,96,208.25",00.00,"9,16,480.65",
10-Jan-25,Debit Card,00.00,"9,16,480.65",00.00,
10-Jan-25,Interest,"1,98,990.00",00.00,"1,98,990.00",
11-Jan-25,Debit Card,00.00,"1,98,990.00",00.00,
11-Jan-25,Cash,07.93,00.00,07.93,
11-Jan-25,Cash,00.00,01.98,05.95,
11-Jan-25,Debit Card,"4,04,672.80",00.00,"4,04,678.75",
11-Jan-25,NEFT,"12,22,030.50",00.00,"16,26,709.25",
11-Jan-25,Debit Card,"6,181.85",00.00,"16,32,891.10",
11-Jan-25,Transfer,"2,26,125.00",00.00,"18,59,016.10",
11-Jan-25,Transportellaneous,00.00,"2,32,377.01","16,26,639.09",
11-Jan-25,Debit Card,"2,745.80",00.00,"16,29,384.89",
11-Jan-25,Interest,"29,041.00",00.00,"16,58,425.89",
12-Jan-25,Tax,"55,642.38",00.00,"17,14,068.27",
12-Jan-25,Cash,00.00,"2,44,866.90","14,69,201.37",
12-Jan-25,IMPS,00.00,"1,46,920.14","13,22,281.23",
12-Jan-25,Transportellaneous,00.00,"1,88,897.32","11,33,383.91",
12-Jan-25,NEFT,00.00,"2,26,676.78","9,06,707.13",
12-Jan-25,Cheque,"11,84,473.80",00.00,"20,91,180.93",
12-Jan-25,Cash,02.00,00.00,"20,91,182.93",
12-Jan-25,NEFT,00.00,"20,91,182.93",00.00,
12-Jan-25,NEFT,"10,99,913.00",00.00,"10,99,913.00",
12-Jan-25,Commission,"2,136.40",00.00,"11,02,049.40",
12-Jan-25,Cash,10.59,00.00,"11,02,059.99",
12-Jan-25,Cash,02.00,00.00,"11,02,061.99",
12-Jan-25,Purchase,00.00,"1,10,206.20","9,91,855.79",
12-Jan-25,Tax,00.00,"4,95,927.90","4,95,927.90",
12-Jan-25,Debit Card,23.25,00.00,"4,95,951.15",
12-Jan-25,ATM,339.13,00.00,"4,96,290.28",
12-Jan-25,Purchase,286.37,00.00,"4,96,576.65",
12-Jan-25,Cash,00.00,"62,072.08","4,34,504.57",
12-Jan-25,Transfer,00.00,"1,08,626.14","3,25,878.43",
13-Jan-25,RTGS,00.00,"3,25,878.43",00.00,
14-Jan-25,Reversal,402.1,00.00,402.1,
14-Jan-25,Bill,00.00,402.1,00.00,
14-Jan-25,RTGS,"13,85,579.50",00.00,"13,85,579.50",
14-Jan-25,Debit Card,20.29,00.00,"13,85,599.79",
14-Jan-25,Transfer,"18,69,685.00",00.00,"32,55,284.79",
15-Jan-25,Bill,"1,71,995.00",00.00,"34,27,279.79",
15-Jan-25,ATM,06.00,00.00,"34,27,285.79",
15-Jan-25,NEFT,00.00,"34,27,285.79",00.00,
15-Jan-25,RTGS,"13,66,848.00",00.00,"13,66,848.00",
15-Jan-25,Interest,00.00,"3,41,712.00","10,25,136.00",
15-Jan-25,Cheque,00.00,"5,12,568.00","5,12,568.00",
15-Jan-25,Transportellaneous,"1,96,158.20",00.00,"7,08,726.20",
15-Jan-25,Bill,18.07,00.00,"7,08,744.27",
15-Jan-25,Cheque,"28,422.50",00.00,"7,37,166.77",
15-Jan-25,Debit Card,"25,655.56",00.00,"7,62,822.33",
15-Jan-25,IMPS,00.00,"1,08,974.62","6,53,847.71",
15-Jan-25,Reversal,"9,49,174.00",00.00,"16,03,021.71",
15-Jan-25,RTGS,802,00.00,"16,03,823.71",
15-Jan-25,Tax,"1,24,952.00",00.00,"17,28,775.71",
15-Jan-25,Tax,00.00,"1,72,877.57","15,55,898.14",
15-Jan-25,RTGS,00.00,"1,94,487.27","13,61,410.87",
15-Jan-25,Bill,00.00,"6,80,705.44","6,80,705.44",
15-Jan-25,ATM,"4,11,154.50",00.00,"10,91,859.94",
15-Jan-25,IMPS,"2,176.68",00.00,"10,94,036.62",
15-Jan-25,Interest,00.00,"2,73,509.16","8,20,527.47",
15-Jan-25,ATM,99.23,00.00,"8,20,626.70",
15-Jan-25,IMPS,00.00,"91,180.74","7,29,445.96",
15-Jan-25,Bill,"62,327.70",00.00,"7,91,773.66",
15-Jan-25,Reversal,00.00,"3,95,886.83","3,95,886.83",
15-Jan-25,RTGS,44.74,00.00,"3,95,931.57",
15-Jan-25,Cheque,636.5,00.00,"3,96,568.07",
15-Jan-25,ATM,"18,515.00",00.00,"4,15,083.07",
15-Jan-25,Debit Card,00.00,"51,885.38","3,63,197.69",
15-Jan-25,Commission,00.00,"60,532.95","3,02,664.74",
15-Jan-25,IMPS,00.00,"75,666.19","2,26,998.56",
15-Jan-25,Cash,00.00,"2,26,998.56",00.00,
15-Jan-25,RTGS,"17,997.00",00.00,"17,997.00",
15-Jan-25,Transfer,"1,88,190.00",00.00,"2,06,187.00",
15-Jan-25,Bill,00.00,"51,546.75","1,54,640.25",
15-Jan-25,Cheque,453.17,00.00,"1,55,093.42",
15-Jan-25,Debit Card,03.10,00.00,"1,55,096.52",
15-Jan-25,Debit Card,00.00,"19,387.07","1,35,709.45",
15-Jan-25,ATM,00.00,"33,927.36","1,01,782.09",
15-Jan-25,Reversal,14.4,00.00,"1,01,796.49",
15-Jan-25,Cheque,74.91,00.00,"1,01,871.40",
15-Jan-25,Commission,00.00,"11,319.04","90,552.36",
15-Jan-25,Cheque,00.00,"22,638.09","67,914.27",
15-Jan-25,Purchase,450,00.00,"68,364.27",
15-Jan-25,Cash,"28,626.00",00.00,"96,990.27",
15-Jan-25,Bill,00.00,"12,123.78","84,866.49",
15-Jan-25,Commission,00.00,"28,288.83","56,577.66",
15-Jan-25,Transfer,00.00,"7,072.21","49,505.45",
15-Jan-25,Reversal,00.00,"8,250.91","41,254.54",
15-Jan-25,Commission,00.00,"4,583.84","36,670.70",
15-Jan-25,Commission,00.00,"36,670.70",00.00,
15-Jan-25,ATM,"5,943.80",00.00,"5,943.80",
15-Jan-25,Purchase,"26,608.00",00.00,"32,551.80",
15-Jan-25,Tax,"32,678.20",00.00,"65,230.00",
15-Jan-25,Debit Card,257.44,00.00,"65,487.44",
15-Jan-25,ATM,00.00,"7,276.38","58,211.06",
15-Jan-25,Debit Card,31.07,00.00,"58,242.13",
15-Jan-25,Debit Card,"2,16,792.30",00.00,"2,75,034.43",
15-Jan-25,RTGS,"9,72,096.00",00.00,"12,47,130.43",
15-Jan-25,Cheque,"14,28,312.20",00.00,"26,75,442.63",
15-Jan-25,Bill,"25,755.90",00.00,"27,01,198.53",
15-Jan-25,Cheque,02.20,00.00,"27,01,200.73",
15-Jan-25,RTGS,50,00.00,"27,01,250.73",
15-Jan-25,Transfer,"20,94,075.25",00.00,"47,95,325.98",
15-Jan-25,Purchase,00.00,"47,95,325.98",00.00,
15-Jan-25,Debit Card,525.52,00.00,525.52,
15-Jan-25,Cheque,"1,986.40",00.00,"2,511.92",
15-Jan-25,NEFT,00.00,418.65,"2,093.27",
15-Jan-25,Interest,00.00,232.59,"1,860.68",
15-Jan-25,Reversal,03.95,00.00,"1,864.63",
15-Jan-25,Cash,00.00,"1,864.63",00.00,
15-Jan-25,ATM,00.52,00.00,00.52,
15-Jan-25,Commission,00.00,00.09,00.43,
15-Jan-25,RTGS,"10,183.20",00.00,"10,183.63",
15-Jan-25,Interest,00.00,"2,036.73","8,146.90",
15-Jan-25,IMPS,34,00.00,"8,180.90",
15-Jan-25,Purchase,"3,21,894.00",00.00,"3,30,074.90",
15-Jan-25,NEFT,"3,471.07",00.00,"3,33,545.97",
15-Jan-25,Bill,00.00,"47,649.42","2,85,896.55",
15-Jan-25,Transfer,00.00,"2,85,896.55",00.00,
15-Jan-25,ATM,"2,052.00",00.00,"2,052.00",
15-Jan-25,Cheque,00.00,"1,026.00","1,026.00",
15-Jan-25,Reversal,00.00,256.5,769.5,
15-Jan-25,Reversal,00.00,76.95,692.55,
15-Jan-25,Bill,"2,41,803.50",00.00,"2,42,496.05",
15-Jan-25,Commission,"3,226.30",00.00,"2,45,722.35",
15-Jan-25,NEFT,185.46,00.00,"2,45,907.81",
15-Jan-25,Purchase,00.00,"1,22,953.91","1,22,953.90",
15-Jan-25,Cheque,"1,82,600.90",00.00,"3,05,554.80",
15-Jan-25,Transfer,00.00,"33,950.53","2,71,604.27",
15-Jan-25,Debit Card,00.00,"27,160.43","2,44,443.84",
15-Jan-25,Reversal,00.00,"1,22,221.92","1,22,221.92",
16-Jan-25,Cheque,00.00,"20,370.32","1,01,851.60",
16-Jan-25,NEFT,"3,510.00",00.00,"1,05,361.60",
16-Jan-25,Tax,00.00,"11,706.84","93,654.76",
16-Jan-25,Bill,"17,91,891.20",00.00,"18,85,545.96",
16-Jan-25,Reversal,12,00.00,"18,85,557.96",
16-Jan-25,Tax,00.00,"2,69,365.42","16,16,192.54",
16-Jan-25,RTGS,00.00,"2,30,884.65","13,85,307.89",
16-Jan-25,Bill,05.30,00.00,"13,85,313.19",
16-Jan-25,Transfer,00.00,"1,73,164.15","12,12,149.04",
16-Jan-25,Bill,"1,24,198.00",00.00,"13,36,347.04",
16-Jan-25,NEFT,35.1,00.00,"13,36,382.14",
16-Jan-25,Commission,00.00,"13,36,382.14",00.00,
16-Jan-25,Bill,"67,142.40",00.00,"67,142.40",
16-Jan-25,Commission,00.00,"67,142.40",00.00,
16-Jan-25,Cheque,33.17,00.00,33.17,
16-Jan-25,Cash,00.00,03.32,29.85,
16-Jan-25,Transfer,00.00,07.46,22.39,
16-Jan-25,Debit Card,00.00,05.60,16.79,
16-Jan-25,Reversal,00.00,16.79,00.00,
16-Jan-25,IMPS,"20,129.00",00.00,"20,129.00",
16-Jan-25,IMPS,"14,944.00",00.00,"35,073.00",
16-Jan-25,Debit Card,02.40,00.00,"35,075.40",
16-Jan-25,NEFT,00.00,"3,507.54","31,567.86",
16-Jan-25,Transfer,00.00,"4,509.69","27,058.17",
16-Jan-25,Commission,00.00,"4,509.70","22,548.48",
16-Jan-25,IMPS,"3,05,088.00",00.00,"3,27,636.48",
16-Jan-25,Bill,00.00,"1,63,818.24","1,63,818.24",
16-Jan-25,Purchase,00.00,"18,202.03","1,45,616.21",
16-Jan-25,IMPS,00.00,"24,269.37","1,21,346.84",
16-Jan-25,Transportellaneous,"18,555.80",00.00,"1,39,902.64",
16-Jan-25,Interest,00.00,"27,980.53","1,11,922.11",
16-Jan-25,Cash,00.00,"15,988.87","95,933.24",
16-Jan-25,NEFT,00.00,"10,659.25","85,273.99",
16-Jan-25,Transfer,00.00,"14,212.33","71,061.66",
16-Jan-25,Bill,"37,689.44",00.00,"1,08,751.10",
16-Jan-25,Transportellaneous,"1,01,477.40",00.00,"2,10,228.50",
16-Jan-25,IMPS,338.4,00.00,"2,10,566.90",
16-Jan-25,RTGS,00.00,"21,056.69","1,89,510.21",
16-Jan-25,RTGS,00.00,"18,951.02","1,70,559.19",
16-Jan-25,Commission,00.00,"1,70,559.19",00.00,
16-Jan-25,Interest,06.48,00.00,06.48,
16-Jan-25,Debit Card,"1,03,945.47",00.00,"1,03,951.95",
16-Jan-25,Bill,00.00,"1,03,951.95",00.00,
16-Jan-25,Cash,53.69,00.00,53.69,
16-Jan-25,Debit Card,64,00.00,117.69,
16-Jan-25,RTGS,"18,84,670.80",00.00,"18,84,788.49",
16-Jan-25,Tax,"1,44,156.00",00.00,"20,28,944.49",
16-Jan-25,Purchase,163,00.00,"20,29,107.49",
16-Jan-25,Tax,"1,06,211.00",00.00,"21,35,318.49",
16-Jan-25,Transfer,609,00.00,"21,35,927.49",
16-Jan-25,NEFT,02.36,00.00,"21,35,929.85",
16-Jan-25,Transportellaneous,00.00,"7,11,976.62","14,23,953.23",
16-Jan-25,Reversal,73,00.00,"14,24,026.23",
16-Jan-25,Commission,"3,325.07",00.00,"14,27,351.30",
16-Jan-25,Bill,308,00.00,"14,27,659.30",
16-Jan-25,RTGS,00.00,00.00,"14,27,659.30",
16-Jan-25,Interest,"25,880.00",00.00,"14,53,539.30",
16-Jan-25,Cheque,"26,891.40",00.00,"14,80,430.70",
16-Jan-25,Tax,40.2,00.00,"14,80,470.90",
16-Jan-25,Reversal,"19,54,333.00",00.00,"34,34,803.90",
16-Jan-25,Commission,00.00,"3,81,644.88","30,53,159.02",
16-Jan-25,Bill,00.00,"4,36,165.57","26,16,993.45",
16-Jan-25,Cheque,"2,797.10",00.00,"26,19,790.55",
16-Jan-25,Cash,00.00,"26,19,790.55",00.00,
16-Jan-25,Transfer,"8,01,666.00",00.00,"8,01,666.00",
16-Jan-25,Debit Card,00.00,"1,33,611.00","6,68,055.00",
16-Jan-25,Debit Card,00.00,"1,11,342.50","5,56,712.50",
16-Jan-25,Reversal,02.77,00.00,"5,56,715.27",
16-Jan-25,Tax,00.00,"1,85,571.76","3,71,143.51",
16-Jan-25,ATM,00.00,"37,114.35","3,34,029.16",
16-Jan-25,Transportellaneous,"1,75,219.81",00.00,"5,09,248.97",
16-Jan-25,Bill,"1,37,376.80",00.00,"6,46,625.77",
16-Jan-25,Bill,"2,22,959.00",00.00,"8,69,584.77",
16-Jan-25,NEFT,00.00,"8,69,584.77",00.00,
16-Jan-25,ATM,383.98,00.00,383.98,
16-Jan-25,Tax,00.00,127.99,255.99,
16-Jan-25,NEFT,00.00,42.67,213.32,
16-Jan-25,IMPS,"1,30,242.84",00.00,"1,30,456.16",
16-Jan-25,IMPS,670,00.00,"1,31,126.16",
16-Jan-25,Purchase,00.00,"14,569.57","1,16,556.59",
16-Jan-25,Debit Card,00.90,00.00,"1,16,557.49",
16-Jan-25,Bill,"11,51,337.75",00.00,"12,67,895.24",
16-Jan-25,Bill,00.00,"2,53,579.05","10,14,316.19",
16-Jan-25,Cash,46,00.00,"10,14,362.19",
16-Jan-25,Bill,02.00,00.00,"10,14,364.19",
16-Jan-25,Commission,00.00,"5,07,182.10","5,07,182.10",
16-Jan-25,Interest,00.00,"5,07,182.10",00.00,
16-Jan-25,Reversal,"3,016.20",00.00,"3,016.20",
16-Jan-25,NEFT,"7,05,252.00",00.00,"7,08,268.20",
16-Jan-25,Interest,00.00,"1,18,044.70","5,90,223.50",
16-Jan-25,RTGS,00.00,"1,96,741.17","3,93,482.33",
16-Jan-25,IMPS,"3,905.85",00.00,"3,97,388.18",
16-Jan-25,ATM,00.00,"99,347.05","2,98,041.14",
16-Jan-25,Commission,60.8,00.00,"2,98,101.94",
16-Jan-25,Commission,00.00,"74,525.49","2,23,576.46",
16-Jan-25,Purchase,"2,55,671.00",00.00,"4,79,247.46",
16-Jan-25,Transportellaneous,08.00,00.00,"4,79,255.46",
16-Jan-25,Cash,00.00,"59,906.93","4,19,348.53",
16-Jan-25,Transfer,"3,042.24",00.00,"4,22,390.77",
16-Jan-25,Cheque,00.00,"84,478.15","3,37,912.62",
16-Jan-25,Bill,00.00,"48,273.23","2,89,639.39",
16-Jan-25,Tax,00.00,"96,546.46","1,93,092.93",
16-Jan-25,RTGS,261.62,00.00,"1,93,354.55",
16-Jan-25,Commission,00.00,"24,169.32","1,69,185.23",
16-Jan-25,RTGS,00.00,"28,197.54","1,40,987.69",
16-Jan-25,Tax,00.00,"1,40,987.69",00.00,
16-Jan-25,Commission,07.70,00.00,07.70,
16-Jan-25,RTGS,04.00,00.00,11.7,
16-Jan-25,Bill,00.00,01.67,10.03,
16-Jan-25,Cheque,"2,585.10",00.00,"2,595.13",
16-Jan-25,Reversal,00.00,"2,595.13",00.00,
16-Jan-25,Cheque,25.75,00.00,25.75,
16-Jan-25,NEFT,850,00.00,875.75,
16-Jan-25,Interest,"14,87,489.75",00.00,"14,88,365.50",
16-Jan-25,Bill,544.08,00.00,"14,88,909.58",
17-Jan-25,Purchase,00.00,"1,86,113.70","13,02,795.88",
17-Jan-25,IMPS,00.00,"1,62,849.49","11,39,946.40",
17-Jan-25,Reversal,460.2,00.00,"11,40,406.60",
17-Jan-25,Cash,"20,42,914.50",00.00,"31,83,321.10",
17-Jan-25,Transfer,314.3,00.00,"31,83,635.40",
17-Jan-25,Cheque,"20,09,020.00",00.00,"51,92,655.40",
17-Jan-25,Cheque,504.52,00.00,"51,93,159.92",
17-Jan-25,Purchase,377.73,00.00,"51,93,537.65",
17-Jan-25,Bill,06.00,00.00,"51,93,543.65",
17-Jan-25,NEFT,00.00,"6,49,192.96","45,44,350.69",
17-Jan-25,NEFT,00.00,"22,72,175.35","22,72,175.35",
17-Jan-25,Commission,989.5,00.00,"22,73,164.85",
17-Jan-25,Tax,00.00,"7,57,721.62","15,15,443.23",
17-Jan-25,Transportellaneous,133.07,00.00,"15,15,576.30",
17-Jan-25,Purchase,00.64,00.00,"15,15,576.94",
17-Jan-25,Reversal,00.00,"2,52,596.16","12,62,980.78",
17-Jan-25,IMPS,00.00,"2,10,496.80","10,52,483.98",
18-Jan-25,Commission,"23,945.45",00.00,"10,76,429.43",
18-Jan-25,Bill,42,00.00,"10,76,471.43",
18-Jan-25,Reversal,00.00,"3,58,823.81","7,17,647.62",
18-Jan-25,Debit Card,00.00,"1,43,529.52","5,74,118.10",
18-Jan-25,Transportellaneous,50.01,00.00,"5,74,168.11",
18-Jan-25,Debit Card,"1,306.80",00.00,"5,75,474.91",
18-Jan-25,Cheque,00.00,"1,15,094.98","4,60,379.93",
18-Jan-25,RTGS,00.00,"46,037.99","4,14,341.94",
18-Jan-25,Transfer,102.3,00.00,"4,14,444.24",
18-Jan-25,RTGS,00.00,"4,14,444.24",00.00,
18-Jan-25,Transportellaneous,"20,497.00",00.00,"20,497.00",
18-Jan-25,Transportellaneous,"13,23,676.25",00.00,"13,44,173.25",
18-Jan-25,Interest,"1,15,443.80",00.00,"14,59,617.05",
18-Jan-25,Cheque,"1,021.80",00.00,"14,60,638.85",
18-Jan-25,Transfer,00.00,"1,82,579.86","12,78,058.99",
18-Jan-25,Cheque,00.00,"12,78,058.99",00.00,
18-Jan-25,Commission,06.00,00.00,06.00,
18-Jan-25,Commission,01.00,00.00,07.00,
18-Jan-25,IMPS,00.00,02.33,04.67,
18-Jan-25,Interest,"12,678.00",00.00,"12,682.67",
18-Jan-25,Transportellaneous,207,00.00,"12,889.67",
18-Jan-25,Reversal,128,00.00,"13,017.67",
18-Jan-25,Interest,00.00,"1,446.41","11,571.26",
18-Jan-25,Purchase,00.00,"1,157.13","10,414.13",
18-Jan-25,Tax,00.00,"1,301.77","9,112.36",
18-Jan-25,Interest,"32,061.29",00.00,"41,173.65",
18-Jan-25,Tax,"3,101.30",00.00,"44,274.95",
18-Jan-25,RTGS,05.00,00.00,"44,279.95",
18-Jan-25,Bill,48,00.00,"44,327.95",
18-Jan-25,NEFT,00.00,"44,327.95",00.00,
18-Jan-25,RTGS,"2,375.60",00.00,"2,375.60",
18-Jan-25,IMPS,00.00,791.87,"1,583.73",
18-Jan-25,Debit Card,00.00,791.87,791.86,
18-Jan-25,Tax,00.00,79.19,712.67,
18-Jan-25,Transfer,335.92,00.00,"1,048.59",
18-Jan-25,IMPS,"1,22,841.78",00.00,"1,23,890.37",
18-Jan-25,Transportellaneous,00.00,"61,945.19","61,945.18",
18-Jan-25,Cash,"2,094.30",00.00,"64,039.48",
18-Jan-25,Reversal,00.00,"7,115.50","56,923.98",
18-Jan-25,Cash,00.00,"7,115.50","49,808.48",
18-Jan-25,Debit Card,"8,90,731.00",00.00,"9,40,539.48",
18-Jan-25,NEFT,00.00,"1,56,756.58","7,83,782.90",
18-Jan-25,IMPS,"16,145.90",00.00,"7,99,928.80",
18-Jan-25,Reversal,00.00,"1,99,982.20","5,99,946.60",
19-Jan-25,IMPS,00.00,"99,991.10","4,99,955.50",
19-Jan-25,Cash,471,00.00,"5,00,426.50",
19-Jan-25,Bill,00.00,"50,042.65","4,50,383.85",
19-Jan-25,Interest,00.00,"1,12,595.96","3,37,787.89",
19-Jan-25,Interest,00.00,"1,12,595.96","2,25,191.93",
19-Jan-25,IMPS,00.00,"37,531.99","1,87,659.94",
19-Jan-25,ATM,03.68,00.00,"1,87,663.62",
19-Jan-25,Tax,00.00,"20,851.51","1,66,812.11",
19-Jan-25,Tax,00.00,"33,362.42","1,33,449.69",
19-Jan-25,Commission,00.00,"19,064.24","1,14,385.45",
19-Jan-25,Commission,"7,05,134.00",00.00,"8,19,519.45",
19-Jan-25,Interest,"14,881.96",00.00,"8,34,401.41",
19-Jan-25,NEFT,134,00.00,"8,34,535.41",
19-Jan-25,Transfer,00.00,"2,78,178.47","5,56,356.94",
19-Jan-25,NEFT,00.00,"79,479.56","4,76,877.38",
19-Jan-25,Tax,"17,14,560.20",00.00,"21,91,437.58",
19-Jan-25,Commission,"3,94,978.00",00.00,"25,86,415.58",
19-Jan-25,Cash,00.00,"4,31,069.26","21,55,346.32",
19-Jan-25,Tax,00.00,"2,69,418.29","18,85,928.03",
19-Jan-25,Transportellaneous,00.00,"3,77,185.61","15,08,742.42",
19-Jan-25,IMPS,00.00,"2,15,534.63","12,93,207.79",
20-Jan-25,Commission,48.83,00.00,"12,93,256.62",
20-Jan-25,RTGS,00.00,"2,58,651.32","10,34,605.30",
20-Jan-25,ATM,00.00,"2,06,921.06","8,27,684.24",
20-Jan-25,Cheque,"1,34,491.00",00.00,"9,62,175.24",
20-Jan-25,ATM,00.00,"2,40,543.81","7,21,631.43",
20-Jan-25,Reversal,05.00,00.00,"7,21,636.43",
21-Jan-25,Cheque,75.8,00.00,"7,21,712.23",
21-Jan-25,Reversal,00.00,"1,03,101.75","6,18,610.48",
21-Jan-25,ATM,00.00,"77,326.31","5,41,284.17",
21-Jan-25,Reversal,00.00,"1,08,256.83","4,33,027.34",
21-Jan-25,Bill,00.00,"1,44,342.45","2,88,684.89",
21-Jan-25,Commission,00.00,"72,171.22","2,16,513.67",
21-Jan-25,RTGS,240.36,00.00,"2,16,754.03",
21-Jan-25,Debit Card,00.00,"30,964.86","1,85,789.17",
21-Jan-25,Cash,00.00,"30,964.86","1,54,824.31",
21-Jan-25,Reversal,"16,70,905.00",00.00,"18,25,729.31",
21-Jan-25,Debit Card,00.00,"18,25,729.31",00.00,
21-Jan-25,Transportellaneous,"2,030.00",00.00,"2,030.00",
21-Jan-25,Bill,00.00,290,"1,740.00",
21-Jan-25,Transportellaneous,00.00,217.5,"1,522.50",
21-Jan-25,Tax,00.00,507.5,"1,015.00",
21-Jan-25,RTGS,"2,47,352.69",00.00,"2,48,367.69",
21-Jan-25,Cheque,00.00,"24,836.77","2,23,530.92",
21-Jan-25,Interest,"3,708.00",00.00,"2,27,238.92",
21-Jan-25,Commission,"13,65,891.00",00.00,"15,93,129.92",
21-Jan-25,IMPS,05.59,00.00,"15,93,135.51",
21-Jan-25,Debit Card,00.00,"2,65,522.59","13,27,612.92",
21-Jan-25,NEFT,00.00,"4,42,537.64","8,85,075.28",
21-Jan-25,Bill,00.00,"2,21,268.82","6,63,806.46",
21-Jan-25,ATM,"1,71,835.44",00.00,"8,35,641.90",
21-Jan-25,Interest,00.00,"1,04,455.24","7,31,186.66",
21-Jan-25,Debit Card,"17,893.00",00.00,"7,49,079.66",
21-Jan-25,Purchase,00.00,"74,907.97","6,74,171.69",
21-Jan-25,Cheque,00.00,"1,34,834.34","5,39,337.35",
21-Jan-25,Cash,18.2,00.00,"5,39,355.55",
21-Jan-25,Debit Card,"1,45,270.00",00.00,"6,84,625.55",
21-Jan-25,NEFT,"2,961.00",00.00,"6,87,586.55",
21-Jan-25,Reversal,"3,184.20",00.00,"6,90,770.75",
21-Jan-25,NEFT,00.00,"69,077.08","6,21,693.68",
21-Jan-25,Commission,00.00,"1,55,423.42","4,66,270.26",
21-Jan-25,Transfer,00.00,"77,711.71","3,88,558.55",
21-Jan-25,Debit Card,00.00,"1,29,519.52","2,59,039.03",
21-Jan-25,Reversal,"1,37,828.20",00.00,"3,96,867.23",
21-Jan-25,Transportellaneous,00.00,"79,373.45","3,17,493.78",
21-Jan-25,Transfer,00.00,"45,356.25","2,72,137.53",
21-Jan-25,NEFT,34.54,00.00,"2,72,172.07",
21-Jan-25,Tax,17.11,00.00,"2,72,189.18",
21-Jan-25,Transportellaneous,"13,04,273.00",00.00,"15,76,462.18",
21-Jan-25,Cheque,00.00,"7,88,231.09","7,88,231.09",
21-Jan-25,Debit Card,"1,24,290.00",00.00,"9,12,521.09",
21-Jan-25,NEFT,04.63,00.00,"9,12,525.72",
21-Jan-25,RTGS,00.00,"4,56,262.86","4,56,262.86",
21-Jan-25,ATM,04.30,00.00,"4,56,267.16",
21-Jan-25,RTGS,03.40,00.00,"4,56,270.56",
21-Jan-25,NEFT,618,00.00,"4,56,888.56",
21-Jan-25,Reversal,00.00,"91,377.71","3,65,510.85",
21-Jan-25,Reversal,"2,56,755.34",00.00,"6,22,266.19",
21-Jan-25,Bill,00.00,"62,226.62","5,60,039.57",
21-Jan-25,RTGS,00.00,"70,004.95","4,90,034.62",
21-Jan-25,Interest,"43,922.20",00.00,"5,33,956.82",
21-Jan-25,Tax,05.40,00.00,"5,33,962.22",
21-Jan-25,Interest,00.00,"2,66,981.11","2,66,981.11",
21-Jan-25,Tax,"1,36,275.25",00.00,"4,03,256.36",
21-Jan-25,ATM,"20,56,637.00",00.00,"24,59,893.36",
21-Jan-25,Commission,"8,535.51",00.00,"24,68,428.87",
21-Jan-25,Purchase,"71,733.80",00.00,"25,40,162.67",
21-Jan-25,Interest,"1,56,691.00",00.00,"26,96,853.67",
21-Jan-25,Reversal,23.3,00.00,"26,96,876.97",
21-Jan-25,RTGS,00.00,"8,98,958.99","17,97,917.98",
21-Jan-25,Bill,00.00,"2,24,739.75","15,73,178.23",
21-Jan-25,Tax,49.37,00.00,"15,73,227.60",
22-Jan-25,Commission,00.00,"3,14,645.52","12,58,582.08",
22-Jan-25,RTGS,00.00,"2,09,763.68","10,48,818.40",
22-Jan-25,Cheque,327.34,00.00,"10,49,145.74",
22-Jan-25,Purchase,00.00,"1,49,877.96","8,99,267.78",
22-Jan-25,Cash,00.00,"1,12,408.47","7,86,859.31",
22-Jan-25,Commission,00.00,"2,62,286.44","5,24,572.87",
22-Jan-25,Reversal,181,00.00,"5,24,753.87",
22-Jan-25,IMPS,00.00,"1,74,917.96","3,49,835.91",
22-Jan-25,Interest,00.00,"69,967.18","2,79,868.73",
22-Jan-25,Commission,06.00,00.00,"2,79,874.73",
22-Jan-25,Bill,461.5,00.00,"2,80,336.23",
22-Jan-25,RTGS,28,00.00,"2,80,364.23",
22-Jan-25,Debit Card,"9,31,828.00",00.00,"12,12,192.23",
22-Jan-25,ATM,00.00,"2,42,438.45","9,69,753.78",
22-Jan-25,Bill,00.00,"1,61,625.63","8,08,128.15",
22-Jan-25,Cheque,"2,24,937.00",00.00,"10,33,065.15",
22-Jan-25,Cash,358.2,00.00,"10,33,423.35",
22-Jan-25,Transportellaneous,00.00,"1,03,342.34","9,30,081.02",
22-Jan-25,Commission,00.00,"4,65,040.51","4,65,040.51",
22-Jan-25,Purchase,464.3,00.00,"4,65,504.81",
22-Jan-25,Transportellaneous,00.00,"77,584.14","3,87,920.68",
22-Jan-25,Cash,00.00,"55,417.24","3,32,503.44",
22-Jan-25,Cheque,496.3,00.00,"3,32,999.74",
22-Jan-25,IMPS,00.00,"3,32,999.74",00.00,
22-Jan-25,Cash,"1,266.79",00.00,"1,266.79",
22-Jan-25,NEFT,"13,344.00",00.00,"14,610.79",
22-Jan-25,Tax,"2,06,081.00",00.00,"2,20,691.79",
22-Jan-25,Transfer,00.00,"1,10,345.90","1,10,345.90",
22-Jan-25,Cheque,00.00,"13,793.24","96,552.66",
23-Jan-25,Cash,00.00,"12,069.08","84,483.58",
23-Jan-25,Commission,"21,884.52",00.00,"1,06,368.10",
23-Jan-25,Transfer,00.00,"17,728.02","88,640.08",
23-Jan-25,Bill,00.00,"14,773.35","73,866.73",
23-Jan-25,IMPS,00.00,"10,552.39","63,314.34",
23-Jan-25,NEFT,00.00,"15,828.59","47,485.76",
23-Jan-25,ATM,"13,53,620.20",00.00,"14,01,105.96",
23-Jan-25,Transfer,470.9,00.00,"14,01,576.86",
23-Jan-25,Bill,"2,35,554.20",00.00,"16,37,131.06",
23-Jan-25,Tax,"2,22,983.00",00.00,"18,60,114.06",
23-Jan-25,ATM,22,00.00,"18,60,136.06",
23-Jan-25,Cheque,00.00,"1,86,013.61","16,74,122.45",
23-Jan-25,Debit Card,"21,568.10",00.00,"16,95,690.55",
23-Jan-25,Cheque,"3,161.00",00.00,"16,98,851.55",
23-Jan-25,Transportellaneous,"30,625.91",00.00,"17,29,477.46",
23-Jan-25,Purchase,00.00,"5,76,492.49","11,52,984.97",
23-Jan-25,IMPS,00.00,"1,64,712.14","9,88,272.83",
23-Jan-25,Bill,00.00,"98,827.28","8,89,445.55",
23-Jan-25,Debit Card,00.00,"98,827.28","7,90,618.27",
23-Jan-25,Debit Card,00.00,"1,97,654.57","5,92,963.70",
23-Jan-25,Commission,188.99,00.00,"5,93,152.69",
23-Jan-25,Interest,00.00,"5,93,152.69",00.00,
23-Jan-25,Cheque,"19,62,976.00",00.00,"19,62,976.00",
23-Jan-25,Bill,02.00,00.00,"19,62,978.00",
23-Jan-25,RTGS,41.69,00.00,"19,63,019.69",
23-Jan-25,Transportellaneous,00.00,"2,18,113.30","17,44,906.39",
23-Jan-25,Purchase,00.00,"4,36,226.60","13,08,679.79",
23-Jan-25,RTGS,381.1,00.00,"13,09,060.89",
23-Jan-25,Tax,"5,000.30",00.00,"13,14,061.19",
23-Jan-25,Debit Card,00.00,"1,64,257.65","11,49,803.54",
23-Jan-25,Reversal,403,00.00,"11,50,206.54",
23-Jan-25,Cash,00.00,"2,87,551.64","8,62,654.90",
23-Jan-25,Transportellaneous,00.00,"95,850.54","7,66,804.36",
23-Jan-25,NEFT,00.00,"1,91,701.09","5,75,103.27",
23-Jan-25,Cheque,"17,86,537.20",00.00,"23,61,640.47",
24-Jan-25,Reversal,00.00,"4,72,328.09","18,89,312.38",
24-Jan-25,Cash,37.3,00.00,"18,89,349.68",
24-Jan-25,Purchase,00.00,"9,44,674.84","9,44,674.84",
24-Jan-25,Interest,00.00,"1,04,963.87","8,39,710.97",
24-Jan-25,RTGS,46.6,00.00,"8,39,757.57",
24-Jan-25,Cheque,00.00,"1,67,951.51","6,71,806.06",
24-Jan-25,IMPS,"3,207.00",00.00,"6,75,013.06",
24-Jan-25,Transportellaneous,110.8,00.00,"6,75,123.86",
24-Jan-25,Purchase,"32,313.40",00.00,"7,07,437.26",
24-Jan-25,Commission,00.00,"1,41,487.45","5,65,949.81",
24-Jan-25,NEFT,00.00,"1,13,189.96","4,52,759.85",
24-Jan-25,Cash,"2,17,762.30",00.00,"6,70,522.15",
24-Jan-25,Purchase,"8,70,820.00",00.00,"15,41,342.15",
24-Jan-25,Cash,00.00,"1,54,134.22","13,87,207.93",
24-Jan-25,ATM,00.00,"2,31,201.32","11,56,006.61",
24-Jan-25,Cash,"15,52,501.25",00.00,"27,08,507.86",
24-Jan-25,Interest,00.00,"13,54,253.93","13,54,253.93",
24-Jan-25,ATM,"2,43,964.00",00.00,"15,98,217.93",
24-Jan-25,Cheque,"10,38,688.50",00.00,"26,36,906.43",
24-Jan-25,Interest,35.1,00.00,"26,36,941.53",
24-Jan-25,Purchase,"17,96,378.00",00.00,"44,33,319.53",
24-Jan-25,Bill,"2,46,966.70",00.00,"46,80,286.23",
24-Jan-25,Debit Card,33,00.00,"46,80,319.23",
25-Jan-25,Transfer,00.00,"4,68,031.92","42,12,287.31",
25-Jan-25,Cheque,00.00,"42,12,287.31",00.00,
25-Jan-25,Commission,"8,080.64",00.00,"8,080.64",
25-Jan-25,Commission,00.00,"1,010.08","7,070.56",
25-Jan-25,Cheque,"3,38,526.25",00.00,"3,45,596.81",
25-Jan-25,Interest,00.00,"43,199.60","3,02,397.21",
25-Jan-25,Interest,"14,909.00",00.00,"3,17,306.21",
25-Jan-25,Tax,00.00,"52,884.37","2,64,421.84",
25-Jan-25,Tax,"18,465.00",00.00,"2,82,886.84",
25-Jan-25,RTGS,00.00,"31,431.87","2,51,454.97",
25-Jan-25,NEFT,00.00,"2,51,454.97",00.00,
25-Jan-25,Tax,06.83,00.00,06.83,
25-Jan-25,Commission,00.00,06.83,00.00,
25-Jan-25,Bill,59,00.00,59,
25-Jan-25,Debit Card,"1,74,952.22",00.00,"1,75,011.22",
25-Jan-25,Tax,00.00,"19,445.69","1,55,565.53",
25-Jan-25,IMPS,00.00,"22,223.65","1,33,341.88",
25-Jan-25,Transfer,00.00,"44,447.29","88,894.59",
25-Jan-25,Bill,138,00.00,"89,032.59",
25-Jan-25,Cheque,00.00,"14,838.77","74,193.82",
25-Jan-25,Bill,"28,582.66",00.00,"1,02,776.48",
25-Jan-25,Reversal,05.11,00.00,"1,02,781.59",
25-Jan-25,Debit Card,14.61,00.00,"1,02,796.20",
25-Jan-25,Debit Card,00.00,"1,02,796.20",00.00,
25-Jan-25,RTGS,26.6,00.00,26.6,
25-Jan-25,Transfer,07.30,00.00,33.9,
25-Jan-25,Commission,"1,05,727.34",00.00,"1,05,761.24",
25-Jan-25,Tax,00.00,"52,880.62","52,880.62",
25-Jan-25,Cash,32,00.00,"52,912.62",
25-Jan-25,RTGS,00.00,"17,637.54","35,275.08",
25-Jan-25,Tax,00.00,"11,758.36","23,516.72",
25-Jan-25,IMPS,00.00,"2,939.59","20,577.13",
25-Jan-25,Purchase,"8,64,947.00",00.00,"8,85,524.13",
25-Jan-25,Cheque,00.00,"88,552.41","7,96,971.72",
25-Jan-25,IMPS,00.00,"1,59,394.34","6,37,577.38",
25-Jan-25,IMPS,00.00,"79,697.17","5,57,880.21",
25-Jan-25,RTGS,"1,19,542.25",00.00,"6,77,422.46",
25-Jan-25,Interest,"1,34,397.00",00.00,"8,11,819.46",
25-Jan-25,Tax,00.00,"2,70,606.49","5,41,212.97",
25-Jan-25,Commission,00.00,"54,121.30","4,87,091.67",
25-Jan-25,RTGS,"1,595.00",00.00,"4,88,686.67",
25-Jan-25,Cheque,00.00,"69,812.38","4,18,874.29",
25-Jan-25,Reversal,00.00,"52,359.29","3,66,515.00",
25-Jan-25,IMPS,"3,483.57",00.00,"3,69,998.57",
25-Jan-25,ATM,"2,49,067.50",00.00,"6,19,066.07",
25-Jan-25,Cheque,133,00.00,"6,19,199.07",
25-Jan-25,IMPS,"8,081.00",00.00,"6,27,280.07",
25-Jan-25,RTGS,487,00.00,"6,27,767.07",
25-Jan-25,ATM,"7,50,463.00",00.00,"13,78,230.07",
25-Jan-25,Debit Card,"1,923.00",00.00,"13,80,153.07",
25-Jan-25,Debit Card,03.64,00.00,"13,80,156.71",
25-Jan-25,Cheque,00.00,"13,80,156.71",00.00,
25-Jan-25,NEFT,"2,12,168.28",00.00,"2,12,168.28",
25-Jan-25,ATM,00.00,"30,309.75","1,81,858.53",
25-Jan-25,IMPS,00.00,"25,979.79","1,55,878.74",
25-Jan-25,ATM,00.00,"77,939.37","77,939.37",
25-Jan-25,Debit Card,00.00,"12,989.90","64,949.48",
25-Jan-25,Tax,00.00,"16,237.37","48,712.11",
25-Jan-25,RTGS,275,00.00,"48,987.11",
25-Jan-25,Debit Card,00.00,"6,998.16","41,988.95",
25-Jan-25,Interest,00.00,"6,998.16","34,990.79",
25-Jan-25,Debit Card,108.92,00.00,"35,099.71",
25-Jan-25,IMPS,00.00,"11,699.90","23,399.81",
25-Jan-25,IMPS,20,00.00,"23,419.81",
25-Jan-25,Reversal,00.00,"3,903.30","19,516.51",
25-Jan-25,Debit Card,00.00,"9,758.26","9,758.25",
25-Jan-25,Debit Card,00.00,"1,951.65","7,806.60",
25-Jan-25,Purchase,"12,101.60",00.00,"19,908.20",
25-Jan-25,Tax,00.00,"6,636.07","13,272.13",
25-Jan-25,Debit Card,00.00,"2,212.02","11,060.11",
25-Jan-25,IMPS,00.00,"1,106.01","9,954.10",
25-Jan-25,RTGS,03.31,00.00,"9,957.41",
25-Jan-25,ATM,00.00,"9,957.41",00.00,
25-Jan-25,RTGS,"12,440.70",00.00,"12,440.70",
25-Jan-25,Commission,"1,890.00",00.00,"14,330.70",
25-Jan-25,IMPS,358.5,00.00,"14,689.20",
25-Jan-25,Tax,00.00,"3,672.30","11,016.90",
25-Jan-25,Tax,00.00,"2,203.38","8,813.52",
25-Jan-25,Bill,00.00,881.35,"7,932.17",
25-Jan-25,Cash,00.00,"1,133.17","6,799.00",
25-Jan-25,ATM,"34,402.90",00.00,"41,201.90",
25-Jan-25,Commission,"14,200.00",00.00,"55,401.90",
25-Jan-25,IMPS,00.00,"13,850.48","41,551.43",
25-Jan-25,Cheque,274.7,00.00,"41,826.13",
25-Jan-25,NEFT,00.00,"10,456.53","31,369.60",
25-Jan-25,Cash,00.00,"7,842.40","23,527.20",
25-Jan-25,Tax,"14,23,351.75",00.00,"14,46,878.95",
25-Jan-25,Cheque,00.00,"2,06,696.99","12,40,181.96",
25-Jan-25,ATM,00.00,"1,24,018.20","11,16,163.76",
25-Jan-25,RTGS,00.00,"5,58,081.88","5,58,081.88",
25-Jan-25,Reversal,00.70,00.00,"5,58,082.58",
25-Jan-25,IMPS,00.00,"55,808.26","5,02,274.32",
25-Jan-25,Purchase,"1,00,296.00",00.00,"6,02,570.32",
25-Jan-25,IMPS,00.00,"1,20,514.06","4,82,056.26",
25-Jan-25,IMPS,54,00.00,"4,82,110.26",
25-Jan-25,Reversal,00.00,"48,211.03","4,33,899.23",
25-Jan-25,Interest,00.00,"2,16,949.62","2,16,949.62",
25-Jan-25,Transfer,00.00,"36,158.27","1,80,791.35",
25-Jan-25,Reversal,00.00,"90,395.68","90,395.68",
25-Jan-25,Cheque,"1,04,440.00",00.00,"1,94,835.68",
25-Jan-25,Bill,"1,678.00",00.00,"1,96,513.68",
25-Jan-25,Interest,"1,832.80",00.00,"1,98,346.48",
25-Jan-25,Purchase,00.00,"49,586.62","1,48,759.86",
25-Jan-25,IMPS,00.00,"24,793.31","1,23,966.55",
25-Jan-25,Tax,"8,05,129.25",00.00,"9,29,095.80",
25-Jan-25,Cash,"3,878.00",00.00,"9,32,973.80",
25-Jan-25,Reversal,00.00,"93,297.38","8,39,676.42",
26-Jan-25,RTGS,03.00,00.00,"8,39,679.42",
26-Jan-25,Transportellaneous,440,00.00,"8,40,119.42",
26-Jan-25,Cheque,00.00,"2,10,029.86","6,30,089.57",
26-Jan-25,Bill,04.40,00.00,"6,30,093.97",
26-Jan-25,ATM,00.00,"70,010.44","5,60,083.53",
27-Jan-25,Cheque,"14,81,391.25",00.00,"20,41,474.78",
27-Jan-25,Tax,00.00,"2,26,830.53","18,14,644.25",
27-Jan-25,Commission,00.00,"3,02,440.71","15,12,203.54",
27-Jan-25,Reversal,"16,74,730.50",00.00,"31,86,934.04",
27-Jan-25,NEFT,189.5,00.00,"31,87,123.54",
27-Jan-25,Debit Card,"5,44,004.00",00.00,"37,31,127.54",
27-Jan-25,Transportellaneous,00.00,"4,66,390.94","32,64,736.60",
27-Jan-25,Bill,12.6,00.00,"32,64,749.20",
27-Jan-25,NEFT,00.00,"8,16,187.30","24,48,561.90",
27-Jan-25,Debit Card,00.00,"12,24,280.95","12,24,280.95",
27-Jan-25,Reversal,"2,06,600.34",00.00,"14,30,881.29",
27-Jan-25,Transfer,47.71,00.00,"14,30,929.00",
27-Jan-25,RTGS,"2,16,731.00",00.00,"16,47,660.00",
27-Jan-25,Interest,40,00.00,"16,47,700.00",
28-Jan-25,RTGS,"13,70,645.75",00.00,"30,18,345.75",
28-Jan-25,Interest,"1,394.30",00.00,"30,19,740.05",
28-Jan-25,Reversal,00.00,"3,01,974.01","27,17,766.04",
28-Jan-25,Purchase,00.00,"3,39,720.76","23,78,045.28",
28-Jan-25,IMPS,00.00,"11,89,022.64","11,89,022.64",
28-Jan-25,Commission,00.00,"1,98,170.44","9,90,852.20",
28-Jan-25,Reversal,00.00,"2,47,713.05","7,43,139.15",
28-Jan-25,NEFT,00.00,"7,43,139.15",00.00,
28-Jan-25,Cheque,135.7,00.00,135.7,
28-Jan-25,ATM,00.00,45.23,90.47,
28-Jan-25,Bill,00.00,00.00,90.47,
28-Jan-25,Bill,"1,21,307.00",00.00,"1,21,397.47",
28-Jan-25,Reversal,"1,997.23",00.00,"1,23,394.70",
28-Jan-25,Cash,00.00,"12,339.47","1,11,055.23",
28-Jan-25,Commission,24.12,00.00,"1,11,079.35",
28-Jan-25,ATM,00.00,"18,513.23","92,566.12",
28-Jan-25,Cheque,00.00,"11,570.77","80,995.36",
28-Jan-25,Interest,"4,46,536.00",00.00,"5,27,531.36",
28-Jan-25,Tax,00.00,"58,614.60","4,68,916.76",
28-Jan-25,RTGS,284.3,00.00,"4,69,201.06",
28-Jan-25,Cash,00.00,"93,840.21","3,75,360.85",
28-Jan-25,ATM,"19,297.00",00.00,"3,94,657.85",
28-Jan-25,Transfer,00.00,"78,931.57","3,15,726.28",
28-Jan-25,Debit Card,00.00,"1,05,242.09","2,10,484.19",
28-Jan-25,Transportellaneous,38.3,00.00,"2,10,522.49",
28-Jan-25,RTGS,00.00,"30,074.64","1,80,447.85",
28-Jan-25,NEFT,00.00,"30,074.64","1,50,373.21",
28-Jan-25,Purchase,00.00,"1,50,373.21",00.00,
28-Jan-25,Cheque,03.24,00.00,03.24,
28-Jan-25,Reversal,"1,89,411.00",00.00,"1,89,414.24",
28-Jan-25,Cash,"2,474.00",00.00,"1,91,888.24",
28-Jan-25,ATM,00.00,"31,981.37","1,59,906.87",
28-Jan-25,RTGS,29.99,00.00,"1,59,936.86",
28-Jan-25,Bill,00.00,"39,984.22","1,19,952.64",
28-Jan-25,Cheque,00.00,"19,992.11","99,960.53",
28-Jan-25,IMPS,00.00,"16,660.09","83,300.44",
28-Jan-25,ATM,"51,412.00",00.00,"1,34,712.44",
28-Jan-25,Cash,00.00,"19,244.63","1,15,467.81",
28-Jan-25,ATM,06.76,00.00,"1,15,474.57",
28-Jan-25,Purchase,94,00.00,"1,15,568.57",
28-Jan-25,Tax,"84,822.50",00.00,"2,00,391.07",
28-Jan-25,Commission,00.00,"1,00,195.54","1,00,195.54",
28-Jan-25,Commission,06.68,00.00,"1,00,202.22",
28-Jan-25,Commission,"1,895.80",00.00,"1,02,098.02",
28-Jan-25,Purchase,00.00,"20,419.60","81,678.42",
28-Jan-25,Reversal,108,00.00,"81,786.42",
28-Jan-25,Transportellaneous,"2,464.90",00.00,"84,251.32",
29-Jan-25,Bill,00.00,"8,425.13","75,826.19",
29-Jan-25,Interest,00.00,"18,956.55","56,869.64",
29-Jan-25,Tax,00.00,"9,478.27","47,391.37",
29-Jan-25,Bill,00.00,"15,797.12","31,594.25",
29-Jan-25,Transfer,00.00,"10,531.42","21,062.83",
29-Jan-25,Commission,"3,629.30",00.00,"24,692.13",
29-Jan-25,Interest,336.66,00.00,"25,028.79",
29-Jan-25,ATM,33,00.00,"25,061.79",
29-Jan-25,NEFT,00.00,"12,530.90","12,530.90",
29-Jan-25,IMPS,17.6,00.00,"12,548.50",
29-Jan-25,RTGS,00.00,"1,568.56","10,979.94",
29-Jan-25,Commission,66.1,00.00,"11,046.04",
29-Jan-25,IMPS,00.00,"1,578.01","9,468.03",
29-Jan-25,IMPS,"14,33,714.75",00.00,"14,43,182.78",
29-Jan-25,Tax,00.00,"2,06,168.97","12,37,013.81",
29-Jan-25,Transfer,"1,901.02",00.00,"12,38,914.83",
29-Jan-25,IMPS,05.00,00.00,"12,38,919.83",
29-Jan-25,Cheque,00.00,"12,38,919.83",00.00,
29-Jan-25,IMPS,04.86,00.00,04.86,
29-Jan-25,Transfer,"3,886.30",00.00,"3,891.16",
29-Jan-25,NEFT,"2,01,866.62",00.00,"2,05,757.78",
29-Jan-25,IMPS,"34,583.10",00.00,"2,40,340.88",
29-Jan-25,Bill,00.00,"48,068.18","1,92,272.70",
29-Jan-25,RTGS,00.00,"32,045.45","1,60,227.25",
29-Jan-25,ATM,243.8,00.00,"1,60,471.05",
29-Jan-25,Transfer,00.00,"40,117.76","1,20,353.29",
29-Jan-25,Commission,00.00,"60,176.65","60,176.64",
29-Jan-25,Transportellaneous,"10,12,177.25",00.00,"10,72,353.89",
29-Jan-25,Commission,07.00,00.00,"10,72,360.89",
29-Jan-25,Purchase,51.53,00.00,"10,72,412.42",
29-Jan-25,Tax,00.00,"2,14,482.48","8,57,929.94",
29-Jan-25,Debit Card,00.00,"2,85,976.65","5,71,953.29",
29-Jan-25,ATM,"5,17,270.00",00.00,"10,89,223.29",
29-Jan-25,RTGS,00.00,"10,89,223.29",00.00,
29-Jan-25,Commission,"1,953.50",00.00,"1,953.50",
29-Jan-25,Interest,"24,325.86",00.00,"26,279.36",
29-Jan-25,Transfer,00.00,"3,754.19","22,525.17",
29-Jan-25,Commission,33.76,00.00,"22,558.93",
29-Jan-25,IMPS,00.00,"2,819.87","19,739.06",
29-Jan-25,Tax,00.00,"9,869.53","9,869.53",
29-Jan-25,Debit Card,00.00,"1,644.92","8,224.61",
29-Jan-25,Reversal,"25,809.00",00.00,"34,033.61",
29-Jan-25,NEFT,11.6,00.00,"34,045.21",
29-Jan-25,Interest,00.00,"3,404.52","30,640.69",
29-Jan-25,ATM,"1,67,023.00",00.00,"1,97,663.69",
29-Jan-25,IMPS,00.00,"49,415.92","1,48,247.77",
29-Jan-25,ATM,00.00,"37,061.94","1,11,185.83",
29-Jan-25,Cheque,644,00.00,"1,11,829.83",
29-Jan-25,Transfer,423,00.00,"1,12,252.83",
29-Jan-25,Transfer,00.00,"56,126.42","56,126.42",
29-Jan-25,Purchase,"3,912.32",00.00,"60,038.74",
29-Jan-25,RTGS,47.1,00.00,"60,085.84",
29-Jan-25,Cheque,00.45,00.00,"60,086.29",
29-Jan-25,Cash,"13,97,456.80",00.00,"14,57,543.09",
29-Jan-25,ATM,00.00,"2,42,923.85","12,14,619.24",
29-Jan-25,Cash,"1,479.30",00.00,"12,16,098.54",
29-Jan-25,Transfer,00.00,"1,52,012.32","10,64,086.22",
29-Jan-25,Transportellaneous,01.10,00.00,"10,64,087.32",
29-Jan-25,Debit Card,"2,04,455.00",00.00,"12,68,542.32",
29-Jan-25,Commission,00.00,"1,58,567.79","11,09,974.53",
29-Jan-25,IMPS,633.7,00.00,"11,10,608.23",
29-Jan-25,Interest,62.8,00.00,"11,10,671.03",
29-Jan-25,Bill,"1,028.00",00.00,"11,11,699.03",
29-Jan-25,ATM,00.00,"5,55,849.52","5,55,849.52",
29-Jan-25,Tax,643.71,00.00,"5,56,493.23",
29-Jan-25,Reversal,00.00,"79,499.03","4,76,994.20",
29-Jan-25,Reversal,00.00,"52,999.36","4,23,994.84",
29-Jan-25,Commission,00.20,00.00,"4,23,995.04",
29-Jan-25,NEFT,30.35,00.00,"4,24,025.39",
29-Jan-25,Debit Card,00.00,"2,12,012.70","2,12,012.70",
29-Jan-25,Tax,00.00,"30,287.53","1,81,725.17",
29-Jan-25,ATM,00.00,"60,575.06","1,21,150.11",
29-Jan-25,Bill,00.00,"30,287.53","90,862.58",
29-Jan-25,IMPS,"1,59,470.00",00.00,"2,50,332.58",
29-Jan-25,Interest,00.00,"31,291.57","2,19,041.01",
29-Jan-25,Interest,00.00,"24,337.89","1,94,703.12",
29-Jan-25,Cheque,00.00,"21,633.68","1,73,069.44",
29-Jan-25,Reversal,"58,644.34",00.00,"2,31,713.78",
29-Jan-25,Debit Card,29,00.00,"2,31,742.78",
29-Jan-25,NEFT,27.7,00.00,"2,31,770.48",
29-Jan-25,Transportellaneous,"19,199.00",00.00,"2,50,969.48",
29-Jan-25,Debit Card,00.00,"50,193.90","2,00,775.58",
29-Jan-25,Cheque,00.00,"1,00,387.79","1,00,387.79",
29-Jan-25,NEFT,44.84,00.00,"1,00,432.63",
29-Jan-25,Cash,00.00,"50,216.32","50,216.32",
29-Jan-25,ATM,"11,52,233.00",00.00,"12,02,449.32",
29-Jan-25,Transfer,06.70,00.00,"12,02,456.02",
30-Jan-25,Tax,"18,88,030.20",00.00,"30,90,486.22",
30-Jan-25,Commission,00.00,"4,41,498.03","26,48,988.19",
30-Jan-25,ATM,"3,21,531.80",00.00,"29,70,519.99",
30-Jan-25,Cash,00.00,"2,97,052.00","26,73,467.99",
30-Jan-25,ATM,"96,928.20",00.00,"27,70,396.19",
30-Jan-25,ATM,482.1,00.00,"27,70,878.29",
30-Jan-25,Commission,05.55,00.00,"27,70,883.84",
30-Jan-25,NEFT,00.00,"5,54,176.77","22,16,707.07",
30-Jan-25,Commission,806.07,00.00,"22,17,513.14",
30-Jan-25,Interest,00.00,"4,43,502.63","17,74,010.51",
30-Jan-25,Commission,60,00.00,"17,74,070.51",
30-Jan-25,Purchase,"1,25,621.00",00.00,"18,99,691.51",
30-Jan-25,Purchase,00.00,"2,11,076.83","16,88,614.68",
30-Jan-25,Cash,"18,899.80",00.00,"17,07,514.48",
30-Jan-25,Bill,00.00,"3,41,502.90","13,66,011.58",
30-Jan-25,Purchase,00.00,"13,66,011.58",00.00,
30-Jan-25,RTGS,"1,815.00",00.00,"1,815.00",
30-Jan-25,Cash,67.33,00.00,"1,882.33",
30-Jan-25,Purchase,"64,593.00",00.00,"66,475.33",
30-Jan-25,Purchase,12.63,00.00,"66,487.96",
30-Jan-25,Bill,00.00,"13,297.59","53,190.37",
30-Jan-25,Purchase,00.00,"5,910.04","47,280.33",
30-Jan-25,Tax,00.00,"4,728.03","42,552.30",
30-Jan-25,IMPS,"3,232.00",00.00,"45,784.30",
30-Jan-25,RTGS,00.00,"45,784.30",00.00,
30-Jan-25,Reversal,07.00,00.00,07.00,
31-Jan-25,Cheque,00.00,00.88,06.12,
31-Jan-25,Bill,06.60,00.00,12.72,
31-Jan-25,Cheque,37.9,00.00,50.62,
31-Jan-25,Debit Card,"3,887.90",00.00,"3,938.52",
31-Jan-25,Cash,00.00,656.42,"3,282.10",
01-Feb-25,Bill,02.70,00.00,"3,284.80",
01-Feb-25,Cheque,"20,13,110.25",00.00,"20,16,395.05",
01-Feb-25,NEFT,28.9,00.00,"20,16,423.95",
02-Feb-25,RTGS,03.85,00.00,"20,16,427.80",
02-Feb-25,Cash,"93,309.19",00.00,"21,09,736.99",
02-Feb-25,Interest,07.00,00.00,"21,09,743.99",
02-Feb-25,Transfer,00.00,"21,09,743.99",00.00,
02-Feb-25,Purchase,"2,835.90",00.00,"2,835.90",
02-Feb-25,Bill,"1,04,756.56",00.00,"1,07,592.46",
02-Feb-25,Interest,00.00,"17,932.08","89,660.38",
02-Feb-25,ATM,00.00,"9,962.26","79,698.12",
02-Feb-25,Transfer,00.00,"13,283.02","66,415.10",
02-Feb-25,Tax,00.00,"66,415.10",00.00,
02-Feb-25,Bill,"20,84,927.25",00.00,"20,84,927.25",
02-Feb-25,IMPS,00.00,"2,97,846.75","17,87,080.50",
02-Feb-25,Commission,00.00,"5,95,693.50","11,91,387.00",
02-Feb-25,Bill,00.00,"1,48,923.38","10,42,463.62",
02-Feb-25,ATM,00.00,"1,73,743.94","8,68,719.68",
02-Feb-25,NEFT,06.25,00.00,"8,68,725.93",
03-Feb-25,Debit Card,00.00,"1,73,745.19","6,94,980.74",
03-Feb-25,Cash,"8,642.00",00.00,"7,03,622.74",
03-Feb-25,Cheque,"1,32,877.00",00.00,"8,36,499.74",
03-Feb-25,Cash,42.07,00.00,"8,36,541.81",
03-Feb-25,RTGS,00.00,"1,67,308.36","6,69,233.45",
03-Feb-25,Cash,06.10,00.00,"6,69,239.55",
03-Feb-25,IMPS,00.00,"83,654.94","5,85,584.61",
03-Feb-25,Purchase,595,00.00,"5,86,179.61",
03-Feb-25,Bill,00.00,"65,131.07","5,21,048.54",
04-Feb-25,Transfer,"17,95,243.50",00.00,"23,16,292.04",
04-Feb-25,Interest,"3,34,603.00",00.00,"26,50,895.04",
04-Feb-25,Transportellaneous,00.44,00.00,"26,50,895.48",
04-Feb-25,Reversal,00.00,"6,62,723.87","19,88,171.61",
04-Feb-25,Reversal,07.00,00.00,"19,88,178.61",
04-Feb-25,Cash,19,00.00,"19,88,197.61",
04-Feb-25,ATM,00.00,"2,84,028.23","17,04,169.38",
04-Feb-25,Purchase,00.00,"2,13,021.17","14,91,148.21",
04-Feb-25,Reversal,"2,00,424.20",00.00,"16,91,572.41",
04-Feb-25,NEFT,366,00.00,"16,91,938.41",
04-Feb-25,Bill,00.00,"8,45,969.21","8,45,969.20",
04-Feb-25,Bill,00.00,"1,05,746.15","7,40,223.05",
04-Feb-25,ATM,368.62,00.00,"7,40,591.67",
04-Feb-25,Interest,"12,50,996.00",00.00,"19,91,587.67",
04-Feb-25,Interest,14,00.00,"19,91,601.67",
05-Feb-25,Debit Card,"6,38,513.75",00.00,"26,30,115.42",
05-Feb-25,Transportellaneous,"4,60,887.50",00.00,"30,91,002.92",
05-Feb-25,Transportellaneous,00.00,"15,45,501.46","15,45,501.46",
05-Feb-25,Tax,00.00,"3,09,100.29","12,36,401.17",
05-Feb-25,Tax,00.00,"3,09,100.29","9,27,300.88",
05-Feb-25,Interest,"13,945.00",00.00,"9,41,245.88",
05-Feb-25,ATM,"76,275.00",00.00,"10,17,520.88",
05-Feb-25,Transportellaneous,00.00,"10,17,520.88",00.00,
05-Feb-25,Reversal,"20,44,088.00",00.00,"20,44,088.00",
05-Feb-25,ATM,00.00,"2,55,511.00","17,88,577.00",
05-Feb-25,Transportellaneous,52.8,00.00,"17,88,629.80",
05-Feb-25,RTGS,427.68,00.00,"17,89,057.48",
05-Feb-25,Cheque,00.00,"5,96,352.49","11,92,704.99",
06-Feb-25,NEFT,00.00,"5,96,352.50","5,96,352.50",
06-Feb-25,Tax,00.00,"1,98,784.17","3,97,568.33",
06-Feb-25,Tax,00.00,"79,513.67","3,18,054.66",
06-Feb-25,Purchase,00.00,"63,610.93","2,54,443.73",
06-Feb-25,Reversal,00.00,"25,444.37","2,28,999.36",
06-Feb-25,Reversal,09.86,00.00,"2,29,009.22",
06-Feb-25,Purchase,00.00,"76,336.41","1,52,672.81",
06-Feb-25,NEFT,00.00,"19,084.10","1,33,588.71",
06-Feb-25,Purchase,617.2,00.00,"1,34,205.91",
06-Feb-25,NEFT,00.00,"19,172.27","1,15,033.64",
06-Feb-25,NEFT,100,00.00,"1,15,133.64",
06-Feb-25,ATM,00.00,"14,391.71","1,00,741.94",
06-Feb-25,Bill,00.00,"10,074.19","90,667.75",
06-Feb-25,Purchase,07.00,00.00,"90,674.75",
06-Feb-25,Commission,00.00,"90,674.75",00.00,
06-Feb-25,Reversal,"11,48,918.80",00.00,"11,48,918.80",
06-Feb-25,Reversal,"34,378.56",00.00,"11,83,297.36",
06-Feb-25,Bill,"26,853.20",00.00,"12,10,150.56",
06-Feb-25,ATM,01.00,00.00,"12,10,151.56",
06-Feb-25,Transfer,00.00,"1,21,015.16","10,89,136.40",
06-Feb-25,Debit Card,00.00,"1,21,015.16","9,68,121.24",
06-Feb-25,Debit Card,00.00,"4,84,060.62","4,84,060.62",
06-Feb-25,NEFT,00.00,"60,507.58","4,23,553.04",
06-Feb-25,Commission,21.68,00.00,"4,23,574.72",
06-Feb-25,Tax,"3,744.30",00.00,"4,27,319.02",
06-Feb-25,ATM,00.00,"85,463.80","3,41,855.22",
06-Feb-25,Debit Card,00.00,"56,975.87","2,84,879.35",
06-Feb-25,Bill,00.00,"47,479.89","2,37,399.46",
06-Feb-25,Purchase,00.00,"79,133.15","1,58,266.31",
06-Feb-25,Commission,00.00,"79,133.16","79,133.16",
07-Feb-25,Cash,00.00,"39,566.58","39,566.58",
07-Feb-25,ATM,01.90,00.00,"39,568.48",
07-Feb-25,RTGS,"2,479.00",00.00,"42,047.48",
07-Feb-25,Debit Card,00.00,"10,511.87","31,535.61",
07-Feb-25,Cheque,"3,093.61",00.00,"34,629.22",
07-Feb-25,Bill,19.9,00.00,"34,649.12",
07-Feb-25,Cheque,53.62,00.00,"34,702.74",
07-Feb-25,NEFT,"85,319.41",00.00,"1,20,022.15",
08-Feb-25,Interest,00.00,"30,005.54","90,016.61",
08-Feb-25,Cash,00.00,"15,002.77","75,013.84",
08-Feb-25,IMPS,35.82,00.00,"75,049.66",
08-Feb-25,Bill,00.00,"9,381.21","65,668.45",
08-Feb-25,NEFT,00.00,"13,133.69","52,534.76",
08-Feb-25,Debit Card,00.00,"26,267.38","26,267.38",
08-Feb-25,IMPS,00.00,"4,377.90","21,889.48",
08-Feb-25,NEFT,00.00,"3,648.25","18,241.23",
08-Feb-25,ATM,"2,164.00",00.00,"20,405.23",
08-Feb-25,Cheque,00.00,"2,040.52","18,364.71",
08-Feb-25,Cash,00.00,"4,591.18","13,773.53",
08-Feb-25,Transportellaneous,996,00.00,"14,769.53",
08-Feb-25,ATM,04.20,00.00,"14,773.73",
08-Feb-25,Cash,00.00,"7,386.87","7,386.86",
08-Feb-25,Transfer,00.00,"1,055.27","6,331.59",
08-Feb-25,Transportellaneous,05.70,00.00,"6,337.29",
08-Feb-25,Commission,"78,986.10",00.00,"85,323.39",
08-Feb-25,Cheque,04.60,00.00,"85,327.99",
08-Feb-25,Cheque,"3,813.50",00.00,"89,141.49",
08-Feb-25,Transfer,"23,619.00",00.00,"1,12,760.49",
08-Feb-25,Bill,00.00,"56,380.25","56,380.24",
08-Feb-25,Transportellaneous,"20,39,528.00",00.00,"20,95,908.24",
08-Feb-25,NEFT,00.00,"2,99,415.46","17,96,492.78",
09-Feb-25,Bill,"46,502.00",00.00,"18,42,994.78",
10-Feb-25,Transfer,229.41,00.00,"18,43,224.19",
10-Feb-25,Bill,"3,01,338.75",00.00,"21,44,562.94",
10-Feb-25,Transportellaneous,00.00,"5,36,140.74","16,08,422.20",
10-Feb-25,Bill,"2,12,230.03",00.00,"18,20,652.23",
10-Feb-25,RTGS,00.00,"2,02,294.69","16,18,357.54",
11-Feb-25,Purchase,00.00,"8,09,178.77","8,09,178.77",
11-Feb-25,IMPS,00.00,"2,69,726.26","5,39,452.51",
11-Feb-25,Interest,216.9,00.00,"5,39,669.41",
11-Feb-25,IMPS,00.00,"5,39,669.41",00.00,
11-Feb-25,Transportellaneous,"14,558.00",00.00,"14,558.00",
11-Feb-25,Cheque,"18,28,654.00",00.00,"18,43,212.00",
11-Feb-25,Transfer,00.00,"3,68,642.40","14,74,569.60",
11-Feb-25,Transfer,00.00,"7,37,284.80","7,37,284.80",
11-Feb-25,Debit Card,00.00,"92,160.60","6,45,124.20",
11-Feb-25,Interest,00.00,"1,29,024.84","5,16,099.36",
11-Feb-25,NEFT,"6,948.00",00.00,"5,23,047.36",
11-Feb-25,Tax,00.00,"1,74,349.12","3,48,698.24",
11-Feb-25,Reversal,00.00,"58,116.37","2,90,581.87",
11-Feb-25,RTGS,00.00,"96,860.62","1,93,721.25",
11-Feb-25,Tax,"2,33,167.50",00.00,"4,26,888.75",
11-Feb-25,Tax,00.00,"4,26,888.75",00.00,
12-Feb-25,Transfer,"27,141.90",00.00,"27,141.90",
12-Feb-25,IMPS,"1,21,868.00",00.00,"1,49,009.90",
12-Feb-25,ATM,"18,170.00",00.00,"1,67,179.90",
12-Feb-25,Cheque,52,00.00,"1,67,231.90",
12-Feb-25,Debit Card,00.00,"55,743.97","1,11,487.93",
12-Feb-25,Interest,926.7,00.00,"1,12,414.63",
13-Feb-25,NEFT,00.00,"11,241.46","1,01,173.17",
13-Feb-25,ATM,00.00,"14,453.31","86,719.86",
13-Feb-25,Interest,"2,48,384.00",00.00,"3,35,103.86",
13-Feb-25,Cheque,00.00,"41,887.98","2,93,215.88",
13-Feb-25,Transportellaneous,00.00,"36,651.99","2,56,563.90",
13-Feb-25,Transfer,"12,545.50",00.00,"2,69,109.40",
13-Feb-25,Transfer,364.1,00.00,"2,69,473.50",
13-Feb-25,Cash,00.00,"26,947.35","2,42,526.15",
13-Feb-25,Interest,00.00,"60,631.54","1,81,894.61",
13-Feb-25,Bill,"8,72,682.00",00.00,"10,54,576.61",
13-Feb-25,Cheque,"16,23,301.75",00.00,"26,77,878.36",
13-Feb-25,IMPS,00.00,"26,77,878.36",00.00,
13-Feb-25,Transfer,"52,013.00",00.00,"52,013.00",
13-Feb-25,Transfer,00.35,00.00,"52,013.35",
13-Feb-25,Interest,"5,541.90",00.00,"57,555.25",
13-Feb-25,Cash,00.00,"6,395.03","51,160.22",
13-Feb-25,IMPS,00.00,"12,790.06","38,370.16",
13-Feb-25,Debit Card,113,00.00,"38,483.16",
13-Feb-25,Transportellaneous,"8,426.00",00.00,"46,909.16",
13-Feb-25,Tax,00.00,"11,727.29","35,181.87",
13-Feb-25,ATM,49.5,00.00,"35,231.37",
13-Feb-25,Reversal,00.00,"35,231.37",00.00,
13-Feb-25,Cheque,14.53,00.00,14.53,
13-Feb-25,Transportellaneous,"1,677.70",00.00,"1,692.23",
13-Feb-25,RTGS,00.00,564.08,"1,128.15",
13-Feb-25,ATM,"12,653.34",00.00,"13,781.49",
13-Feb-25,Tax,"12,49,938.00",00.00,"12,63,719.49",
13-Feb-25,Commission,00.00,"1,26,371.95","11,37,347.54",
14-Feb-25,Tax,"1,17,703.00",00.00,"12,55,050.54",
14-Feb-25,Commission,"1,09,569.00",00.00,"13,64,619.54",
14-Feb-25,Commission,45,00.00,"13,64,664.54",
14-Feb-25,Cash,00.00,"2,27,444.09","11,37,220.45",
14-Feb-25,Commission,00.00,"1,42,152.56","9,95,067.89",
14-Feb-25,Bill,"2,701.15",00.00,"9,97,769.04",
14-Feb-25,Interest,00.00,"3,32,589.68","6,65,179.36",
14-Feb-25,Commission,00.00,"3,32,589.68","3,32,589.68",
14-Feb-25,Tax,00.00,"66,517.94","2,66,071.74",
14-Feb-25,Debit Card,"1,93,094.90",00.00,"4,59,166.64",
14-Feb-25,Debit Card,00.00,"65,595.23","3,93,571.41",
14-Feb-25,RTGS,"7,62,504.00",00.00,"11,56,075.41",
14-Feb-25,IMPS,00.00,"1,65,153.63","9,90,921.78",
14-Feb-25,NEFT,"8,703.00",00.00,"9,99,624.78",
14-Feb-25,Transportellaneous,00.00,"1,11,069.42","8,88,555.36",
14-Feb-25,Transportellaneous,"2,31,276.40",00.00,"11,19,831.76",
15-Feb-25,Commission,"13,108.10",00.00,"11,32,939.86",
15-Feb-25,RTGS,"47,581.60",00.00,"11,80,521.46",
15-Feb-25,RTGS,"1,29,138.10",00.00,"13,09,659.56",
15-Feb-25,Cheque,00.00,"4,36,553.19","8,73,106.37",
15-Feb-25,NEFT,15.9,00.00,"8,73,122.27",
15-Feb-25,RTGS,"28,590.90",00.00,"9,01,713.17",
15-Feb-25,NEFT,31.33,00.00,"9,01,744.50",
15-Feb-25,Commission,00.00,"9,01,744.50",00.00,
15-Feb-25,Reversal,61,00.00,61,
15-Feb-25,Tax,"1,78,244.38",00.00,"1,78,305.38",
16-Feb-25,Cash,"1,81,514.84",00.00,"3,59,820.22",
16-Feb-25,Cash,00.00,"51,402.89","3,08,417.33",
16-Feb-25,Transfer,"25,934.69",00.00,"3,34,352.02",
16-Feb-25,Tax,"1,04,389.75",00.00,"4,38,741.77",
16-Feb-25,Transfer,01.90,00.00,"4,38,743.67",
16-Feb-25,ATM,"16,80,143.50",00.00,"21,18,887.17",
16-Feb-25,Transfer,74.4,00.00,"21,18,961.57",
16-Feb-25,Interest,"2,03,131.00",00.00,"23,22,092.57",
16-Feb-25,Commission,"2,37,468.80",00.00,"25,59,561.37",
16-Feb-25,Reversal,00.00,"3,65,651.62","21,93,909.75",
16-Feb-25,IMPS,00.00,"2,19,390.98","19,74,518.78",
16-Feb-25,Purchase,00.00,"19,74,518.78",00.00,
16-Feb-25,Bill,"12,57,520.00",00.00,"12,57,520.00",
16-Feb-25,Cheque,00.00,"1,57,190.00","11,00,330.00",
16-Feb-25,RTGS,129,00.00,"11,00,459.00",
16-Feb-25,ATM,"1,062.00",00.00,"11,01,521.00",
16-Feb-25,Reversal,"3,397.00",00.00,"11,04,918.00",
17-Feb-25,Cheque,00.00,"3,68,306.00","7,36,612.00",
17-Feb-25,Debit Card,"13,24,024.20",00.00,"20,60,636.20",
17-Feb-25,Debit Card,"4,186.00",00.00,"20,64,822.20",
18-Feb-25,Transportellaneous,00.00,"6,88,274.07","13,76,548.13",
18-Feb-25,Commission,00.00,"2,29,424.69","11,47,123.44",
18-Feb-25,Reversal,"2,04,051.40",00.00,"13,51,174.84",
18-Feb-25,Purchase,90,00.00,"13,51,264.84",
18-Feb-25,Transportellaneous,"3,45,512.75",00.00,"16,96,777.59",
18-Feb-25,Transportellaneous,00.00,"2,12,097.20","14,84,680.39",
18-Feb-25,Bill,"31,183.00",00.00,"15,15,863.39",
18-Feb-25,Interest,00.00,"3,03,172.68","12,12,690.71",
18-Feb-25,Transportellaneous,"5,378.90",00.00,"12,18,069.61",
18-Feb-25,Transportellaneous,00.00,"6,09,034.81","6,09,034.81",
18-Feb-25,Transfer,250.1,00.00,"6,09,284.91",
18-Feb-25,Tax,00.00,"67,698.32","5,41,586.59",
18-Feb-25,Bill,44.41,00.00,"5,41,631.00",
18-Feb-25,Interest,00.00,"67,703.88","4,73,927.12",
18-Feb-25,ATM,00.00,"1,18,481.78","3,55,445.34",
18-Feb-25,Tax,00.00,"44,430.67","3,11,014.67",
19-Feb-25,Commission,04.00,00.00,"3,11,018.67",
19-Feb-25,ATM,00.00,"34,557.63","2,76,461.04",
19-Feb-25,Transfer,03.15,00.00,"2,76,464.19",
19-Feb-25,Tax,00.00,"34,558.02","2,41,906.17",
19-Feb-25,Reversal,00.00,"80,635.39","1,61,270.78",
19-Feb-25,Commission,18,00.00,"1,61,288.78",
19-Feb-25,Bill,"85,605.00",00.00,"2,46,893.78",
19-Feb-25,Commission,00.00,"49,378.76","1,97,515.02",
19-Feb-25,ATM,"2,03,625.00",00.00,"4,01,140.02",
19-Feb-25,Interest,00.00,"2,00,570.01","2,00,570.01",
19-Feb-25,Debit Card,00.00,"25,071.25","1,75,498.76",
19-Feb-25,Transportellaneous,"22,967.60",00.00,"1,98,466.36",
19-Feb-25,Commission,00.00,"22,051.82","1,76,414.54",
19-Feb-25,Commission,"1,153.60",00.00,"1,77,568.14",
19-Feb-25,Commission,"29,642.25",00.00,"2,07,210.39",
20-Feb-25,Cheque,00.00,"25,901.30","1,81,309.09",
20-Feb-25,Commission,00.00,"25,901.30","1,55,407.79",
20-Feb-25,Interest,363.4,00.00,"1,55,771.19",
20-Feb-25,Transportellaneous,"1,75,155.20",00.00,"3,30,926.39",
20-Feb-25,Transfer,"16,29,853.00",00.00,"19,60,779.39",
20-Feb-25,Commission,00.00,"1,96,077.94","17,64,701.45",
20-Feb-25,Tax,79,00.00,"17,64,780.45",
20-Feb-25,Transfer,00.00,"8,82,390.23","8,82,390.22",
20-Feb-25,Tax,00.00,"1,76,478.04","7,05,912.18",
20-Feb-25,Bill,00.00,"7,05,912.18",00.00,
20-Feb-25,Commission,"2,223.00",00.00,"2,223.00",
20-Feb-25,IMPS,00.00,"1,111.50","1,111.50",
20-Feb-25,Interest,128,00.00,"1,239.50",
20-Feb-25,Purchase,00.00,123.95,"1,115.55",
20-Feb-25,Bill,04.00,00.00,"1,119.55",
20-Feb-25,Tax,00.00,186.59,932.96,
20-Feb-25,Cheque,00.00,233.24,699.72,
20-Feb-25,Transportellaneous,00.00,349.86,349.86,
20-Feb-25,Tax,00.00,38.87,310.99,
20-Feb-25,Cash,00.00,31.1,279.89,
20-Feb-25,IMPS,00.00,39.98,239.91,
20-Feb-25,Commission,00.00,26.66,213.25,
20-Feb-25,Transfer,00.00,106.63,106.62,
20-Feb-25,Cash,00.00,17.77,88.85,
20-Feb-25,Debit Card,"2,820.40",00.00,"2,909.25",
20-Feb-25,ATM,04.17,00.00,"2,913.42",
20-Feb-25,RTGS,12.09,00.00,"2,925.51",
20-Feb-25,IMPS,"24,469.00",00.00,"27,394.51",
21-Feb-25,Transfer,"17,01,823.00",00.00,"17,29,217.51",
21-Feb-25,Commission,00.00,"2,88,202.92","14,41,014.59",
21-Feb-25,Purchase,00.00,"3,60,253.65","10,80,760.94",
21-Feb-25,NEFT,00.00,"3,60,253.65","7,20,507.29",
21-Feb-25,Tax,"29,169.20",00.00,"7,49,676.49",
21-Feb-25,NEFT,00.00,"93,709.56","6,55,966.93",
21-Feb-25,RTGS,"55,789.44",00.00,"7,11,756.37",
21-Feb-25,Reversal,"1,37,163.00",00.00,"8,48,919.37",
21-Feb-25,RTGS,"15,40,725.00",00.00,"23,89,644.37",
21-Feb-25,Transportellaneous,00.00,"3,98,274.06","19,91,370.31",
21-Feb-25,Cheque,955.45,00.00,"19,92,325.76",
21-Feb-25,IMPS,"1,75,522.00",00.00,"21,67,847.76",
21-Feb-25,Transfer,00.00,"3,09,692.54","18,58,155.22",
21-Feb-25,Debit Card,53.8,00.00,"18,58,209.02",
21-Feb-25,Debit Card,00.00,"1,85,820.90","16,72,388.12",
21-Feb-25,Tax,00.00,"2,38,912.59","14,33,475.53",
21-Feb-25,Bill,00.00,"1,79,184.44","12,54,291.09",
21-Feb-25,Commission,00.00,"3,13,572.77","9,40,718.32",
21-Feb-25,Reversal,00.00,"1,56,786.39","7,83,931.93",
21-Feb-25,ATM,00.00,"2,61,310.64","5,22,621.29",
21-Feb-25,Tax,389.4,00.00,"5,23,010.69",
21-Feb-25,Transfer,00.00,"52,301.07","4,70,709.62",
21-Feb-25,IMPS,00.00,"78,451.60","3,92,258.02",
21-Feb-25,Transportellaneous,"11,41,911.00",00.00,"15,34,169.02",
21-Feb-25,Cash,21.2,00.00,"15,34,190.22",
21-Feb-25,NEFT,00.00,"2,19,170.03","13,15,020.19",
21-Feb-25,NEFT,"2,66,514.50",00.00,"15,81,534.69",
21-Feb-25,RTGS,04.02,00.00,"15,81,538.71",
21-Feb-25,NEFT,00.00,"2,63,589.79","13,17,948.92",
21-Feb-25,Cash,"2,389.00",00.00,"13,20,337.92",
21-Feb-25,Cheque,00.00,"1,88,619.70","11,31,718.22",
21-Feb-25,Transportellaneous,00.00,"1,13,171.82","10,18,546.40",
21-Feb-25,NEFT,00.00,"2,54,636.60","7,63,909.80",
22-Feb-25,Purchase,45.8,00.00,"7,63,955.60",
22-Feb-25,Transportellaneous,00.00,"7,63,955.60",00.00,
22-Feb-25,Cheque,03.60,00.00,03.60,
22-Feb-25,Commission,00.00,01.20,02.40,
22-Feb-25,Debit Card,00.00,00.60,01.80,
22-Feb-25,Interest,00.00,00.23,01.58,
22-Feb-25,NEFT,"1,942.00",00.00,"1,943.58",
22-Feb-25,Reversal,00.00,242.95,"1,700.63",
22-Feb-25,Transfer,00.00,212.58,"1,488.05",
22-Feb-25,Reversal,00.00,186.01,"1,302.04",
22-Feb-25,IMPS,"3,86,470.20",00.00,"3,87,772.24",
22-Feb-25,Bill,48,00.00,"3,87,820.24",
22-Feb-25,Debit Card,"11,224.06",00.00,"3,99,044.30",
22-Feb-25,Interest,00.00,"3,99,044.30",00.00,
22-Feb-25,Interest,"2,07,953.20",00.00,"2,07,953.20",
22-Feb-25,Transportellaneous,"20,91,395.00",00.00,"22,99,348.20",
22-Feb-25,ATM,00.00,"4,59,869.64","18,39,478.56",
22-Feb-25,Debit Card,00.00,"2,62,782.65","15,76,695.91",
22-Feb-25,Purchase,00.00,"15,76,695.91",00.00,
22-Feb-25,Cheque,"17,26,862.00",00.00,"17,26,862.00",
22-Feb-25,Commission,00.00,"2,46,694.57","14,80,167.43",
22-Feb-25,Reversal,00.00,"2,11,452.49","12,68,714.94",
22-Feb-25,RTGS,00.00,"1,26,871.49","11,41,843.45",
22-Feb-25,Interest,246,00.00,"11,42,089.45",
22-Feb-25,Debit Card,"1,22,112.00",00.00,"12,64,201.45",
22-Feb-25,ATM,00.00,"1,40,466.83","11,23,734.62",
22-Feb-25,Purchase,00.00,"1,24,859.40","9,98,875.22",
22-Feb-25,Transportellaneous,42.7,00.00,"9,98,917.92",
22-Feb-25,Purchase,05.70,00.00,"9,98,923.62",
22-Feb-25,IMPS,00.00,"4,99,461.81","4,99,461.81",
22-Feb-25,Tax,00.00,"2,49,730.91","2,49,730.90",
22-Feb-25,RTGS,"1,294.00",00.00,"2,51,024.90",
22-Feb-25,Reversal,00.00,"25,102.49","2,25,922.41",
22-Feb-25,Commission,00.00,"75,307.47","1,50,614.94",
22-Feb-25,Debit Card,00.00,"50,204.98","1,00,409.96",
22-Feb-25,ATM,00.00,"12,551.25","87,858.72",
22-Feb-25,Cheque,00.00,"29,286.24","58,572.48",
22-Feb-25,NEFT,01.00,00.00,"58,573.48",
22-Feb-25,Transfer,00.00,"58,573.48",00.00,
22-Feb-25,Commission,"23,560.58",00.00,"23,560.58",
22-Feb-25,Interest,00.00,"5,890.15","17,670.44",
22-Feb-25,Interest,00.00,"4,417.61","13,252.83",
22-Feb-25,Tax,"1,23,080.00",00.00,"1,36,332.83",
22-Feb-25,Cheque,00.00,"22,722.14","1,13,610.69",
22-Feb-25,Purchase,00.00,"37,870.23","75,740.46",
22-Feb-25,NEFT,"14,46,065.50",00.00,"15,21,805.96",
22-Feb-25,NEFT,19,00.00,"15,21,824.96",
22-Feb-25,Bill,00.00,"1,69,091.66","13,52,733.30",
22-Feb-25,Purchase,00.49,00.00,"13,52,733.79",
22-Feb-25,NEFT,00.00,"1,93,247.68","11,59,486.11",
22-Feb-25,RTGS,480,00.00,"11,59,966.11",
22-Feb-25,Cheque,00.00,"3,86,655.37","7,73,310.74",
22-Feb-25,Cheque,00.00,"77,331.07","6,95,979.67",
22-Feb-25,Debit Card,00.00,"69,597.97","6,26,381.70",
22-Feb-25,Bill,462.2,00.00,"6,26,843.90",
22-Feb-25,Transfer,00.00,"69,649.32","5,57,194.58",
22-Feb-25,Transfer,"32,376.32",00.00,"5,89,570.90",
22-Feb-25,Interest,43.9,00.00,"5,89,614.80",
22-Feb-25,IMPS,00.00,"1,96,538.27","3,93,076.53",
22-Feb-25,Transportellaneous,00.00,"43,675.17","3,49,401.36",
22-Feb-25,NEFT,42.18,00.00,"3,49,443.54",
22-Feb-25,Reversal,"18,021.46",00.00,"3,67,465.00",
22-Feb-25,ATM,"41,790.00",00.00,"4,09,255.00",
22-Feb-25,NEFT,"21,525.10",00.00,"4,30,780.10",
22-Feb-25,Cash,00.00,"2,15,390.05","2,15,390.05",
22-Feb-25,Reversal,"14,83,928.50",00.00,"16,99,318.55",
22-Feb-25,Debit Card,"1,342.47",00.00,"17,00,661.02",
22-Feb-25,Bill,"2,30,426.00",00.00,"19,31,087.02",
22-Feb-25,Transportellaneous,00.00,"9,65,543.51","9,65,543.51",
22-Feb-25,Reversal,00.00,"9,65,543.51",00.00,
22-Feb-25,Interest,"11,98,739.00",00.00,"11,98,739.00",
22-Feb-25,Cheque,"64,447.60",00.00,"12,63,186.60",
22-Feb-25,Transfer,"10,272.75",00.00,"12,73,459.35",
22-Feb-25,Purchase,57,00.00,"12,73,516.35",
22-Feb-25,Debit Card,00.00,"4,24,505.45","8,49,010.90",
22-Feb-25,NEFT,"29,347.12",00.00,"8,78,358.02",
23-Feb-25,Transportellaneous,03.39,00.00,"8,78,361.41",
23-Feb-25,Purchase,00.00,"1,46,393.57","7,31,967.84",
23-Feb-25,Cheque,00.00,"73,196.78","6,58,771.06",
23-Feb-25,NEFT,00.00,"65,877.11","5,92,893.95",
23-Feb-25,RTGS,00.00,"59,289.40","5,33,604.55",
23-Feb-25,Transportellaneous,00.00,"1,77,868.18","3,55,736.37",
23-Feb-25,Interest,00.00,"71,147.27","2,84,589.10",
23-Feb-25,RTGS,00.00,"31,621.01","2,52,968.09",
23-Feb-25,Bill,39,00.00,"2,53,007.09",
23-Feb-25,Commission,02.00,00.00,"2,53,009.09",
23-Feb-25,Debit Card,01.28,00.00,"2,53,010.37",
23-Feb-25,Transfer,00.00,"84,336.79","1,68,673.58",
23-Feb-25,Commission,00.00,"16,867.36","1,51,806.22",
23-Feb-25,RTGS,"2,488.10",00.00,"1,54,294.32",
23-Feb-25,Bill,"12,74,402.25",00.00,"14,28,696.57",
23-Feb-25,Transfer,"31,024.81",00.00,"14,59,721.38",
24-Feb-25,Purchase,"3,63,200.00",00.00,"18,22,921.38",
24-Feb-25,Bill,00.00,"3,03,820.23","15,19,101.15",
24-Feb-25,IMPS,00.00,"2,17,014.45","13,02,086.70",
24-Feb-25,RTGS,00.00,"1,30,208.67","11,71,878.03",
24-Feb-25,Transportellaneous,26.12,00.00,"11,71,904.15",
25-Feb-25,Reversal,00.00,"5,85,952.08","5,85,952.07",
25-Feb-25,Commission,264,00.00,"5,86,216.07",
25-Feb-25,Tax,00.00,"97,702.68","4,88,513.39",
25-Feb-25,IMPS,421,00.00,"4,88,934.39",
25-Feb-25,ATM,00.00,"1,22,233.60","3,66,700.79",
25-Feb-25,NEFT,00.00,"45,837.60","3,20,863.19",
25-Feb-25,RTGS,529,00.00,"3,21,392.19",
25-Feb-25,RTGS,04.20,00.00,"3,21,396.39",
25-Feb-25,Transportellaneous,00.00,"3,21,396.39",00.00,
25-Feb-25,RTGS,"92,141.80",00.00,"92,141.80",
25-Feb-25,Reversal,00.00,"23,035.45","69,106.35",
25-Feb-25,Debit Card,00.00,"11,517.73","57,588.63",
25-Feb-25,IMPS,04.00,00.00,"57,592.63",
26-Feb-25,Interest,"7,89,329.00",00.00,"8,46,921.63",
26-Feb-25,Interest,00.00,"8,46,921.63",00.00,
27-Feb-25,Reversal,"2,52,063.80",00.00,"2,52,063.80",
27-Feb-25,Transportellaneous,00.00,"1,26,031.90","1,26,031.90",
27-Feb-25,Transfer,"10,50,068.00",00.00,"11,76,099.90",
27-Feb-25,Transfer,00.00,"2,94,024.98","8,82,074.92",
27-Feb-25,Debit Card,00.00,"1,76,414.98","7,05,659.94",
27-Feb-25,Bill,00.00,"3,52,829.97","3,52,829.97",
27-Feb-25,Reversal,239.7,00.00,"3,53,069.67",
27-Feb-25,Cash,20,00.00,"3,53,089.67",
27-Feb-25,Cheque,00.00,"1,17,696.56","2,35,393.11",
27-Feb-25,NEFT,80.65,00.00,"2,35,473.76",
27-Feb-25,ATM,04.80,00.00,"2,35,478.56",
27-Feb-25,Reversal,"18,820.19",00.00,"2,54,298.75",
27-Feb-25,Reversal,"1,211.00",00.00,"2,55,509.75",
27-Feb-25,Debit Card,504,00.00,"2,56,013.75",
27-Feb-25,Reversal,00.00,"85,337.92","1,70,675.83",
28-Feb-25,Reversal,00.00,"24,382.26","1,46,293.57",
28-Feb-25,NEFT,"1,305.02",00.00,"1,47,598.59",
28-Feb-25,Bill,"7,061.13",00.00,"1,54,659.72",
28-Feb-25,Transportellaneous,00.00,"25,776.62","1,28,883.10",
28-Feb-25,IMPS,00.00,"21,480.52","1,07,402.58",
28-Feb-25,Debit Card,"20,44,637.80",00.00,"21,52,040.38",
28-Feb-25,Debit Card,05.00,00.00,"21,52,045.38",
28-Feb-25,Cash,00.00,"5,38,011.35","16,14,034.04",
28-Feb-25,Tax,487,00.00,"16,14,521.04",
28-Feb-25,Reversal,323.3,00.00,"16,14,844.34",
28-Feb-25,Commission,00.00,"2,30,692.05","13,84,152.29",
28-Feb-25,RTGS,"1,836.01",00.00,"13,85,988.30",
28-Feb-25,Tax,06.70,00.00,"13,85,995.00",
28-Feb-25,Reversal,"71,756.00",00.00,"14,57,751.00",
28-Feb-25,IMPS,245.36,00.00,"14,57,996.36",
01-Mar-25,ATM,00.00,"2,91,599.27","11,66,397.09",
01-Mar-25,Interest,00.00,"11,66,397.09",00.00,
01-Mar-25,IMPS,"15,01,463.00",00.00,"15,01,463.00",
01-Mar-25,Cheque,01.20,00.00,"15,01,464.20",
01-Mar-25,Debit Card,368.5,00.00,"15,01,832.70",
01-Mar-25,Cash,00.00,"3,00,366.54","12,01,466.16",
01-Mar-25,Cash,51.28,00.00,"12,01,517.44",
01-Mar-25,IMPS,33.86,00.00,"12,01,551.30",
01-Mar-25,RTGS,37,00.00,"12,01,588.30",
01-Mar-25,Cheque,"3,637.00",00.00,"12,05,225.30",
01-Mar-25,Interest,"12,993.40",00.00,"12,18,218.70",
01-Mar-25,Commission,"15,923.00",00.00,"12,34,141.70",
01-Mar-25,Commission,07.90,00.00,"12,34,149.60",
01-Mar-25,NEFT,00.00,"2,05,691.60","10,28,458.00",
01-Mar-25,ATM,00.00,"1,02,845.80","9,25,612.20",
01-Mar-25,NEFT,00.00,"1,54,268.70","7,71,343.50",
01-Mar-25,RTGS,"3,995.35",00.00,"7,75,338.85",
01-Mar-25,Debit Card,"2,141.00",00.00,"7,77,479.85",
01-Mar-25,Debit Card,00.00,"97,184.98","6,80,294.87",
01-Mar-25,Interest,"2,07,924.00",00.00,"8,88,218.87",
01-Mar-25,NEFT,00.00,"4,44,109.44","4,44,109.44",
01-Mar-25,ATM,"1,975.00",00.00,"4,46,084.44",
01-Mar-25,Cheque,196,00.00,"4,46,280.44",
01-Mar-25,Cash,00.00,"55,785.06","3,90,495.38",
01-Mar-25,Interest,01.35,00.00,"3,90,496.73",
01-Mar-25,Purchase,"3,952.76",00.00,"3,94,449.49",
01-Mar-25,Transportellaneous,379.2,00.00,"3,94,828.69",
01-Mar-25,Interest,00.00,"78,965.74","3,15,862.95",
01-Mar-25,Commission,"82,707.80",00.00,"3,98,570.75",
01-Mar-25,Cash,07.90,00.00,"3,98,578.65",
01-Mar-25,Transportellaneous,04.00,00.00,"3,98,582.65",
01-Mar-25,NEFT,00.00,"1,99,291.33","1,99,291.32",
01-Mar-25,Debit Card,"3,767.00",00.00,"2,03,058.32",
01-Mar-25,Transfer,00.00,"33,843.05","1,69,215.27",
01-Mar-25,Commission,00.00,"1,69,215.27",00.00,
01-Mar-25,Transfer,"4,059.40",00.00,"4,059.40",
01-Mar-25,Reversal,00.00,451.04,"3,608.36",
01-Mar-25,RTGS,61,00.00,"3,669.36",
01-Mar-25,Debit Card,"13,654.00",00.00,"17,323.36",
01-Mar-25,Interest,00.00,"17,323.36",00.00,
01-Mar-25,Interest,01.90,00.00,01.90,
01-Mar-25,Interest,"1,81,838.00",00.00,"1,81,839.90",
01-Mar-25,Purchase,00.00,"45,459.98","1,36,379.92",
01-Mar-25,Reversal,02.74,00.00,"1,36,382.66",
01-Mar-25,Cheque,00.00,"22,730.44","1,13,652.22",
01-Mar-25,Transfer,04.00,00.00,"1,13,656.22",
01-Mar-25,ATM,317.3,00.00,"1,13,973.52",
01-Mar-25,Interest,"3,715.37",00.00,"1,17,688.89",
01-Mar-25,Reversal,00.00,"29,422.22","88,266.67",
02-Mar-25,Cheque,00.00,"22,066.67","66,200.00",
02-Mar-25,NEFT,44.6,00.00,"66,244.60",
02-Mar-25,Debit Card,00.00,"11,040.77","55,203.83",
02-Mar-25,Purchase,00.00,"55,203.83",00.00,
02-Mar-25,Cheque,13.35,00.00,13.35,
02-Mar-25,Reversal,00.00,01.67,11.68,
02-Mar-25,Tax,00.00,02.34,09.34,
02-Mar-25,Debit Card,00.00,01.04,08.30,
02-Mar-25,Tax,214,00.00,222.3,
02-Mar-25,Purchase,00.00,31.76,190.54,
02-Mar-25,Bill,"2,573.23",00.00,"2,763.77",
02-Mar-25,NEFT,00.00,345.47,"2,418.30",
02-Mar-25,Reversal,"19,056.60",00.00,"21,474.90",
02-Mar-25,Cheque,00.00,"2,386.10","19,088.80",
02-Mar-25,Transfer,"2,220.71",00.00,"21,309.51",
02-Mar-25,NEFT,00.00,"4,261.90","17,047.61",
02-Mar-25,NEFT,00.00,"5,682.54","11,365.07",
02-Mar-25,Commission,"2,388.64",00.00,"13,753.71",
02-Mar-25,RTGS,27.1,00.00,"13,780.81",
02-Mar-25,Reversal,00.00,"1,722.60","12,058.21",
02-Mar-25,Reversal,05.00,00.00,"12,063.21",
02-Mar-25,Debit Card,463.3,00.00,"12,526.51",
02-Mar-25,Purchase,00.00,"2,087.75","10,438.76",
02-Mar-25,RTGS,"4,28,479.25",00.00,"4,38,918.01",
02-Mar-25,Cheque,"15,753.10",00.00,"4,54,671.11",
02-Mar-25,Cheque,00.00,"56,833.89","3,97,837.22",
02-Mar-25,ATM,00.00,"79,567.44","3,18,269.78",
03-Mar-25,Transportellaneous,00.00,"31,826.98","2,86,442.80",
03-Mar-25,Commission,"8,55,956.00",00.00,"11,42,398.80",
03-Mar-25,Bill,462,00.00,"11,42,860.80",
03-Mar-25,IMPS,"19,43,061.50",00.00,"30,85,922.30",
03-Mar-25,Transportellaneous,00.00,"10,28,640.77","20,57,281.53",
03-Mar-25,Cash,00.00,"2,57,160.19","18,00,121.34",
03-Mar-25,RTGS,00.00,"18,00,121.34",00.00,
03-Mar-25,Cash,"7,25,584.50",00.00,"7,25,584.50",
03-Mar-25,RTGS,00.00,"7,25,584.50",00.00,
03-Mar-25,Tax,"1,17,345.00",00.00,"1,17,345.00",
03-Mar-25,ATM,07.71,00.00,"1,17,352.71",
03-Mar-25,Interest,00.00,"29,338.18","88,014.53",
03-Mar-25,IMPS,"1,162.30",00.00,"89,176.83",
03-Mar-25,Reversal,"59,430.60",00.00,"1,48,607.43",
03-Mar-25,NEFT,00.00,"1,48,607.43",00.00,
03-Mar-25,Cheque,03.10,00.00,03.10,
03-Mar-25,Tax,00.00,00.78,02.33,
03-Mar-25,Tax,00.00,00.58,01.75,
03-Mar-25,Transfer,00.00,00.58,01.17,
03-Mar-25,ATM,"29,619.00",00.00,"29,620.17",
03-Mar-25,Cash,"19,29,649.00",00.00,"19,59,269.17",
04-Mar-25,IMPS,08.00,00.00,"19,59,277.17",
04-Mar-25,NEFT,100.34,00.00,"19,59,377.51",
04-Mar-25,NEFT,00.00,"9,79,688.76","9,79,688.76",
04-Mar-25,Transportellaneous,00.00,"4,89,844.38","4,89,844.38",
04-Mar-25,IMPS,"3,893.84",00.00,"4,93,738.22",
04-Mar-25,Debit Card,00.00,"49,373.82","4,44,364.40",
04-Mar-25,Purchase,"2,958.92",00.00,"4,47,323.32",
04-Mar-25,IMPS,00.00,"1,49,107.77","2,98,215.55",
04-Mar-25,Transportellaneous,00.00,"29,821.56","2,68,394.00",
04-Mar-25,NEFT,"1,301.00",00.00,"2,69,695.00",
05-Mar-25,Purchase,00.00,"38,527.86","2,31,167.14",
05-Mar-25,Transfer,"55,578.00",00.00,"2,86,745.14",
05-Mar-25,Cash,06.70,00.00,"2,86,751.84",
05-Mar-25,ATM,00.00,"47,791.97","2,38,959.87",
05-Mar-25,Commission,00.00,"59,739.97","1,79,219.90",
05-Mar-25,IMPS,"9,32,733.25",00.00,"11,11,953.15",
05-Mar-25,Transportellaneous,00.00,"1,58,850.45","9,53,102.70",
05-Mar-25,IMPS,04.00,00.00,"9,53,106.70",
05-Mar-25,Cash,00.00,"1,05,900.74","8,47,205.96",
05-Mar-25,Reversal,"3,902.25",00.00,"8,51,108.21",
05-Mar-25,Commission,00.00,"85,110.82","7,65,997.39",
05-Mar-25,Transfer,"1,66,631.72",00.00,"9,32,629.11",
05-Mar-25,IMPS,"1,10,448.44",00.00,"10,43,077.55",
05-Mar-25,Cheque,00.00,"5,21,538.78","5,21,538.78",
05-Mar-25,Transfer,582.5,00.00,"5,22,121.28",
05-Mar-25,Transfer,00.00,"5,22,121.28",00.00,
05-Mar-25,Transportellaneous,00.70,00.00,00.70,
05-Mar-25,Tax,00.00,00.70,00.00,
05-Mar-25,Interest,08.00,00.00,08.00,
05-Mar-25,RTGS,"1,159.38",00.00,"1,167.38",
05-Mar-25,Bill,52,00.00,"1,219.38",
05-Mar-25,NEFT,"20,27,337.20",00.00,"20,28,556.58",
05-Mar-25,Transportellaneous,"1,94,312.00",00.00,"22,22,868.58",
05-Mar-25,Reversal,38,00.00,"22,22,906.58",
05-Mar-25,ATM,31.5,00.00,"22,22,938.08",
05-Mar-25,Commission,00.00,"3,17,562.58","19,05,375.50",
05-Mar-25,Interest,"74,250.00",00.00,"19,79,625.50",
05-Mar-25,Reversal,00.00,"2,82,803.64","16,96,821.86",
05-Mar-25,RTGS,"6,76,656.00",00.00,"23,73,477.86",
05-Mar-25,Cheque,02.00,00.00,"23,73,479.86",
05-Mar-25,Transportellaneous,"4,093.00",00.00,"23,77,572.86",
05-Mar-25,Interest,00.00,"2,37,757.29","21,39,815.57",
05-Mar-25,Bill,00.00,"3,56,635.93","17,83,179.64",
05-Mar-25,Debit Card,"10,41,842.20",00.00,"28,25,021.84",
05-Mar-25,Purchase,05.00,00.00,"28,25,026.84",
05-Mar-25,Interest,00.00,"14,12,513.42","14,12,513.42",
05-Mar-25,Reversal,06.70,00.00,"14,12,520.12",
05-Mar-25,Commission,00.00,"2,35,420.02","11,77,100.10",
05-Mar-25,IMPS,00.00,"1,47,137.51","10,29,962.59",
05-Mar-25,Commission,00.00,"10,29,962.59",00.00,
05-Mar-25,Reversal,390.2,00.00,390.2,
05-Mar-25,RTGS,"8,15,896.00",00.00,"8,16,286.20",
05-Mar-25,Debit Card,00.00,"1,63,257.24","6,53,028.96",
05-Mar-25,Reversal,288.27,00.00,"6,53,317.23",
05-Mar-25,ATM,00.00,"2,17,772.41","4,35,544.82",
05-Mar-25,Cheque,06.78,00.00,"4,35,551.60",
05-Mar-25,Tax,00.00,"43,555.16","3,91,996.44",
05-Mar-25,RTGS,00.00,"78,399.29","3,13,597.15",
05-Mar-25,Transportellaneous,61.11,00.00,"3,13,658.26",
05-Mar-25,Transfer,00.00,"62,731.65","2,50,926.61",
05-Mar-25,Interest,00.00,"41,821.10","2,09,105.51",
05-Mar-25,ATM,00.00,"26,138.19","1,82,967.32",
05-Mar-25,Transfer,"1,62,158.20",00.00,"3,45,125.52",
05-Mar-25,Bill,00.00,"86,281.38","2,58,844.14",
05-Mar-25,Commission,"2,37,763.38",00.00,"4,96,607.52",
05-Mar-25,IMPS,04.20,00.00,"4,96,611.72",
05-Mar-25,Transportellaneous,00.00,"62,076.47","4,34,535.26",
05-Mar-25,NEFT,11.85,00.00,"4,34,547.11",
05-Mar-25,Interest,00.00,"48,283.01","3,86,264.10",
05-Mar-25,Cheque,"20,58,721.80",00.00,"24,44,985.90",
05-Mar-25,Transfer,55,00.00,"24,45,040.90",
05-Mar-25,Purchase,00.00,"4,89,008.18","19,56,032.72",
06-Mar-25,Transportellaneous,"4,83,793.00",00.00,"24,39,825.72",
06-Mar-25,IMPS,00.00,"8,13,275.24","16,26,550.48",
06-Mar-25,ATM,03.38,00.00,"16,26,553.86",
06-Mar-25,Transportellaneous,461.15,00.00,"16,27,015.01",
06-Mar-25,Transfer,"13,720.44",00.00,"16,40,735.45",
06-Mar-25,Transportellaneous,05.00,00.00,"16,40,740.45",
06-Mar-25,IMPS,111.26,00.00,"16,40,851.71",
06-Mar-25,Debit Card,00.00,"3,28,170.34","13,12,681.37",
06-Mar-25,IMPS,00.00,"1,87,525.91","11,25,155.46",
06-Mar-25,Purchase,00.00,"1,87,525.91","9,37,629.55",
06-Mar-25,Purchase,07.00,00.00,"9,37,636.55",
06-Mar-25,Transfer,"3,32,208.25",00.00,"12,69,844.80",
06-Mar-25,RTGS,"15,54,322.00",00.00,"28,24,166.80",
06-Mar-25,Bill,00.00,"5,64,833.36","22,59,333.44",
06-Mar-25,ATM,"14,22,899.50",00.00,"36,82,232.94",
06-Mar-25,Cheque,02.10,00.00,"36,82,235.04",
06-Mar-25,Tax,"76,695.62",00.00,"37,58,930.66",
06-Mar-25,IMPS,"2,30,172.10",00.00,"39,89,102.76",
06-Mar-25,Commission,"2,950.00",00.00,"39,92,052.76",
06-Mar-25,Purchase,03.68,00.00,"39,92,056.44",
06-Mar-25,IMPS,"1,23,377.00",00.00,"41,15,433.44",
06-Mar-25,Cheque,"1,810.50",00.00,"41,17,243.94",
06-Mar-25,Debit Card,"1,931.00",00.00,"41,19,174.94",
06-Mar-25,Debit Card,00.00,"4,11,917.49","37,07,257.45",
06-Mar-25,Interest,02.90,00.00,"37,07,260.35",
06-Mar-25,RTGS,384.6,00.00,"37,07,644.95",
06-Mar-25,ATM,04.00,00.00,"37,07,648.95",
06-Mar-25,Cheque,"8,43,772.00",00.00,"45,51,420.95",
06-Mar-25,Debit Card,00.00,"7,58,570.16","37,92,850.79",
06-Mar-25,Purchase,00.00,"5,41,835.83","32,51,014.96",
06-Mar-25,Transfer,00.00,"3,61,223.88","28,89,791.08",
06-Mar-25,IMPS,01.00,00.00,"28,89,792.08",
06-Mar-25,Tax,04.00,00.00,"28,89,796.08",
06-Mar-25,Interest,00.81,00.00,"28,89,796.89",
06-Mar-25,Cheque,00.00,"3,21,088.54","25,68,708.35",
06-Mar-25,IMPS,00.00,"3,66,958.34","22,01,750.01",
06-Mar-25,Purchase,"2,379.81",00.00,"22,04,129.82",
06-Mar-25,Bill,00.00,"2,75,516.23","19,28,613.59",
06-Mar-25,Reversal,"58,991.00",00.00,"19,87,604.59",
06-Mar-25,Cheque,419,00.00,"19,88,023.59",
06-Mar-25,Commission,00.00,"4,97,005.90","14,91,017.69",
06-Mar-25,NEFT,05.63,00.00,"14,91,023.32",
06-Mar-25,ATM,00.30,00.00,"14,91,023.62",
06-Mar-25,ATM,00.00,"14,91,023.62",00.00,
06-Mar-25,Bill,272,00.00,272,
06-Mar-25,Transportellaneous,93.41,00.00,365.41,
06-Mar-25,Transportellaneous,00.00,91.35,274.06,
06-Mar-25,Transportellaneous,"13,31,947.00",00.00,"13,32,221.06",
06-Mar-25,Commission,"57,493.00",00.00,"13,89,714.06",
06-Mar-25,RTGS,"3,79,640.75",00.00,"17,69,354.81",
06-Mar-25,IMPS,00.00,"8,84,677.41","8,84,677.40",
06-Mar-25,Transportellaneous,"22,928.72",00.00,"9,07,606.12",
06-Mar-25,RTGS,00.00,"1,51,267.69","7,56,338.43",
06-Mar-25,Tax,"1,968.18",00.00,"7,58,306.61",
06-Mar-25,Interest,03.00,00.00,"7,58,309.61",
06-Mar-25,Tax,149.5,00.00,"7,58,459.11",
06-Mar-25,Cash,00.00,"84,273.23","6,74,185.88",
06-Mar-25,Transfer,"17,855.00",00.00,"6,92,040.88",
06-Mar-25,Commission,"22,915.40",00.00,"7,14,956.28",
06-Mar-25,Transportellaneous,"20,306.53",00.00,"7,35,262.81",
06-Mar-25,Tax,00.00,"3,67,631.41","3,67,631.40",
06-Mar-25,Transportellaneous,00.00,"61,271.90","3,06,359.50",
06-Mar-25,ATM,"4,84,151.50",00.00,"7,90,511.00",
06-Mar-25,IMPS,"26,206.90",00.00,"8,16,717.90",
06-Mar-25,Reversal,00.00,"2,04,179.48","6,12,538.43",
06-Mar-25,Interest,00.00,"6,12,538.43",00.00,
06-Mar-25,Transfer,"1,51,462.00",00.00,"1,51,462.00",
06-Mar-25,Transportellaneous,00.00,"18,932.75","1,32,529.25",
06-Mar-25,Transportellaneous,00.00,"33,132.31","99,396.94",
06-Mar-25,Cash,00.00,"99,396.94",00.00,
06-Mar-25,NEFT,05.00,00.00,05.00,
06-Mar-25,Cash,00.00,01.00,04.00,
06-Mar-25,Cash,02.98,00.00,06.98,
06-Mar-25,Interest,00.00,02.33,04.65,
06-Mar-25,RTGS,00.00,00.52,04.13,
06-Mar-25,Reversal,"22,811.50",00.00,"22,815.63",
06-Mar-25,ATM,37.4,00.00,"22,853.03",
07-Mar-25,Tax,00.00,"5,713.26","17,139.77",
07-Mar-25,ATM,712.4,00.00,"17,852.17",
07-Mar-25,NEFT,00.00,"2,550.31","15,301.86",
07-Mar-25,Interest,00.00,"1,700.21","13,601.65",
07-Mar-25,Purchase,42.32,00.00,"13,643.97",
07-Mar-25,NEFT,00.00,"1,364.40","12,279.57",
07-Mar-25,Transportellaneous,61.5,00.00,"12,341.07",
07-Mar-25,Interest,"2,524.61",00.00,"14,865.68",
07-Mar-25,Commission,00.00,"3,716.42","11,149.26",
08-Mar-25,Bill,00.00,"1,114.93","10,034.33",
08-Mar-25,Reversal,"9,686.60",00.00,"19,720.93",
08-Mar-25,Tax,00.00,"9,860.47","9,860.46",
08-Mar-25,Tax,00.00,"9,860.46",00.00,
08-Mar-25,Purchase,"8,95,284.50",00.00,"8,95,284.50",
08-Mar-25,Bill,00.00,"89,528.45","8,05,756.05",
08-Mar-25,Transfer,00.00,"2,01,439.01","6,04,317.04",
08-Mar-25,Debit Card,02.15,00.00,"6,04,319.19",
08-Mar-25,NEFT,00.00,"6,04,319.19",00.00,
08-Mar-25,NEFT,"10,621.00",00.00,"10,621.00",
08-Mar-25,NEFT,00.00,"1,180.11","9,440.89",
08-Mar-25,Transfer,00.00,944.09,"8,496.80",
08-Mar-25,Bill,00.00,"4,248.40","4,248.40",
08-Mar-25,Purchase,"10,912.30",00.00,"15,160.70",
08-Mar-25,Commission,00.00,"1,684.52","13,476.18",
08-Mar-25,Debit Card,"10,89,967.80",00.00,"11,03,443.98",
08-Mar-25,ATM,"2,23,781.50",00.00,"13,27,225.48",
08-Mar-25,Interest,00.00,"13,27,225.48",00.00,
08-Mar-25,Transportellaneous,"2,452.78",00.00,"2,452.78",
08-Mar-25,Commission,00.00,245.28,"2,207.50",
08-Mar-25,NEFT,00.00,"1,103.75","1,103.75",
08-Mar-25,Interest,00.00,110.38,993.38,
08-Mar-25,Transfer,"2,658.05",00.00,"3,651.43",
08-Mar-25,RTGS,07.00,00.00,"3,658.43",
08-Mar-25,Commission,00.00,457.3,"3,201.13",
08-Mar-25,Transportellaneous,"2,28,419.41",00.00,"2,31,620.54",
08-Mar-25,NEFT,00.00,"38,603.42","1,93,017.12",
08-Mar-25,NEFT,"1,363.60",00.00,"1,94,380.72",
08-Mar-25,IMPS,07.50,00.00,"1,94,388.22",
08-Mar-25,IMPS,"32,501.47",00.00,"2,26,889.69",
08-Mar-25,Transportellaneous,00.00,"56,722.42","1,70,167.27",
08-Mar-25,IMPS,00.99,00.00,"1,70,168.26",
08-Mar-25,RTGS,00.00,"1,70,168.26",00.00,
08-Mar-25,Bill,339.7,00.00,339.7,
08-Mar-25,Debit Card,"2,479.38",00.00,"2,819.08",
08-Mar-25,ATM,40,00.00,"2,859.08",
08-Mar-25,Cheque,00.00,285.91,"2,573.17",
08-Mar-25,Commission,06.41,00.00,"2,579.58",
08-Mar-25,Transfer,58.93,00.00,"2,638.51",
08-Mar-25,Commission,"1,63,784.22",00.00,"1,66,422.73",
08-Mar-25,Transfer,00.00,"1,66,422.73",00.00,
08-Mar-25,Reversal,"13,115.60",00.00,"13,115.60",
08-Mar-25,Bill,"9,87,441.00",00.00,"10,00,556.60",
08-Mar-25,RTGS,"2,859.60",00.00,"10,03,416.20",
08-Mar-25,Commission,00.00,"3,34,472.07","6,68,944.13",
08-Mar-25,Reversal,00.00,"6,68,944.13",00.00,
08-Mar-25,Transfer,"1,989.00",00.00,"1,989.00",
08-Mar-25,Purchase,"3,174.39",00.00,"5,163.39",
08-Mar-25,Bill,00.00,"1,032.68","4,130.71",
08-Mar-25,Transfer,21.98,00.00,"4,152.69",
08-Mar-25,Cheque,00.00,519.09,"3,633.60",
08-Mar-25,Cheque,"1,59,071.34",00.00,"1,62,704.94",
08-Mar-25,ATM,00.00,"20,338.12","1,42,366.82",
08-Mar-25,Purchase,"2,318.03",00.00,"1,44,684.85",
08-Mar-25,Reversal,00.00,"28,936.97","1,15,747.88",
08-Mar-25,ATM,00.00,"38,582.63","77,165.25",
09-Mar-25,Cash,58.1,00.00,"77,223.35",
09-Mar-25,Bill,00.00,"77,223.35",00.00,
09-Mar-25,Debit Card,07.00,00.00,07.00,
09-Mar-25,Purchase,00.00,01.00,06.00,
09-Mar-25,NEFT,"17,09,582.00",00.00,"17,09,588.00",
09-Mar-25,Reversal,00.00,"2,84,931.33","14,24,656.67",
09-Mar-25,Reversal,288.2,00.00,"14,24,944.87",
09-Mar-25,Reversal,"17,962.00",00.00,"14,42,906.87",
09-Mar-25,Transfer,00.00,"3,60,726.72","10,82,180.15",
09-Mar-25,Purchase,00.00,"5,41,090.08","5,41,090.07",
09-Mar-25,Tax,594,00.00,"5,41,684.07",
09-Mar-25,Cash,254.63,00.00,"5,41,938.70",
09-Mar-25,Debit Card,"5,063.60",00.00,"5,47,002.30",
09-Mar-25,IMPS,00.00,"1,36,750.58","4,10,251.72",
09-Mar-25,Cash,"1,73,356.00",00.00,"5,83,607.72",
09-Mar-25,Interest,00.00,"1,45,901.93","4,37,705.79",
09-Mar-25,ATM,"1,644.99",00.00,"4,39,350.78",
09-Mar-25,Commission,00.00,"54,918.85","3,84,431.93",
09-Mar-25,Tax,07.01,00.00,"3,84,438.94",
09-Mar-25,Tax,"28,757.00",00.00,"4,13,195.94",
09-Mar-25,ATM,00.00,"68,865.99","3,44,329.95",
09-Mar-25,Interest,00.00,"49,189.99","2,95,139.96",
09-Mar-25,NEFT,00.00,"29,514.00","2,65,625.96",
09-Mar-25,IMPS,306,00.00,"2,65,931.96",
09-Mar-25,Cheque,00.00,"53,186.39","2,12,745.57",
09-Mar-25,Commission,00.00,"1,06,372.79","1,06,372.78",
09-Mar-25,Tax,285.33,00.00,"1,06,658.11",
09-Mar-25,Cash,"3,673.54",00.00,"1,10,331.65",
09-Mar-25,Debit Card,"49,826.00",00.00,"1,60,157.65",
09-Mar-25,Transfer,00.00,"53,385.88","1,06,771.77",
09-Mar-25,RTGS,00.00,"11,863.53","94,908.24",
09-Mar-25,RTGS,245.7,00.00,"95,153.94",
09-Mar-25,Commission,00.00,"23,788.49","71,365.46",
09-Mar-25,Cheque,00.00,"7,929.50","63,435.96",
09-Mar-25,Debit Card,"1,39,262.60",00.00,"2,02,698.56",
09-Mar-25,Transportellaneous,00.00,"22,522.06","1,80,176.50",
09-Mar-25,Reversal,"11,377.60",00.00,"1,91,554.10",
09-Mar-25,NEFT,00.00,"47,888.53","1,43,665.58",
09-Mar-25,ATM,61.53,00.00,"1,43,727.11",
09-Mar-25,Debit Card,"2,50,637.47",00.00,"3,94,364.58",
09-Mar-25,Cheque,00.00,"56,337.80","3,38,026.78",
09-Mar-25,RTGS,00.00,"67,605.36","2,70,421.42",
09-Mar-25,Transportellaneous,20.8,00.00,"2,70,442.22",
09-Mar-25,Cheque,"1,04,644.00",00.00,"3,75,086.22",
09-Mar-25,Purchase,335,00.00,"3,75,421.22",
09-Mar-25,Transfer,02.90,00.00,"3,75,424.12",
09-Mar-25,Reversal,02.30,00.00,"3,75,426.42",
09-Mar-25,Bill,115.5,00.00,"3,75,541.92",
09-Mar-25,Purchase,00.00,"53,648.85","3,21,893.07",
09-Mar-25,Transfer,106.4,00.00,"3,21,999.47",
09-Mar-25,NEFT,"10,05,793.00",00.00,"13,27,792.47",
09-Mar-25,RTGS,00.00,"4,42,597.49","8,85,194.98",
09-Mar-25,Bill,00.00,"88,519.50","7,96,675.48",
09-Mar-25,Reversal,00.00,"88,519.50","7,08,155.98",
09-Mar-25,IMPS,"2,54,309.50",00.00,"9,62,465.48",
09-Mar-25,IMPS,00.00,"1,20,308.19","8,42,157.30",
09-Mar-25,IMPS,"17,71,566.00",00.00,"26,13,723.30",
09-Mar-25,Transfer,00.00,"8,71,241.10","17,42,482.20",
09-Mar-25,IMPS,50.56,00.00,"17,42,532.76",
09-Mar-25,RTGS,00.00,"2,90,422.13","14,52,110.63",
09-Mar-25,Interest,"8,21,608.50",00.00,"22,73,719.13",
09-Mar-25,Transportellaneous,00.00,"2,84,214.89","19,89,504.24",
09-Mar-25,Purchase,"8,82,850.00",00.00,"28,72,354.24",
09-Mar-25,ATM,00.00,"14,36,177.12","14,36,177.12",
09-Mar-25,Commission,56.3,00.00,"14,36,233.42",
09-Mar-25,Cheque,210.4,00.00,"14,36,443.82",
09-Mar-25,Transportellaneous,"6,25,613.00",00.00,"20,62,056.82",
09-Mar-25,IMPS,00.00,"2,94,579.55","17,67,477.27",
09-Mar-25,Reversal,"74,071.81",00.00,"18,41,549.08",
09-Mar-25,NEFT,856,00.00,"18,42,405.08",
09-Mar-25,Tax,00.00,"4,60,601.27","13,81,803.81",
09-Mar-25,Cheque,00.00,"2,30,300.64","11,51,503.18",
09-Mar-25,IMPS,"3,185.42",00.00,"11,54,688.60",
09-Mar-25,Cheque,"1,18,657.20",00.00,"12,73,345.80",
09-Mar-25,Interest,"9,756.00",00.00,"12,83,101.80",
09-Mar-25,Commission,06.00,00.00,"12,83,107.80",
09-Mar-25,Cheque,00.00,"4,27,702.60","8,55,405.20",
09-Mar-25,Cash,04.60,00.00,"8,55,409.80",
09-Mar-25,NEFT,00.00,"1,42,568.30","7,12,841.50",
09-Mar-25,NEFT,"20,36,105.80",00.00,"27,48,947.30",
09-Mar-25,Commission,00.00,"3,43,618.41","24,05,328.89",
09-Mar-25,Cheque,00.00,"4,81,065.78","19,24,263.11",
09-Mar-25,Transfer,"86,807.12",00.00,"20,11,070.23",
10-Mar-25,Tax,00.00,"2,87,295.75","17,23,774.48",
10-Mar-25,Commission,00.00,"8,61,887.24","8,61,887.24",
10-Mar-25,Transfer,32,00.00,"8,61,919.24",
10-Mar-25,Transfer,00.00,"2,15,479.81","6,46,439.43",
10-Mar-25,IMPS,"30,968.25",00.00,"6,77,407.68",
10-Mar-25,NEFT,00.00,"1,69,351.92","5,08,055.76",
10-Mar-25,NEFT,00.00,"1,69,351.92","3,38,703.84",
10-Mar-25,Transfer,"50,206.00",00.00,"3,88,909.84",
10-Mar-25,Cheque,"1,885.63",00.00,"3,90,795.47",
10-Mar-25,Commission,"15,544.06",00.00,"4,06,339.53",
10-Mar-25,Cheque,"3,555.92",00.00,"4,09,895.45",
10-Mar-25,Reversal,"77,690.00",00.00,"4,87,585.45",
10-Mar-25,Transportellaneous,81,00.00,"4,87,666.45",
10-Mar-25,Transfer,00.00,"1,62,555.48","3,25,110.97",
10-Mar-25,Cash,00.00,"65,022.19","2,60,088.78",
10-Mar-25,IMPS,00.00,"26,008.88","2,34,079.90",
10-Mar-25,RTGS,00.00,"26,008.88","2,08,071.02",
10-Mar-25,Transportellaneous,00.00,"52,017.76","1,56,053.26",
10-Mar-25,Interest,421,00.00,"1,56,474.26",
10-Mar-25,Debit Card,"7,53,008.00",00.00,"9,09,482.26",
10-Mar-25,ATM,00.00,"1,51,580.38","7,57,901.88",
10-Mar-25,Bill,"94,406.20",00.00,"8,52,308.08",
10-Mar-25,ATM,00.00,"1,06,538.51","7,45,769.57",
10-Mar-25,Reversal,00.00,"82,863.29","6,62,906.28",
10-Mar-25,RTGS,00.00,"1,65,726.57","4,97,179.71",
10-Mar-25,Cash,00.00,"71,025.67","4,26,154.04",
10-Mar-25,Cash,00.00,"53,269.26","3,72,884.78",
10-Mar-25,NEFT,00.00,"1,24,294.93","2,48,589.85",
10-Mar-25,Cash,22.15,00.00,"2,48,612.00",
10-Mar-25,Interest,15.7,00.00,"2,48,627.70",
10-Mar-25,Interest,00.00,"82,875.90","1,65,751.80",
10-Mar-25,Interest,00.00,"33,150.36","1,32,601.44",
10-Mar-25,Reversal,00.00,"16,575.18","1,16,026.26",
10-Mar-25,Purchase,00.00,"12,891.81","1,03,134.45",
10-Mar-25,Transportellaneous,"72,673.28",00.00,"1,75,807.73",
10-Mar-25,Transportellaneous,"24,755.00",00.00,"2,00,562.73",
10-Mar-25,Transportellaneous,00.00,"20,056.27","1,80,506.46",
10-Mar-25,Purchase,00.00,"25,786.64","1,54,719.82",
10-Mar-25,Cash,00.00,"1,54,719.82",00.00,
10-Mar-25,NEFT,"2,097.00",00.00,"2,097.00",
10-Mar-25,Transportellaneous,01.90,00.00,"2,098.90",
10-Mar-25,Cheque,60.33,00.00,"2,159.23",
10-Mar-25,Debit Card,00.00,539.81,"1,619.42",
10-Mar-25,ATM,03.33,00.00,"1,622.75",
10-Mar-25,Bill,00.00,811.38,811.38,
10-Mar-25,IMPS,00.00,811.38,00.00,
10-Mar-25,Interest,"16,88,595.20",00.00,"16,88,595.20",
10-Mar-25,Cheque,00.00,"8,44,297.60","8,44,297.60",
10-Mar-25,Transfer,04.00,00.00,"8,44,301.60",
11-Mar-25,Transportellaneous,00.00,"2,11,075.40","6,33,226.20",
11-Mar-25,NEFT,00.00,"63,322.62","5,69,903.58",
11-Mar-25,NEFT,06.87,00.00,"5,69,910.45",
11-Mar-25,RTGS,"3,166.85",00.00,"5,73,077.30",
11-Mar-25,Purchase,00.00,"2,86,538.65","2,86,538.65",
11-Mar-25,Purchase,"7,100.89",00.00,"2,93,639.54",
11-Mar-25,Transfer,"1,64,182.38",00.00,"4,57,821.92",
11-Mar-25,Interest,"3,365.20",00.00,"4,61,187.12",
11-Mar-25,NEFT,"2,865.63",00.00,"4,64,052.75",
11-Mar-25,Interest,"1,64,503.50",00.00,"6,28,556.25",
11-Mar-25,Bill,02.40,00.00,"6,28,558.65",
11-Mar-25,Interest,01.00,00.00,"6,28,559.65",
12-Mar-25,Cheque,"4,75,295.50",00.00,"11,03,855.15",
12-Mar-25,Reversal,"10,067.50",00.00,"11,13,922.65",
12-Mar-25,ATM,00.00,"2,22,784.53","8,91,138.12",
12-Mar-25,Transportellaneous,02.70,00.00,"8,91,140.82",
12-Mar-25,Purchase,"16,93,082.50",00.00,"25,84,223.32",
12-Mar-25,IMPS,"2,49,716.28",00.00,"28,33,939.60",
12-Mar-25,Transportellaneous,"2,870.50",00.00,"28,36,810.10",
12-Mar-25,Transportellaneous,00.00,"4,72,801.68","23,64,008.42",
12-Mar-25,Transportellaneous,"2,791.10",00.00,"23,66,799.52",
12-Mar-25,Debit Card,00.00,"5,91,699.88","17,75,099.64",
12-Mar-25,Transportellaneous,"2,054.31",00.00,"17,77,153.95",
12-Mar-25,Reversal,00.00,"2,53,879.14","15,23,274.81",
12-Mar-25,NEFT,06.30,00.00,"15,23,281.11",
12-Mar-25,Reversal,"26,804.10",00.00,"15,50,085.21",
12-Mar-25,NEFT,00.00,"3,87,521.30","11,62,563.91",
12-Mar-25,Reversal,00.00,"1,29,173.77","10,33,390.14",
12-Mar-25,Cash,00.00,"3,44,463.38","6,88,926.76",
12-Mar-25,Reversal,"2,15,541.00",00.00,"9,04,467.76",
12-Mar-25,Reversal,00.00,"1,13,058.47","7,91,409.29",
12-Mar-25,Commission,637.9,00.00,"7,92,047.19",
12-Mar-25,Bill,01.00,00.00,"7,92,048.19",
12-Mar-25,Tax,00.00,"1,98,012.05","5,94,036.14",
12-Mar-25,Reversal,00.00,"99,006.02","4,95,030.12",
12-Mar-25,RTGS,00.00,"49,503.01","4,45,527.11",
12-Mar-25,Cheque,00.00,"4,45,527.11",00.00,
12-Mar-25,Commission,33.3,00.00,33.3,
12-Mar-25,Transportellaneous,"10,09,803.00",00.00,"10,09,836.30",
12-Mar-25,Cash,00.00,"2,52,459.08","7,57,377.23",
12-Mar-25,RTGS,00.00,"7,57,377.23",00.00,
12-Mar-25,Debit Card,62,00.00,62,
12-Mar-25,Cheque,05.44,00.00,67.44,
12-Mar-25,Cheque,63.1,00.00,130.54,
12-Mar-25,Bill,"2,24,759.50",00.00,"2,24,890.04",
12-Mar-25,ATM,227.3,00.00,"2,25,117.34",
12-Mar-25,Cheque,00.00,"75,039.11","1,50,078.23",
12-Mar-25,Bill,"2,71,300.75",00.00,"4,21,378.98",
12-Mar-25,RTGS,415,00.00,"4,21,793.98",
12-Mar-25,Transportellaneous,"71,687.00",00.00,"4,93,480.98",
13-Mar-25,Commission,"17,65,004.00",00.00,"22,58,484.98",
13-Mar-25,ATM,00.00,"4,51,697.00","18,06,787.98",
13-Mar-25,ATM,00.00,"18,06,787.98",00.00,
13-Mar-25,ATM,"28,026.50",00.00,"28,026.50",
13-Mar-25,Commission,00.00,"2,802.65","25,223.85",
13-Mar-25,Purchase,00.00,"4,203.98","21,019.88",
13-Mar-25,ATM,00.00,"5,254.97","15,764.91",
13-Mar-25,Cheque,85.7,00.00,"15,850.61",
13-Mar-25,Reversal,00.00,"3,170.12","12,680.49",
13-Mar-25,Purchase,00.00,"12,680.49",00.00,
14-Mar-25,Cheque,"11,29,380.00",00.00,"11,29,380.00",
14-Mar-25,RTGS,00.00,"3,76,460.00","7,52,920.00",
14-Mar-25,Bill,28,00.00,"7,52,948.00",
14-Mar-25,Purchase,"17,75,056.80",00.00,"25,28,004.80",
14-Mar-25,Bill,00.50,00.00,"25,28,005.30",
14-Mar-25,Interest,"25,734.00",00.00,"25,53,739.30",
14-Mar-25,Bill,01.70,00.00,"25,53,741.00",
14-Mar-25,Cheque,00.00,"3,19,217.63","22,34,523.38",
14-Mar-25,Interest,00.00,"3,72,420.56","18,62,102.82",
14-Mar-25,Reversal,00.00,"3,72,420.56","14,89,682.26",
14-Mar-25,IMPS,00.00,"7,44,841.13","7,44,841.13",
14-Mar-25,NEFT,00.00,"93,105.14","6,51,735.99",
14-Mar-25,Commission,00.00,"1,08,622.67","5,43,113.32",
14-Mar-25,IMPS,00.00,"90,518.89","4,52,594.43",
14-Mar-25,RTGS,63.77,00.00,"4,52,658.20",
14-Mar-25,ATM,384.4,00.00,"4,53,042.60",
14-Mar-25,Cheque,00.00,"90,608.52","3,62,434.08",
14-Mar-25,Cash,00.00,"90,608.52","2,71,825.56",
14-Mar-25,ATM,04.00,00.00,"2,71,829.56",
15-Mar-25,Bill,"2,36,092.00",00.00,"5,07,921.56",
15-Mar-25,ATM,04.70,00.00,"5,07,926.26",
15-Mar-25,Bill,00.00,"50,792.63","4,57,133.63",
15-Mar-25,Debit Card,00.00,"45,713.36","4,11,420.27",
15-Mar-25,IMPS,00.00,"82,284.05","3,29,136.22",
15-Mar-25,Transfer,"1,35,324.70",00.00,"4,64,460.92",
15-Mar-25,Cash,185.01,00.00,"4,64,645.93",
15-Mar-25,Purchase,00.00,"92,929.19","3,71,716.74",
15-Mar-25,Interest,"17,071.00",00.00,"3,88,787.74",
15-Mar-25,Bill,"1,01,604.10",00.00,"4,90,391.84",
15-Mar-25,RTGS,01.00,00.00,"4,90,392.84",
15-Mar-25,Tax,"20,587.40",00.00,"5,10,980.24",
15-Mar-25,NEFT,00.00,"85,163.37","4,25,816.87",
15-Mar-25,Transfer,308.3,00.00,"4,26,125.17",
16-Mar-25,RTGS,07.09,00.00,"4,26,132.26",
16-Mar-25,Reversal,00.00,"42,613.23","3,83,519.03",
16-Mar-25,Transportellaneous,56.69,00.00,"3,83,575.72",
16-Mar-25,Interest,17,00.00,"3,83,592.72",
16-Mar-25,Debit Card,"20,56,734.25",00.00,"24,40,326.97",
16-Mar-25,NEFT,285,00.00,"24,40,611.97",
16-Mar-25,Transfer,293.5,00.00,"24,40,905.47",
16-Mar-25,Cash,338,00.00,"24,41,243.47",
16-Mar-25,Cash,00.00,"3,05,155.43","21,36,088.04",
16-Mar-25,Cheque,21,00.00,"21,36,109.04",
16-Mar-25,Transfer,04.60,00.00,"21,36,113.64",
16-Mar-25,Transportellaneous,"26,609.20",00.00,"21,62,722.84",
16-Mar-25,Debit Card,00.00,"21,62,722.84",00.00,
16-Mar-25,Cash,358.8,00.00,358.8,
16-Mar-25,Commission,00.00,179.4,179.4,
16-Mar-25,Debit Card,00.00,17.94,161.46,
16-Mar-25,NEFT,"2,28,724.90",00.00,"2,28,886.36",
16-Mar-25,IMPS,00.00,00.00,"2,28,886.36",
16-Mar-25,Tax,00.00,"57,221.59","1,71,664.77",
16-Mar-25,RTGS,07.00,00.00,"1,71,671.77",
16-Mar-25,Transfer,54.51,00.00,"1,71,726.28",
16-Mar-25,Reversal,"4,79,292.00",00.00,"6,51,018.28",
16-Mar-25,Debit Card,00.00,"2,17,006.09","4,34,012.19",
16-Mar-25,NEFT,06.93,00.00,"4,34,019.12",
16-Mar-25,Cash,00.00,"62,002.73","3,72,016.39",
16-Mar-25,Reversal,00.00,"37,201.64","3,34,814.75",
16-Mar-25,ATM,00.00,"66,962.95","2,67,851.80",
16-Mar-25,Debit Card,40.6,00.00,"2,67,892.40",
16-Mar-25,Commission,00.00,"66,973.10","2,00,919.30",
16-Mar-25,Purchase,00.00,"33,486.55","1,67,432.75",
16-Mar-25,Reversal,00.00,"1,67,432.75",00.00,
16-Mar-25,Transportellaneous,"7,385.00",00.00,"7,385.00",
16-Mar-25,Cash,00.00,"1,477.00","5,908.00",
16-Mar-25,RTGS,00.00,"2,954.00","2,954.00",
16-Mar-25,Reversal,00.00,"2,954.00",00.00,
16-Mar-25,Commission,186.55,00.00,186.55,
16-Mar-25,Interest,00.00,26.65,159.9,
16-Mar-25,Tax,22.83,00.00,182.73,
16-Mar-25,Transportellaneous,04.40,00.00,187.13,
16-Mar-25,Commission,"4,007.00",00.00,"4,194.13",
16-Mar-25,Cheque,"30,387.00",00.00,"34,581.13",
16-Mar-25,Commission,00.00,"3,842.35","30,738.78",
16-Mar-25,IMPS,00.00,"3,842.35","26,896.43",
16-Mar-25,Bill,"14,63,460.50",00.00,"14,90,356.93",
16-Mar-25,ATM,00.00,"4,96,785.64","9,93,571.29",
16-Mar-25,Commission,"17,792.50",00.00,"10,11,363.79",
16-Mar-25,Bill,"19,29,241.80",00.00,"29,40,605.59",
16-Mar-25,Tax,00.00,"7,35,151.40","22,05,454.19",
16-Mar-25,Purchase,05.30,00.00,"22,05,459.49",
16-Mar-25,Debit Card,00.00,"3,67,576.58","18,37,882.91",
16-Mar-25,Bill,00.00,"4,59,470.73","13,78,412.18",
16-Mar-25,Transfer,00.00,"2,75,682.44","11,02,729.74",
16-Mar-25,Transportellaneous,00.00,"1,57,532.82","9,45,196.92",
16-Mar-25,Bill,00.00,"3,15,065.64","6,30,131.28",
16-Mar-25,Cash,"1,58,483.97",00.00,"7,88,615.25",
16-Mar-25,Purchase,"3,438.00",00.00,"7,92,053.25",
16-Mar-25,Transfer,00.00,"1,98,013.31","5,94,039.94",
16-Mar-25,Tax,00.00,"2,97,019.97","2,97,019.97",
16-Mar-25,Tax,"37,842.80",00.00,"3,34,862.77",
16-Mar-25,Tax,"17,75,568.50",00.00,"21,10,431.27",
16-Mar-25,Reversal,00.00,"2,63,803.91","18,46,627.36",
16-Mar-25,Cheque,00.00,"18,46,627.36",00.00,
17-Mar-25,Cheque,20,00.00,20,
17-Mar-25,Interest,00.00,10,10,
17-Mar-25,ATM,337,00.00,347,
17-Mar-25,Debit Card,"1,69,942.60",00.00,"1,70,289.60",
17-Mar-25,Transportellaneous,00.00,"1,70,289.60",00.00,
17-Mar-25,RTGS,08.00,00.00,08.00,
18-Mar-25,ATM,"22,381.22",00.00,"22,389.22",
18-Mar-25,RTGS,22.8,00.00,"22,412.02",
18-Mar-25,Tax,00.00,"2,241.20","20,170.82",
18-Mar-25,Interest,"9,609.02",00.00,"29,779.84",
18-Mar-25,Commission,"98,662.20",00.00,"1,28,442.04",
18-Mar-25,IMPS,00.00,"32,110.51","96,331.53",
18-Mar-25,Debit Card,00.00,"9,633.15","86,698.38",
18-Mar-25,Tax,"3,786.49",00.00,"90,484.87",
18-Mar-25,IMPS,00.00,"9,048.49","81,436.38",
18-Mar-25,NEFT,"1,117.50",00.00,"82,553.88",
18-Mar-25,Cash,00.00,"9,172.65","73,381.23",
18-Mar-25,Cash,00.00,"14,676.25","58,704.98",
18-Mar-25,Transportellaneous,00.00,"9,784.16","48,920.82",
18-Mar-25,Cash,00.00,"6,115.10","42,805.72",
18-Mar-25,Cheque,00.00,"7,134.29","35,671.43",
18-Mar-25,Purchase,55,00.00,"35,726.43",
18-Mar-25,Cheque,00.77,00.00,"35,727.20",
18-Mar-25,Debit Card,00.00,"3,572.72","32,154.48",
19-Mar-25,Commission,"74,359.00",00.00,"1,06,513.48",
19-Mar-25,Interest,00.00,"53,256.74","53,256.74",
19-Mar-25,Transfer,"6,60,733.25",00.00,"7,13,989.99",
19-Mar-25,Bill,06.00,00.00,"7,13,995.99",
19-Mar-25,Transportellaneous,00.00,"7,13,995.99",00.00,
19-Mar-25,Reversal,"25,392.60",00.00,"25,392.60",
19-Mar-25,IMPS,00.00,"2,821.40","22,571.20",
19-Mar-25,Debit Card,"1,84,812.00",00.00,"2,07,383.20",
19-Mar-25,Tax,00.00,"2,07,383.20",00.00,
19-Mar-25,Transfer,"4,932.05",00.00,"4,932.05",
19-Mar-25,RTGS,00.00,"1,233.01","3,699.04",
19-Mar-25,Tax,00.00,"1,233.01","2,466.03",
19-Mar-25,Transfer,00.00,411.01,"2,055.02",
19-Mar-25,Purchase,"74,672.00",00.00,"76,727.02",
19-Mar-25,NEFT,"22,608.00",00.00,"99,335.02",
19-Mar-25,RTGS,19.65,00.00,"99,354.67",
19-Mar-25,Transportellaneous,00.00,"49,677.34","49,677.34",
19-Mar-25,Reversal,"1,454.80",00.00,"51,132.14",
19-Mar-25,ATM,16,00.00,"51,148.14",
19-Mar-25,Cash,"21,847.00",00.00,"72,995.14",
19-Mar-25,Cheque,00.00,"8,110.57","64,884.57",
19-Mar-25,Interest,01.90,00.00,"64,886.47",
19-Mar-25,IMPS,"25,649.00",00.00,"90,535.47",
19-Mar-25,Bill,"1,67,865.80",00.00,"2,58,401.27",
19-Mar-25,Transportellaneous,"2,493.00",00.00,"2,60,894.27",
19-Mar-25,Transfer,"59,567.50",00.00,"3,20,461.77",
19-Mar-25,IMPS,00.00,"1,60,230.89","1,60,230.88",
19-Mar-25,Reversal,30.4,00.00,"1,60,261.28",
19-Mar-25,Reversal,"2,957.10",00.00,"1,63,218.38",
19-Mar-25,Reversal,00.00,"27,203.06","1,36,015.32",
19-Mar-25,NEFT,06.48,00.00,"1,36,021.80",
19-Mar-25,NEFT,00.00,"15,113.53","1,20,908.27",
19-Mar-25,ATM,00.00,"1,20,908.27",00.00,
19-Mar-25,RTGS,"21,321.10",00.00,"21,321.10",
19-Mar-25,Cheque,"1,139.00",00.00,"22,460.10",
19-Mar-25,RTGS,00.00,"4,492.02","17,968.08",
19-Mar-25,Tax,01.30,00.00,"17,969.38",
19-Mar-25,Purchase,00.00,"8,984.69","8,984.69",
19-Mar-25,Transfer,00.00,"1,283.53","7,701.16",
19-Mar-25,RTGS,"13,848.91",00.00,"21,550.07",
19-Mar-25,IMPS,"1,36,662.00",00.00,"1,58,212.07",
19-Mar-25,Bill,"2,49,675.00",00.00,"4,07,887.07",
19-Mar-25,Cheque,"35,751.41",00.00,"4,43,638.48",
19-Mar-25,Commission,00.00,"55,454.81","3,88,183.67",
19-Mar-25,Commission,00.00,"64,697.28","3,23,486.39",
19-Mar-25,Interest,00.00,"46,212.34","2,77,274.05",
19-Mar-25,Tax,00.00,"55,454.81","2,21,819.24",
19-Mar-25,Cash,00.00,"22,181.92","1,99,637.32",
19-Mar-25,Purchase,"1,73,803.00",00.00,"3,73,440.32",
19-Mar-25,Transportellaneous,"19,17,169.50",00.00,"22,90,609.82",
19-Mar-25,Debit Card,00.00,"4,58,121.96","18,32,487.86",
19-Mar-25,Interest,"2,193.80",00.00,"18,34,681.66",
19-Mar-25,Reversal,00.00,"3,66,936.33","14,67,745.33",
19-Mar-25,Tax,25.6,00.00,"14,67,770.93",
19-Mar-25,Reversal,00.00,"2,09,681.56","12,58,089.37",
19-Mar-25,Purchase,00.00,"3,14,522.34","9,43,567.03",
19-Mar-25,Transfer,01.46,00.00,"9,43,568.49",
19-Mar-25,NEFT,392.4,00.00,"9,43,960.89",
19-Mar-25,IMPS,00.00,"2,35,990.22","7,07,970.67",
19-Mar-25,IMPS,209.96,00.00,"7,08,180.63",
19-Mar-25,Commission,"20,033.32",00.00,"7,28,213.95",
19-Mar-25,Tax,00.00,"1,45,642.79","5,82,571.16",
19-Mar-25,ATM,00.00,"72,821.40","5,09,749.76",
19-Mar-25,Tax,"29,646.40",00.00,"5,39,396.16",
19-Mar-25,ATM,00.00,"89,899.36","4,49,496.80",
19-Mar-25,Bill,00.00,"44,949.68","4,04,547.12",
19-Mar-25,Transfer,00.00,"40,454.71","3,64,092.41",
19-Mar-25,Transfer,00.00,"1,82,046.21","1,82,046.20",
19-Mar-25,Interest,14.22,00.00,"1,82,060.42",
19-Mar-25,Cash,00.00,"22,757.55","1,59,302.87",
19-Mar-25,Bill,00.00,"19,912.86","1,39,390.01",
19-Mar-25,Interest,462.3,00.00,"1,39,852.31",
19-Mar-25,Transportellaneous,"19,805.70",00.00,"1,59,658.01",
19-Mar-25,NEFT,"6,58,356.00",00.00,"8,18,014.01",
19-Mar-25,Tax,00.00,"90,890.45","7,27,123.56",
19-Mar-25,NEFT,07.00,00.00,"7,27,130.56",
19-Mar-25,Transfer,36,00.00,"7,27,166.56",
19-Mar-25,Reversal,419,00.00,"7,27,585.56",
19-Mar-25,NEFT,"25,076.30",00.00,"7,52,661.86",
19-Mar-25,Transfer,00.00,"7,52,661.86",00.00,
19-Mar-25,ATM,26.68,00.00,26.68,
19-Mar-25,Commission,"2,950.14",00.00,"2,976.82",
19-Mar-25,NEFT,00.00,330.76,"2,646.06",
19-Mar-25,Cheque,00.00,378.01,"2,268.05",
20-Mar-25,IMPS,00.00,756.02,"1,512.03",
20-Mar-25,Debit Card,00.00,756.02,756.02,
20-Mar-25,Interest,00.00,378.01,378.01,
20-Mar-25,Reversal,"6,05,054.00",00.00,"6,05,432.01",
20-Mar-25,NEFT,00.00,"67,270.22","5,38,161.79",
20-Mar-25,Transfer,00.00,"1,07,632.36","4,30,529.43",
20-Mar-25,Interest,"2,22,771.90",00.00,"6,53,301.33",
20-Mar-25,RTGS,00.00,"1,63,325.33","4,89,976.00",
20-Mar-25,Purchase,00.00,"48,997.60","4,40,978.40",
20-Mar-25,Interest,00.00,"62,996.91","3,77,981.49",
20-Mar-25,Bill,"2,432.00",00.00,"3,80,413.49",
20-Mar-25,Debit Card,"15,97,556.00",00.00,"19,77,969.49",
20-Mar-25,Tax,00.00,"2,47,246.19","17,30,723.30",
20-Mar-25,Reversal,486.56,00.00,"17,31,209.86",
20-Mar-25,RTGS,"5,639.08",00.00,"17,36,848.94",
20-Mar-25,Reversal,"10,47,391.00",00.00,"27,84,239.94",
20-Mar-25,Commission,"19,83,538.80",00.00,"47,67,778.74",
20-Mar-25,ATM,00.00,"11,91,944.69","35,75,834.06",
20-Mar-25,Reversal,00.00,"3,57,583.41","32,18,250.65",
21-Mar-25,Commission,07.17,00.00,"32,18,257.82",
21-Mar-25,Debit Card,54,00.00,"32,18,311.82",
21-Mar-25,Interest,"4,035.00",00.00,"32,22,346.82",
21-Mar-25,Cheque,164.8,00.00,"32,22,511.62",
21-Mar-25,Commission,00.00,"10,74,170.54","21,48,341.08",
21-Mar-25,RTGS,"1,814.24",00.00,"21,50,155.32",
21-Mar-25,Bill,00.00,"3,07,165.05","18,42,990.27",
21-Mar-25,Interest,00.00,"4,60,747.57","13,82,242.70",
21-Mar-25,Cheque,00.00,"3,45,560.68","10,36,682.02",
21-Mar-25,Tax,"2,36,939.80",00.00,"12,73,621.82",
21-Mar-25,Debit Card,00.00,"2,12,270.30","10,61,351.52",
21-Mar-25,IMPS,"15,922.20",00.00,"10,77,273.72",
21-Mar-25,ATM,"3,708.00",00.00,"10,80,981.72",
21-Mar-25,ATM,00.00,"10,80,981.72",00.00,
21-Mar-25,Transfer,"5,01,340.50",00.00,"5,01,340.50",
21-Mar-25,Tax,01.00,00.00,"5,01,341.50",
21-Mar-25,IMPS,00.55,00.00,"5,01,342.05",
21-Mar-25,Purchase,"1,94,226.22",00.00,"6,95,568.27",
21-Mar-25,Reversal,00.00,"86,946.03","6,08,622.24",
21-Mar-25,IMPS,00.00,"1,21,724.45","4,86,897.79",
22-Mar-25,Debit Card,00.00,"48,689.78","4,38,208.01",
22-Mar-25,Reversal,00.00,"73,034.67","3,65,173.34",
22-Mar-25,Commission,00.00,"40,574.82","3,24,598.52",
22-Mar-25,NEFT,00.00,"3,24,598.52",00.00,
22-Mar-25,RTGS,12,00.00,12,
22-Mar-25,NEFT,"3,64,568.00",00.00,"3,64,580.00",
22-Mar-25,Transportellaneous,00.00,"1,21,526.67","2,43,053.33",
22-Mar-25,IMPS,00.00,"34,721.90","2,08,331.43",
22-Mar-25,Transportellaneous,"1,062.60",00.00,"2,09,394.03",
22-Mar-25,Bill,00.00,"2,09,394.03",00.00,
22-Mar-25,Interest,"1,69,393.00",00.00,"1,69,393.00",
22-Mar-25,Bill,"2,49,356.03",00.00,"4,18,749.03",
22-Mar-25,IMPS,09.71,00.00,"4,18,758.74",
23-Mar-25,Tax,"3,636.00",00.00,"4,22,394.74",
23-Mar-25,Interest,366.4,00.00,"4,22,761.14",
23-Mar-25,Transfer,00.00,"2,11,380.57","2,11,380.57",
23-Mar-25,ATM,52,00.00,"2,11,432.57",
23-Mar-25,Reversal,"19,34,992.80",00.00,"21,46,425.37",
23-Mar-25,Interest,"20,25,182.50",00.00,"41,71,607.87",
23-Mar-25,Reversal,00.00,"4,17,160.79","37,54,447.08",
23-Mar-25,NEFT,"19,994.90",00.00,"37,74,441.98",
24-Mar-25,Tax,"1,31,476.00",00.00,"39,05,917.98",
24-Mar-25,Tax,301.49,00.00,"39,06,219.47",
24-Mar-25,Debit Card,"3,655.58",00.00,"39,09,875.05",
24-Mar-25,Reversal,00.00,"3,90,987.51","35,18,887.54",
24-Mar-25,ATM,"1,73,418.80",00.00,"36,92,306.34",
24-Mar-25,Reversal,00.00,"7,38,461.27","29,53,845.07",
24-Mar-25,Cash,"99,541.53",00.00,"30,53,386.60",
24-Mar-25,Tax,00.00,"6,10,677.32","24,42,709.28",
24-Mar-25,Purchase,279,00.00,"24,42,988.28",
24-Mar-25,Bill,"19,256.20",00.00,"24,62,244.48",
24-Mar-25,Commission,00.00,"3,07,780.56","21,54,463.92",
24-Mar-25,Transfer,00.00,"10,77,231.96","10,77,231.96",
24-Mar-25,Purchase,07.80,00.00,"10,77,239.76",
24-Mar-25,Tax,00.00,"1,19,693.31","9,57,546.45",
24-Mar-25,Transfer,491.1,00.00,"9,58,037.55",
24-Mar-25,IMPS,"31,177.00",00.00,"9,89,214.55",
24-Mar-25,Reversal,44,00.00,"9,89,258.55",
25-Mar-25,Tax,00.00,"1,23,657.32","8,65,601.23",
25-Mar-25,IMPS,00.18,00.00,"8,65,601.41",
25-Mar-25,Reversal,00.00,"4,32,800.71","4,32,800.70",
25-Mar-25,Transportellaneous,00.00,"1,08,200.18","3,24,600.53",
25-Mar-25,Interest,206.62,00.00,"3,24,807.15",
25-Mar-25,Purchase,"1,43,583.00",00.00,"4,68,390.15",
25-Mar-25,Debit Card,00.00,"93,678.03","3,74,712.12",
25-Mar-25,IMPS,00.00,"53,530.30","3,21,181.82",
25-Mar-25,Transfer,00.00,"1,07,060.61","2,14,121.21",
25-Mar-25,NEFT,"4,49,435.25",00.00,"6,63,556.46",
25-Mar-25,ATM,00.00,"2,21,185.49","4,42,370.97",
25-Mar-25,Transportellaneous,384.54,00.00,"4,42,755.51",
25-Mar-25,Transfer,202,00.00,"4,42,957.51",
25-Mar-25,IMPS,"73,947.80",00.00,"5,16,905.31",
25-Mar-25,RTGS,00.00,"86,150.89","4,30,754.42",
25-Mar-25,Transportellaneous,"10,894.90",00.00,"4,41,649.32",
25-Mar-25,ATM,62,00.00,"4,41,711.32",
25-Mar-25,RTGS,362,00.00,"4,42,073.32",
25-Mar-25,Commission,00.00,"88,414.66","3,53,658.66",
25-Mar-25,Cheque,"3,355.70",00.00,"3,57,014.36",
25-Mar-25,Bill,00.00,"71,402.87","2,85,611.49",
25-Mar-25,Interest,00.00,"47,601.92","2,38,009.58",
25-Mar-25,Bill,"9,616.00",00.00,"2,47,625.58",
25-Mar-25,Cheque,00.00,"24,762.56","2,22,863.02",
25-Mar-25,Cheque,288.71,00.00,"2,23,151.73",
25-Mar-25,Transportellaneous,"21,537.60",00.00,"2,44,689.33",
26-Mar-25,Commission,00.00,"48,937.87","1,95,751.46",
26-Mar-25,NEFT,"8,50,100.80",00.00,"10,45,852.26",
26-Mar-25,Transfer,00.00,"2,09,170.45","8,36,681.81",
26-Mar-25,Cash,"20,65,962.00",00.00,"29,02,643.81",
26-Mar-25,RTGS,"3,211.00",00.00,"29,05,854.81",
26-Mar-25,Cheque,00.00,"29,05,854.81",00.00,
26-Mar-25,Tax,"17,119.69",00.00,"17,119.69",
26-Mar-25,Debit Card,00.00,"8,559.85","8,559.84",
26-Mar-25,Purchase,00.00,"8,559.84",00.00,
26-Mar-25,Bill,04.70,00.00,04.70,
26-Mar-25,Reversal,"1,543.00",00.00,"1,547.70",
26-Mar-25,Cash,00.00,309.54,"1,238.16",
26-Mar-25,Transportellaneous,231.03,00.00,"1,469.19",
26-Mar-25,Commission,00.00,734.6,734.6,
26-Mar-25,IMPS,00.00,183.65,550.95,
26-Mar-25,Purchase,"3,68,435.20",00.00,"3,68,986.15",
26-Mar-25,Purchase,110,00.00,"3,69,096.15",
26-Mar-25,RTGS,00.00,"52,728.02","3,16,368.13",
26-Mar-25,Debit Card,"1,90,321.81",00.00,"5,06,689.94",
26-Mar-25,Transportellaneous,00.00,"2,53,344.97","2,53,344.97",
26-Mar-25,NEFT,07.70,00.00,"2,53,352.67",
27-Mar-25,IMPS,"7,46,195.80",00.00,"9,99,548.47",
27-Mar-25,RTGS,00.00,"1,99,909.69","7,99,638.78",
27-Mar-25,Transportellaneous,204.1,00.00,"7,99,842.88",
27-Mar-25,Commission,00.00,"2,66,614.29","5,33,228.59",
27-Mar-25,Bill,00.00,"1,77,742.86","3,55,485.73",
27-Mar-25,Transportellaneous,00.00,"3,55,485.73",00.00,
27-Mar-25,IMPS,"8,93,916.20",00.00,"8,93,916.20",
27-Mar-25,Transportellaneous,121,00.00,"8,94,037.20",
27-Mar-25,Commission,00.00,"1,11,754.65","7,82,282.55",
27-Mar-25,Transfer,"15,555.00",00.00,"7,97,837.55",
28-Mar-25,Purchase,00.00,"88,648.62","7,09,188.93",
28-Mar-25,IMPS,00.00,"78,798.77","6,30,390.16",
28-Mar-25,Commission,10,00.00,"6,30,400.16",
28-Mar-25,Tax,13.76,00.00,"6,30,413.92",
28-Mar-25,Cash,"2,37,656.00",00.00,"8,68,069.92",
28-Mar-25,Tax,"1,15,834.50",00.00,"9,83,904.42",
28-Mar-25,Interest,"19,37,759.80",00.00,"29,21,664.22",
28-Mar-25,Reversal,00.00,"29,21,664.22",00.00,
28-Mar-25,Purchase,"17,42,885.20",00.00,"17,42,885.20",
28-Mar-25,Purchase,35.4,00.00,"17,42,920.60",
28-Mar-25,ATM,00.00,"3,48,584.12","13,94,336.48",
28-Mar-25,Transfer,"6,62,160.50",00.00,"20,56,496.98",
28-Mar-25,Transfer,00.00,"4,11,299.40","16,45,197.58",
28-Mar-25,RTGS,"2,60,841.20",00.00,"19,06,038.78",
28-Mar-25,Transfer,"1,18,156.72",00.00,"20,24,195.50",
28-Mar-25,Cash,00.00,"2,53,024.44","17,71,171.06",
28-Mar-25,Bill,"26,667.00",00.00,"17,97,838.06",
28-Mar-25,Transfer,"12,11,765.00",00.00,"30,09,603.06",
28-Mar-25,NEFT,00.00,"6,01,920.61","24,07,682.45",
28-Mar-25,Transportellaneous,00.00,"3,00,960.31","21,06,722.14",
28-Mar-25,Cash,"1,280.00",00.00,"21,08,002.14",
28-Mar-25,Bill,00.00,"3,51,333.69","17,56,668.45",
28-Mar-25,RTGS,00.00,"4,39,167.11","13,17,501.34",
28-Mar-25,ATM,"23,156.00",00.00,"13,40,657.34",
28-Mar-25,RTGS,00.00,"2,23,442.89","11,17,214.45",
28-Mar-25,Purchase,703.33,00.00,"11,17,917.78",
28-Mar-25,Purchase,00.00,"1,39,739.72","9,78,178.06",
28-Mar-25,Purchase,"1,783.56",00.00,"9,79,961.62",
28-Mar-25,Transfer,"15,97,044.25",00.00,"25,77,005.87",
28-Mar-25,Cash,"1,43,798.00",00.00,"27,20,803.87",
28-Mar-25,Purchase,00.00,"3,40,100.48","23,80,703.39",
28-Mar-25,Transfer,00.00,"23,80,703.39",00.00,
28-Mar-25,NEFT,00.97,00.00,00.97,
28-Mar-25,IMPS,00.00,00.11,00.86,
28-Mar-25,Transportellaneous,"4,723.57",00.00,"4,724.43",
28-Mar-25,NEFT,00.00,"4,724.43",00.00,
28-Mar-25,Bill,"15,517.40",00.00,"15,517.40",
28-Mar-25,Interest,00.00,"2,216.77","13,300.63",
28-Mar-25,Bill,"4,657.87",00.00,"17,958.50",
28-Mar-25,Reversal,00.00,"4,489.63","13,468.88",
28-Mar-25,NEFT,00.00,"1,683.61","11,785.27",
28-Mar-25,Tax,00.00,"2,357.05","9,428.22",
28-Mar-25,Tax,00.00,"1,178.53","8,249.69",
28-Mar-25,Commission,00.00,824.97,"7,424.72",
28-Mar-25,Transfer,171.7,00.00,"7,596.42",
28-Mar-25,Purchase,"16,80,930.00",00.00,"16,88,526.42",
28-Mar-25,RTGS,123.1,00.00,"16,88,649.52",
28-Mar-25,Cheque,00.00,"5,62,883.17","11,25,766.35",
28-Mar-25,Debit Card,"18,42,787.25",00.00,"29,68,553.60",
28-Mar-25,NEFT,"12,585.60",00.00,"29,81,139.20",
28-Mar-25,Transfer,52.99,00.00,"29,81,192.19",
28-Mar-25,Cheque,"26,119.81",00.00,"30,07,312.00",
28-Mar-25,Purchase,00.00,"6,01,462.40","24,05,849.60",
28-Mar-25,Cheque,59.63,00.00,"24,05,909.23",
28-Mar-25,ATM,"4,012.50",00.00,"24,09,921.73",
28-Mar-25,ATM,00.00,"3,01,240.22","21,08,681.51",
28-Mar-25,Tax,00.00,"5,27,170.38","15,81,511.13",
28-Mar-25,Commission,00.00,"1,75,723.46","14,05,787.67",
28-Mar-25,Bill,00.00,"14,05,787.67",00.00,
28-Mar-25,ATM,00.41,00.00,00.41,
28-Mar-25,Purchase,"79,905.50",00.00,"79,905.91",
28-Mar-25,Interest,00.00,"13,317.65","66,588.26",
28-Mar-25,Transportellaneous,"18,316.15",00.00,"84,904.41",
28-Mar-25,Transfer,00.00,"42,452.21","42,452.20",
28-Mar-25,Reversal,00.00,"21,226.10","21,226.10",
28-Mar-25,Purchase,"14,168.90",00.00,"35,395.00",
28-Mar-25,RTGS,00.00,"35,395.00",00.00,
28-Mar-25,Tax,05.40,00.00,05.40,
28-Mar-25,Commission,"1,786.00",00.00,"1,791.40",
28-Mar-25,IMPS,"7,638.06",00.00,"9,429.46",
28-Mar-25,IMPS,219,00.00,"9,648.46",
28-Mar-25,RTGS,00.00,"1,206.06","8,442.40",
28-Mar-25,Debit Card,00.00,"1,407.07","7,035.33",
28-Mar-25,Commission,00.00,"1,172.56","5,862.78",
28-Mar-25,Bill,00.00,"2,931.39","2,931.39",
28-Mar-25,Cheque,"1,91,296.00",00.00,"1,94,227.39",
28-Mar-25,ATM,00.00,"24,278.42","1,69,948.97",
28-Mar-25,Commission,40,00.00,"1,69,988.97",
28-Mar-25,Cheque,"5,97,654.00",00.00,"7,67,642.97",
28-Mar-25,Cheque,"10,74,460.00",00.00,"18,42,102.97",
28-Mar-25,Cheque,00.00,"9,21,051.49","9,21,051.48",
28-Mar-25,Cheque,00.00,"2,30,262.87","6,90,788.61",
28-Mar-25,Cash,"18,052.00",00.00,"7,08,840.61",
28-Mar-25,Cash,"1,68,146.81",00.00,"8,76,987.42",
28-Mar-25,Transfer,00.00,"1,75,397.48","7,01,589.94",
28-Mar-25,RTGS,188.68,00.00,"7,01,778.62",
28-Mar-25,ATM,00.60,00.00,"7,01,779.22",
28-Mar-25,Debit Card,"5,88,721.50",00.00,"12,90,500.72",
28-Mar-25,IMPS,"2,109.60",00.00,"12,92,610.32",
28-Mar-25,Cash,00.00,"12,92,610.32",00.00,
28-Mar-25,Bill,415,00.00,415,
28-Mar-25,Interest,"19,62,092.00",00.00,"19,62,507.00",
28-Mar-25,Bill,413,00.00,"19,62,920.00",
28-Mar-25,Tax,03.00,00.00,"19,62,923.00",
28-Mar-25,Transportellaneous,00.00,"19,62,923.00",00.00,
28-Mar-25,Bill,161,00.00,161,
28-Mar-25,ATM,00.00,20.13,140.88,
28-Mar-25,Interest,00.00,46.96,93.92,
28-Mar-25,Transfer,00.00,11.74,82.18,
28-Mar-25,Bill,424.55,00.00,506.73,
28-Mar-25,Interest,00.00,84.46,422.28,
28-Mar-25,ATM,"28,393.40",00.00,"28,815.68",
28-Mar-25,Commission,"11,12,743.75",00.00,"11,41,559.43",
28-Mar-25,RTGS,00.00,"11,41,559.43",00.00,
29-Mar-25,Reversal,108.81,00.00,108.81,
29-Mar-25,RTGS,00.00,15.54,93.27,
29-Mar-25,Commission,"10,96,922.75",00.00,"10,97,016.02",
29-Mar-25,Purchase,"8,96,920.00",00.00,"19,93,936.02",
29-Mar-25,IMPS,"2,151.97",00.00,"19,96,087.99",
29-Mar-25,Debit Card,"6,639.30",00.00,"20,02,727.29",
29-Mar-25,Purchase,21.4,00.00,"20,02,748.69",
29-Mar-25,Cheque,"1,435.00",00.00,"20,04,183.69",
29-Mar-25,Transportellaneous,00.00,"6,68,061.23","13,36,122.46",
29-Mar-25,NEFT,00.00,"3,34,030.62","10,02,091.84",
29-Mar-25,IMPS,00.00,"2,50,522.96","7,51,568.88",
29-Mar-25,Bill,"22,685.81",00.00,"7,74,254.69",
29-Mar-25,Bill,00.00,"86,028.30","6,88,226.39",
29-Mar-25,Purchase,"1,48,424.00",00.00,"8,36,650.39",
29-Mar-25,NEFT,00.00,"2,09,162.60","6,27,487.79",
29-Mar-25,Reversal,"2,076.00",00.00,"6,29,563.79",
29-Mar-25,NEFT,"2,05,079.20",00.00,"8,34,642.99",
29-Mar-25,Transfer,00.00,"1,39,107.17","6,95,535.82",
29-Mar-25,ATM,460.7,00.00,"6,95,996.52",
29-Mar-25,Reversal,"1,684.38",00.00,"6,97,680.90",
29-Mar-25,Transfer,07.89,00.00,"6,97,688.79",
29-Mar-25,Transfer,00.00,"1,74,422.20","5,23,266.59",
29-Mar-25,Debit Card,54.1,00.00,"5,23,320.69",
29-Mar-25,Tax,"9,72,319.50",00.00,"14,95,640.19",
29-Mar-25,Reversal,"2,887.20",00.00,"14,98,527.39",
29-Mar-25,Bill,00.00,"1,49,852.74","13,48,674.65",
29-Mar-25,Cash,07.00,00.00,"13,48,681.65",
29-Mar-25,Interest,"8,428.41",00.00,"13,57,110.06",
29-Mar-25,ATM,00.00,"2,26,185.01","11,30,925.05",
29-Mar-25,ATM,02.60,00.00,"11,30,927.65",
29-Mar-25,Tax,00.00,"3,76,975.88","7,53,951.77",
29-Mar-25,Bill,02.00,00.00,"7,53,953.77",
29-Mar-25,Debit Card,00.00,"1,88,488.44","5,65,465.33",
29-Mar-25,Bill,00.00,"1,41,366.33","4,24,099.00",
29-Mar-25,Transfer,34.29,00.00,"4,24,133.29",
29-Mar-25,Transfer,00.00,"53,016.66","3,71,116.63",
29-Mar-25,ATM,03.00,00.00,"3,71,119.63",
29-Mar-25,Debit Card,00.00,"1,23,706.54","2,47,413.09",
29-Mar-25,Tax,00.00,"1,23,706.55","1,23,706.54",
29-Mar-25,Reversal,"2,040.00",00.00,"1,25,746.54",
29-Mar-25,Tax,69,00.00,"1,25,815.54",
29-Mar-25,Bill,"19,571.33",00.00,"1,45,386.87",
29-Mar-25,Cash,00.00,"1,45,386.87",00.00,
29-Mar-25,Cash,"6,061.10",00.00,"6,061.10",
29-Mar-25,Debit Card,"20,298.00",00.00,"26,359.10",
29-Mar-25,Cheque,00.00,"2,635.91","23,723.19",
29-Mar-25,Debit Card,"12,75,468.00",00.00,"12,99,191.19",
29-Mar-25,Transfer,54,00.00,"12,99,245.19",
29-Mar-25,Debit Card,"2,39,562.00",00.00,"15,38,807.19",
29-Mar-25,IMPS,00.00,"7,69,403.60","7,69,403.60",
29-Mar-25,NEFT,00.00,"7,69,403.60",00.00,
29-Mar-25,NEFT,01.80,00.00,01.80,
29-Mar-25,RTGS,"2,796.00",00.00,"2,797.80",
29-Mar-25,Cash,00.00,932.6,"1,865.20",
29-Mar-25,NEFT,00.00,207.24,"1,657.96",
29-Mar-25,Reversal,"6,23,479.50",00.00,"6,25,137.46",
29-Mar-25,Commission,00.00,"89,305.35","5,35,832.11",
29-Mar-25,Transfer,00.00,"1,07,166.42","4,28,665.69",
29-Mar-25,Cash,19.5,00.00,"4,28,685.19",
29-Mar-25,Transportellaneous,00.00,"53,585.65","3,75,099.54",
29-Mar-25,Transportellaneous,"51,511.00",00.00,"4,26,610.54",
29-Mar-25,Transportellaneous,"11,760.19",00.00,"4,38,370.73",
29-Mar-25,Interest,01.50,00.00,"4,38,372.23",
29-Mar-25,Purchase,"1,398.00",00.00,"4,39,770.23",
30-Mar-25,Commission,339.51,00.00,"4,40,109.74",
30-Mar-25,Transportellaneous,"8,83,703.00",00.00,"13,23,812.74",
30-Mar-25,Transfer,"31,444.17",00.00,"13,55,256.91",
30-Mar-25,Cheque,00.00,"1,69,407.11","11,85,849.80",
30-Mar-25,RTGS,"12,452.03",00.00,"11,98,301.83",
30-Mar-25,Tax,"1,71,568.20",00.00,"13,69,870.03",
30-Mar-25,Debit Card,00.00,"2,73,974.01","10,95,896.02",
30-Mar-25,ATM,"14,78,948.00",00.00,"25,74,844.02",
30-Mar-25,Reversal,00.00,"5,14,968.80","20,59,875.22",
30-Mar-25,Interest,00.00,"2,05,987.52","18,53,887.70",
30-Mar-25,RTGS,00.00,"4,63,471.93","13,90,415.78",
30-Mar-25,Tax,00.00,"1,98,630.83","11,91,784.95",
30-Mar-25,NEFT,03.00,00.00,"11,91,787.95",
30-Mar-25,Interest,00.00,"1,32,420.88","10,59,367.07",
30-Mar-25,Purchase,00.00,"1,76,561.18","8,82,805.89",
30-Mar-25,Cash,00.00,"2,20,701.47","6,62,104.42",
30-Mar-25,Interest,42.2,00.00,"6,62,146.62",
30-Mar-25,ATM,00.00,"1,32,429.32","5,29,717.30",
30-Mar-25,Cash,00.00,"52,971.73","4,76,745.57",
30-Mar-25,Commission,"35,374.60",00.00,"5,12,120.17",
30-Mar-25,Commission,00.00,"85,353.36","4,26,766.81",
30-Mar-25,Interest,405,00.00,"4,27,171.81",
30-Mar-25,ATM,"1,70,733.20",00.00,"5,97,905.01",
30-Mar-25,Transfer,36,00.00,"5,97,941.01",
30-Mar-25,Purchase,27.92,00.00,"5,97,968.93",
30-Mar-25,Bill,"9,76,281.00",00.00,"15,74,249.93",
30-Mar-25,Interest,00.00,"2,24,892.85","13,49,357.08",
30-Mar-25,Reversal,"2,48,569.30",00.00,"15,97,926.38",
30-Mar-25,Tax,00.00,"5,32,642.13","10,65,284.25",
30-Mar-25,NEFT,00.00,"1,33,160.53","9,32,123.72",
30-Mar-25,Tax,00.00,"3,10,707.91","6,21,415.81",
30-Mar-25,Cheque,00.00,"77,676.98","5,43,738.83",
30-Mar-25,Bill,510.6,00.00,"5,44,249.43",
30-Mar-25,Debit Card,00.00,"68,031.18","4,76,218.25",
30-Mar-25,Purchase,00.00,"79,369.71","3,96,848.54",
30-Mar-25,Tax,00.00,"1,32,282.85","2,64,565.69",
30-Mar-25,Transportellaneous,00.00,"66,141.42","1,98,424.27",
30-Mar-25,RTGS,00.00,"1,98,424.27",00.00,
30-Mar-25,Tax,49,00.00,49,
31-Mar-25,Commission,00.00,06.13,42.88,
31-Mar-25,Cash,00.00,04.76,38.12,
31-Mar-25,Cash,00.00,12.71,25.41,
31-Mar-25,ATM,00.00,02.54,22.87,
31-Mar-25,Transfer,"11,199.90",00.00,"11,222.77",
31-Mar-25,Commission,00.00,"1,246.97","9,975.80",
31-Mar-25,Cash,00.00,"2,493.95","7,481.85",
31-Mar-25,NEFT,00.00,748.19,"6,733.66",
01-Apr-25,Commission,00.00,"1,683.42","5,050.24",
01-Apr-25,Reversal,00.00,631.28,"4,418.96",
01-Apr-25,Cash,00.00,"1,104.74","3,314.22",
01-Apr-25,RTGS,"1,564.10",00.00,"4,878.32",
01-Apr-25,Debit Card,00.00,542.04,"4,336.28",
01-Apr-25,Bill,00.00,"1,084.07","3,252.21",
02-Apr-25,Tax,00.00,464.6,"2,787.61",
03-Apr-25,Bill,63.5,00.00,"2,851.11",
03-Apr-25,Reversal,00.00,"2,851.11",00.00,
03-Apr-25,Transfer,"15,82,375.00",00.00,"15,82,375.00",
03-Apr-25,Debit Card,"1,77,582.00",00.00,"17,59,957.00",
03-Apr-25,Debit Card,"15,26,132.75",00.00,"32,86,089.75",
03-Apr-25,IMPS,45.52,00.00,"32,86,135.27",
03-Apr-25,Debit Card,00.00,"6,57,227.05","26,28,908.22",
03-Apr-25,Transportellaneous,00.00,"13,14,454.11","13,14,454.11",
03-Apr-25,IMPS,00.90,00.00,"13,14,455.01",
03-Apr-25,Transfer,00.00,"13,14,455.01",00.00,
03-Apr-25,ATM,"2,317.21",00.00,"2,317.21",
03-Apr-25,Transportellaneous,"29,534.60",00.00,"31,851.81",
03-Apr-25,IMPS,00.00,"31,851.81",00.00,
03-Apr-25,RTGS,"19,54,040.50",00.00,"19,54,040.50",
03-Apr-25,IMPS,461.64,00.00,"19,54,502.14",
03-Apr-25,ATM,10,00.00,"19,54,512.14",
03-Apr-25,Debit Card,"12,18,573.80",00.00,"31,73,085.94",
03-Apr-25,RTGS,00.00,"10,57,695.31","21,15,390.63",
03-Apr-25,Transportellaneous,941.98,00.00,"21,16,332.61",
03-Apr-25,RTGS,06.70,00.00,"21,16,339.31",
03-Apr-25,RTGS,41.3,00.00,"21,16,380.61",
03-Apr-25,NEFT,460.89,00.00,"21,16,841.50",
03-Apr-25,Cash,00.00,"2,11,684.15","19,05,157.35",
03-Apr-25,Interest,00.00,"4,76,289.34","14,28,868.01",
03-Apr-25,Transfer,240,00.00,"14,29,108.01",
03-Apr-25,Transportellaneous,00.00,"2,04,158.29","12,24,949.72",
03-Apr-25,Debit Card,00.00,"1,22,494.97","11,02,454.75",
03-Apr-25,Bill,297,00.00,"11,02,751.75",
03-Apr-25,Debit Card,07.35,00.00,"11,02,759.10",
03-Apr-25,Transfer,00.00,"3,67,586.37","7,35,172.73",
03-Apr-25,Commission,"30,562.00",00.00,"7,65,734.73",
03-Apr-25,Transportellaneous,380.85,00.00,"7,66,115.58",
03-Apr-25,NEFT,"4,000.80",00.00,"7,70,116.38",
03-Apr-25,Cheque,00.00,"1,54,023.28","6,16,093.10",
03-Apr-25,Reversal,"1,534.00",00.00,"6,17,627.10",
03-Apr-25,Cash,00.00,"68,625.23","5,49,001.87",
03-Apr-25,IMPS,00.00,"1,83,000.62","3,66,001.25",
03-Apr-25,Cheque,"24,657.90",00.00,"3,90,659.15",
03-Apr-25,Debit Card,"1,35,408.30",00.00,"5,26,067.45",
03-Apr-25,Bill,"13,482.31",00.00,"5,39,549.76",
03-Apr-25,Cash,"2,277.06",00.00,"5,41,826.82",
03-Apr-25,Transfer,00.00,"5,41,826.82",00.00,
03-Apr-25,IMPS,"20,756.00",00.00,"20,756.00",
03-Apr-25,ATM,00.00,"2,594.50","18,161.50",
03-Apr-25,Debit Card,810.7,00.00,"18,972.20",
03-Apr-25,Debit Card,05.00,00.00,"18,977.20",
03-Apr-25,RTGS,00.00,"3,162.87","15,814.33",
03-Apr-25,Interest,00.00,"1,757.15","14,057.18",
03-Apr-25,ATM,00.00,"1,405.72","12,651.46",
03-Apr-25,Transportellaneous,00.00,"6,325.73","6,325.73",
03-Apr-25,NEFT,00.00,"2,108.58","4,217.15",
03-Apr-25,Bill,02.56,00.00,"4,219.71",
03-Apr-25,Reversal,"6,870.39",00.00,"11,090.10",
03-Apr-25,Debit Card,00.00,"5,545.05","5,545.05",
03-Apr-25,Transportellaneous,"66,713.78",00.00,"72,258.83",
03-Apr-25,RTGS,00.00,"12,043.14","60,215.69",
03-Apr-25,Bill,"20,40,492.00",00.00,"21,00,707.69",
03-Apr-25,Purchase,"19,55,777.50",00.00,"40,56,485.19",
03-Apr-25,Cash,"1,73,233.25",00.00,"42,29,718.44",
03-Apr-25,Bill,00.00,"4,69,968.72","37,59,749.72",
03-Apr-25,NEFT,00.00,"4,17,749.97","33,41,999.75",
03-Apr-25,ATM,07.21,00.00,"33,42,006.96",
03-Apr-25,Transfer,07.00,00.00,"33,42,013.96",
03-Apr-25,Cash,"2,772.20",00.00,"33,44,786.16",
03-Apr-25,Transportellaneous,00.00,"3,34,478.62","30,10,307.54",
03-Apr-25,RTGS,00.00,"6,02,061.51","24,08,246.03",
03-Apr-25,Reversal,"1,521.40",00.00,"24,09,767.43",
03-Apr-25,Cheque,06.40,00.00,"24,09,773.83",
03-Apr-25,Debit Card,00.00,"24,09,773.83",00.00,
03-Apr-25,Commission,"26,939.30",00.00,"26,939.30",
03-Apr-25,Cash,"64,899.30",00.00,"91,838.60",
03-Apr-25,Debit Card,15.75,00.00,"91,854.35",
03-Apr-25,Tax,00.00,"22,963.59","68,890.76",
03-Apr-25,Reversal,"1,228.00",00.00,"70,118.76",
03-Apr-25,Transportellaneous,00.00,"14,023.75","56,095.01",
03-Apr-25,Bill,"14,954.90",00.00,"71,049.91",
03-Apr-25,Tax,49.04,00.00,"71,098.95",
04-Apr-25,Bill,00.00,"7,109.90","63,989.06",
04-Apr-25,Transfer,00.70,00.00,"63,989.76",
04-Apr-25,Interest,"14,90,146.00",00.00,"15,54,135.76",
04-Apr-25,Bill,"1,92,327.72",00.00,"17,46,463.48",
04-Apr-25,Transportellaneous,00.00,"8,73,231.74","8,73,231.74",
04-Apr-25,Debit Card,00.00,"1,09,153.97","7,64,077.77",
04-Apr-25,Bill,00.00,"1,09,153.97","6,54,923.80",
04-Apr-25,NEFT,23.9,00.00,"6,54,947.70",
04-Apr-25,Cash,00.00,"81,868.46","5,73,079.24",
04-Apr-25,Cheque,00.00,"95,513.21","4,77,566.03",
04-Apr-25,Cash,"24,195.00",00.00,"5,01,761.03",
04-Apr-25,Interest,00.00,"2,50,880.52","2,50,880.52",
04-Apr-25,IMPS,"2,48,419.19",00.00,"4,99,299.71",
04-Apr-25,Cash,"25,737.14",00.00,"5,25,036.85",
04-Apr-25,Cheque,"2,20,776.00",00.00,"7,45,812.85",
04-Apr-25,Purchase,"14,385.86",00.00,"7,60,198.71",
04-Apr-25,Purchase,05.40,00.00,"7,60,204.11",
04-Apr-25,Cheque,570.9,00.00,"7,60,775.01",
04-Apr-25,Tax,00.00,"2,53,591.67","5,07,183.34",
04-Apr-25,NEFT,00.00,"56,353.70","4,50,829.64",
04-Apr-25,Commission,00.00,"45,082.96","4,05,746.68",
04-Apr-25,Commission,266,00.00,"4,06,012.68",
04-Apr-25,Cheque,00.00,"1,35,337.56","2,70,675.12",
04-Apr-25,IMPS,403.73,00.00,"2,71,078.85",
04-Apr-25,IMPS,"14,05,226.00",00.00,"16,76,304.85",
04-Apr-25,Tax,"1,532.00",00.00,"16,77,836.85",
04-Apr-25,ATM,00.00,"3,35,567.37","13,42,269.48",
04-Apr-25,Reversal,00.00,"6,71,134.74","6,71,134.74",
04-Apr-25,IMPS,00.00,"83,891.84","5,87,242.90",
04-Apr-25,Purchase,00.00,"1,95,747.63","3,91,495.27",
04-Apr-25,Reversal,"1,34,565.88",00.00,"5,26,061.15",
04-Apr-25,Commission,"10,39,746.80",00.00,"15,65,807.95",
04-Apr-25,RTGS,00.00,"1,73,978.66","13,91,829.29",
05-Apr-25,Interest,00.00,"6,95,914.65","6,95,914.64",
05-Apr-25,Transfer,"13,23,962.00",00.00,"20,19,876.64",
05-Apr-25,Debit Card,"26,781.34",00.00,"20,46,657.98",
05-Apr-25,NEFT,00.00,"2,27,406.44","18,19,251.54",
05-Apr-25,IMPS,00.00,"3,63,850.31","14,55,401.23",
05-Apr-25,ATM,"26,864.00",00.00,"14,82,265.23",
05-Apr-25,IMPS,"2,31,993.09",00.00,"17,14,258.32",
05-Apr-25,Reversal,03.96,00.00,"17,14,262.28",
05-Apr-25,Bill,356,00.00,"17,14,618.28",
05-Apr-25,IMPS,00.00,"2,85,769.71","14,28,848.57",
05-Apr-25,Debit Card,"16,98,011.80",00.00,"31,26,860.37",
05-Apr-25,Debit Card,29.4,00.00,"31,26,889.77",
05-Apr-25,Transportellaneous,"27,935.52",00.00,"31,54,825.29",
05-Apr-25,Reversal,212.07,00.00,"31,55,037.36",
05-Apr-25,Tax,00.00,"5,25,839.56","26,29,197.80",
06-Apr-25,Tax,"74,342.00",00.00,"27,03,539.80",
06-Apr-25,Tax,00.00,"6,75,884.95","20,27,654.85",
06-Apr-25,Bill,"4,31,654.00",00.00,"24,59,308.85",
06-Apr-25,Debit Card,"82,332.00",00.00,"25,41,640.85",
06-Apr-25,Commission,"2,765.76",00.00,"25,44,406.61",
06-Apr-25,Cash,00.00,"4,24,067.77","21,20,338.84",
06-Apr-25,Transportellaneous,00.00,"2,35,593.20","18,84,745.64",
06-Apr-25,Purchase,"8,391.30",00.00,"18,93,136.94",
06-Apr-25,IMPS,189.8,00.00,"18,93,326.74",
06-Apr-25,Tax,00.00,"2,70,475.25","16,22,851.49",
06-Apr-25,Bill,"1,67,971.50",00.00,"17,90,822.99",
06-Apr-25,Tax,00.00,"2,23,852.87","15,66,970.12",
06-Apr-25,Debit Card,00.00,"15,66,970.12",00.00,
06-Apr-25,Cheque,48.45,00.00,48.45,
06-Apr-25,Reversal,00.00,05.38,43.07,
06-Apr-25,Debit Card,08.73,00.00,51.8,
06-Apr-25,Purchase,00.00,05.76,46.04,
06-Apr-25,RTGS,04.85,00.00,50.89,
06-Apr-25,NEFT,03.00,00.00,53.89,
06-Apr-25,Purchase,00.00,05.39,48.5,
06-Apr-25,Bill,02.00,00.00,50.5,
06-Apr-25,Purchase,00.00,05.05,45.45,
06-Apr-25,Debit Card,"19,806.95",00.00,"19,852.40",
06-Apr-25,Transportellaneous,00.00,"3,970.48","15,881.92",
06-Apr-25,Debit Card,00.00,"7,940.96","7,940.96",
06-Apr-25,NEFT,"1,315.30",00.00,"9,256.26",
06-Apr-25,Reversal,00.00,"1,028.47","8,227.79",
06-Apr-25,Bill,00.00,"1,175.40","7,052.39",
06-Apr-25,Tax,"57,401.19",00.00,"64,453.58",
06-Apr-25,Bill,00.00,"64,453.58",00.00,
06-Apr-25,Tax,02.20,00.00,02.20,
06-Apr-25,Cash,00.00,00.22,01.98,
06-Apr-25,IMPS,"10,18,756.50",00.00,"10,18,758.48",
06-Apr-25,Bill,"3,73,500.25",00.00,"13,92,258.73",
06-Apr-25,Reversal,00.00,"3,48,064.68","10,44,194.05",
06-Apr-25,NEFT,00.00,"5,22,097.03","5,22,097.02",
06-Apr-25,ATM,00.00,"1,30,524.26","3,91,572.76",
06-Apr-25,Cash,00.00,"43,508.08","3,48,064.68",
06-Apr-25,Bill,00.00,"69,612.94","2,78,451.74",
06-Apr-25,Bill,00.00,"1,39,225.87","1,39,225.87",
06-Apr-25,Bill,00.00,"17,403.23","1,21,822.64",
06-Apr-25,Debit Card,00.00,"13,535.85","1,08,286.79",
06-Apr-25,Transfer,358.87,00.00,"1,08,645.66",
06-Apr-25,Transfer,"2,59,279.97",00.00,"3,67,925.63",
06-Apr-25,Cheque,59,00.00,"3,67,984.63",
06-Apr-25,Debit Card,00.00,"45,998.08","3,21,986.55",
06-Apr-25,ATM,00.00,"32,198.66","2,89,787.90",
06-Apr-25,Purchase,00.00,"57,957.58","2,31,830.32",
06-Apr-25,Purchase,"3,759.30",00.00,"2,35,589.62",
06-Apr-25,Commission,07.30,00.00,"2,35,596.92",
06-Apr-25,NEFT,"10,71,466.00",00.00,"13,07,062.92",
06-Apr-25,Purchase,47.95,00.00,"13,07,110.87",
06-Apr-25,Interest,00.00,"1,45,234.54","11,61,876.33",
06-Apr-25,Purchase,02.00,00.00,"11,61,878.33",
06-Apr-25,Debit Card,00.00,"1,45,234.79","10,16,643.54",
06-Apr-25,Tax,00.00,"1,01,664.35","9,14,979.19",
06-Apr-25,Cheque,00.00,"1,82,995.84","7,31,983.35",
06-Apr-25,Reversal,00.00,"2,43,994.45","4,87,988.90",
06-Apr-25,Reversal,25.6,00.00,"4,88,014.50",
06-Apr-25,Reversal,00.00,"97,602.90","3,90,411.60",
06-Apr-25,Interest,00.00,"39,041.16","3,51,370.44",
06-Apr-25,NEFT,00.00,"3,51,370.44",00.00,
06-Apr-25,NEFT,"3,98,539.00",00.00,"3,98,539.00",
06-Apr-25,Bill,00.00,"99,634.75","2,98,904.25",
06-Apr-25,Cash,00.00,"2,98,904.25",00.00,
06-Apr-25,Bill,"16,694.32",00.00,"16,694.32",
06-Apr-25,NEFT,18.3,00.00,"16,712.62",
07-Apr-25,IMPS,00.00,"8,356.31","8,356.31",
07-Apr-25,Interest,00.00,"1,193.76","7,162.55",
07-Apr-25,Purchase,02.01,00.00,"7,164.56",
07-Apr-25,Tax,00.00,796.06,"6,368.50",
07-Apr-25,NEFT,00.00,"1,592.13","4,776.38",
07-Apr-25,Reversal,25,00.00,"4,801.38",
07-Apr-25,Transportellaneous,00.00,685.91,"4,115.47",
07-Apr-25,NEFT,02.70,00.00,"4,118.17",
07-Apr-25,RTGS,"1,35,219.00",00.00,"1,39,337.17",
07-Apr-25,Reversal,00.00,"46,445.72","92,891.45",
07-Apr-25,Bill,146,00.00,"93,037.45",
07-Apr-25,Interest,00.00,"23,259.36","69,778.09",
07-Apr-25,Interest,01.20,00.00,"69,779.29",
07-Apr-25,NEFT,00.00,"9,968.47","59,810.82",
07-Apr-25,Tax,29.2,00.00,"59,840.02",
07-Apr-25,Commission,00.00,"5,984.00","53,856.02",
07-Apr-25,Reversal,00.00,"53,856.02",00.00,
07-Apr-25,RTGS,"16,623.60",00.00,"16,623.60",
07-Apr-25,Transfer,00.00,"1,662.36","14,961.24",
07-Apr-25,Transfer,00.00,"1,496.12","13,465.12",
07-Apr-25,Cash,00.00,"13,465.12",00.00,
07-Apr-25,Cash,01.80,00.00,01.80,
07-Apr-25,Transfer,09.00,00.00,10.8,
07-Apr-25,Cheque,00.00,01.20,09.60,
07-Apr-25,Interest,07.06,00.00,16.66,
07-Apr-25,Transfer,"10,03,641.50",00.00,"10,03,658.16",
07-Apr-25,Tax,"3,028.00",00.00,"10,06,686.16",
07-Apr-25,Cash,458,00.00,"10,07,144.16",
07-Apr-25,Transportellaneous,33.4,00.00,"10,07,177.56",
07-Apr-25,RTGS,00.00,"1,43,882.51","8,63,295.05",
07-Apr-25,RTGS,03.10,00.00,"8,63,298.15",
07-Apr-25,Bill,00.00,"86,329.82","7,76,968.34",
07-Apr-25,ATM,"18,437.22",00.00,"7,95,405.56",
08-Apr-25,NEFT,"7,46,383.50",00.00,"15,41,789.06",
08-Apr-25,Bill,00.00,"3,08,357.81","12,33,431.25",
08-Apr-25,Transfer,00.00,"1,76,204.46","10,57,226.79",
08-Apr-25,ATM,"1,31,203.59",00.00,"11,88,430.38",
08-Apr-25,Transportellaneous,"2,21,521.31",00.00,"14,09,951.69",
08-Apr-25,Tax,427.69,00.00,"14,10,379.38",
08-Apr-25,Cheque,"9,727.00",00.00,"14,20,106.38",
08-Apr-25,Commission,"28,821.97",00.00,"14,48,928.35",
08-Apr-25,NEFT,317.32,00.00,"14,49,245.67",
08-Apr-25,Debit Card,00.00,"4,83,081.89","9,66,163.78",
08-Apr-25,Debit Card,00.00,"9,66,163.78",00.00,
09-Apr-25,Cash,"52,706.80",00.00,"52,706.80",
09-Apr-25,Cash,00.00,"5,856.31","46,850.49",
09-Apr-25,Tax,24.38,00.00,"46,874.87",
09-Apr-25,Purchase,28,00.00,"46,902.87",
09-Apr-25,Cash,00.00,"5,862.86","41,040.01",
09-Apr-25,RTGS,20.9,00.00,"41,060.91",
09-Apr-25,Reversal,00.00,"4,562.32","36,498.59",
09-Apr-25,RTGS,00.00,"36,498.59",00.00,
09-Apr-25,Commission,"1,717.08",00.00,"1,717.08",
09-Apr-25,Reversal,"2,13,686.50",00.00,"2,15,403.58",
09-Apr-25,Purchase,00.00,"23,933.73","1,91,469.85",
09-Apr-25,ATM,"2,210.00",00.00,"1,93,679.85",
10-Apr-25,Reversal,00.00,"24,209.98","1,69,469.87",
10-Apr-25,ATM,00.00,"33,893.97","1,35,575.90",
10-Apr-25,Purchase,"16,01,089.25",00.00,"17,36,665.15",
10-Apr-25,Commission,00.00,"8,68,332.58","8,68,332.58",
10-Apr-25,Debit Card,"5,38,863.00",00.00,"14,07,195.58",
10-Apr-25,Cash,00.00,"7,03,597.79","7,03,597.79",
10-Apr-25,Reversal,279.67,00.00,"7,03,877.46",
10-Apr-25,RTGS,58.64,00.00,"7,03,936.10",
10-Apr-25,Purchase,00.00,"1,17,322.68","5,86,613.42",
10-Apr-25,Cash,"1,168.50",00.00,"5,87,781.92",
10-Apr-25,IMPS,00.00,"2,93,890.96","2,93,890.96",
10-Apr-25,NEFT,00.00,"36,736.37","2,57,154.59",
11-Apr-25,NEFT,"11,880.82",00.00,"2,69,035.41",
11-Apr-25,Purchase,00.00,"29,892.82","2,39,142.59",
11-Apr-25,ATM,"49,653.00",00.00,"2,88,795.59",
11-Apr-25,ATM,00.00,"72,198.90","2,16,596.69",
11-Apr-25,Reversal,00.00,"36,099.45","1,80,497.24",
11-Apr-25,Cheque,00.00,"20,055.25","1,60,441.99",
11-Apr-25,Purchase,17,00.00,"1,60,458.99",
11-Apr-25,ATM,00.00,"26,743.17","1,33,715.82",
12-Apr-25,IMPS,00.00,"14,857.31","1,18,858.51",
12-Apr-25,Commission,153,00.00,"1,19,011.51",
12-Apr-25,Bill,"1,67,394.00",00.00,"2,86,405.51",
12-Apr-25,NEFT,00.00,"40,915.07","2,45,490.44",
12-Apr-25,Interest,02.00,00.00,"2,45,492.44",
12-Apr-25,RTGS,27.41,00.00,"2,45,519.85",
12-Apr-25,Tax,00.00,"40,919.98","2,04,599.88",
12-Apr-25,ATM,00.00,"22,733.32","1,81,866.56",
12-Apr-25,Interest,00.00,"18,186.66","1,63,679.90",
12-Apr-25,ATM,00.00,"18,186.66","1,45,493.24",
13-Apr-25,NEFT,00.00,"1,45,493.24",00.00,
13-Apr-25,Transfer,"12,85,608.00",00.00,"12,85,608.00",
13-Apr-25,Cheque,457.27,00.00,"12,86,065.27",
13-Apr-25,ATM,"15,23,498.00",00.00,"28,09,563.27",
13-Apr-25,Tax,00.00,"2,80,956.33","25,28,606.94",
13-Apr-25,ATM,"22,393.30",00.00,"25,51,000.24",
13-Apr-25,Transfer,00.00,"8,50,333.41","17,00,666.83",
14-Apr-25,Transportellaneous,00.00,"5,66,888.94","11,33,777.89",
14-Apr-25,Purchase,00.00,"1,41,722.24","9,92,055.65",
14-Apr-25,Interest,00.00,"9,92,055.65",00.00,
14-Apr-25,Cheque,30,00.00,30,
14-Apr-25,Transfer,"3,12,895.50",00.00,"3,12,925.50",
14-Apr-25,RTGS,813,00.00,"3,13,738.50",
14-Apr-25,ATM,00.00,"39,217.31","2,74,521.19",
14-Apr-25,ATM,"14,64,396.80",00.00,"17,38,917.99",
14-Apr-25,IMPS,00.00,"8,69,459.00","8,69,459.00",
14-Apr-25,NEFT,00.00,"1,73,891.80","6,95,567.20",
14-Apr-25,IMPS,00.00,"3,47,783.60","3,47,783.60",
14-Apr-25,Cash,"16,395.00",00.00,"3,64,178.60",
14-Apr-25,Transportellaneous,51.3,00.00,"3,64,229.90",
14-Apr-25,Purchase,"15,69,189.25",00.00,"19,33,419.15",
14-Apr-25,Tax,409,00.00,"19,33,828.15",
15-Apr-25,IMPS,00.00,"6,44,609.38","12,89,218.77",
15-Apr-25,Debit Card,00.00,"1,84,174.11","11,05,044.66",
15-Apr-25,NEFT,"4,010.80",00.00,"11,09,055.46",
15-Apr-25,Commission,"8,85,962.00",00.00,"19,95,017.46",
15-Apr-25,Tax,344,00.00,"19,95,361.46",
15-Apr-25,NEFT,00.00,"3,99,072.29","15,96,289.17",
15-Apr-25,IMPS,"1,32,171.25",00.00,"17,28,460.42",
15-Apr-25,Cheque,00.00,"1,92,051.16","15,36,409.26",
15-Apr-25,Commission,00.00,"5,12,136.42","10,24,272.84",
15-Apr-25,ATM,00.00,"2,56,068.21","7,68,204.63",
15-Apr-25,Commission,"16,678.22",00.00,"7,84,882.85",
15-Apr-25,ATM,213.92,00.00,"7,85,096.77",
15-Apr-25,Transfer,"2,45,613.50",00.00,"10,30,710.27",
15-Apr-25,Bill,07.77,00.00,"10,30,718.04",
15-Apr-25,Interest,57.89,00.00,"10,30,775.93",
15-Apr-25,Cash,"5,64,267.00",00.00,"15,95,042.93",
15-Apr-25,NEFT,00.00,"3,98,760.73","11,96,282.20",
15-Apr-25,Interest,311.8,00.00,"11,96,594.00",
15-Apr-25,IMPS,00.00,"2,39,318.80","9,57,275.20",
15-Apr-25,Debit Card,00.00,"9,57,275.20",00.00,
15-Apr-25,Tax,"10,39,217.80",00.00,"10,39,217.80",
15-Apr-25,Interest,00.00,"1,48,459.69","8,90,758.11",
15-Apr-25,Commission,"5,96,247.20",00.00,"14,87,005.31",
15-Apr-25,Tax,00.00,"2,47,834.22","12,39,171.09",
15-Apr-25,Tax,"8,442.00",00.00,"12,47,613.09",
15-Apr-25,ATM,00.00,"3,11,903.27","9,35,709.82",
15-Apr-25,Purchase,171.05,00.00,"9,35,880.87",
15-Apr-25,IMPS,40.3,00.00,"9,35,921.17",
15-Apr-25,Cheque,00.00,"1,16,990.15","8,18,931.02",
15-Apr-25,Tax,313.6,00.00,"8,19,244.62",
15-Apr-25,Reversal,29.71,00.00,"8,19,274.33",
15-Apr-25,NEFT,00.00,"1,63,854.87","6,55,419.46",
15-Apr-25,Cheque,"2,39,146.80",00.00,"8,94,566.26",
15-Apr-25,Debit Card,409.28,00.00,"8,94,975.54",
15-Apr-25,IMPS,00.00,"4,47,487.77","4,47,487.77",
15-Apr-25,Interest,27.65,00.00,"4,47,515.42",
15-Apr-25,Transfer,00.00,"74,585.90","3,72,929.52",
15-Apr-25,Tax,00.00,"41,436.61","3,31,492.91",
15-Apr-25,RTGS,"3,915.90",00.00,"3,35,408.81",
15-Apr-25,Commission,00.00,"3,35,408.81",00.00,
15-Apr-25,Reversal,"60,430.10",00.00,"60,430.10",
15-Apr-25,Bill,"43,704.00",00.00,"1,04,134.10",
15-Apr-25,Transfer,00.00,"1,04,134.10",00.00,
15-Apr-25,Bill,"3,62,392.00",00.00,"3,62,392.00",
15-Apr-25,Purchase,43.08,00.00,"3,62,435.08",
15-Apr-25,IMPS,00.00,"36,243.51","3,26,191.57",
15-Apr-25,RTGS,"1,36,673.16",00.00,"4,62,864.73",
15-Apr-25,Debit Card,00.00,"66,123.53","3,96,741.20",
15-Apr-25,Interest,00.00,"1,98,370.60","1,98,370.60",
15-Apr-25,Tax,00.80,00.00,"1,98,371.40",
15-Apr-25,Transportellaneous,"75,089.53",00.00,"2,73,460.93",
15-Apr-25,Cash,394.13,00.00,"2,73,855.06",
15-Apr-25,Transportellaneous,00.00,"68,463.77","2,05,391.30",
15-Apr-25,Cash,"22,307.70",00.00,"2,27,699.00",
15-Apr-25,Transfer,"45,077.90",00.00,"2,72,776.90",
15-Apr-25,IMPS,00.00,"34,097.11","2,38,679.79",
16-Apr-25,RTGS,00.00,"29,834.97","2,08,844.82",
16-Apr-25,Commission,"9,92,234.00",00.00,"12,01,078.82",
16-Apr-25,Commission,05.00,00.00,"12,01,083.82",
16-Apr-25,Reversal,"1,02,496.50",00.00,"13,03,580.32",
16-Apr-25,Tax,656.53,00.00,"13,04,236.85",
16-Apr-25,Transfer,00.00,"2,60,847.37","10,43,389.48",
16-Apr-25,NEFT,"44,442.70",00.00,"10,87,832.18",
16-Apr-25,Commission,"8,048.00",00.00,"10,95,880.18",
17-Apr-25,IMPS,00.00,"5,47,940.09","5,47,940.09",
17-Apr-25,Bill,191.05,00.00,"5,48,131.14",
17-Apr-25,Bill,00.00,"54,813.11","4,93,318.03",
17-Apr-25,Transfer,"1,19,119.25",00.00,"6,12,437.28",
17-Apr-25,RTGS,"1,73,570.70",00.00,"7,86,007.98",
17-Apr-25,IMPS,04.00,00.00,"7,86,011.98",
17-Apr-25,Transportellaneous,105.74,00.00,"7,86,117.72",
17-Apr-25,Debit Card,00.00,"7,86,117.72",00.00,
17-Apr-25,Bill,272.16,00.00,272.16,
17-Apr-25,Cheque,00.00,136.08,136.08,
17-Apr-25,Purchase,02.22,00.00,138.3,
17-Apr-25,Transfer,05.02,00.00,143.32,
17-Apr-25,Cash,00.00,15.92,127.4,
17-Apr-25,Transfer,231.07,00.00,358.47,
17-Apr-25,Interest,"2,058.00",00.00,"2,416.47",
18-Apr-25,Debit Card,293,00.00,"2,709.47",
18-Apr-25,Transfer,00.00,451.58,"2,257.89",
18-Apr-25,Cash,"14,551.70",00.00,"16,809.59",
18-Apr-25,Cheque,07.00,00.00,"16,816.59",
18-Apr-25,IMPS,"2,17,500.75",00.00,"2,34,317.34",
18-Apr-25,Interest,00.00,"23,431.73","2,10,885.61",
18-Apr-25,Interest,00.00,"23,431.73","1,87,453.88",
18-Apr-25,Reversal,00.00,"26,779.13","1,60,674.75",
18-Apr-25,Transfer,00.00,"53,558.25","1,07,116.50",
18-Apr-25,Cash,00.00,"1,07,116.50",00.00,
18-Apr-25,Reversal,"19,912.30",00.00,"19,912.30",
18-Apr-25,Reversal,00.00,"19,912.30",00.00,
18-Apr-25,Interest,01.82,00.00,01.82,
18-Apr-25,Transportellaneous,"11,184.62",00.00,"11,186.44",
18-Apr-25,Tax,00.00,"1,398.31","9,788.14",
18-Apr-25,Purchase,00.00,"1,398.31","8,389.83",
18-Apr-25,Transfer,07.80,00.00,"8,397.63",
18-Apr-25,Reversal,00.50,00.00,"8,398.13",
18-Apr-25,NEFT,00.00,"4,199.07","4,199.06",
18-Apr-25,Reversal,00.00,419.91,"3,779.15",
18-Apr-25,NEFT,980.66,00.00,"4,759.81",
18-Apr-25,Commission,00.00,594.98,"4,164.83",
18-Apr-25,Transfer,"2,25,662.40",00.00,"2,29,827.23",
18-Apr-25,Cash,91.5,00.00,"2,29,918.73",
18-Apr-25,Commission,05.70,00.00,"2,29,924.43",
18-Apr-25,Reversal,"3,814.00",00.00,"2,33,738.43",
18-Apr-25,RTGS,"1,25,550.50",00.00,"3,59,288.93",
18-Apr-25,NEFT,04.34,00.00,"3,59,293.27",
18-Apr-25,Transfer,"1,39,817.00",00.00,"4,99,110.27",
18-Apr-25,NEFT,00.00,"1,66,370.09","3,32,740.18",
18-Apr-25,IMPS,00.00,"1,66,370.09","1,66,370.09",
18-Apr-25,NEFT,00.00,"27,728.35","1,38,641.74",
18-Apr-25,ATM,06.00,00.00,"1,38,647.74",
18-Apr-25,Transportellaneous,"7,478.00",00.00,"1,46,125.74",
18-Apr-25,Tax,"12,217.00",00.00,"1,58,342.74",
18-Apr-25,Purchase,05.20,00.00,"1,58,347.94",
18-Apr-25,Bill,00.00,"1,58,347.94",00.00,
18-Apr-25,Interest,"3,439.36",00.00,"3,439.36",
18-Apr-25,RTGS,61,00.00,"3,500.36",
18-Apr-25,Debit Card,00.00,875.09,"2,625.27",
18-Apr-25,IMPS,00.00,328.16,"2,297.11",
18-Apr-25,Cheque,"3,184.30",00.00,"5,481.41",
18-Apr-25,NEFT,"3,920.00",00.00,"9,401.41",
18-Apr-25,Cash,00.00,"2,350.35","7,051.06",
18-Apr-25,Tax,"2,33,110.50",00.00,"2,40,161.56",
18-Apr-25,Bill,05.74,00.00,"2,40,167.30",
18-Apr-25,RTGS,40,00.00,"2,40,207.30",
18-Apr-25,RTGS,04.40,00.00,"2,40,211.70",
18-Apr-25,Bill,00.00,"60,052.93","1,80,158.78",
18-Apr-25,Cash,"2,675.20",00.00,"1,82,833.98",
18-Apr-25,Transportellaneous,00.00,"18,283.40","1,64,550.58",
18-Apr-25,Interest,00.00,"82,275.29","82,275.29",
18-Apr-25,ATM,04.30,00.00,"82,279.59",
18-Apr-25,Tax,00.00,"11,754.23","70,525.36",
18-Apr-25,Purchase,00.00,"7,052.54","63,472.82",
18-Apr-25,Tax,44.5,00.00,"63,517.32",
18-Apr-25,Purchase,06.00,00.00,"63,523.32",
18-Apr-25,NEFT,01.40,00.00,"63,524.72",
18-Apr-25,Purchase,00.00,"9,074.96","54,449.76",
19-Apr-25,Reversal,526,00.00,"54,975.76",
19-Apr-25,Purchase,00.00,"7,853.68","47,122.08",
19-Apr-25,Transfer,00.00,"7,853.68","39,268.40",
19-Apr-25,NEFT,"2,41,148.00",00.00,"2,80,416.40",
19-Apr-25,Interest,00.00,"46,736.07","2,33,680.33",
19-Apr-25,Transfer,"1,678.00",00.00,"2,35,358.33",
19-Apr-25,NEFT,00.00,"23,535.83","2,11,822.50",
19-Apr-25,IMPS,00.00,"30,260.36","1,81,562.14",
19-Apr-25,Cheque,00.00,"25,937.45","1,55,624.69",
19-Apr-25,Transfer,00.00,"77,812.35","77,812.34",
19-Apr-25,Interest,00.00,"8,645.82","69,166.52",
19-Apr-25,Cash,377.6,00.00,"69,544.12",
19-Apr-25,Bill,01.16,00.00,"69,545.28",
19-Apr-25,Debit Card,"3,874.00",00.00,"73,419.28",
19-Apr-25,Cash,"23,963.10",00.00,"97,382.38",
19-Apr-25,Tax,"18,17,330.50",00.00,"19,14,712.88",
19-Apr-25,ATM,00.00,"4,78,678.22","14,36,034.66",
19-Apr-25,Cash,00.00,"7,18,017.33","7,18,017.33",
19-Apr-25,RTGS,01.20,00.00,"7,18,018.53",
19-Apr-25,Cheque,"3,664.30",00.00,"7,21,682.83",
20-Apr-25,Tax,00.00,"90,210.35","6,31,472.48",
20-Apr-25,IMPS,00.00,"3,15,736.24","3,15,736.24",
20-Apr-25,Interest,05.00,00.00,"3,15,741.24",
20-Apr-25,ATM,"12,759.10",00.00,"3,28,500.34",
20-Apr-25,Debit Card,00.00,"1,64,250.17","1,64,250.17",
20-Apr-25,Interest,00.00,"1,64,250.17",00.00,
20-Apr-25,Transfer,243.7,00.00,243.7,
20-Apr-25,Purchase,00.00,121.85,121.85,
20-Apr-25,RTGS,"3,259.13",00.00,"3,380.98",
20-Apr-25,Cheque,412.4,00.00,"3,793.38",
20-Apr-25,Tax,"6,938.00",00.00,"10,731.38",
20-Apr-25,Transportellaneous,36.2,00.00,"10,767.58",
20-Apr-25,Cheque,00.00,"3,589.19","7,178.39",
20-Apr-25,Debit Card,"14,56,888.00",00.00,"14,64,066.39",
20-Apr-25,ATM,00.00,"2,44,011.07","12,20,055.32",
20-Apr-25,IMPS,25.6,00.00,"12,20,080.92",
20-Apr-25,Transportellaneous,67.34,00.00,"12,20,148.26",
20-Apr-25,IMPS,00.00,"6,10,074.13","6,10,074.13",
20-Apr-25,Commission,00.00,"1,22,014.83","4,88,059.30",
20-Apr-25,Transfer,"5,876.50",00.00,"4,93,935.80",
20-Apr-25,RTGS,00.00,"54,881.76","4,39,054.04",
20-Apr-25,NEFT,"2,19,053.75",00.00,"6,58,107.79",
20-Apr-25,RTGS,00.00,"73,123.09","5,84,984.70",
20-Apr-25,NEFT,"31,417.00",00.00,"6,16,401.70",
20-Apr-25,Transportellaneous,05.90,00.00,"6,16,407.60",
20-Apr-25,ATM,00.00,"88,058.23","5,28,349.37",
20-Apr-25,Cheque,"1,72,699.59",00.00,"7,01,048.96",
20-Apr-25,Commission,"1,45,321.30",00.00,"8,46,370.26",
20-Apr-25,Transfer,00.00,"1,05,796.28","7,40,573.98",
20-Apr-25,Tax,44,00.00,"7,40,617.98",
20-Apr-25,NEFT,"75,694.00",00.00,"8,16,311.98",
21-Apr-25,IMPS,"1,144.00",00.00,"8,17,455.98",
21-Apr-25,Transfer,00.00,"90,828.44","7,26,627.54",
21-Apr-25,Transportellaneous,00.00,"3,63,313.77","3,63,313.77",
21-Apr-25,Bill,00.00,"40,368.20","3,22,945.57",
21-Apr-25,Transfer,"1,337.00",00.00,"3,24,282.57",
21-Apr-25,Tax,00.00,"40,535.32","2,83,747.25",
21-Apr-25,RTGS,"21,975.00",00.00,"3,05,722.25",
21-Apr-25,Cash,00.00,"38,215.28","2,67,506.97",
21-Apr-25,Reversal,"24,063.40",00.00,"2,91,570.37",
21-Apr-25,Bill,"1,52,027.00",00.00,"4,43,597.37",
21-Apr-25,NEFT,"1,99,489.00",00.00,"6,43,086.37",
21-Apr-25,Interest,113.7,00.00,"6,43,200.07",
21-Apr-25,Purchase,00.00,"91,885.72","5,51,314.35",
21-Apr-25,Tax,"16,035.78",00.00,"5,67,350.13",
21-Apr-25,Interest,"14,767.00",00.00,"5,82,117.13",
21-Apr-25,Commission,63,00.00,"5,82,180.13",
21-Apr-25,Cash,00.00,"1,45,545.03","4,36,635.10",
21-Apr-25,Purchase,00.00,"4,36,635.10",00.00,
21-Apr-25,Transfer,"14,80,507.00",00.00,"14,80,507.00",
21-Apr-25,ATM,03.56,00.00,"14,80,510.56",
21-Apr-25,Purchase,00.00,"4,93,503.52","9,87,007.04",
21-Apr-25,Cash,"28,548.00",00.00,"10,15,555.04",
21-Apr-25,Debit Card,"31,009.10",00.00,"10,46,564.14",
21-Apr-25,Interest,"11,560.00",00.00,"10,58,124.14",
21-Apr-25,Commission,"95,604.94",00.00,"11,53,729.08",
21-Apr-25,Transfer,07.00,00.00,"11,53,736.08",
21-Apr-25,ATM,00.00,"1,92,289.35","9,61,446.73",
21-Apr-25,Commission,00.00,"2,40,361.68","7,21,085.05",
21-Apr-25,RTGS,"25,246.54",00.00,"7,46,331.59",
21-Apr-25,Bill,00.00,"2,48,777.20","4,97,554.39",
21-Apr-25,NEFT,"1,334.00",00.00,"4,98,888.39",
21-Apr-25,Interest,123,00.00,"4,99,011.39",
21-Apr-25,Transportellaneous,00.00,"83,168.57","4,15,842.82",
21-Apr-25,ATM,00.00,"51,980.35","3,63,862.47",
21-Apr-25,NEFT,01.00,00.00,"3,63,863.47",
21-Apr-25,Tax,00.00,"40,429.27","3,23,434.20",
21-Apr-25,Transfer,"1,25,647.06",00.00,"4,49,081.26",
21-Apr-25,ATM,"22,543.00",00.00,"4,71,624.26",
21-Apr-25,Debit Card,00.10,00.00,"4,71,624.36",
21-Apr-25,Tax,00.00,"1,17,906.09","3,53,718.27",
21-Apr-25,NEFT,04.97,00.00,"3,53,723.24",
21-Apr-25,Interest,"1,130.70",00.00,"3,54,853.94",
21-Apr-25,Commission,"6,77,341.00",00.00,"10,32,194.94",
21-Apr-25,NEFT,00.00,"1,72,032.49","8,60,162.45",
21-Apr-25,Transfer,00.00,"1,22,880.35","7,37,282.10",
21-Apr-25,Cash,221.86,00.00,"7,37,503.96",
21-Apr-25,Cheque,00.00,"1,05,357.71","6,32,146.25",
21-Apr-25,Cash,"13,22,260.00",00.00,"19,54,406.25",
21-Apr-25,NEFT,00.00,"2,79,200.89","16,75,205.36",
21-Apr-25,RTGS,00.00,"8,37,602.68","8,37,602.68",
21-Apr-25,Bill,00.00,"1,39,600.45","6,98,002.23",
22-Apr-25,ATM,06.00,00.00,"6,98,008.23",
22-Apr-25,Tax,00.00,"69,800.82","6,28,207.41",
22-Apr-25,Bill,07.10,00.00,"6,28,214.51",
22-Apr-25,Cash,00.00,"3,14,107.26","3,14,107.26",
23-Apr-25,ATM,00.00,"1,04,702.42","2,09,404.84",
23-Apr-25,Interest,"23,108.00",00.00,"2,32,512.84",
23-Apr-25,Cash,00.00,"58,128.21","1,74,384.63",
23-Apr-25,Reversal,00.00,"34,876.93","1,39,507.70",
23-Apr-25,IMPS,00.00,"27,901.54","1,11,606.16",
23-Apr-25,Cash,00.00,"37,202.05","74,404.11",
23-Apr-25,Tax,"1,76,672.28",00.00,"2,51,076.39",
23-Apr-25,Transportellaneous,00.00,"31,384.55","2,19,691.84",
23-Apr-25,Tax,00.00,"27,461.48","1,92,230.36",
23-Apr-25,Tax,27,00.00,"1,92,257.36",
23-Apr-25,Transportellaneous,"46,028.70",00.00,"2,38,286.06",
23-Apr-25,Transportellaneous,"2,623.00",00.00,"2,40,909.06",
23-Apr-25,Commission,321.43,00.00,"2,41,230.49",
23-Apr-25,Reversal,00.00,"40,205.08","2,01,025.41",
23-Apr-25,IMPS,"14,52,648.25",00.00,"16,53,673.66",
23-Apr-25,Bill,00.00,"1,83,741.52","14,69,932.14",
23-Apr-25,Purchase,00.00,"1,83,741.52","12,86,190.62",
23-Apr-25,RTGS,00.00,"2,57,238.12","10,28,952.50",
24-Apr-25,Tax,"3,27,947.00",00.00,"13,56,899.50",
24-Apr-25,Cash,00.00,"4,52,299.83","9,04,599.67",
24-Apr-25,Cheque,00.00,"1,29,228.52","7,75,371.15",
24-Apr-25,Cheque,"1,437.00",00.00,"7,76,808.15",
24-Apr-25,Transfer,04.86,00.00,"7,76,813.01",
24-Apr-25,Interest,00.00,"7,76,813.01",00.00,
24-Apr-25,Commission,01.70,00.00,01.70,
24-Apr-25,Purchase,420.83,00.00,422.53,
24-Apr-25,IMPS,00.00,422.53,00.00,
24-Apr-25,Cheque,34,00.00,34,
24-Apr-25,Tax,00.00,17,17,
24-Apr-25,Cheque,"33,791.60",00.00,"33,808.60",
24-Apr-25,Transportellaneous,107.8,00.00,"33,916.40",
24-Apr-25,Interest,00.00,"8,479.10","25,437.30",
24-Apr-25,Tax,"1,410.00",00.00,"26,847.30",
25-Apr-25,Commission,00.00,"3,355.91","23,491.39",
25-Apr-25,Transfer,"2,18,810.91",00.00,"2,42,302.30",
25-Apr-25,Cheque,281,00.00,"2,42,583.30",
25-Apr-25,RTGS,"16,42,277.00",00.00,"18,84,860.30",
25-Apr-25,IMPS,06.00,00.00,"18,84,866.30",
25-Apr-25,Transportellaneous,00.00,"2,35,608.29","16,49,258.01",
25-Apr-25,Cash,52.85,00.00,"16,49,310.86",
25-Apr-25,Interest,00.00,"2,74,885.14","13,74,425.72",
25-Apr-25,NEFT,00.00,"1,96,346.53","11,78,079.19",
25-Apr-25,Cheque,"2,11,199.70",00.00,"13,89,278.89",
25-Apr-25,Commission,"20,675.40",00.00,"14,09,954.29",
25-Apr-25,Interest,00.00,"1,76,244.29","12,33,710.00",
25-Apr-25,Purchase,221,00.00,"12,33,931.00",
25-Apr-25,Transfer,33.9,00.00,"12,33,964.90",
25-Apr-25,Bill,495,00.00,"12,34,459.90",
25-Apr-25,Interest,00.00,"1,76,351.41","10,58,108.49",
25-Apr-25,Debit Card,00.00,"2,64,527.12","7,93,581.37",
25-Apr-25,Cheque,"15,186.60",00.00,"8,08,767.97",
25-Apr-25,Commission,00.00,"2,69,589.32","5,39,178.65",
25-Apr-25,Interest,00.00,"1,07,835.73","4,31,342.92",
25-Apr-25,Purchase,00.00,"86,268.58","3,45,074.34",
25-Apr-25,ATM,00.00,"43,134.29","3,01,940.05",
25-Apr-25,Tax,27,00.00,"3,01,967.05",
25-Apr-25,Interest,00.00,"60,393.41","2,41,573.64",
25-Apr-25,Cheque,00.00,"30,196.71","2,11,376.94",
25-Apr-25,Reversal,00.00,"35,229.49","1,76,147.45",
25-Apr-25,Transfer,00.00,"58,715.82","1,17,431.63",
25-Apr-25,ATM,"7,735.86",00.00,"1,25,167.49",
25-Apr-25,Bill,00.00,"31,291.87","93,875.62",
25-Apr-25,Cheque,"24,445.20",00.00,"1,18,320.82",
25-Apr-25,Transfer,00.00,"59,160.41","59,160.41",
25-Apr-25,Reversal,"9,333.00",00.00,"68,493.41",
25-Apr-25,Commission,778,00.00,"69,271.41",
25-Apr-25,Purchase,"35,757.91",00.00,"1,05,029.32",
25-Apr-25,RTGS,11.39,00.00,"1,05,040.71",
25-Apr-25,Transportellaneous,"3,444.95",00.00,"1,08,485.66",
25-Apr-25,Cheque,00.00,"1,08,485.66",00.00,
25-Apr-25,NEFT,12.02,00.00,12.02,
25-Apr-25,Cash,00.00,06.01,06.01,
25-Apr-25,Interest,"10,38,800.00",00.00,"10,38,806.01",
25-Apr-25,Cash,00.00,"10,38,806.01",00.00,
25-Apr-25,IMPS,03.00,00.00,03.00,
25-Apr-25,Purchase,"3,237.34",00.00,"3,240.34",
25-Apr-25,Debit Card,00.66,00.00,"3,241.00",
25-Apr-25,Bill,00.00,405.13,"2,835.88",
25-Apr-25,Commission,00.00,283.59,"2,552.29",
25-Apr-25,Commission,00.00,"2,552.29",00.00,
25-Apr-25,Debit Card,"26,851.34",00.00,"26,851.34",
25-Apr-25,Debit Card,00.00,"26,851.34",00.00,
25-Apr-25,Reversal,"2,48,327.40",00.00,"2,48,327.40",
25-Apr-25,Reversal,"4,837.58",00.00,"2,53,164.98",
25-Apr-25,ATM,00.00,"50,633.00","2,02,531.98",
25-Apr-25,Debit Card,00.00,"28,933.14","1,73,598.84",
25-Apr-25,Commission,00.00,"86,799.42","86,799.42",
25-Apr-25,RTGS,00.00,"17,359.88","69,439.54",
25-Apr-25,Transfer,845.18,00.00,"70,284.72",
25-Apr-25,Bill,00.00,"23,428.24","46,856.48",
25-Apr-25,Transportellaneous,"1,21,900.00",00.00,"1,68,756.48",
25-Apr-25,NEFT,00.00,"28,126.08","1,40,630.40",
25-Apr-25,Tax,00.00,"14,063.04","1,26,567.36",
25-Apr-25,Transportellaneous,"1,708.30",00.00,"1,28,275.66",
25-Apr-25,Commission,00.00,"42,758.55","85,517.11",
25-Apr-25,Reversal,"8,718.59",00.00,"94,235.70",
25-Apr-25,Bill,"3,503.19",00.00,"97,738.89",
25-Apr-25,Purchase,00.00,"10,859.88","86,879.01",
25-Apr-25,Tax,00.00,"8,687.90","78,191.11",
25-Apr-25,Commission,00.00,"13,031.85","65,159.26",
25-Apr-25,Purchase,01.00,00.00,"65,160.26",
25-Apr-25,NEFT,07.34,00.00,"65,167.60",
25-Apr-25,Cash,00.00,"8,145.95","57,021.65",
25-Apr-25,Interest,320.91,00.00,"57,342.56",
25-Apr-25,RTGS,00.00,"19,114.19","38,228.37",
25-Apr-25,Transportellaneous,"74,388.00",00.00,"1,12,616.37",
25-Apr-25,Cash,00.00,"14,077.05","98,539.32",
25-Apr-25,Transportellaneous,"2,27,729.00",00.00,"3,26,268.32",
25-Apr-25,Reversal,"1,231.55",00.00,"3,27,499.87",
25-Apr-25,Reversal,00.00,"1,09,166.62","2,18,333.25",
25-Apr-25,Purchase,05.64,00.00,"2,18,338.89",
25-Apr-25,Transfer,00.00,"21,833.89","1,96,505.00",
25-Apr-25,IMPS,"2,58,493.72",00.00,"4,54,998.72",
25-Apr-25,ATM,00.00,"1,13,749.68","3,41,249.04",
25-Apr-25,Bill,"7,50,547.25",00.00,"10,91,796.29",
25-Apr-25,ATM,00.00,"1,55,970.90","9,35,825.39",
25-Apr-25,Cheque,00.00,"1,33,689.34","8,02,136.05",
25-Apr-25,Tax,"25,076.70",00.00,"8,27,212.75",
25-Apr-25,Purchase,00.00,"4,13,606.38","4,13,606.38",
25-Apr-25,Transfer,"4,028.00",00.00,"4,17,634.38",
25-Apr-25,NEFT,07.00,00.00,"4,17,641.38",
25-Apr-25,Reversal,495,00.00,"4,18,136.38",
25-Apr-25,ATM,30.4,00.00,"4,18,166.78",
25-Apr-25,Purchase,00.00,"2,09,083.39","2,09,083.39",
25-Apr-25,Commission,00.00,"23,231.49","1,85,851.90",
25-Apr-25,Commission,05.00,00.00,"1,85,856.90",
25-Apr-25,Commission,00.00,"37,171.38","1,48,685.52",
25-Apr-25,Debit Card,00.00,"24,780.92","1,23,904.60",
25-Apr-25,Purchase,"16,89,466.00",00.00,"18,13,370.60",
25-Apr-25,Bill,03.00,00.00,"18,13,373.60",
25-Apr-25,NEFT,01.16,00.00,"18,13,374.76",
25-Apr-25,Transportellaneous,00.00,"2,01,486.08","16,11,888.68",
26-Apr-25,Transportellaneous,05.00,00.00,"16,11,893.68",
26-Apr-25,Interest,00.20,00.00,"16,11,893.88",
26-Apr-25,Transportellaneous,18.15,00.00,"16,11,912.03",
26-Apr-25,Debit Card,00.00,"1,79,101.34","14,32,810.69",
26-Apr-25,Purchase,00.00,"2,38,801.78","11,94,008.91",
26-Apr-25,Bill,09.70,00.00,"11,94,018.61",
26-Apr-25,Cheque,"1,65,528.70",00.00,"13,59,547.31",
26-Apr-25,Interest,00.00,"1,94,221.04","11,65,326.27",
26-Apr-25,Bill,740,00.00,"11,66,066.27",
26-Apr-25,Cheque,"15,32,976.50",00.00,"26,99,042.77",
26-Apr-25,Transfer,00.00,"4,49,840.46","22,49,202.31",
26-Apr-25,Transfer,00.00,"5,62,300.58","16,86,901.73",
26-Apr-25,ATM,"3,717.50",00.00,"16,90,619.23",
26-Apr-25,Cheque,00.00,"1,69,061.92","15,21,557.31",
26-Apr-25,ATM,"9,33,739.00",00.00,"24,55,296.31",
26-Apr-25,Tax,00.00,"4,91,059.26","19,64,237.05",
26-Apr-25,Debit Card,00.00,"2,45,529.63","17,18,707.42",
26-Apr-25,Commission,34.78,00.00,"17,18,742.20",
26-Apr-25,ATM,"92,181.78",00.00,"18,10,923.98",
26-Apr-25,Transportellaneous,"22,628.00",00.00,"18,33,551.98",
26-Apr-25,Cash,00.00,"1,83,355.20","16,50,196.78",
26-Apr-25,Bill,00.00,"2,35,742.40","14,14,454.38",
26-Apr-25,RTGS,22.3,00.00,"14,14,476.68",
26-Apr-25,Purchase,"2,969.00",00.00,"14,17,445.68",
26-Apr-25,IMPS,00.00,"1,57,493.96","12,59,951.72",
26-Apr-25,Cheque,00.00,"12,59,951.72",00.00,
26-Apr-25,Reversal,51.44,00.00,51.44,
26-Apr-25,RTGS,"3,080.67",00.00,"3,132.11",
26-Apr-25,RTGS,00.00,348.01,"2,784.10",
26-Apr-25,Reversal,"22,158.87",00.00,"24,942.97",
26-Apr-25,Transfer,00.00,"6,235.74","18,707.23",
26-Apr-25,RTGS,57.27,00.00,"18,764.50",
26-Apr-25,Reversal,00.00,"3,752.90","15,011.60",
26-Apr-25,ATM,00.00,"7,505.80","7,505.80",
26-Apr-25,Commission,00.00,"1,501.16","6,004.64",
27-Apr-25,IMPS,00.00,750.58,"5,254.06",
27-Apr-25,Reversal,"2,26,072.00",00.00,"2,31,326.06",
27-Apr-25,Cheque,00.00,"57,831.52","1,73,494.54",
27-Apr-25,Cheque,"23,545.50",00.00,"1,97,040.04",
27-Apr-25,Interest,401,00.00,"1,97,441.04",
27-Apr-25,Cheque,00.00,"39,488.21","1,57,952.83",
27-Apr-25,Transfer,"30,434.10",00.00,"1,88,386.93",
27-Apr-25,Transportellaneous,00.00,"62,795.64","1,25,591.29",
27-Apr-25,RTGS,"79,298.00",00.00,"2,04,889.29",
27-Apr-25,Cash,21.4,00.00,"2,04,910.69",
27-Apr-25,RTGS,00.00,"34,151.78","1,70,758.91",
27-Apr-25,NEFT,491.2,00.00,"1,71,250.11",
28-Apr-25,Transfer,"14,099.70",00.00,"1,85,349.81",
28-Apr-25,ATM,00.00,"46,337.45","1,39,012.36",
28-Apr-25,IMPS,00.00,"17,376.55","1,21,635.81",
28-Apr-25,Cash,"12,51,654.25",00.00,"13,73,290.06",
28-Apr-25,Cheque,"91,191.00",00.00,"14,64,481.06",
28-Apr-25,Cheque,00.00,"2,44,080.18","12,20,400.88",
28-Apr-25,Purchase,547,00.00,"12,20,947.88",
28-Apr-25,RTGS,00.00,"1,35,660.88","10,85,287.00",
29-Apr-25,Debit Card,"34,564.38",00.00,"11,19,851.38",
29-Apr-25,Transportellaneous,"1,65,322.80",00.00,"12,85,174.18",
29-Apr-25,IMPS,00.00,"6,42,587.09","6,42,587.09",
30-Apr-25,Interest,00.00,"64,258.71","5,78,328.38",
30-Apr-25,Interest,00.00,"96,388.06","4,81,940.32",
30-Apr-25,Cheque,00.00,"53,548.92","4,28,391.40",
30-Apr-25,Cheque,191.6,00.00,"4,28,583.00",
30-Apr-25,Tax,00.00,"1,07,145.75","3,21,437.25",
30-Apr-25,ATM,00.00,"64,287.45","2,57,149.80",
30-Apr-25,ATM,00.00,"1,28,574.90","1,28,574.90",
30-Apr-25,RTGS,"19,969.30",00.00,"1,48,544.20",
30-Apr-25,Tax,00.00,"14,854.42","1,33,689.78",
30-Apr-25,Cheque,"18,71,140.00",00.00,"20,04,829.78",
30-Apr-25,Cheque,00.00,"2,50,603.72","17,54,226.06",
30-Apr-25,ATM,"3,077.32",00.00,"17,57,303.38",
30-Apr-25,ATM,00.00,"2,19,662.92","15,37,640.46",
30-Apr-25,Bill,00.00,"7,68,820.23","7,68,820.23",
30-Apr-25,Cheque,00.00,"76,882.02","6,91,938.21",
30-Apr-25,Cash,00.00,"1,15,323.04","5,76,615.17",
30-Apr-25,Transfer,"1,21,663.03",00.00,"6,98,278.20",
30-Apr-25,Debit Card,"14,94,170.00",00.00,"21,92,448.20",
01-May-25,Tax,"32,053.80",00.00,"22,24,502.00",
01-May-25,Debit Card,00.00,"2,22,450.20","20,02,051.80",
01-May-25,Tax,00.00,"2,86,007.40","17,16,044.40",
01-May-25,Reversal,00.00,"5,72,014.80","11,44,029.60",
01-May-25,Transportellaneous,00.00,"2,86,007.40","8,58,022.20",
01-May-25,Transfer,"15,623.00",00.00,"8,73,645.20",
01-May-25,Cheque,00.00,"1,24,806.46","7,48,838.74",
01-May-25,Debit Card,"23,114.20",00.00,"7,71,952.94",
01-May-25,Transfer,00.00,"1,28,658.82","6,43,294.12",
02-May-25,RTGS,00.00,"6,43,294.12",00.00,
02-May-25,Reversal,"2,819.88",00.00,"2,819.88",
02-May-25,Transfer,00.00,"2,819.88",00.00,
02-May-25,Purchase,"2,47,630.00",00.00,"2,47,630.00",
02-May-25,RTGS,"21,825.60",00.00,"2,69,455.60",
02-May-25,ATM,00.00,"33,681.95","2,35,773.65",
02-May-25,Bill,00.00,"29,471.71","2,06,301.94",
02-May-25,NEFT,00.00,"41,260.39","1,65,041.55",
02-May-25,Transportellaneous,02.00,00.00,"1,65,043.55",
02-May-25,Transportellaneous,00.00,"16,504.36","1,48,539.19",
02-May-25,Transportellaneous,00.00,"74,269.60","74,269.60",
02-May-25,Bill,"2,333.90",00.00,"76,603.50",
03-May-25,NEFT,04.20,00.00,"76,607.70",
03-May-25,NEFT,"13,49,930.00",00.00,"14,26,537.70",
03-May-25,Debit Card,00.00,"7,13,268.85","7,13,268.85",
04-May-25,Transportellaneous,00.00,"2,37,756.28","4,75,512.57",
04-May-25,Tax,00.00,"47,551.26","4,27,961.31",
04-May-25,Debit Card,04.88,00.00,"4,27,966.19",
05-May-25,Debit Card,190.24,00.00,"4,28,156.43",
05-May-25,IMPS,00.00,"1,42,718.81","2,85,437.62",
05-May-25,Transportellaneous,241.6,00.00,"2,85,679.22",
05-May-25,Cheque,03.20,00.00,"2,85,682.42",
05-May-25,Reversal,00.00,"1,42,841.21","1,42,841.21",
05-May-25,Reversal,359.1,00.00,"1,43,200.31",
05-May-25,Reversal,00.00,"1,43,200.31",00.00,
05-May-25,Cheque,"70,214.00",00.00,"70,214.00",
05-May-25,Debit Card,00.00,"10,030.57","60,183.43",
05-May-25,ATM,03.00,00.00,"60,186.43",
05-May-25,Purchase,00.00,"20,062.14","40,124.29",
05-May-25,Commission,609.2,00.00,"40,733.49",
05-May-25,Transportellaneous,00.00,"6,788.92","33,944.57",
05-May-25,Transfer,05.40,00.00,"33,949.97",
05-May-25,Debit Card,"1,178.33",00.00,"35,128.30",
05-May-25,Purchase,41.92,00.00,"35,170.22",
05-May-25,Reversal,00.00,"8,792.56","26,377.66",
05-May-25,Interest,34.86,00.00,"26,412.52",
05-May-25,ATM,"12,62,180.50",00.00,"12,88,593.02",
05-May-25,Transfer,"1,339.40",00.00,"12,89,932.42",
05-May-25,Commission,71.1,00.00,"12,90,003.52",
05-May-25,Tax,00.00,"2,58,000.70","10,32,002.82",
05-May-25,NEFT,37.73,00.00,"10,32,040.55",
05-May-25,Tax,00.00,"1,29,005.07","9,03,035.48",
05-May-25,Cash,"2,47,601.10",00.00,"11,50,636.58",
05-May-25,Commission,04.00,00.00,"11,50,640.58",
05-May-25,NEFT,00.00,"3,83,546.86","7,67,093.72",
05-May-25,IMPS,00.00,"2,55,697.91","5,11,395.81",
05-May-25,NEFT,00.00,"2,55,697.91","2,55,697.90",
05-May-25,NEFT,00.00,"63,924.48","1,91,773.42",
05-May-25,ATM,430,00.00,"1,92,203.42",
05-May-25,Interest,00.00,"19,220.34","1,72,983.08",
05-May-25,Cheque,00.00,"57,661.03","1,15,322.05",
05-May-25,Tax,00.00,"28,830.51","86,491.54",
05-May-25,RTGS,"6,64,976.50",00.00,"7,51,468.04",
05-May-25,Interest,00.00,"93,933.51","6,57,534.54",
05-May-25,IMPS,00.80,00.00,"6,57,535.34",
05-May-25,Tax,01.14,00.00,"6,57,536.48",
05-May-25,Cash,162,00.00,"6,57,698.48",
05-May-25,NEFT,00.00,"1,09,616.41","5,48,082.07",
05-May-25,RTGS,"8,82,805.00",00.00,"14,30,887.07",
05-May-25,Bill,"92,411.10",00.00,"15,23,298.17",
05-May-25,Interest,00.00,"7,61,649.09","7,61,649.08",
05-May-25,RTGS,61.15,00.00,"7,61,710.23",
05-May-25,Debit Card,"1,36,584.00",00.00,"8,98,294.23",
05-May-25,Commission,00.00,"99,810.47","7,98,483.76",
05-May-25,NEFT,"1,27,232.20",00.00,"9,25,715.96",
05-May-25,ATM,00.00,"1,85,143.19","7,40,572.77",
05-May-25,Purchase,00.00,"1,05,796.11","6,34,776.66",
05-May-25,NEFT,00.00,"3,17,388.33","3,17,388.33",
05-May-25,ATM,29.5,00.00,"3,17,417.83",
05-May-25,Reversal,163,00.00,"3,17,580.83",
05-May-25,ATM,00.00,"79,395.21","2,38,185.62",
05-May-25,Transfer,00.00,"39,697.60","1,98,488.02",
05-May-25,Tax,36.82,00.00,"1,98,524.84",
05-May-25,Purchase,00.00,"28,360.69","1,70,164.15",
06-May-25,NEFT,"1,11,148.12",00.00,"2,81,312.27",
06-May-25,Bill,00.00,"40,187.47","2,41,124.80",
06-May-25,IMPS,00.00,"24,112.48","2,17,012.32",
06-May-25,Interest,227.6,00.00,"2,17,239.92",
07-May-25,ATM,00.00,"24,137.77","1,93,102.15",
07-May-25,Commission,00.00,"24,137.77","1,68,964.38",
07-May-25,Tax,00.00,"1,68,964.38",00.00,
07-May-25,Tax,"1,20,471.66",00.00,"1,20,471.66",
07-May-25,Debit Card,00.00,"17,210.24","1,03,261.42",
07-May-25,Interest,00.00,"12,907.68","90,353.74",
07-May-25,Interest,"3,596.95",00.00,"93,950.69",
07-May-25,Transportellaneous,"7,223.00",00.00,"1,01,173.69",
07-May-25,NEFT,"10,244.53",00.00,"1,11,418.22",
07-May-25,Commission,00.00,"1,11,418.22",00.00,
07-May-25,RTGS,"14,51,715.50",00.00,"14,51,715.50",
07-May-25,Cheque,00.00,"4,83,905.17","9,67,810.33",
07-May-25,Tax,152.27,00.00,"9,67,962.60",
07-May-25,Transfer,"3,617.00",00.00,"9,71,579.60",
07-May-25,IMPS,00.00,"1,94,315.92","7,77,263.68",
07-May-25,Interest,00.00,"97,157.96","6,80,105.72",
07-May-25,RTGS,"15,700.40",00.00,"6,95,806.12",
07-May-25,ATM,00.00,"99,400.87","5,96,405.25",
07-May-25,Tax,"14,093.40",00.00,"6,10,498.65",
07-May-25,Bill,"30,498.10",00.00,"6,40,996.75",
07-May-25,Tax,00.00,"91,570.96","5,49,425.79",
07-May-25,Transfer,04.83,00.00,"5,49,430.62",
07-May-25,IMPS,"1,685.50",00.00,"5,51,116.12",
07-May-25,Purchase,00.00,"91,852.69","4,59,263.43",
07-May-25,Cash,"5,28,270.00",00.00,"9,87,533.43",
07-May-25,Debit Card,04.00,00.00,"9,87,537.43",
07-May-25,Cheque,00.00,"1,64,589.57","8,22,947.86",
07-May-25,IMPS,00.00,"1,64,589.57","6,58,358.29",
07-May-25,Cash,"8,07,225.00",00.00,"14,65,583.29",
07-May-25,Interest,"2,999.00",00.00,"14,68,582.29",
07-May-25,Debit Card,00.00,"2,44,763.72","12,23,818.58",
07-May-25,Cheque,00.00,"12,23,818.58",00.00,
07-May-25,Interest,06.00,00.00,06.00,
07-May-25,ATM,00.00,03.00,03.00,
07-May-25,Tax,"13,664.00",00.00,"13,667.00",
07-May-25,Tax,"20,82,389.25",00.00,"20,96,056.25",
07-May-25,Cheque,604.7,00.00,"20,96,660.95",
08-May-25,IMPS,00.00,"5,24,165.24","15,72,495.71",
09-May-25,Cash,00.00,"1,57,249.57","14,15,246.14",
09-May-25,NEFT,00.00,"3,53,811.54","10,61,434.60",
09-May-25,RTGS,00.00,"1,76,905.77","8,84,528.83",
09-May-25,Cheque,"6,06,613.75",00.00,"14,91,142.58",
09-May-25,Commission,"2,29,891.44",00.00,"17,21,034.02",
09-May-25,Cheque,"47,519.00",00.00,"17,68,553.02",
09-May-25,Cash,"7,940.62",00.00,"17,76,493.64",
09-May-25,Cheque,48.8,00.00,"17,76,542.44",
09-May-25,Cheque,59.6,00.00,"17,76,602.04",
09-May-25,Cash,00.00,"4,44,150.51","13,32,451.53",
09-May-25,Commission,00.00,"6,66,225.77","6,66,225.76",
09-May-25,Reversal,00.00,"74,025.08","5,92,200.68",
09-May-25,Cheque,00.00,"65,800.08","5,26,400.60",
09-May-25,Cash,00.00,"65,800.08","4,60,600.52",
09-May-25,Debit Card,"1,335.00",00.00,"4,61,935.52",
09-May-25,Tax,00.00,"76,989.25","3,84,946.27",
09-May-25,NEFT,829.7,00.00,"3,85,775.97",
09-May-25,Commission,345.9,00.00,"3,86,121.87",
09-May-25,NEFT,"16,873.59",00.00,"4,02,995.46",
09-May-25,Interest,00.00,"4,02,995.46",00.00,
09-May-25,Debit Card,40.5,00.00,40.5,
09-May-25,Commission,"22,311.00",00.00,"22,351.50",
09-May-25,RTGS,00.00,"3,725.25","18,626.25",
09-May-25,Transfer,04.54,00.00,"18,630.79",
09-May-25,RTGS,"2,345.90",00.00,"20,976.69",
09-May-25,ATM,00.00,"2,330.74","18,645.95",
09-May-25,Purchase,00.00,"2,071.77","16,574.18",
09-May-25,NEFT,"1,647.00",00.00,"18,221.18",
09-May-25,Cheque,"13,39,230.00",00.00,"13,57,451.18",
09-May-25,Purchase,"5,57,037.00",00.00,"19,14,488.18",
09-May-25,Interest,00.00,"3,19,081.36","15,95,406.82",
09-May-25,ATM,"3,488.00",00.00,"15,98,894.82",
09-May-25,NEFT,00.00,"7,99,447.41","7,99,447.41",
09-May-25,Bill,00.00,"99,930.93","6,99,516.48",
09-May-25,Bill,00.00,"1,16,586.08","5,82,930.40",
10-May-25,ATM,00.00,"1,16,586.08","4,66,344.32",
10-May-25,NEFT,318.1,00.00,"4,66,662.42",
10-May-25,Debit Card,00.05,00.00,"4,66,662.47",
10-May-25,RTGS,00.00,"1,16,665.62","3,49,996.85",
10-May-25,Bill,"3,031.06",00.00,"3,53,027.91",
10-May-25,Tax,145,00.00,"3,53,172.91",
10-May-25,Debit Card,00.00,"70,634.58","2,82,538.33",
10-May-25,Commission,00.00,"94,179.44","1,88,358.89",
10-May-25,Bill,"10,569.00",00.00,"1,98,927.89",
10-May-25,Debit Card,00.00,"33,154.65","1,65,773.24",
10-May-25,RTGS,"1,73,943.00",00.00,"3,39,716.24",
10-May-25,Tax,"5,16,915.00",00.00,"8,56,631.24",
10-May-25,Transportellaneous,06.45,00.00,"8,56,637.69",
10-May-25,Interest,00.00,"1,42,772.95","7,13,864.74",
10-May-25,IMPS,00.00,"1,18,977.46","5,94,887.28",
10-May-25,RTGS,00.00,"59,488.73","5,35,398.55",
10-May-25,Bill,00.70,00.00,"5,35,399.25",
10-May-25,Purchase,00.00,"76,485.61","4,58,913.64",
10-May-25,Tax,"5,24,639.00",00.00,"9,83,552.64",
11-May-25,NEFT,"1,96,893.00",00.00,"11,80,445.64",
11-May-25,Cheque,00.00,"1,31,160.63","10,49,285.01",
11-May-25,Transfer,00.00,"1,04,928.50","9,44,356.51",
11-May-25,Commission,"1,27,748.00",00.00,"10,72,104.51",
11-May-25,Cash,00.00,"1,34,013.06","9,38,091.45",
11-May-25,Commission,00.00,"3,12,697.15","6,25,394.30",
11-May-25,Purchase,00.00,"1,25,078.86","5,00,315.44",
11-May-25,Transfer,00.00,"5,00,315.44",00.00,
11-May-25,Interest,"14,18,527.00",00.00,"14,18,527.00",
11-May-25,Cheque,00.00,"14,18,527.00",00.00,
11-May-25,Cheque,182.4,00.00,182.4,
11-May-25,Bill,00.00,60.8,121.6,
11-May-25,Bill,00.00,121.6,00.00,
11-May-25,Transfer,233,00.00,233,
11-May-25,RTGS,00.00,33.29,199.71,
11-May-25,Transfer,32.47,00.00,232.18,
11-May-25,Tax,00.00,232.18,00.00,
11-May-25,Cash,36,00.00,36,
11-May-25,Reversal,00.00,12,24,
11-May-25,Commission,00.00,02.67,21.33,
11-May-25,ATM,00.00,03.56,17.77,
11-May-25,Cheque,00.00,02.22,15.55,
11-May-25,Interest,00.00,05.18,10.37,
11-May-25,Purchase,00.00,02.07,08.30,
11-May-25,Transportellaneous,865,00.00,873.3,
11-May-25,Bill,00.00,873.3,00.00,
12-May-25,Bill,"80,515.56",00.00,"80,515.56",
12-May-25,Transportellaneous,07.00,00.00,"80,522.56",
12-May-25,Commission,"53,506.75",00.00,"1,34,029.31",
12-May-25,RTGS,00.00,"44,676.44","89,352.87",
12-May-25,ATM,00.00,"17,870.57","71,482.30",
12-May-25,Tax,"18,27,063.20",00.00,"18,98,545.50",
12-May-25,Purchase,00.00,"2,71,220.79","16,27,324.71",
12-May-25,Tax,00.00,"3,25,464.94","13,01,859.77",
12-May-25,Bill,"8,833.80",00.00,"13,10,693.57",
12-May-25,Interest,"3,246.36",00.00,"13,13,939.93",
13-May-25,Cheque,"4,700.20",00.00,"13,18,640.13",
13-May-25,Purchase,23.8,00.00,"13,18,663.93",
13-May-25,Transportellaneous,00.00,"1,88,380.56","11,30,283.37",
13-May-25,Commission,00.00,"11,30,283.37",00.00,
13-May-25,Transportellaneous,"4,07,287.00",00.00,"4,07,287.00",
13-May-25,Interest,00.00,"58,183.86","3,49,103.14",
13-May-25,Bill,00.00,"1,16,367.71","2,32,735.43",
13-May-25,Transfer,35.7,00.00,"2,32,771.13",
13-May-25,Transfer,00.00,"29,096.39","2,03,674.74",
13-May-25,Cheque,"3,772.40",00.00,"2,07,447.14",
13-May-25,ATM,00.00,"25,930.89","1,81,516.25",
13-May-25,Cash,00.00,"36,303.25","1,45,213.00",
13-May-25,Interest,00.00,"16,134.78","1,29,078.22",
13-May-25,Cheque,08.00,00.00,"1,29,086.22",
13-May-25,Purchase,"22,802.50",00.00,"1,51,888.72",
13-May-25,Cheque,00.00,"50,629.57","1,01,259.15",
13-May-25,Commission,00.00,"11,251.02","90,008.13",
13-May-25,ATM,"3,268.00",00.00,"93,276.13",
13-May-25,Purchase,00.00,"13,325.16","79,950.97",
13-May-25,NEFT,"2,23,709.00",00.00,"3,03,659.97",
13-May-25,Interest,00.00,"30,366.00","2,73,293.97",
13-May-25,Cash,00.00,"1,36,646.99","1,36,646.98",
13-May-25,Purchase,00.00,"68,323.49","68,323.49",
13-May-25,Cash,03.00,00.00,"68,326.49",
13-May-25,Transfer,00.00,"34,163.25","34,163.25",
13-May-25,Transfer,13,00.00,"34,176.25",
13-May-25,Interest,00.00,"4,882.32","29,293.93",
13-May-25,Bill,18.8,00.00,"29,312.73",
13-May-25,Cheque,22,00.00,"29,334.73",
13-May-25,Tax,"2,39,308.00",00.00,"2,68,642.73",
13-May-25,Transfer,"8,60,874.50",00.00,"11,29,517.23",
13-May-25,Bill,32,00.00,"11,29,549.23",
13-May-25,IMPS,"29,775.56",00.00,"11,59,324.79",
13-May-25,Debit Card,00.00,"1,93,220.80","9,66,103.99",
13-May-25,Reversal,00.00,"9,66,103.99",00.00,
13-May-25,Tax,10,00.00,10,
13-May-25,Cheque,"28,867.23",00.00,"28,877.23",
13-May-25,Reversal,175,00.00,"29,052.23",
13-May-25,Bill,42.9,00.00,"29,095.13",
13-May-25,Tax,"1,943.00",00.00,"31,038.13",
13-May-25,Tax,290,00.00,"31,328.13",
13-May-25,IMPS,"2,626.98",00.00,"33,955.11",
13-May-25,ATM,00.00,"4,244.39","29,710.72",
13-May-25,Cheque,"1,41,675.00",00.00,"1,71,385.72",
13-May-25,IMPS,"11,03,749.00",00.00,"12,75,134.72",
13-May-25,RTGS,"2,00,589.00",00.00,"14,75,723.72",
13-May-25,NEFT,00.00,"4,91,907.91","9,83,815.81",
13-May-25,Commission,00.00,"1,96,763.16","7,87,052.65",
13-May-25,Cash,"2,02,538.00",00.00,"9,89,590.65",
13-May-25,Purchase,166,00.00,"9,89,756.65",
13-May-25,IMPS,00.00,"1,41,393.81","8,48,362.84",
13-May-25,Purchase,40,00.00,"8,48,402.84",
13-May-25,Commission,17.4,00.00,"8,48,420.24",
13-May-25,Debit Card,"15,88,014.80",00.00,"24,36,435.04",
13-May-25,ATM,00.00,"3,04,554.38","21,31,880.66",
13-May-25,Cash,00.00,"2,36,875.63","18,95,005.03",
13-May-25,Reversal,00.00,"3,79,001.01","15,16,004.02",
13-May-25,Cheque,06.70,00.00,"15,16,010.72",
13-May-25,Transportellaneous,00.00,"1,51,601.07","13,64,409.65",
13-May-25,ATM,00.00,"4,54,803.22","9,09,606.43",
13-May-25,RTGS,00.00,"1,29,943.78","7,79,662.65",
13-May-25,Interest,"37,263.00",00.00,"8,16,925.65",
13-May-25,Reversal,40.82,00.00,"8,16,966.47",
13-May-25,ATM,00.00,"2,04,241.62","6,12,724.85",
13-May-25,Reversal,48,00.00,"6,12,772.85",
13-May-25,RTGS,"12,84,615.80",00.00,"18,97,388.65",
13-May-25,ATM,00.00,"6,32,462.88","12,64,925.77",
13-May-25,RTGS,383.39,00.00,"12,65,309.16",
13-May-25,Commission,"15,947.00",00.00,"12,81,256.16",
13-May-25,IMPS,00.00,"1,28,125.62","11,53,130.54",
13-May-25,Commission,02.20,00.00,"11,53,132.74",
13-May-25,ATM,370.8,00.00,"11,53,503.54",
13-May-25,IMPS,07.00,00.00,"11,53,510.54",
13-May-25,Cash,00.00,"2,88,377.64","8,65,132.90",
13-May-25,NEFT,00.00,"4,32,566.45","4,32,566.45",
13-May-25,Interest,"1,49,982.41",00.00,"5,82,548.86",
13-May-25,IMPS,"16,59,741.00",00.00,"22,42,289.86",
13-May-25,Cash,00.00,"3,20,327.12","19,21,962.74",
13-May-25,Transportellaneous,00.00,"2,40,245.34","16,81,717.40",
13-May-25,Bill,00.00,"8,40,858.70","8,40,858.70",
13-May-25,Bill,00.00,"4,20,429.35","4,20,429.35",
13-May-25,Transfer,00.00,"4,20,429.35",00.00,
13-May-25,Reversal,"16,50,537.50",00.00,"16,50,537.50",
13-May-25,Transfer,"16,392.00",00.00,"16,66,929.50",
13-May-25,Reversal,55.58,00.00,"16,66,985.08",
13-May-25,Purchase,00.00,"2,38,140.73","14,28,844.35",
13-May-25,Purchase,00.00,"14,28,844.35",00.00,
13-May-25,Interest,"2,734.00",00.00,"2,734.00",
13-May-25,Cheque,"3,668.31",00.00,"6,402.31",
13-May-25,Cash,"3,442.30",00.00,"9,844.61",
13-May-25,Bill,16.3,00.00,"9,860.91",
13-May-25,NEFT,00.00,"1,643.49","8,217.42",
13-May-25,Tax,"8,545.00",00.00,"16,762.42",
13-May-25,Bill,432.7,00.00,"17,195.12",
13-May-25,Transportellaneous,00.00,"17,195.12",00.00,
13-May-25,Cash,"1,70,626.20",00.00,"1,70,626.20",
13-May-25,RTGS,27,00.00,"1,70,653.20",
13-May-25,ATM,854.6,00.00,"1,71,507.80",
13-May-25,Bill,318,00.00,"1,71,825.80",
13-May-25,Commission,07.74,00.00,"1,71,833.54",
13-May-25,Transportellaneous,"15,96,543.00",00.00,"17,68,376.54",
13-May-25,Commission,00.00,"4,42,094.14","13,26,282.40",
13-May-25,Reversal,00.00,"1,47,364.71","11,78,917.69",
13-May-25,RTGS,233.95,00.00,"11,79,151.64",
13-May-25,Commission,00.00,"5,89,575.82","5,89,575.82",
13-May-25,Debit Card,434,00.00,"5,90,009.82",
14-May-25,ATM,"32,320.68",00.00,"6,22,330.50",
14-May-25,NEFT,"1,149.30",00.00,"6,23,479.80",
14-May-25,Cash,211,00.00,"6,23,690.80",
14-May-25,RTGS,00.00,"1,55,922.70","4,67,768.10",
14-May-25,NEFT,00.00,"51,974.23","4,15,793.87",
14-May-25,NEFT,00.00,"2,07,896.94","2,07,896.94",
14-May-25,NEFT,00.00,"25,987.12","1,81,909.82",
14-May-25,ATM,00.00,"22,738.73","1,59,171.09",
14-May-25,Reversal,00.00,"15,917.11","1,43,253.98",
14-May-25,Cash,00.00,"47,751.33","95,502.65",
14-May-25,Commission,00.00,"15,917.11","79,585.54",
14-May-25,NEFT,"2,341.70",00.00,"81,927.24",
14-May-25,ATM,00.00,"11,703.89","70,223.35",
14-May-25,Debit Card,"1,93,734.53",00.00,"2,63,957.88",
14-May-25,Cash,00.00,"87,985.96","1,75,971.92",
14-May-25,Tax,00.00,"17,597.19","1,58,374.73",
14-May-25,Cash,00.00,"52,791.58","1,05,583.15",
14-May-25,Cash,07.00,00.00,"1,05,590.15",
14-May-25,NEFT,04.73,00.00,"1,05,594.88",
14-May-25,Cheque,49,00.00,"1,05,643.88",
14-May-25,Debit Card,00.00,"1,05,643.88",00.00,
14-May-25,Commission,"15,356.40",00.00,"15,356.40",
15-May-25,Reversal,336,00.00,"15,692.40",
15-May-25,Cheque,00.00,"7,846.20","7,846.20",
15-May-25,Reversal,"73,837.70",00.00,"81,683.90",
15-May-25,RTGS,"1,745.00",00.00,"83,428.90",
15-May-25,NEFT,"9,53,943.00",00.00,"10,37,371.90",
15-May-25,Transfer,00.00,"10,37,371.90",00.00,
15-May-25,Interest,"4,466.63",00.00,"4,466.63",
15-May-25,ATM,00.00,"1,488.88","2,977.75",
15-May-25,Interest,00.00,595.55,"2,382.20",
15-May-25,ATM,00.00,264.69,"2,117.51",
15-May-25,Bill,"2,19,696.44",00.00,"2,21,813.95",
15-May-25,NEFT,00.00,"44,362.79","1,77,451.16",
15-May-25,NEFT,01.10,00.00,"1,77,452.26",
15-May-25,Purchase,00.00,"25,350.32","1,52,101.94",
15-May-25,Transportellaneous,"1,479.00",00.00,"1,53,580.94",
15-May-25,Purchase,00.00,"76,790.47","76,790.47",
15-May-25,Debit Card,03.00,00.00,"76,793.47",
15-May-25,Transfer,234,00.00,"77,027.47",
15-May-25,Cheque,00.00,"8,558.61","68,468.86",
15-May-25,Bill,00.00,"9,781.27","58,687.59",
15-May-25,ATM,"30,905.05",00.00,"89,592.64",
15-May-25,Debit Card,00.00,"29,864.21","59,728.43",
15-May-25,Reversal,00.00,"19,909.48","39,818.95",
15-May-25,IMPS,00.00,"5,688.42","34,130.53",
15-May-25,Bill,108,00.00,"34,238.53",
15-May-25,Interest,00.00,"3,423.85","30,814.68",
15-May-25,Debit Card,05.20,00.00,"30,819.88",
15-May-25,RTGS,00.00,"30,819.88",00.00,
15-May-25,Debit Card,"13,247.90",00.00,"13,247.90",
15-May-25,Reversal,00.00,"1,892.56","11,355.34",
15-May-25,Transfer,48,00.00,"11,403.34",
15-May-25,ATM,00.00,"3,801.11","7,602.23",
15-May-25,Reversal,113,00.00,"7,715.23",
15-May-25,Transportellaneous,00.00,"3,857.62","3,857.62",
15-May-25,Interest,00.00,551.09,"3,306.53",
15-May-25,IMPS,56,00.00,"3,362.53",
15-May-25,RTGS,00.00,840.63,"2,521.90",
15-May-25,Commission,00.00,252.19,"2,269.71",
15-May-25,Transfer,"18,65,984.50",00.00,"18,68,254.21",
15-May-25,Cheque,"31,844.40",00.00,"19,00,098.61",
15-May-25,Reversal,"3,271.40",00.00,"19,03,370.01",
15-May-25,Cash,00.00,"19,03,370.01",00.00,
15-May-25,IMPS,04.00,00.00,04.00,
15-May-25,Bill,47,00.00,51,
15-May-25,Interest,"15,21,381.00",00.00,"15,21,432.00",
15-May-25,NEFT,00.00,"3,80,358.00","11,41,074.00",
15-May-25,Interest,00.00,"11,41,074.00",00.00,
15-May-25,NEFT,"18,88,510.20",00.00,"18,88,510.20",
15-May-25,Transportellaneous,"20,018.75",00.00,"19,08,528.95",
15-May-25,Cheque,54.6,00.00,"19,08,583.55",
15-May-25,NEFT,"1,232.70",00.00,"19,09,816.25",
15-May-25,ATM,00.00,"4,77,454.06","14,32,362.19",
15-May-25,Reversal,00.00,"1,43,236.22","12,89,125.97",
15-May-25,Transportellaneous,00.00,"2,14,854.33","10,74,271.64",
15-May-25,Cash,"3,279.09",00.00,"10,77,550.73",
15-May-25,Cheque,00.00,"2,15,510.15","8,62,040.58",
15-May-25,Cash,"1,51,076.80",00.00,"10,13,117.38",
15-May-25,NEFT,"2,647.90",00.00,"10,15,765.28",
15-May-25,Purchase,00.00,"3,38,588.43","6,77,176.85",
15-May-25,ATM,05.50,00.00,"6,77,182.35",
15-May-25,Transportellaneous,29,00.00,"6,77,211.35",
15-May-25,Interest,00.00,"2,25,737.12","4,51,474.23",
15-May-25,RTGS,"83,586.00",00.00,"5,35,060.23",
15-May-25,IMPS,00.00,"2,67,530.12","2,67,530.12",
15-May-25,Debit Card,00.00,"29,725.57","2,37,804.55",
15-May-25,RTGS,00.00,"23,780.46","2,14,024.10",
15-May-25,Transfer,00.00,"23,780.46","1,90,243.64",
15-May-25,Transportellaneous,00.48,00.00,"1,90,244.12",
15-May-25,IMPS,00.00,"1,90,244.12",00.00,
15-May-25,Commission,06.00,00.00,06.00,
15-May-25,RTGS,"28,149.38",00.00,"28,155.38",
15-May-25,Transportellaneous,03.00,00.00,"28,158.38",
15-May-25,Cheque,00.00,"3,128.71","25,029.67",
15-May-25,Cash,"10,365.70",00.00,"35,395.37",
15-May-25,Cheque,46.1,00.00,"35,441.47",
15-May-25,Transportellaneous,00.00,"3,544.15","31,897.32",
15-May-25,Bill,"3,753.40",00.00,"35,650.72",
15-May-25,RTGS,00.00,"17,825.36","17,825.36",
16-May-25,RTGS,39,00.00,"17,864.36",
16-May-25,Cheque,"47,923.00",00.00,"65,787.36",
16-May-25,Cash,00.00,"16,446.84","49,340.52",
16-May-25,ATM,00.00,"5,482.28","43,858.24",
16-May-25,NEFT,00.00,"4,385.82","39,472.42",
16-May-25,Cheque,00.00,"19,736.21","19,736.21",
16-May-25,Bill,01.55,00.00,"19,737.76",
16-May-25,Cash,04.10,00.00,"19,741.86",
16-May-25,Purchase,00.00,"1,974.19","17,767.67",
16-May-25,ATM,00.00,"1,776.77","15,990.90",
17-May-25,Bill,01.00,00.00,"15,991.90",
17-May-25,Transfer,"22,115.90",00.00,"38,107.80",
17-May-25,IMPS,00.00,"4,763.48","33,344.33",
17-May-25,Cash,00.00,"4,763.48","28,580.85",
17-May-25,RTGS,00.00,"5,716.17","22,864.68",
17-May-25,RTGS,00.00,"5,716.17","17,148.51",
17-May-25,Debit Card,00.00,"2,449.79","14,698.72",
17-May-25,Transfer,00.00,"14,698.72",00.00,
17-May-25,RTGS,02.63,00.00,02.63,
17-May-25,Cash,"5,59,488.00",00.00,"5,59,490.63",
17-May-25,IMPS,00.00,"79,927.23","4,79,563.40",
18-May-25,ATM,00.00,"59,945.43","4,19,617.98",
18-May-25,Bill,"17,999.00",00.00,"4,37,616.98",
18-May-25,Reversal,01.40,00.00,"4,37,618.38",
19-May-25,Transportellaneous,00.00,"54,702.30","3,82,916.08",
19-May-25,RTGS,00.00,"1,27,638.69","2,55,277.39",
19-May-25,Transportellaneous,00.00,"51,055.48","2,04,221.91",
19-May-25,Cheque,00.00,"51,055.48","1,53,166.43",
19-May-25,Bill,00.00,"51,055.48","1,02,110.95",
19-May-25,Debit Card,00.00,"11,345.66","90,765.29",
19-May-25,RTGS,00.00,"18,153.06","72,612.23",
19-May-25,Reversal,00.00,"9,076.53","63,535.70",
19-May-25,Commission,54.1,00.00,"63,589.80",
19-May-25,Interest,"15,42,702.00",00.00,"16,06,291.80",
19-May-25,NEFT,14.8,00.00,"16,06,306.60",
19-May-25,Debit Card,00.00,"2,00,788.33","14,05,518.28",
19-May-25,Tax,"13,18,945.50",00.00,"27,24,463.78",
19-May-25,Transportellaneous,444,00.00,"27,24,907.78",
19-May-25,Cheque,00.00,"4,54,151.30","22,70,756.48",
19-May-25,NEFT,324.73,00.00,"22,71,081.21",
19-May-25,Transportellaneous,00.00,"5,67,770.30","17,03,310.91",
19-May-25,IMPS,00.00,"1,70,331.09","15,32,979.82",
19-May-25,Transportellaneous,00.00,"3,06,595.96","12,26,383.86",
19-May-25,Interest,00.00,"1,36,264.87","10,90,118.99",
20-May-25,NEFT,00.00,"1,09,011.90","9,81,107.09",
20-May-25,Interest,00.00,"1,22,638.39","8,58,468.70",
20-May-25,RTGS,00.00,"2,86,156.23","5,72,312.47",
20-May-25,Commission,05.70,00.00,"5,72,318.17",
20-May-25,Commission,00.00,"2,86,159.09","2,86,159.09",
20-May-25,Transportellaneous,"15,494.00",00.00,"3,01,653.09",
20-May-25,Bill,00.00,"75,413.27","2,26,239.82",
20-May-25,Purchase,60.79,00.00,"2,26,300.61",
20-May-25,Purchase,00.00,"25,144.51","2,01,156.10",
20-May-25,Commission,"13,65,981.25",00.00,"15,67,137.35",
20-May-25,Transfer,"13,718.90",00.00,"15,80,856.25",
20-May-25,Tax,00.00,"15,80,856.25",00.00,
20-May-25,Transfer,03.60,00.00,03.60,
20-May-25,RTGS,"4,53,856.25",00.00,"4,53,859.85",
20-May-25,Cash,"11,661.00",00.00,"4,65,520.85",
20-May-25,Debit Card,420,00.00,"4,65,940.85",
20-May-25,Interest,00.00,"51,771.21","4,14,169.64",
20-May-25,Commission,"4,70,147.25",00.00,"8,84,316.89",
20-May-25,NEFT,07.52,00.00,"8,84,324.41",
20-May-25,NEFT,00.00,"88,432.44","7,95,891.97",
20-May-25,Purchase,00.00,"1,59,178.39","6,36,713.58",
20-May-25,Cheque,00.00,"1,59,178.40","4,77,535.18",
20-May-25,Cash,"3,005.00",00.00,"4,80,540.18",
20-May-25,Bill,25.3,00.00,"4,80,565.48",
20-May-25,IMPS,19.7,00.00,"4,80,585.18",
20-May-25,RTGS,94,00.00,"4,80,679.18",
20-May-25,Debit Card,"2,538.82",00.00,"4,83,218.00",
20-May-25,ATM,00.00,"48,321.80","4,34,896.20",
20-May-25,RTGS,"29,436.80",00.00,"4,64,333.00",
20-May-25,IMPS,"35,941.53",00.00,"5,00,274.53",
20-May-25,Debit Card,"2,032.80",00.00,"5,02,307.33",
20-May-25,NEFT,00.00,"55,811.93","4,46,495.40",
20-May-25,ATM,00.00,"63,785.06","3,82,710.34",
20-May-25,Transportellaneous,04.30,00.00,"3,82,714.64",
21-May-25,Tax,00.00,"76,542.93","3,06,171.71",
21-May-25,Cash,35.6,00.00,"3,06,207.31",
21-May-25,NEFT,00.00,"51,034.55","2,55,172.76",
21-May-25,Reversal,21.61,00.00,"2,55,194.37",
21-May-25,IMPS,378,00.00,"2,55,572.37",
21-May-25,Purchase,00.00,"31,946.55","2,23,625.82",
21-May-25,IMPS,"2,78,566.00",00.00,"5,02,191.82",
21-May-25,RTGS,"2,277.00",00.00,"5,04,468.82",
21-May-25,IMPS,29,00.00,"5,04,497.82",
21-May-25,Transfer,00.00,"5,04,497.82",00.00,
21-May-25,Bill,04.50,00.00,04.50,
21-May-25,Bill,00.00,00.56,03.94,
21-May-25,Transfer,"4,90,010.00",00.00,"4,90,013.94",
21-May-25,NEFT,00.00,"81,668.99","4,08,344.95",
21-May-25,Debit Card,00.00,"1,36,114.98","2,72,229.97",
21-May-25,Interest,00.00,"34,028.75","2,38,201.22",
21-May-25,Bill,00.00,"34,028.75","2,04,172.47",
21-May-25,IMPS,00.00,"34,028.75","1,70,143.72",
21-May-25,Cash,00.00,"56,714.57","1,13,429.15",
22-May-25,Commission,"13,68,926.20",00.00,"14,82,355.35",
22-May-25,Cash,"1,71,010.00",00.00,"16,53,365.35",
22-May-25,Cash,00.00,"3,30,673.07","13,22,692.28",
22-May-25,Transfer,00.00,"1,32,269.23","11,90,423.05",
22-May-25,RTGS,00.00,"1,32,269.23","10,58,153.82",
22-May-25,Cash,02.00,00.00,"10,58,155.82",
22-May-25,Debit Card,00.00,"1,17,572.87","9,40,582.95",
22-May-25,Commission,"5,85,612.00",00.00,"15,26,194.95",
22-May-25,Reversal,00.00,"5,08,731.65","10,17,463.30",
22-May-25,Transportellaneous,58.3,00.00,"10,17,521.60",
22-May-25,ATM,00.00,"1,69,586.93","8,47,934.67",
22-May-25,Interest,"1,25,308.90",00.00,"9,73,243.57",
22-May-25,Commission,"2,43,356.91",00.00,"12,16,600.48",
22-May-25,Reversal,480.45,00.00,"12,17,080.93",
22-May-25,Debit Card,00.00,"12,17,080.93",00.00,
22-May-25,NEFT,"1,18,780.30",00.00,"1,18,780.30",
22-May-25,Purchase,00.00,"29,695.08","89,085.22",
22-May-25,Cash,00.00,"44,542.61","44,542.61",
22-May-25,NEFT,00.00,"14,847.54","29,695.07",
22-May-25,Purchase,00.00,"7,423.77","22,271.30",
22-May-25,Cheque,00.00,"11,135.65","11,135.65",
22-May-25,NEFT,00.00,"2,227.13","8,908.52",
22-May-25,Bill,56,00.00,"8,964.52",
22-May-25,Cash,00.00,996.06,"7,968.46",
22-May-25,Interest,"14,91,472.00",00.00,"14,99,440.46",
22-May-25,Tax,448,00.00,"14,99,888.46",
22-May-25,NEFT,"90,233.72",00.00,"15,90,122.18",
22-May-25,Purchase,"6,534.00",00.00,"15,96,656.18",
22-May-25,Interest,12,00.00,"15,96,668.18",
22-May-25,IMPS,00.00,"1,99,583.52","13,97,084.66",
22-May-25,Reversal,"43,752.10",00.00,"14,40,836.76",
22-May-25,Debit Card,"2,51,265.80",00.00,"16,92,102.56",
22-May-25,Tax,264.7,00.00,"16,92,367.26",
22-May-25,Debit Card,"2,716.50",00.00,"16,95,083.76",
22-May-25,NEFT,00.00,"2,11,885.47","14,83,198.29",
22-May-25,IMPS,405.1,00.00,"14,83,603.39",
22-May-25,Interest,00.00,"2,11,943.34","12,71,660.05",
23-May-25,Interest,00.00,"4,23,886.68","8,47,773.37",
23-May-25,Bill,00.00,"8,47,773.37",00.00,
23-May-25,Interest,"1,028.00",00.00,"1,028.00",
23-May-25,Interest,00.00,514,514,
23-May-25,Debit Card,"1,21,836.00",00.00,"1,22,350.00",
23-May-25,RTGS,"2,406.70",00.00,"1,24,756.70",
23-May-25,Interest,16,00.00,"1,24,772.70",
23-May-25,Debit Card,00.00,"17,824.67","1,06,948.03",
23-May-25,Interest,00.00,"26,737.01","80,211.02",
23-May-25,Tax,00.00,"13,368.50","66,842.52",
23-May-25,RTGS,00.00,"9,548.93","57,293.59",
23-May-25,Interest,00.00,"19,097.86","38,195.73",
23-May-25,RTGS,00.00,"7,639.15","30,556.58",
23-May-25,Cash,00.00,"6,111.32","24,445.26",
23-May-25,Commission,"4,187.34",00.00,"28,632.60",
23-May-25,ATM,00.00,"7,158.15","21,474.45",
23-May-25,Tax,00.00,"21,474.45",00.00,
23-May-25,NEFT,"12,92,562.75",00.00,"12,92,562.75",
23-May-25,Debit Card,"50,530.10",00.00,"13,43,092.85",
23-May-25,Purchase,00.00,"1,67,886.61","11,75,206.24",
23-May-25,Cheque,00.00,"11,75,206.24",00.00,
23-May-25,Reversal,55.3,00.00,55.3,
23-May-25,Interest,00.00,11.06,44.24,
23-May-25,Purchase,02.50,00.00,46.74,
23-May-25,Cheque,"57,022.60",00.00,"57,069.34",
23-May-25,Tax,"22,181.39",00.00,"79,250.73",
23-May-25,Purchase,"1,241.00",00.00,"80,491.73",
23-May-25,IMPS,00.00,"11,498.82","68,992.91",
23-May-25,NEFT,00.00,"7,665.88","61,327.03",
23-May-25,Reversal,00.00,"6,132.70","55,194.33",
23-May-25,ATM,"8,182.02",00.00,"63,376.35",
23-May-25,Transportellaneous,00.00,"15,844.09","47,532.26",
23-May-25,Reversal,876,00.00,"48,408.26",
23-May-25,Purchase,140.8,00.00,"48,549.06",
23-May-25,Transportellaneous,00.00,"8,091.51","40,457.55",
23-May-25,Tax,"9,89,940.00",00.00,"10,30,397.55",
23-May-25,Cash,07.24,00.00,"10,30,404.79",
23-May-25,Tax,00.00,"1,28,800.60","9,01,604.19",
23-May-25,Transportellaneous,05.62,00.00,"9,01,609.81",
23-May-25,Bill,"1,478.00",00.00,"9,03,087.81",
23-May-25,Debit Card,00.00,"1,50,514.64","7,52,573.18",
23-May-25,Commission,15,00.00,"7,52,588.18",
23-May-25,Interest,"2,17,490.00",00.00,"9,70,078.18",
23-May-25,Debit Card,00.00,"1,07,786.46","8,62,291.72",
23-May-25,IMPS,00.00,"2,87,430.57","5,74,861.15",
23-May-25,Interest,"28,035.87",00.00,"6,02,897.02",
23-May-25,Transportellaneous,00.00,"1,50,724.26","4,52,172.76",
23-May-25,Tax,"1,84,776.00",00.00,"6,36,948.76",
23-May-25,ATM,00.68,00.00,"6,36,949.44",
23-May-25,Tax,322.6,00.00,"6,37,272.04",
23-May-25,Purchase,"4,34,024.00",00.00,"10,71,296.04",
23-May-25,Interest,00.00,"1,78,549.34","8,92,746.70",
23-May-25,Transfer,00.00,"1,78,549.34","7,14,197.36",
23-May-25,Reversal,00.00,"79,355.26","6,34,842.10",
23-May-25,Purchase,00.00,"79,355.26","5,55,486.84",
23-May-25,Reversal,00.00,"61,720.76","4,93,766.08",
23-May-25,Interest,00.00,"61,720.76","4,32,045.32",
24-May-25,IMPS,"3,217.70",00.00,"4,35,263.02",
24-May-25,IMPS,00.00,"4,35,263.02",00.00,
24-May-25,Interest,"3,306.60",00.00,"3,306.60",
24-May-25,Bill,00.00,"3,306.60",00.00,
24-May-25,Cheque,415,00.00,415,
24-May-25,NEFT,604.42,00.00,"1,019.42",
24-May-25,Transportellaneous,00.00,169.9,849.52,
24-May-25,Purchase,00.00,84.95,764.57,
24-May-25,Bill,00.00,254.86,509.71,
24-May-25,NEFT,00.00,50.97,458.74,
24-May-25,Cash,"4,094.77",00.00,"4,553.51",
24-May-25,Bill,"20,63,630.00",00.00,"20,68,183.51",
24-May-25,Bill,"3,372.00",00.00,"20,71,555.51",
24-May-25,Transfer,00.00,"3,45,259.25","17,26,296.26",
24-May-25,Transportellaneous,00.00,"1,72,629.63","15,53,666.63",
24-May-25,Tax,00.00,"5,17,888.88","10,35,777.75",
25-May-25,NEFT,00.00,"1,03,577.78","9,32,199.98",
25-May-25,Interest,00.00,"1,03,577.78","8,28,622.20",
25-May-25,Bill,06.02,00.00,"8,28,628.22",
25-May-25,Commission,"1,19,744.50",00.00,"9,48,372.72",
25-May-25,Transfer,00.00,"2,37,093.18","7,11,279.54",
25-May-25,Tax,"12,81,413.50",00.00,"19,92,693.04",
25-May-25,NEFT,00.00,"19,92,693.04",00.00,
25-May-25,Bill,"9,820.00",00.00,"9,820.00",
25-May-25,Purchase,"16,87,874.80",00.00,"16,97,694.80",
25-May-25,Cash,"1,80,088.10",00.00,"18,77,782.90",
25-May-25,ATM,"31,159.38",00.00,"19,08,942.28",
25-May-25,Debit Card,"28,565.90",00.00,"19,37,508.18",
25-May-25,Transfer,00.00,"9,68,754.09","9,68,754.09",
25-May-25,Bill,00.00,"96,875.41","8,71,878.68",
25-May-25,RTGS,37.6,00.00,"8,71,916.28",
25-May-25,Transportellaneous,00.00,"2,90,638.76","5,81,277.52",
25-May-25,Commission,00.00,"1,93,759.17","3,87,518.35",
26-May-25,NEFT,00.00,"38,751.84","3,48,766.51",
26-May-25,Cash,00.00,"43,595.81","3,05,170.70",
26-May-25,Reversal,459,00.00,"3,05,629.70",
26-May-25,Bill,00.00,"1,52,814.85","1,52,814.85",
26-May-25,IMPS,04.00,00.00,"1,52,818.85",
26-May-25,IMPS,14.56,00.00,"1,52,833.41",
26-May-25,Cash,00.00,"38,208.35","1,14,625.06",
26-May-25,Bill,415.8,00.00,"1,15,040.86",
26-May-25,Cash,00.00,"38,346.95","76,693.91",
26-May-25,Interest,00.00,"15,338.78","61,355.13",
26-May-25,Cash,"1,18,013.00",00.00,"1,79,368.13",
26-May-25,Cheque,00.00,"29,894.69","1,49,473.44",
26-May-25,Interest,"13,97,064.00",00.00,"15,46,537.44",
26-May-25,Transfer,00.00,"15,46,537.44",00.00,
26-May-25,ATM,67.4,00.00,67.4,
26-May-25,Reversal,00.00,16.85,50.55,
26-May-25,NEFT,163.6,00.00,214.15,
26-May-25,Commission,54,00.00,268.15,
27-May-25,Purchase,"2,865.43",00.00,"3,133.58",
27-May-25,Transportellaneous,"1,86,853.00",00.00,"1,89,986.58",
27-May-25,Interest,00.00,"23,748.32","1,66,238.26",
28-May-25,Interest,00.00,"83,119.13","83,119.13",
28-May-25,Interest,"1,772.39",00.00,"84,891.52",
28-May-25,Interest,00.00,"9,432.39","75,459.13",
28-May-25,RTGS,00.00,"18,864.78","56,594.35",
28-May-25,Bill,00.00,"8,084.91","48,509.44",
28-May-25,NEFT,00.00,"48,509.44",00.00,
28-May-25,Transportellaneous,"1,844.10",00.00,"1,844.10",
28-May-25,Interest,00.00,263.44,"1,580.66",
28-May-25,Debit Card,00.00,526.89,"1,053.77",
28-May-25,RTGS,17.6,00.00,"1,071.37",
28-May-25,Tax,"2,09,396.00",00.00,"2,10,467.37",
28-May-25,Cheque,00.00,"26,308.42","1,84,158.95",
28-May-25,NEFT,"47,050.78",00.00,"2,31,209.73",
28-May-25,Commission,"6,833.12",00.00,"2,38,042.85",
28-May-25,Debit Card,00.00,"34,006.12","2,04,036.73",
28-May-25,Debit Card,"6,046.15",00.00,"2,10,082.88",
28-May-25,Transfer,00.00,"21,008.29","1,89,074.59",
28-May-25,IMPS,00.00,"18,907.46","1,70,167.13",
28-May-25,ATM,00.00,"24,309.59","1,45,857.54",
28-May-25,Cheque,00.00,"1,45,857.54",00.00,
28-May-25,IMPS,347.7,00.00,347.7,
28-May-25,Bill,"14,167.75",00.00,"14,515.45",
28-May-25,Interest,"1,51,607.20",00.00,"1,66,122.65",
28-May-25,Reversal,"22,106.50",00.00,"1,88,229.15",
28-May-25,Cash,"1,629.44",00.00,"1,89,858.59",
28-May-25,RTGS,"18,025.00",00.00,"2,07,883.59",
28-May-25,NEFT,"4,67,884.80",00.00,"6,75,768.39",
28-May-25,Transfer,00.86,00.00,"6,75,769.25",
28-May-25,RTGS,00.00,"75,085.47","6,00,683.78",
28-May-25,Cash,00.00,"75,085.47","5,25,598.31",
28-May-25,NEFT,00.00,"75,085.47","4,50,512.84",
28-May-25,Transportellaneous,"1,52,711.00",00.00,"6,03,223.84",
28-May-25,Interest,00.00,"75,402.98","5,27,820.86",
28-May-25,ATM,961.31,00.00,"5,28,782.17",
28-May-25,Transportellaneous,"1,67,214.00",00.00,"6,95,996.17",
28-May-25,Purchase,03.00,00.00,"6,95,999.17",
28-May-25,Tax,00.00,"1,15,999.86","5,79,999.31",
28-May-25,Debit Card,00.00,"72,499.91","5,07,499.40",
28-May-25,Purchase,00.00,"1,01,499.88","4,05,999.52",
29-May-25,Bill,00.00,"57,999.93","3,47,999.59",
29-May-25,Purchase,00.00,"57,999.93","2,89,999.66",
29-May-25,Debit Card,00.00,"41,428.52","2,48,571.14",
29-May-25,Interest,"6,663.00",00.00,"2,55,234.14",
29-May-25,RTGS,109.74,00.00,"2,55,343.88",
29-May-25,Transfer,"18,79,790.25",00.00,"21,35,134.13",
29-May-25,Debit Card,05.76,00.00,"21,35,139.89",
29-May-25,RTGS,00.00,"10,67,569.95","10,67,569.94",
29-May-25,RTGS,421.68,00.00,"10,67,991.62",
29-May-25,Bill,00.00,"1,77,998.60","8,89,993.02",
29-May-25,Cheque,"2,543.27",00.00,"8,92,536.29",
29-May-25,ATM,"2,022.25",00.00,"8,94,558.54",
29-May-25,Debit Card,"4,65,308.50",00.00,"13,59,867.04",
29-May-25,Cheque,21.17,00.00,"13,59,888.21",
29-May-25,Reversal,00.00,"2,26,648.04","11,33,240.18",
29-May-25,Cash,"3,177.41",00.00,"11,36,417.59",
29-May-25,ATM,"96,382.90",00.00,"12,32,800.49",
29-May-25,Transfer,00.00,"1,36,977.83","10,95,822.66",
29-May-25,ATM,"1,61,736.10",00.00,"12,57,558.76",
29-May-25,ATM,170.6,00.00,"12,57,729.36",
29-May-25,Commission,"3,779.00",00.00,"12,61,508.36",
29-May-25,RTGS,238.4,00.00,"12,61,746.76",
29-May-25,Transfer,03.29,00.00,"12,61,750.05",
29-May-25,Commission,00.00,"1,40,194.45","11,21,555.60",
29-May-25,Transfer,00.00,"1,40,194.45","9,81,361.15",
29-May-25,Debit Card,00.00,"1,63,560.19","8,17,800.96",
29-May-25,Reversal,233,00.00,"8,18,033.96",
29-May-25,Transportellaneous,"26,086.17",00.00,"8,44,120.13",
29-May-25,NEFT,27,00.00,"8,44,147.13",
29-May-25,ATM,00.00,"4,22,073.57","4,22,073.56",
29-May-25,Purchase,00.00,"52,759.20","3,69,314.36",
29-May-25,RTGS,"8,523.70",00.00,"3,77,838.06",
29-May-25,Cheque,00.00,"47,229.76","3,30,608.30",
29-May-25,RTGS,"1,332.63",00.00,"3,31,940.93",
29-May-25,Bill,00.00,"1,65,970.47","1,65,970.46",
29-May-25,Interest,"6,767.00",00.00,"1,72,737.46",
29-May-25,IMPS,00.00,"1,72,737.46",00.00,
29-May-25,Cash,"13,29,030.25",00.00,"13,29,030.25",
29-May-25,Interest,00.00,"6,64,515.13","6,64,515.12",
29-May-25,IMPS,00.00,"1,66,128.78","4,98,386.34",
29-May-25,Transportellaneous,00.00,"1,66,128.78","3,32,257.56",
30-May-25,Transportellaneous,"3,380.21",00.00,"3,35,637.77",
30-May-25,IMPS,42.3,00.00,"3,35,680.07",
30-May-25,IMPS,71,00.00,"3,35,751.07",
30-May-25,NEFT,03.90,00.00,"3,35,754.97",
30-May-25,Bill,00.00,"1,67,877.49","1,67,877.48",
30-May-25,Cheque,"2,764.20",00.00,"1,70,641.68",
30-May-25,Commission,436.7,00.00,"1,71,078.38",
30-May-25,RTGS,03.96,00.00,"1,71,082.34",
30-May-25,Purchase,00.00,"1,71,082.34",00.00,
30-May-25,Debit Card,06.00,00.00,06.00,
30-May-25,Purchase,"8,74,460.75",00.00,"8,74,466.75",
30-May-25,Cash,00.00,"1,45,744.46","7,28,722.29",
30-May-25,Cash,"1,29,626.30",00.00,"8,58,348.59",
30-May-25,ATM,24.26,00.00,"8,58,372.85",
30-May-25,NEFT,00.00,"4,29,186.43","4,29,186.42",
30-May-25,Tax,00.00,"4,29,186.42",00.00,
30-May-25,Bill,25.9,00.00,25.9,
30-May-25,Cash,00.00,02.88,23.02,
30-May-25,RTGS,00.00,11.51,11.51,
30-May-25,Cash,00.00,03.84,07.67,
30-May-25,Reversal,00.00,01.53,06.14,
30-May-25,ATM,00.00,00.77,05.37,
31-May-25,Purchase,00.00,00.60,04.77,
31-May-25,Commission,00.00,00.80,03.97,
31-May-25,Interest,"5,41,915.00",00.00,"5,41,918.97",
31-May-25,Tax,"2,218.51",00.00,"5,44,137.48",
31-May-25,Purchase,"2,287.00",00.00,"5,46,424.48",
31-May-25,IMPS,00.00,"5,46,424.48",00.00,
31-May-25,Debit Card,"37,124.00",00.00,"37,124.00",
31-May-25,ATM,03.00,00.00,"37,127.00",
31-May-25,Purchase,"2,38,111.00",00.00,"2,75,238.00",
31-May-25,RTGS,00.00,"2,75,238.00",00.00,
31-May-25,Interest,26.86,00.00,26.86,
31-May-25,Reversal,00.00,26.86,00.00,
31-May-25,Cash,03.00,00.00,03.00,
31-May-25,ATM,"12,49,868.50",00.00,"12,49,871.50",
31-May-25,Tax,33.3,00.00,"12,49,904.80",
31-May-25,Commission,"50,280.80",00.00,"13,00,185.60",
31-May-25,Tax,00.00,"2,16,697.60","10,83,488.00",
31-May-25,Cash,00.00,"1,20,387.56","9,63,100.44",
31-May-25,Interest,461.1,00.00,"9,63,561.54",
31-May-25,Cheque,00.00,"9,63,561.54",00.00,
31-May-25,Reversal,01.80,00.00,01.80,
31-May-25,RTGS,00.00,00.26,01.54,
31-May-25,Debit Card,"14,02,730.20",00.00,"14,02,731.74",
31-May-25,Tax,27,00.00,"14,02,758.74",
31-May-25,Cash,00.00,"4,67,586.25","9,35,172.49",
31-May-25,Tax,00.00,"3,11,724.16","6,23,448.33",
31-May-25,Transportellaneous,00.00,"62,344.83","5,61,103.50",
31-May-25,Bill,00.00,"2,80,551.75","2,80,551.75",
01-Jun-25,ATM,"7,25,435.00",00.00,"10,05,986.75",
01-Jun-25,Commission,00.00,"2,51,496.69","7,54,490.06",
01-Jun-25,Purchase,01.00,00.00,"7,54,491.06",
01-Jun-25,Commission,"14,911.00",00.00,"7,69,402.06",
01-Jun-25,Cash,00.00,"1,09,914.58","6,59,487.48",
01-Jun-25,Bill,00.00,"6,59,487.48",00.00,
01-Jun-25,Cheque,08.00,00.00,08.00,
01-Jun-25,Debit Card,04.10,00.00,12.1,
01-Jun-25,Interest,00.00,12.1,00.00,
01-Jun-25,Debit Card,251.2,00.00,251.2,
01-Jun-25,Transfer,01.40,00.00,252.6,
01-Jun-25,Cash,00.00,25.26,227.34,
01-Jun-25,Commission,"14,78,676.00",00.00,"14,78,903.34",
02-Jun-25,Tax,00.00,"4,92,967.78","9,85,935.56",
02-Jun-25,Commission,01.00,00.00,"9,85,936.56",
02-Jun-25,Cash,00.00,"2,46,484.14","7,39,452.42",
03-Jun-25,Cheque,403,00.00,"7,39,855.42",
03-Jun-25,Tax,00.00,"2,46,618.47","4,93,236.95",
03-Jun-25,Cheque,"2,187.00",00.00,"4,95,423.95",
03-Jun-25,Transfer,06.77,00.00,"4,95,430.72",
03-Jun-25,Commission,"13,57,338.00",00.00,"18,52,768.72",
03-Jun-25,Interest,00.00,"18,52,768.72",00.00,
03-Jun-25,IMPS,00.32,00.00,00.32,
03-Jun-25,Tax,00.00,00.08,00.24,
03-Jun-25,Debit Card,00.00,00.04,00.20,
03-Jun-25,Commission,02.50,00.00,02.70,
03-Jun-25,IMPS,378,00.00,380.7,
03-Jun-25,NEFT,149,00.00,529.7,
03-Jun-25,Transportellaneous,"19,08,383.80",00.00,"19,08,913.50",
03-Jun-25,Commission,"20,77,077.50",00.00,"39,85,991.00",
03-Jun-25,Reversal,"2,604.70",00.00,"39,88,595.70",
03-Jun-25,ATM,00.00,"19,94,297.85","19,94,297.85",
03-Jun-25,Transfer,"62,266.00",00.00,"20,56,563.85",
03-Jun-25,Debit Card,178.9,00.00,"20,56,742.75",
03-Jun-25,Reversal,43,00.00,"20,56,785.75",
03-Jun-25,ATM,"2,907.30",00.00,"20,59,693.05",
03-Jun-25,Transportellaneous,00.00,"10,29,846.53","10,29,846.52",
03-Jun-25,Debit Card,"3,122.83",00.00,"10,32,969.35",
03-Jun-25,Debit Card,00.00,"1,47,567.05","8,85,402.30",
03-Jun-25,Bill,427,00.00,"8,85,829.30",
03-Jun-25,Debit Card,00.00,"2,21,457.33","6,64,371.98",
04-Jun-25,Tax,"18,965.00",00.00,"6,83,336.98",
04-Jun-25,Commission,"15,365.22",00.00,"6,98,702.20",
04-Jun-25,Cheque,"16,13,952.00",00.00,"23,12,654.20",
04-Jun-25,Reversal,227,00.00,"23,12,881.20",
04-Jun-25,Cash,00.00,"5,78,220.30","17,34,660.90",
04-Jun-25,Commission,00.00,"2,16,832.61","15,17,828.29",
04-Jun-25,Interest,06.00,00.00,"15,17,834.29",
04-Jun-25,Debit Card,00.00,"5,05,944.76","10,11,889.53",
04-Jun-25,Purchase,"6,99,132.00",00.00,"17,11,021.53",
04-Jun-25,Purchase,"2,119.90",00.00,"17,13,141.43",
04-Jun-25,NEFT,00.00,"4,28,285.36","12,84,856.07",
04-Jun-25,Transportellaneous,55.3,00.00,"12,84,911.37",
04-Jun-25,NEFT,00.00,"1,28,491.14","11,56,420.23",
04-Jun-25,Cheque,"5,283.00",00.00,"11,61,703.23",
04-Jun-25,Interest,00.00,"2,90,425.81","8,71,277.42",
04-Jun-25,Transportellaneous,"2,628.60",00.00,"8,73,906.02",
04-Jun-25,Debit Card,"1,22,858.31",00.00,"9,96,764.33",
04-Jun-25,Reversal,"9,52,474.00",00.00,"19,49,238.33",
04-Jun-25,Bill,00.00,"2,43,654.79","17,05,583.54",
04-Jun-25,Tax,"3,692.86",00.00,"17,09,276.40",
04-Jun-25,Commission,76,00.00,"17,09,352.40",
04-Jun-25,ATM,"1,213.49",00.00,"17,10,565.89",
04-Jun-25,Transportellaneous,00.00,"2,85,094.32","14,25,471.58",
04-Jun-25,Purchase,"11,33,035.00",00.00,"25,58,506.58",
04-Jun-25,ATM,00.00,"25,58,506.58",00.00,
04-Jun-25,Tax,85,00.00,85,
04-Jun-25,Cheque,"4,76,514.00",00.00,"4,76,599.00",
04-Jun-25,Reversal,00.00,"1,58,866.33","3,17,732.67",
04-Jun-25,NEFT,00.00,"52,955.45","2,64,777.22",
04-Jun-25,Interest,00.00,"37,825.32","2,26,951.90",
04-Jun-25,Transportellaneous,00.00,"75,650.63","1,51,301.27",
04-Jun-25,Purchase,"4,31,152.80",00.00,"5,82,454.07",
04-Jun-25,Purchase,35.4,00.00,"5,82,489.47",
04-Jun-25,Debit Card,50.45,00.00,"5,82,539.92",
04-Jun-25,Reversal,00.00,"97,089.99","4,85,449.93",
04-Jun-25,RTGS,"18,36,611.80",00.00,"23,22,061.73",
04-Jun-25,IMPS,00.00,"7,74,020.58","15,48,041.15",
04-Jun-25,Purchase,"29,115.10",00.00,"15,77,156.25",
04-Jun-25,Bill,"3,557.88",00.00,"15,80,714.13",
04-Jun-25,Cash,"2,376.00",00.00,"15,83,090.13",
04-Jun-25,Cash,00.00,"3,16,618.03","12,66,472.10",
04-Jun-25,Commission,00.00,"1,58,309.01","11,08,163.09",
04-Jun-25,Cash,00.00,"1,84,693.85","9,23,469.24",
04-Jun-25,Commission,00.00,"92,346.92","8,31,122.32",
04-Jun-25,Tax,02.80,00.00,"8,31,125.12",
04-Jun-25,Interest,61,00.00,"8,31,186.12",
04-Jun-25,Cheque,00.00,"92,354.01","7,38,832.11",
04-Jun-25,Cheque,00.00,"1,47,766.42","5,91,065.69",
04-Jun-25,NEFT,"1,77,205.00",00.00,"7,68,270.69",
04-Jun-25,IMPS,00.00,"1,28,045.12","6,40,225.57",
04-Jun-25,Purchase,00.00,"1,06,704.26","5,33,521.31",
04-Jun-25,IMPS,00.00,"53,352.13","4,80,169.18",
04-Jun-25,IMPS,218.52,00.00,"4,80,387.70",
04-Jun-25,Purchase,"18,738.00",00.00,"4,99,125.70",
04-Jun-25,Bill,"24,758.00",00.00,"5,23,883.70",
04-Jun-25,Tax,00.03,00.00,"5,23,883.73",
04-Jun-25,Tax,"6,22,208.50",00.00,"11,46,092.23",
04-Jun-25,Bill,00.00,"3,82,030.74","7,64,061.49",
04-Jun-25,ATM,00.00,"95,507.69","6,68,553.80",
04-Jun-25,Reversal,294,00.00,"6,68,847.80",
04-Jun-25,Interest,00.00,"3,34,423.90","3,34,423.90",
04-Jun-25,Bill,"15,90,075.00",00.00,"19,24,498.90",
04-Jun-25,Transportellaneous,"2,266.00",00.00,"19,26,764.90",
05-Jun-25,Bill,"1,18,473.10",00.00,"20,45,238.00",
05-Jun-25,Purchase,00.00,"2,92,176.86","17,53,061.14",
05-Jun-25,Transportellaneous,00.00,"1,94,784.57","15,58,276.57",
05-Jun-25,Bill,00.00,"1,55,827.66","14,02,448.91",
05-Jun-25,Cash,384,00.00,"14,02,832.91",
05-Jun-25,NEFT,"2,443.47",00.00,"14,05,276.38",
05-Jun-25,Interest,"1,15,340.00",00.00,"15,20,616.38",
05-Jun-25,Commission,00.00,"2,53,436.06","12,67,180.32",
06-Jun-25,RTGS,00.00,"2,53,436.06","10,13,744.26",
06-Jun-25,Debit Card,00.00,"2,02,748.85","8,10,995.41",
06-Jun-25,Tax,54.98,00.00,"8,11,050.39",
06-Jun-25,ATM,00.00,"4,05,525.20","4,05,525.20",
06-Jun-25,Debit Card,00.00,"57,932.17","3,47,593.03",
06-Jun-25,Interest,00.00,"34,759.30","3,12,833.73",
06-Jun-25,Cheque,322,00.00,"3,13,155.73",
06-Jun-25,IMPS,00.00,"44,736.53","2,68,419.20",
06-Jun-25,NEFT,00.00,"38,345.60","2,30,073.60",
06-Jun-25,Reversal,00.00,"46,014.72","1,84,058.88",
06-Jun-25,Purchase,"3,364.90",00.00,"1,87,423.78",
06-Jun-25,Commission,00.00,"46,855.95","1,40,567.84",
06-Jun-25,Tax,54,00.00,"1,40,621.84",
06-Jun-25,NEFT,00.00,"23,436.97","1,17,184.87",
06-Jun-25,Commission,"12,30,381.00",00.00,"13,47,565.87",
06-Jun-25,Transportellaneous,"2,371.80",00.00,"13,49,937.67",
06-Jun-25,Transfer,"99,395.34",00.00,"14,49,333.01",
06-Jun-25,IMPS,00.00,"1,81,166.63","12,68,166.38",
06-Jun-25,Purchase,00.00,"1,81,166.63","10,86,999.75",
06-Jun-25,IMPS,"1,644.00",00.00,"10,88,643.75",
06-Jun-25,Interest,"2,35,037.70",00.00,"13,23,681.45",
06-Jun-25,Debit Card,00.00,"3,30,920.36","9,92,761.09",
06-Jun-25,Purchase,00.00,"1,10,306.79","8,82,454.30",
07-Jun-25,ATM,"1,17,255.62",00.00,"9,99,709.92",
07-Jun-25,Debit Card,00.00,"1,24,963.74","8,74,746.18",
07-Jun-25,RTGS,"14,93,038.50",00.00,"23,67,784.68",
07-Jun-25,Commission,250,00.00,"23,68,034.68",
07-Jun-25,Transfer,00.00,"2,36,803.47","21,31,231.21",
07-Jun-25,IMPS,52.2,00.00,"21,31,283.41",
07-Jun-25,Reversal,00.00,"7,10,427.80","14,20,855.61",
07-Jun-25,ATM,00.00,"7,10,427.81","7,10,427.80",
07-Jun-25,Transportellaneous,00.00,"1,18,404.63","5,92,023.17",
07-Jun-25,NEFT,00.00,"98,670.53","4,93,352.64",
07-Jun-25,RTGS,00.00,"49,335.26","4,44,017.38",
07-Jun-25,Reversal,367,00.00,"4,44,384.38",
07-Jun-25,IMPS,00.00,"49,376.04","3,95,008.34",
07-Jun-25,Interest,"26,026.00",00.00,"4,21,034.34",
07-Jun-25,NEFT,00.00,"1,05,258.59","3,15,775.76",
07-Jun-25,Commission,00.00,"63,155.15","2,52,620.61",
07-Jun-25,IMPS,00.00,"63,155.15","1,89,465.46",
07-Jun-25,NEFT,"95,885.60",00.00,"2,85,351.06",
07-Jun-25,Interest,"8,92,506.00",00.00,"11,77,857.06",
07-Jun-25,IMPS,00.00,"1,17,785.71","10,60,071.35",
07-Jun-25,Cheque,09.00,00.00,"10,60,080.35",
07-Jun-25,RTGS,"5,88,543.75",00.00,"16,48,624.10",
07-Jun-25,IMPS,02.81,00.00,"16,48,626.91",
07-Jun-25,Bill,00.00,"16,48,626.91",00.00,
07-Jun-25,Tax,375.1,00.00,375.1,
07-Jun-25,Cash,"8,70,963.00",00.00,"8,71,338.10",
07-Jun-25,Transportellaneous,"28,134.06",00.00,"8,99,472.16",
07-Jun-25,Debit Card,00.00,"4,49,736.08","4,49,736.08",
07-Jun-25,ATM,00.00,"49,970.68","3,99,765.40",
07-Jun-25,NEFT,00.00,"39,976.54","3,59,788.86",
07-Jun-25,Cash,00.00,"39,976.54","3,19,812.32",
07-Jun-25,NEFT,"2,329.21",00.00,"3,22,141.53",
07-Jun-25,Purchase,"1,82,915.00",00.00,"5,05,056.53",
07-Jun-25,Reversal,00.00,"50,505.65","4,54,550.88",
07-Jun-25,Transfer,"1,623.30",00.00,"4,56,174.18",
07-Jun-25,Bill,189.2,00.00,"4,56,363.38",
07-Jun-25,Reversal,00.18,00.00,"4,56,363.56",
07-Jun-25,Debit Card,00.00,"50,707.06","4,05,656.50",
07-Jun-25,Transfer,00.00,"45,072.94","3,60,583.56",
07-Jun-25,Bill,"1,66,642.20",00.00,"5,27,225.76",
07-Jun-25,Reversal,00.00,"87,870.96","4,39,354.80",
07-Jun-25,Cash,00.00,"62,764.97","3,76,589.83",
07-Jun-25,Debit Card,00.00,"41,843.31","3,34,746.52",
07-Jun-25,Cheque,00.00,"3,34,746.52",00.00,
07-Jun-25,Bill,"9,12,470.00",00.00,"9,12,470.00",
07-Jun-25,IMPS,"1,006.30",00.00,"9,13,476.30",
07-Jun-25,Transportellaneous,36,00.00,"9,13,512.30",
07-Jun-25,Tax,"9,948.86",00.00,"9,23,461.16",
07-Jun-25,Interest,"17,11,361.00",00.00,"26,34,822.16",
07-Jun-25,Transportellaneous,17,00.00,"26,34,839.16",
07-Jun-25,Tax,"15,330.80",00.00,"26,50,169.96",
07-Jun-25,IMPS,"3,157.50",00.00,"26,53,327.46",
07-Jun-25,ATM,00.00,"8,84,442.49","17,68,884.97",
07-Jun-25,Cash,00.00,"17,68,884.97",00.00,
07-Jun-25,NEFT,"2,035.20",00.00,"2,035.20",
07-Jun-25,Commission,"3,416.70",00.00,"5,451.90",
07-Jun-25,Purchase,02.00,00.00,"5,453.90",
07-Jun-25,Purchase,00.00,605.99,"4,847.91",
07-Jun-25,NEFT,00.00,"1,615.97","3,231.94",
07-Jun-25,ATM,30.2,00.00,"3,262.14",
07-Jun-25,Purchase,"3,784.38",00.00,"7,046.52",
07-Jun-25,Debit Card,00.00,"1,174.42","5,872.10",
07-Jun-25,ATM,00.00,"1,468.03","4,404.08",
07-Jun-25,Purchase,00.00,550.51,"3,853.57",
07-Jun-25,Commission,"1,14,669.00",00.00,"1,18,522.57",
07-Jun-25,Bill,00.00,"14,815.32","1,03,707.25",
07-Jun-25,Transportellaneous,"1,26,876.00",00.00,"2,30,583.25",
07-Jun-25,Transfer,00.00,"76,861.08","1,53,722.17",
07-Jun-25,Transportellaneous,"22,423.00",00.00,"1,76,145.17",
07-Jun-25,Cash,00.00,"29,357.53","1,46,787.64",
07-Jun-25,Cash,00.00,"73,393.82","73,393.82",
07-Jun-25,Interest,00.00,"9,174.23","64,219.59",
07-Jun-25,Cash,183.2,00.00,"64,402.79",
07-Jun-25,Interest,"1,57,227.00",00.00,"2,21,629.79",
07-Jun-25,Commission,00.00,"24,625.53","1,97,004.26",
07-Jun-25,Debit Card,00.00,"32,834.04","1,64,170.22",
07-Jun-25,Commission,"21,821.00",00.00,"1,85,991.22",
07-Jun-25,Tax,00.00,"92,995.61","92,995.61",
07-Jun-25,Purchase,01.30,00.00,"92,996.91",
07-Jun-25,RTGS,00.00,"9,299.69","83,697.22",
07-Jun-25,Cash,387.8,00.00,"84,085.02",
07-Jun-25,Reversal,"36,115.60",00.00,"1,20,200.62",
07-Jun-25,IMPS,"9,452.16",00.00,"1,29,652.78",
07-Jun-25,IMPS,00.00,"12,965.28","1,16,687.50",
07-Jun-25,Reversal,53.31,00.00,"1,16,740.81",
07-Jun-25,NEFT,00.00,"12,971.20","1,03,769.61",
07-Jun-25,Interest,00.00,"12,971.20","90,798.41",
07-Jun-25,Cheque,00.00,"15,133.07","75,665.34",
07-Jun-25,NEFT,190.5,00.00,"75,855.84",
08-Jun-25,ATM,00.00,"15,171.17","60,684.67",
08-Jun-25,Cheque,00.00,"7,585.58","53,099.09",
08-Jun-25,RTGS,"99,743.03",00.00,"1,52,842.12",
08-Jun-25,Debit Card,00.00,00.00,"1,52,842.12",
08-Jun-25,Cheque,"1,03,430.72",00.00,"2,56,272.84",
09-Jun-25,IMPS,00.00,"32,034.11","2,24,238.74",
09-Jun-25,Cheque,00.00,"2,24,238.74",00.00,
09-Jun-25,Bill,17.2,00.00,17.2,
09-Jun-25,Transfer,00.00,01.72,15.48,
09-Jun-25,Transfer,00.00,01.94,13.54,
09-Jun-25,Commission,00.00,01.35,12.19,
09-Jun-25,Reversal,54.36,00.00,66.55,
09-Jun-25,Cheque,00.00,09.51,57.04,
09-Jun-25,Interest,27,00.00,84.04,
09-Jun-25,IMPS,"9,451.00",00.00,"9,535.04",
09-Jun-25,Debit Card,00.00,"1,191.88","8,343.16",
09-Jun-25,Transportellaneous,"1,46,798.75",00.00,"1,55,141.91",
09-Jun-25,IMPS,46,00.00,"1,55,187.91",
09-Jun-25,Interest,"9,960.53",00.00,"1,65,148.44",
09-Jun-25,Purchase,"1,165.01",00.00,"1,66,313.45",
09-Jun-25,RTGS,"3,659.00",00.00,"1,69,972.45",
09-Jun-25,Commission,00.00,"16,997.25","1,52,975.21",
09-Jun-25,Transportellaneous,"6,073.61",00.00,"1,59,048.82",
09-Jun-25,Cheque,00.00,"15,904.88","1,43,143.94",
09-Jun-25,Transportellaneous,00.00,"17,892.99","1,25,250.95",
09-Jun-25,RTGS,"13,36,674.50",00.00,"14,61,925.45",
09-Jun-25,Cheque,02.40,00.00,"14,61,927.85",
09-Jun-25,Commission,00.00,"2,92,385.57","11,69,542.28",
09-Jun-25,Commission,264,00.00,"11,69,806.28",
09-Jun-25,Bill,"2,36,959.69",00.00,"14,06,765.97",
09-Jun-25,ATM,00.00,"14,06,765.97",00.00,
09-Jun-25,Interest,45,00.00,45,
09-Jun-25,Debit Card,00.00,04.50,40.5,
09-Jun-25,Cheque,00.00,06.75,33.75,
09-Jun-25,Tax,00.00,04.82,28.93,
09-Jun-25,Interest,"2,22,414.20",00.00,"2,22,443.13",
09-Jun-25,Transportellaneous,970.7,00.00,"2,23,413.83",
09-Jun-25,RTGS,"21,212.00",00.00,"2,44,625.83",
09-Jun-25,Tax,00.00,"61,156.46","1,83,469.37",
09-Jun-25,Interest,45,00.00,"1,83,514.37",
09-Jun-25,Reversal,00.00,"91,757.19","91,757.18",
09-Jun-25,Transfer,00.00,"10,195.24","81,561.94",
09-Jun-25,Interest,00.00,"40,780.97","40,780.97",
09-Jun-25,Purchase,04.00,00.00,"40,784.97",
09-Jun-25,Interest,00.00,"40,784.97",00.00,
09-Jun-25,Commission,655.8,00.00,655.8,
09-Jun-25,ATM,00.00,65.58,590.22,
09-Jun-25,Transportellaneous,00.00,147.56,442.66,
09-Jun-25,Commission,"2,16,624.80",00.00,"2,17,067.46",
09-Jun-25,RTGS,00.00,"1,08,533.73","1,08,533.73",
09-Jun-25,Interest,00.00,"36,177.91","72,355.82",
09-Jun-25,Tax,20.8,00.00,"72,376.62",
09-Jun-25,Purchase,"40,665.75",00.00,"1,13,042.37",
09-Jun-25,Purchase,00.00,"16,148.91","96,893.46",
09-Jun-25,Commission,00.00,"12,111.68","84,781.78",
09-Jun-25,Cash,"1,77,289.00",00.00,"2,62,070.78",
09-Jun-25,Commission,00.00,"29,118.98","2,32,951.80",
09-Jun-25,Transportellaneous,02.10,00.00,"2,32,953.90",
09-Jun-25,IMPS,275,00.00,"2,33,228.90",
09-Jun-25,Reversal,"31,079.30",00.00,"2,64,308.20",
09-Jun-25,Commission,00.00,"33,038.53","2,31,269.68",
09-Jun-25,Bill,341,00.00,"2,31,610.68",
10-Jun-25,Reversal,00.00,"23,161.07","2,08,449.61",
10-Jun-25,Purchase,00.00,"2,08,449.61",00.00,
10-Jun-25,Cheque,88,00.00,88,
11-Jun-25,Transfer,"6,67,792.00",00.00,"6,67,880.00",
11-Jun-25,Purchase,00.00,"66,788.00","6,01,092.00",
11-Jun-25,Debit Card,104.8,00.00,"6,01,196.80",
11-Jun-25,IMPS,00.00,"66,799.64","5,34,397.16",
11-Jun-25,Cash,00.00,"59,377.46","4,75,019.70",
12-Jun-25,Transfer,00.00,"1,18,754.93","3,56,264.78",
12-Jun-25,Transportellaneous,"5,53,845.00",00.00,"9,10,109.78",
12-Jun-25,Transportellaneous,00.00,"3,03,369.93","6,06,739.85",
12-Jun-25,Bill,00.00,"86,677.12","5,20,062.73",
12-Jun-25,Purchase,00.00,"86,677.12","4,33,385.61",
12-Jun-25,Tax,"1,955.60",00.00,"4,35,341.21",
12-Jun-25,ATM,"1,160.00",00.00,"4,36,501.21",
12-Jun-25,IMPS,"69,216.00",00.00,"5,05,717.21",
12-Jun-25,Transfer,00.00,"1,26,429.30","3,79,287.91",
12-Jun-25,RTGS,"16,021.40",00.00,"3,95,309.31",
12-Jun-25,Cheque,00.00,"56,472.76","3,38,836.55",
13-Jun-25,Transportellaneous,00.00,"33,883.66","3,04,952.90",
13-Jun-25,Interest,"2,29,518.50",00.00,"5,34,471.40",
13-Jun-25,Transportellaneous,00.00,"76,353.06","4,58,118.34",
13-Jun-25,Purchase,"9,024.00",00.00,"4,67,142.34",
13-Jun-25,Cash,00.00,"4,67,142.34",00.00,
13-Jun-25,Reversal,17.5,00.00,17.5,
13-Jun-25,ATM,"3,974.19",00.00,"3,991.69",
13-Jun-25,NEFT,"2,05,540.80",00.00,"2,09,532.49",
13-Jun-25,IMPS,"19,29,746.50",00.00,"21,39,278.99",
13-Jun-25,Reversal,"8,71,770.20",00.00,"30,11,049.19",
13-Jun-25,Interest,08.00,00.00,"30,11,057.19",
13-Jun-25,Transportellaneous,00.00,"10,03,685.73","20,07,371.46",
13-Jun-25,RTGS,00.00,"2,50,921.43","17,56,450.03",
13-Jun-25,Transfer,00.00,"5,85,483.34","11,70,966.69",
13-Jun-25,Purchase,"25,706.36",00.00,"11,96,673.05",
13-Jun-25,Commission,00.00,"1,49,584.13","10,47,088.92",
13-Jun-25,Bill,00.00,"1,30,886.12","9,16,202.80",
13-Jun-25,Reversal,00.00,"4,58,101.40","4,58,101.40",
13-Jun-25,Transportellaneous,00.00,"50,900.16","4,07,201.24",
13-Jun-25,ATM,00.00,"40,720.12","3,66,481.12",
13-Jun-25,Reversal,"39,480.44",00.00,"4,05,961.56",
13-Jun-25,Transportellaneous,00.00,"57,994.51","3,47,967.05",
13-Jun-25,Transfer,"11,46,701.00",00.00,"14,94,668.05",
13-Jun-25,Transfer,00.00,"1,49,466.81","13,45,201.24",
13-Jun-25,Bill,"2,27,527.81",00.00,"15,72,729.05",
13-Jun-25,Transportellaneous,335,00.00,"15,73,064.05",
13-Jun-25,Transportellaneous,"2,20,675.00",00.00,"17,93,739.05",
13-Jun-25,ATM,"5,32,227.80",00.00,"23,25,966.85",
13-Jun-25,Debit Card,"30,155.20",00.00,"23,56,122.05",
13-Jun-25,RTGS,04.00,00.00,"23,56,126.05",
13-Jun-25,Purchase,04.00,00.00,"23,56,130.05",
13-Jun-25,RTGS,02.00,00.00,"23,56,132.05",
13-Jun-25,Cash,06.18,00.00,"23,56,138.23",
13-Jun-25,Purchase,00.00,"2,94,517.28","20,61,620.95",
13-Jun-25,Cheque,00.00,"2,06,162.10","18,55,458.86",
14-Jun-25,IMPS,210.6,00.00,"18,55,669.46",
14-Jun-25,Debit Card,07.38,00.00,"18,55,676.84",
14-Jun-25,Commission,00.00,"2,65,096.69","15,90,580.15",
14-Jun-25,NEFT,00.00,"3,97,645.04","11,92,935.11",
14-Jun-25,Cheque,"7,66,205.00",00.00,"19,59,140.11",
14-Jun-25,Bill,00.00,"4,89,785.03","14,69,355.08",
14-Jun-25,IMPS,353.62,00.00,"14,69,708.70",
14-Jun-25,Debit Card,00.00,"3,67,427.18","11,02,281.52",
14-Jun-25,Transfer,00.00,"1,22,475.72","9,79,805.80",
14-Jun-25,Reversal,"1,804.10",00.00,"9,81,609.90",
14-Jun-25,Debit Card,"12,773.33",00.00,"9,94,383.23",
14-Jun-25,Cash,00.00,"1,24,297.90","8,70,085.33",
14-Jun-25,Cheque,"16,907.04",00.00,"8,86,992.37",
14-Jun-25,Tax,"15,07,648.00",00.00,"23,94,640.37",
14-Jun-25,IMPS,433,00.00,"23,95,073.37",
14-Jun-25,Cheque,"9,55,130.00",00.00,"33,50,203.37",
14-Jun-25,Cheque,00.00,"11,16,734.46","22,33,468.91",
14-Jun-25,Bill,"7,916.43",00.00,"22,41,385.34",
14-Jun-25,Cheque,00.00,"7,47,128.45","14,94,256.89",
14-Jun-25,Tax,00.00,"2,13,465.27","12,80,791.62",
14-Jun-25,Interest,00.00,"1,28,079.16","11,52,712.46",
15-Jun-25,Tax,00.00,"3,84,237.49","7,68,474.97",
15-Jun-25,Interest,"11,005.00",00.00,"7,79,479.97",
15-Jun-25,Debit Card,00.00,"77,948.00","7,01,531.97",
15-Jun-25,Purchase,00.00,"1,00,218.85","6,01,313.12",
15-Jun-25,Transportellaneous,30,00.00,"6,01,343.12",
15-Jun-25,RTGS,00.00,"60,134.31","5,41,208.81",
15-Jun-25,Transportellaneous,"1,52,843.38",00.00,"6,94,052.19",
15-Jun-25,Interest,00.00,"1,73,513.05","5,20,539.14",
15-Jun-25,Interest,03.76,00.00,"5,20,542.90",
15-Jun-25,Transportellaneous,279.1,00.00,"5,20,822.00",
15-Jun-25,Commission,00.00,"74,403.14","4,46,418.86",
15-Jun-25,Bill,"3,71,233.75",00.00,"8,17,652.61",
15-Jun-25,Bill,07.60,00.00,"8,17,660.21",
15-Jun-25,Cash,00.00,"1,36,276.70","6,81,383.51",
15-Jun-25,ATM,00.00,"68,138.35","6,13,245.16",
15-Jun-25,Transportellaneous,00.00,"1,53,311.29","4,59,933.87",
15-Jun-25,NEFT,00.00,"1,14,983.47","3,44,950.40",
15-Jun-25,Tax,00.00,"1,72,475.20","1,72,475.20",
15-Jun-25,Commission,"26,561.00",00.00,"1,99,036.20",
15-Jun-25,Commission,00.00,"66,345.40","1,32,690.80",
15-Jun-25,Tax,00.00,"66,345.40","66,345.40",
15-Jun-25,Debit Card,"10,443.71",00.00,"76,789.11",
15-Jun-25,Transportellaneous,"17,625.11",00.00,"94,414.22",
15-Jun-25,Purchase,00.00,"47,207.11","47,207.11",
15-Jun-25,Transfer,00.00,"5,245.23","41,961.88",
15-Jun-25,Commission,58.9,00.00,"42,020.78",
15-Jun-25,Debit Card,00.00,"4,668.98","37,351.80",
15-Jun-25,Reversal,"21,479.00",00.00,"58,830.80",
15-Jun-25,Cash,57,00.00,"58,887.80",
15-Jun-25,IMPS,46.3,00.00,"58,934.10",
15-Jun-25,Interest,"14,140.00",00.00,"73,074.10",
15-Jun-25,Transportellaneous,00.00,"36,537.05","36,537.05",
15-Jun-25,Interest,00.00,"7,307.41","29,229.64",
15-Jun-25,Tax,452,00.00,"29,681.64",
15-Jun-25,Cheque,216,00.00,"29,897.64",
15-Jun-25,Transportellaneous,00.00,"9,965.88","19,931.76",
15-Jun-25,Cash,"1,22,122.00",00.00,"1,42,053.76",
15-Jun-25,Interest,00.00,"23,675.63","1,18,378.13",
15-Jun-25,IMPS,00.00,"11,837.81","1,06,540.32",
15-Jun-25,Tax,00.00,"13,317.54","93,222.78",
15-Jun-25,Tax,"24,827.07",00.00,"1,18,049.85",
15-Jun-25,Tax,"1,40,348.25",00.00,"2,58,398.10",
15-Jun-25,Transportellaneous,00.00,"51,679.62","2,06,718.48",
15-Jun-25,Cheque,"6,76,665.75",00.00,"8,83,384.23",
15-Jun-25,RTGS,"2,38,979.90",00.00,"11,22,364.13",
15-Jun-25,Cash,00.00,"1,40,295.52","9,82,068.61",
15-Jun-25,Transportellaneous,00.00,"1,63,678.10","8,18,390.51",
15-Jun-25,Tax,07.00,00.00,"8,18,397.51",
15-Jun-25,NEFT,"1,45,955.31",00.00,"9,64,352.82",
15-Jun-25,Cash,"1,11,972.30",00.00,"10,76,325.12",
15-Jun-25,Bill,00.00,"10,76,325.12",00.00,
15-Jun-25,Transfer,"67,191.97",00.00,"67,191.97",
16-Jun-25,Purchase,"3,820.85",00.00,"71,012.82",
16-Jun-25,Commission,00.00,"8,876.60","62,136.22",
16-Jun-25,Reversal,00.00,"62,136.22",00.00,
17-Jun-25,Debit Card,"1,32,446.00",00.00,"1,32,446.00",
17-Jun-25,ATM,00.00,"13,244.60","1,19,201.40",
17-Jun-25,Transfer,00.00,"1,19,201.40",00.00,
17-Jun-25,Transfer,"1,98,421.00",00.00,"1,98,421.00",
18-Jun-25,NEFT,"16,19,653.75",00.00,"18,18,074.75",
18-Jun-25,Cheque,436.4,00.00,"18,18,511.15",
18-Jun-25,IMPS,00.00,"2,02,056.79","16,16,454.36",
18-Jun-25,Commission,00.00,"2,69,409.06","13,47,045.30",
18-Jun-25,IMPS,00.00,"13,47,045.30",00.00,
18-Jun-25,IMPS,"1,02,440.80",00.00,"1,02,440.80",
18-Jun-25,RTGS,79.53,00.00,"1,02,520.33",
18-Jun-25,Cash,01.10,00.00,"1,02,521.43",
18-Jun-25,Cheque,07.00,00.00,"1,02,528.43",
18-Jun-25,Cash,00.00,"14,646.92","87,881.51",
18-Jun-25,Transportellaneous,00.00,"8,788.15","79,093.36",
18-Jun-25,Purchase,00.00,"26,364.45","52,728.91",
18-Jun-25,Transfer,"4,919.98",00.00,"57,648.89",
18-Jun-25,Transportellaneous,00.00,"14,412.22","43,236.67",
18-Jun-25,Cash,"1,531.00",00.00,"44,767.67",
18-Jun-25,ATM,70.19,00.00,"44,837.86",
18-Jun-25,Bill,00.00,"7,472.98","37,364.88",
18-Jun-25,RTGS,00.00,"6,227.48","31,137.40",
18-Jun-25,Bill,00.00,"31,137.40",00.00,
18-Jun-25,Debit Card,"17,35,617.00",00.00,"17,35,617.00",
18-Jun-25,Transfer,"16,685.10",00.00,"17,52,302.10",
18-Jun-25,NEFT,"27,054.00",00.00,"17,79,356.10",
18-Jun-25,RTGS,00.00,"4,44,839.03","13,34,517.08",
18-Jun-25,ATM,"30,408.00",00.00,"13,64,925.08",
18-Jun-25,IMPS,"2,279.40",00.00,"13,67,204.48",
18-Jun-25,IMPS,00.00,"13,67,204.48",00.00,
18-Jun-25,Interest,"12,920.46",00.00,"12,920.46",
18-Jun-25,Transfer,00.00,"1,292.05","11,628.41",
18-Jun-25,Cash,"63,329.34",00.00,"74,957.75",
18-Jun-25,Debit Card,00.00,"8,328.64","66,629.11",
18-Jun-25,Purchase,00.00,"66,629.11",00.00,
18-Jun-25,IMPS,"30,366.00",00.00,"30,366.00",
18-Jun-25,Cheque,00.00,"7,591.50","22,774.50",
18-Jun-25,ATM,"2,28,580.44",00.00,"2,51,354.94",
19-Jun-25,Reversal,00.00,"50,270.99","2,01,083.95",
19-Jun-25,Interest,"3,039.00",00.00,"2,04,122.95",
19-Jun-25,Tax,00.00,"29,160.42","1,74,962.53",
19-Jun-25,Cash,45,00.00,"1,75,007.53",
20-Jun-25,Transportellaneous,00.00,"58,335.84","1,16,671.69",
20-Jun-25,Reversal,00.00,"12,963.52","1,03,708.17",
20-Jun-25,Commission,00.00,"1,03,708.17",00.00,
20-Jun-25,Bill,07.92,00.00,07.92,
20-Jun-25,Reversal,00.00,07.92,00.00,
20-Jun-25,ATM,228,00.00,228,
20-Jun-25,RTGS,"12,232.00",00.00,"12,460.00",
20-Jun-25,ATM,00.00,"6,230.00","6,230.00",
20-Jun-25,Transfer,00.00,"2,076.67","4,153.33",
20-Jun-25,IMPS,"1,23,069.75",00.00,"1,27,223.08",
20-Jun-25,Commission,"24,693.70",00.00,"1,51,916.78",
20-Jun-25,RTGS,00.00,"21,702.40","1,30,214.38",
20-Jun-25,Interest,00.00,"65,107.19","65,107.19",
20-Jun-25,Purchase,"1,62,675.00",00.00,"2,27,782.19",
20-Jun-25,Bill,00.00,"1,13,891.10","1,13,891.10",
20-Jun-25,Cheque,00.00,"12,654.57","1,01,236.53",
20-Jun-25,Purchase,00.00,"12,654.57","88,581.96",
21-Jun-25,IMPS,00.00,"88,581.96",00.00,
21-Jun-25,Bill,59.14,00.00,59.14,
21-Jun-25,Tax,00.00,19.71,39.43,
21-Jun-25,Commission,21,00.00,60.43,
21-Jun-25,Transfer,00.00,60.43,00.00,
21-Jun-25,NEFT,"4,556.50",00.00,"4,556.50",
21-Jun-25,Purchase,00.00,"2,278.25","2,278.25",
22-Jun-25,IMPS,"1,67,991.00",00.00,"1,70,269.25",
22-Jun-25,Transportellaneous,00.00,"85,134.63","85,134.62",
22-Jun-25,Transportellaneous,00.00,"28,378.21","56,756.41",
22-Jun-25,Bill,00.00,"7,094.55","49,661.86",
22-Jun-25,Interest,14.49,00.00,"49,676.35",
22-Jun-25,NEFT,51.64,00.00,"49,727.99",
22-Jun-25,Commission,00.00,"7,104.00","42,623.99",
22-Jun-25,Bill,"3,61,974.50",00.00,"4,04,598.49",
22-Jun-25,Interest,00.50,00.00,"4,04,598.99",
22-Jun-25,IMPS,00.00,"2,02,299.50","2,02,299.50",
22-Jun-25,Reversal,00.00,"25,287.44","1,77,012.06",
22-Jun-25,Commission,07.00,00.00,"1,77,019.06",
22-Jun-25,ATM,"1,924.00",00.00,"1,78,943.06",
22-Jun-25,ATM,"5,054.92",00.00,"1,83,997.98",
22-Jun-25,Reversal,00.00,"91,998.99","91,998.99",
22-Jun-25,IMPS,00.00,"13,142.71","78,856.28",
22-Jun-25,ATM,00.00,"19,714.07","59,142.21",
22-Jun-25,Cheque,97,00.00,"59,239.21",
22-Jun-25,Purchase,"1,41,264.00",00.00,"2,00,503.21",
22-Jun-25,Cheque,00.00,"20,050.32","1,80,452.89",
22-Jun-25,RTGS,"3,205.58",00.00,"1,83,658.47",
22-Jun-25,Reversal,00.00,"26,236.92","1,57,421.55",
22-Jun-25,IMPS,00.00,"26,236.93","1,31,184.62",
23-Jun-25,IMPS,00.00,"26,236.92","1,04,947.70",
23-Jun-25,NEFT,"8,131.66",00.00,"1,13,079.36",
23-Jun-25,Commission,00.00,"28,269.84","84,809.52",
23-Jun-25,Bill,"3,572.00",00.00,"88,381.52",
23-Jun-25,Cash,26.56,00.00,"88,408.08",
23-Jun-25,Interest,00.00,"17,681.62","70,726.46",
23-Jun-25,Tax,"18,868.90",00.00,"89,595.36",
23-Jun-25,IMPS,485,00.00,"90,080.36",
23-Jun-25,Cheque,00.00,"12,868.62","77,211.74",
23-Jun-25,Cheque,00.00,"12,868.62","64,343.12",
23-Jun-25,Purchase,03.50,00.00,"64,346.62",
23-Jun-25,Tax,"4,984.00",00.00,"69,330.62",
23-Jun-25,Debit Card,00.00,"69,330.62",00.00,
23-Jun-25,Bill,"19,17,427.25",00.00,"19,17,427.25",
23-Jun-25,Debit Card,00.00,"3,83,485.45","15,33,941.80",
23-Jun-25,IMPS,05.04,00.00,"15,33,946.84",
24-Jun-25,Bill,"17,809.20",00.00,"15,51,756.04",
24-Jun-25,Interest,00.00,"3,10,351.21","12,41,404.83",
24-Jun-25,RTGS,"32,180.60",00.00,"12,73,585.43",
24-Jun-25,Transportellaneous,39.51,00.00,"12,73,624.94",
24-Jun-25,Interest,58.21,00.00,"12,73,683.15",
24-Jun-25,Reversal,"1,699.20",00.00,"12,75,382.35",
24-Jun-25,ATM,00.00,"6,37,691.18","6,37,691.18",
24-Jun-25,Reversal,"46,664.80",00.00,"6,84,355.98",
24-Jun-25,Cheque,419,00.00,"6,84,774.98",
24-Jun-25,Tax,00.00,"2,28,258.33","4,56,516.65",
24-Jun-25,Debit Card,"12,403.80",00.00,"4,68,920.45",
24-Jun-25,Purchase,"2,884.00",00.00,"4,71,804.45",
24-Jun-25,Debit Card,06.60,00.00,"4,71,811.05",
24-Jun-25,Bill,00.00,"58,976.38","4,12,834.67",
24-Jun-25,Transportellaneous,00.00,"58,976.38","3,53,858.29",
24-Jun-25,Reversal,00.00,"70,771.66","2,83,086.63",
24-Jun-25,Reversal,00.00,"70,771.66","2,12,314.97",
24-Jun-25,Bill,00.00,"30,330.71","1,81,984.26",
24-Jun-25,NEFT,00.00,"36,396.85","1,45,587.41",
24-Jun-25,Transportellaneous,"28,224.50",00.00,"1,73,811.91",
24-Jun-25,ATM,00.00,"86,905.96","86,905.96",
24-Jun-25,ATM,"9,899.60",00.00,"96,805.56",
24-Jun-25,Interest,"3,083.70",00.00,"99,889.26",
24-Jun-25,RTGS,00.00,"19,977.85","79,911.41",
24-Jun-25,Bill,00.00,"39,955.71","39,955.70",
25-Jun-25,RTGS,00.00,"6,659.28","33,296.42",
25-Jun-25,Reversal,00.00,"5,549.40","27,747.02",
25-Jun-25,Cheque,00.00,"3,468.38","24,278.64",
25-Jun-25,Cash,00.00,"3,034.83","21,243.81",
25-Jun-25,ATM,00.00,"7,081.27","14,162.54",
25-Jun-25,Debit Card,00.00,"2,360.42","11,802.12",
26-Jun-25,Cheque,04.06,00.00,"11,806.18",
26-Jun-25,IMPS,00.00,"1,967.70","9,838.48",
26-Jun-25,Purchase,"10,585.78",00.00,"20,424.26",
26-Jun-25,Cheque,00.00,"2,042.43","18,381.83",
26-Jun-25,Commission,222.5,00.00,"18,604.33",
26-Jun-25,Debit Card,"4,055.00",00.00,"22,659.33",
26-Jun-25,RTGS,"13,354.80",00.00,"36,014.13",
26-Jun-25,Transfer,834,00.00,"36,848.13",
26-Jun-25,NEFT,"1,063.00",00.00,"37,911.13",
26-Jun-25,Debit Card,"1,272.20",00.00,"39,183.33",
26-Jun-25,ATM,"2,237.00",00.00,"41,420.33",
26-Jun-25,Cash,06.30,00.00,"41,426.63",
26-Jun-25,RTGS,00.00,"4,142.66","37,283.97",
26-Jun-25,IMPS,"32,379.00",00.00,"69,662.97",
26-Jun-25,Transportellaneous,00.00,"9,951.85","59,711.12",
26-Jun-25,RTGS,03.00,00.00,"59,714.12",
26-Jun-25,Transfer,"16,335.00",00.00,"76,049.12",
26-Jun-25,Cash,01.00,00.00,"76,050.12",
26-Jun-25,Debit Card,00.00,"10,864.30","65,185.82",
26-Jun-25,Bill,00.00,"65,185.82",00.00,
27-Jun-25,Purchase,"2,44,071.00",00.00,"2,44,071.00",
27-Jun-25,Transportellaneous,00.00,"81,357.00","1,62,714.00",
27-Jun-25,Cheque,00.00,"32,542.80","1,30,171.20",
27-Jun-25,Transportellaneous,00.00,"14,463.47","1,15,707.73",
27-Jun-25,IMPS,"9,774.00",00.00,"1,25,481.73",
27-Jun-25,Reversal,00.00,"41,827.24","83,654.49",
27-Jun-25,IMPS,00.00,"20,913.62","62,740.87",
27-Jun-25,Tax,01.90,00.00,"62,742.77",
27-Jun-25,Commission,"3,808.00",00.00,"66,550.77",
27-Jun-25,ATM,00.00,"11,091.80","55,458.98",
27-Jun-25,Cash,00.00,"55,458.98",00.00,
27-Jun-25,Transportellaneous,"13,42,989.00",00.00,"13,42,989.00",
27-Jun-25,Interest,00.00,"1,34,298.90","12,08,690.10",
27-Jun-25,Cash,64,00.00,"12,08,754.10",
27-Jun-25,Transfer,00.00,"1,72,679.16","10,36,074.94",
27-Jun-25,Commission,00.00,"1,03,607.49","9,32,467.45",
27-Jun-25,NEFT,00.00,"93,246.75","8,39,220.70",
27-Jun-25,Commission,00.00,"93,246.74","7,45,973.96",
27-Jun-25,Interest,00.00,"1,49,194.79","5,96,779.17",
27-Jun-25,IMPS,"1,445.05",00.00,"5,98,224.22",
27-Jun-25,Commission,65,00.00,"5,98,289.22",
27-Jun-25,ATM,"3,660.00",00.00,"6,01,949.22",
27-Jun-25,Purchase,33.7,00.00,"6,01,982.92",
27-Jun-25,Purchase,"5,765.00",00.00,"6,07,747.92",
27-Jun-25,Debit Card,00.00,"3,03,873.96","3,03,873.96",
27-Jun-25,RTGS,19.7,00.00,"3,03,893.66",
27-Jun-25,ATM,00.00,"60,778.73","2,43,114.93",
28-Jun-25,ATM,00.00,"34,730.70","2,08,384.23",
28-Jun-25,RTGS,"1,45,463.59",00.00,"3,53,847.82",
28-Jun-25,Interest,00.00,"39,316.42","3,14,531.40",
28-Jun-25,Interest,00.00,"1,57,265.70","1,57,265.70",
28-Jun-25,RTGS,00.00,"1,57,265.70",00.00,
28-Jun-25,Transfer,"1,42,928.00",00.00,"1,42,928.00",
28-Jun-25,ATM,00.00,"28,585.60","1,14,342.40",
28-Jun-25,Cheque,266.4,00.00,"1,14,608.80",
28-Jun-25,Transfer,00.00,"57,304.40","57,304.40",
28-Jun-25,Interest,"7,13,602.75",00.00,"7,70,907.15",
28-Jun-25,Purchase,07.60,00.00,"7,70,914.75",
28-Jun-25,Cash,06.00,00.00,"7,70,920.75",
28-Jun-25,Interest,00.00,"77,092.08","6,93,828.68",
28-Jun-25,Bill,02.61,00.00,"6,93,831.29",
28-Jun-25,IMPS,07.00,00.00,"6,93,838.29",
28-Jun-25,Reversal,00.00,"6,93,838.29",00.00,
28-Jun-25,NEFT,40.4,00.00,40.4,
28-Jun-25,Debit Card,00.00,04.49,35.91,
28-Jun-25,Tax,"18,877.40",00.00,"18,913.31",
28-Jun-25,Reversal,434,00.00,"19,347.31",
28-Jun-25,Purchase,00.00,"2,763.90","16,583.41",
28-Jun-25,Transfer,00.00,"1,842.60","14,740.81",
28-Jun-25,Cash,"2,98,097.50",00.00,"3,12,838.31",
28-Jun-25,Purchase,"26,296.00",00.00,"3,39,134.31",
28-Jun-25,Transportellaneous,27.43,00.00,"3,39,161.74",
28-Jun-25,NEFT,"11,13,743.00",00.00,"14,52,904.74",
28-Jun-25,Debit Card,162.6,00.00,"14,53,067.34",
28-Jun-25,RTGS,00.00,"2,42,177.89","12,10,889.45",
28-Jun-25,NEFT,"31,024.60",00.00,"12,41,914.05",
28-Jun-25,IMPS,501,00.00,"12,42,415.05",
28-Jun-25,NEFT,00.00,"1,38,046.12","11,04,368.93",
28-Jun-25,Cheque,"17,26,855.25",00.00,"28,31,224.18",
28-Jun-25,Transportellaneous,00.00,"28,31,224.18",00.00,
29-Jun-25,Transfer,"10,975.00",00.00,"10,975.00",
29-Jun-25,Purchase,02.14,00.00,"10,977.14",
29-Jun-25,Transfer,"1,86,985.28",00.00,"1,97,962.42",
29-Jun-25,Tax,00.00,"1,97,962.42",00.00,
30-Jun-25,ATM,"5,933.00",00.00,"5,933.00",
30-Jun-25,Reversal,00.00,847.57,"5,085.43",
30-Jun-25,Reversal,00.00,"1,271.36","3,814.07",
30-Jun-25,Commission,00.00,953.52,"2,860.55",
30-Jun-25,RTGS,00.00,953.52,"1,907.03",
30-Jun-25,Cash,00.00,211.89,"1,695.14",
30-Jun-25,Cash,257,00.00,"1,952.14",
30-Jun-25,Commission,00.00,390.43,"1,561.71",
30-Jun-25,IMPS,00.00,195.21,"1,366.50",
30-Jun-25,Purchase,123.5,00.00,"1,490.00",
30-Jun-25,Cash,00.00,149,"1,341.00",
30-Jun-25,Cheque,116.9,00.00,"1,457.90",
30-Jun-25,Transfer,05.85,00.00,"1,463.75",
30-Jun-25,Interest,00.00,"1,463.75",00.00,
30-Jun-25,Commission,00.36,00.00,00.36,
30-Jun-25,Reversal,00.00,00.05,00.32,
30-Jun-25,Interest,03.00,00.00,03.32,
30-Jun-25,Commission,00.00,00.42,02.90,
30-Jun-25,Purchase,00.00,00.97,01.93,
30-Jun-25,Purchase,00.00,00.97,00.96,
30-Jun-25,Cash,00.00,00.32,00.64,
30-Jun-25,Tax,00.00,00.16,00.48,
30-Jun-25,Interest,00.00,00.06,00.42,
30-Jun-25,IMPS,437.9,00.00,438.32,
30-Jun-25,Interest,"42,879.00",00.00,"43,317.32",
30-Jun-25,RTGS,00.00,"14,439.11","28,878.21",
30-Jun-25,Cash,29.63,00.00,"28,907.84",
30-Jun-25,Cash,"10,24,681.00",00.00,"10,53,588.84",
30-Jun-25,Cash,"12,34,412.75",00.00,"22,88,001.59",
30-Jun-25,Bill,00.00,"3,81,333.60","19,06,667.99",
01-Jul-25,Reversal,12.37,00.00,"19,06,680.36",
01-Jul-25,Transportellaneous,"20,08,052.00",00.00,"39,14,732.36",
01-Jul-25,Commission,34.8,00.00,"39,14,767.16",
01-Jul-25,Bill,"6,85,174.00",00.00,"45,99,941.16",
01-Jul-25,NEFT,00.00,"6,57,134.45","39,42,806.71",
01-Jul-25,Transportellaneous,84.9,00.00,"39,42,891.61",
02-Jul-25,Debit Card,00.00,"3,94,289.16","35,48,602.45",
02-Jul-25,NEFT,00.00,"5,06,943.21","30,41,659.24",
02-Jul-25,Cheque,"6,76,168.20",00.00,"37,17,827.44",
02-Jul-25,Tax,00.00,"7,43,565.49","29,74,261.95",
02-Jul-25,Tax,"2,31,408.70",00.00,"32,05,670.65",
02-Jul-25,RTGS,"14,21,452.00",00.00,"46,27,122.65",
02-Jul-25,Tax,32.3,00.00,"46,27,154.95",
02-Jul-25,Reversal,01.45,00.00,"46,27,156.40",
02-Jul-25,Debit Card,04.02,00.00,"46,27,160.42",
02-Jul-25,Purchase,01.58,00.00,"46,27,162.00",
02-Jul-25,Tax,02.00,00.00,"46,27,164.00",
02-Jul-25,Tax,04.00,00.00,"46,27,168.00",
02-Jul-25,IMPS,08.00,00.00,"46,27,176.00",
02-Jul-25,Bill,00.00,"15,42,392.00","30,84,784.00",
02-Jul-25,Purchase,00.00,"4,40,683.43","26,44,100.57",
02-Jul-25,Transportellaneous,"17,39,467.00",00.00,"43,83,567.57",
02-Jul-25,Reversal,00.00,"4,38,356.76","39,45,210.81",
02-Jul-25,Purchase,06.00,00.00,"39,45,216.81",
03-Jul-25,Cheque,00.00,"9,86,304.20","29,58,912.61",
03-Jul-25,Bill,00.00,"4,22,701.80","25,36,210.81",
03-Jul-25,Debit Card,"1,958.53",00.00,"25,38,169.34",
03-Jul-25,Reversal,"1,522.11",00.00,"25,39,691.45",
03-Jul-25,Reversal,00.00,"12,69,845.73","12,69,845.73",
03-Jul-25,NEFT,00.00,"1,81,406.53","10,88,439.20",
03-Jul-25,IMPS,"2,160.07",00.00,"10,90,599.27",
03-Jul-25,Interest,"20,88,498.00",00.00,"31,79,097.27",
03-Jul-25,Transportellaneous,00.00,"7,94,774.32","23,84,322.95",
03-Jul-25,Transfer,00.00,"4,76,864.59","19,07,458.36",
03-Jul-25,Purchase,00.00,"4,76,864.59","14,30,593.77",
03-Jul-25,ATM,217.74,00.00,"14,30,811.51",
03-Jul-25,Transfer,00.00,"4,76,937.17","9,53,874.34",
03-Jul-25,NEFT,00.00,"1,90,774.87","7,63,099.47",
03-Jul-25,Bill,"30,575.00",00.00,"7,93,674.47",
03-Jul-25,Commission,00.00,"2,64,558.16","5,29,116.31",
03-Jul-25,ATM,"31,999.50",00.00,"5,61,115.81",
03-Jul-25,Transportellaneous,00.00,"70,139.48","4,90,976.33",
03-Jul-25,IMPS,"2,226.31",00.00,"4,93,202.64",
03-Jul-25,Transfer,"3,65,027.50",00.00,"8,58,230.14",
03-Jul-25,Purchase,"1,32,080.00",00.00,"9,90,310.14",
03-Jul-25,Purchase,00.00,"3,30,103.38","6,60,206.76",
03-Jul-25,Debit Card,55.86,00.00,"6,60,262.62",
03-Jul-25,Tax,00.00,"82,532.83","5,77,729.79",
03-Jul-25,ATM,00.00,"1,15,545.96","4,62,183.83",
04-Jul-25,Tax,21.1,00.00,"4,62,204.93",
04-Jul-25,RTGS,00.00,"46,220.49","4,15,984.44",
04-Jul-25,Tax,00.00,"69,330.74","3,46,653.70",
04-Jul-25,NEFT,05.01,00.00,"3,46,658.71",
04-Jul-25,Reversal,"1,416.00",00.00,"3,48,074.71",
04-Jul-25,Purchase,03.67,00.00,"3,48,078.38",
04-Jul-25,RTGS,00.00,"1,74,039.19","1,74,039.19",
04-Jul-25,ATM,00.00,"58,013.06","1,16,026.13",
04-Jul-25,Tax,"1,79,374.00",00.00,"2,95,400.13",
04-Jul-25,IMPS,00.00,"42,200.02","2,53,200.11",
04-Jul-25,Debit Card,00.00,"25,320.01","2,27,880.10",
04-Jul-25,NEFT,00.00,"32,554.30","1,95,325.80",
04-Jul-25,Cash,152,00.00,"1,95,477.80",
04-Jul-25,Bill,265,00.00,"1,95,742.80",
04-Jul-25,Bill,"1,104.00",00.00,"1,96,846.80",
04-Jul-25,Transfer,"17,61,554.00",00.00,"19,58,400.80",
04-Jul-25,Bill,00.00,"9,79,200.40","9,79,200.40",
04-Jul-25,NEFT,00.00,"3,26,400.13","6,52,800.27",
04-Jul-25,Cash,00.00,"93,257.18","5,59,543.09",
05-Jul-25,Reversal,00.00,"62,171.45","4,97,371.64",
05-Jul-25,Purchase,07.10,00.00,"4,97,378.74",
05-Jul-25,Bill,00.00,"2,48,689.37","2,48,689.37",
05-Jul-25,Commission,"1,026.69",00.00,"2,49,716.06",
05-Jul-25,Purchase,13.7,00.00,"2,49,729.76",
05-Jul-25,Purchase,852.4,00.00,"2,50,582.16",
05-Jul-25,Debit Card,04.00,00.00,"2,50,586.16",
06-Jul-25,Interest,00.00,"50,117.23","2,00,468.93",
06-Jul-25,Tax,"22,252.43",00.00,"2,22,721.36",
06-Jul-25,Commission,01.30,00.00,"2,22,722.66",
06-Jul-25,Reversal,00.00,"37,120.44","1,85,602.22",
06-Jul-25,Transportellaneous,00.00,"37,120.44","1,48,481.78",
06-Jul-25,Cheque,"15,833.50",00.00,"1,64,315.28",
06-Jul-25,Bill,00.00,"54,771.76","1,09,543.52",
06-Jul-25,Transportellaneous,08.21,00.00,"1,09,551.73",
06-Jul-25,Interest,"1,07,834.00",00.00,"2,17,385.73",
06-Jul-25,RTGS,07.70,00.00,"2,17,393.43",
06-Jul-25,Cheque,"13,305.90",00.00,"2,30,699.33",
06-Jul-25,Cheque,"2,079.47",00.00,"2,32,778.80",
06-Jul-25,ATM,"1,10,417.60",00.00,"3,43,196.40",
06-Jul-25,Reversal,02.26,00.00,"3,43,198.66",
06-Jul-25,Cash,07.30,00.00,"3,43,205.96",
06-Jul-25,Transportellaneous,"16,285.00",00.00,"3,59,490.96",
06-Jul-25,Debit Card,00.00,"51,355.85","3,08,135.11",
06-Jul-25,IMPS,"1,81,500.91",00.00,"4,89,636.02",
06-Jul-25,RTGS,00.00,"2,44,818.01","2,44,818.01",
06-Jul-25,Transfer,00.00,"34,974.00","2,09,844.01",
06-Jul-25,Transfer,04.59,00.00,"2,09,848.60",
06-Jul-25,Reversal,"10,62,314.00",00.00,"12,72,162.60",
06-Jul-25,Purchase,109,00.00,"12,72,271.60",
06-Jul-25,Tax,59,00.00,"12,72,330.60",
06-Jul-25,Transfer,00.00,"1,59,041.33","11,13,289.28",
06-Jul-25,Purchase,00.00,"5,56,644.64","5,56,644.64",
07-Jul-25,Cash,00.00,"1,85,548.21","3,71,096.43",
07-Jul-25,Reversal,00.00,"1,23,698.81","2,47,397.62",
07-Jul-25,Transportellaneous,31,00.00,"2,47,428.62",
07-Jul-25,Commission,50,00.00,"2,47,478.62",
07-Jul-25,Cheque,"2,383.80",00.00,"2,49,862.42",
07-Jul-25,Commission,00.00,"62,465.61","1,87,396.82",
07-Jul-25,Bill,00.00,"46,849.21","1,40,547.62",
07-Jul-25,Commission,"25,594.80",00.00,"1,66,142.42",
07-Jul-25,Cash,"14,28,765.00",00.00,"15,94,907.42",
07-Jul-25,Cheque,03.00,00.00,"15,94,910.42",
07-Jul-25,Cheque,"7,905.81",00.00,"16,02,816.23",
07-Jul-25,Transfer,990.78,00.00,"16,03,807.01",
07-Jul-25,NEFT,00.00,"2,00,475.88","14,03,331.13",
07-Jul-25,RTGS,00.00,"2,33,888.52","11,69,442.61",
07-Jul-25,Purchase,"9,88,457.50",00.00,"21,57,900.11",
07-Jul-25,Reversal,00.00,"4,31,580.02","17,26,320.09",
07-Jul-25,IMPS,"15,94,451.00",00.00,"33,20,771.09",
07-Jul-25,ATM,431,00.00,"33,21,202.09",
07-Jul-25,RTGS,00.00,"11,07,067.36","22,14,134.73",
07-Jul-25,Transportellaneous,283,00.00,"22,14,417.73",
07-Jul-25,RTGS,55,00.00,"22,14,472.73",
07-Jul-25,Commission,00.00,"2,76,809.09","19,37,663.64",
08-Jul-25,Purchase,"1,422.00",00.00,"19,39,085.64",
08-Jul-25,Interest,00.00,"19,39,085.64",00.00,
08-Jul-25,NEFT,121,00.00,121,
08-Jul-25,ATM,00.00,30.25,90.75,
08-Jul-25,Bill,00.00,45.38,45.38,
08-Jul-25,ATM,00.00,45.38,00.00,
08-Jul-25,Purchase,44.8,00.00,44.8,
08-Jul-25,RTGS,157,00.00,201.8,
08-Jul-25,Tax,00.00,40.36,161.44,
08-Jul-25,Reversal,00.00,16.14,145.3,
08-Jul-25,Tax,02.00,00.00,147.3,
08-Jul-25,Debit Card,00.00,14.73,132.57,
08-Jul-25,Cheque,00.00,18.94,113.63,
08-Jul-25,Commission,"14,318.63",00.00,"14,432.26",
08-Jul-25,Cash,324,00.00,"14,756.26",
08-Jul-25,Cheque,00.00,"14,756.26",00.00,
08-Jul-25,NEFT,266,00.00,266,
08-Jul-25,Interest,00.00,44.33,221.67,
08-Jul-25,Cheque,00.00,36.95,184.72,
08-Jul-25,RTGS,01.00,00.00,185.72,
08-Jul-25,Reversal,"1,151.00",00.00,"1,336.72",
08-Jul-25,Transportellaneous,00.00,167.09,"1,169.63",
08-Jul-25,NEFT,00.00,292.41,877.22,
08-Jul-25,Interest,00.00,97.47,779.75,
09-Jul-25,Commission,00.00,129.96,649.79,
09-Jul-25,ATM,"2,988.00",00.00,"3,637.79",
09-Jul-25,IMPS,10,00.00,"3,647.79",
09-Jul-25,Commission,00.00,"1,215.93","2,431.86",
09-Jul-25,Debit Card,00.00,405.31,"2,026.55",
09-Jul-25,Transfer,"1,38,686.53",00.00,"1,40,713.08",
09-Jul-25,Tax,05.71,00.00,"1,40,718.79",
09-Jul-25,Tax,00.30,00.00,"1,40,719.09",
09-Jul-25,Cheque,363,00.00,"1,41,082.09",
09-Jul-25,Cash,03.00,00.00,"1,41,085.09",
09-Jul-25,Purchase,00.00,"20,155.01","1,20,930.08",
09-Jul-25,Transfer,"55,436.59",00.00,"1,76,366.67",
09-Jul-25,NEFT,16.68,00.00,"1,76,383.35",
09-Jul-25,Commission,"9,051.41",00.00,"1,85,434.76",
09-Jul-25,IMPS,"19,89,676.00",00.00,"21,75,110.76",
09-Jul-25,Cash,468.2,00.00,"21,75,578.96",
09-Jul-25,ATM,"2,212.59",00.00,"21,77,791.55",
09-Jul-25,Purchase,484.1,00.00,"21,78,275.65",
09-Jul-25,Debit Card,"3,004.04",00.00,"21,81,279.69",
09-Jul-25,ATM,00.00,"10,90,639.85","10,90,639.84",
09-Jul-25,Transportellaneous,00.00,"1,55,805.69","9,34,834.15",
09-Jul-25,ATM,00.00,"93,483.42","8,41,350.74",
09-Jul-25,ATM,00.00,"1,68,270.15","6,73,080.59",
09-Jul-25,Interest,"4,93,822.00",00.00,"11,66,902.59",
09-Jul-25,Cash,06.04,00.00,"11,66,908.63",
09-Jul-25,ATM,00.00,"1,45,863.58","10,21,045.05",
09-Jul-25,Bill,04.00,00.00,"10,21,049.05",
09-Jul-25,Reversal,174.4,00.00,"10,21,223.45",
09-Jul-25,Cheque,00.00,"1,02,122.35","9,19,101.10",
09-Jul-25,Cash,"19,872.60",00.00,"9,38,973.70",
09-Jul-25,Purchase,57.5,00.00,"9,39,031.20",
09-Jul-25,Bill,"31,042.06",00.00,"9,70,073.26",
09-Jul-25,NEFT,00.00,"2,42,518.32","7,27,554.94",
09-Jul-25,IMPS,00.00,"1,03,936.42","6,23,618.52",
09-Jul-25,Reversal,22.44,00.00,"6,23,640.96",
09-Jul-25,Purchase,02.96,00.00,"6,23,643.92",
09-Jul-25,Reversal,00.00,"69,293.77","5,54,350.15",
10-Jul-25,Transportellaneous,46,00.00,"5,54,396.15",
10-Jul-25,Commission,101.5,00.00,"5,54,497.65",
11-Jul-25,NEFT,127.66,00.00,"5,54,625.31",
11-Jul-25,Bill,257.9,00.00,"5,54,883.21",
11-Jul-25,Reversal,"2,611.00",00.00,"5,57,494.21",
11-Jul-25,Cheque,44.1,00.00,"5,57,538.31",
11-Jul-25,Debit Card,00.00,"5,57,538.31",00.00,
11-Jul-25,Tax,"3,09,738.50",00.00,"3,09,738.50",
11-Jul-25,Cash,"18,44,082.25",00.00,"21,53,820.75",
11-Jul-25,Tax,00.00,"3,58,970.13","17,94,850.62",
12-Jul-25,IMPS,37.8,00.00,"17,94,888.42",
12-Jul-25,IMPS,00.00,"2,24,361.05","15,70,527.37",
12-Jul-25,NEFT,"3,945.42",00.00,"15,74,472.79",
12-Jul-25,RTGS,"1,449.00",00.00,"15,75,921.79",
12-Jul-25,Commission,"15,633.00",00.00,"15,91,554.79",
12-Jul-25,ATM,00.40,00.00,"15,91,555.19",
12-Jul-25,Commission,00.00,"1,59,155.52","14,32,399.67",
12-Jul-25,NEFT,148,00.00,"14,32,547.67",
12-Jul-25,RTGS,00.00,"2,04,649.67","12,27,898.00",
12-Jul-25,Reversal,"16,75,420.00",00.00,"29,03,318.00",
12-Jul-25,Transfer,01.18,00.00,"29,03,319.18",
12-Jul-25,Interest,00.00,"7,25,829.80","21,77,489.39",
12-Jul-25,Transportellaneous,"3,908.27",00.00,"21,81,397.66",
12-Jul-25,Cash,"3,041.00",00.00,"21,84,438.66",
12-Jul-25,NEFT,00.00,"10,92,219.33","10,92,219.33",
12-Jul-25,Tax,00.00,"5,46,109.67","5,46,109.66",
12-Jul-25,Interest,"1,795.80",00.00,"5,47,905.46",
12-Jul-25,Interest,00.00,"78,272.21","4,69,633.25",
12-Jul-25,Transportellaneous,00.00,"46,963.33","4,22,669.92",
12-Jul-25,Tax,"22,715.38",00.00,"4,45,385.30",
12-Jul-25,Debit Card,00.00,"4,45,385.30",00.00,
12-Jul-25,Cash,"32,048.00",00.00,"32,048.00",
13-Jul-25,Cash,00.00,"3,560.89","28,487.11",
13-Jul-25,RTGS,"1,48,198.00",00.00,"1,76,685.11",
13-Jul-25,Cash,381.82,00.00,"1,77,066.93",
13-Jul-25,Interest,00.00,"35,413.39","1,41,653.54",
13-Jul-25,Cheque,00.00,"35,413.39","1,06,240.16",
13-Jul-25,RTGS,00.00,"10,624.02","95,616.14",
13-Jul-25,IMPS,00.00,"13,659.45","81,956.69",
13-Jul-25,Bill,00.00,"13,659.45","68,297.24",
13-Jul-25,Interest,00.00,"9,756.75","58,540.49",
13-Jul-25,IMPS,"3,59,900.00",00.00,"4,18,440.49",
13-Jul-25,Transportellaneous,00.00,"4,18,440.49",00.00,
13-Jul-25,Reversal,"17,40,765.50",00.00,"17,40,765.50",
13-Jul-25,Reversal,00.00,"2,17,595.69","15,23,169.81",
13-Jul-25,RTGS,"18,72,839.00",00.00,"33,96,008.81",
13-Jul-25,Tax,00.00,"4,24,501.10","29,71,507.71",
13-Jul-25,Tax,"12,64,408.50",00.00,"42,35,916.21",
13-Jul-25,IMPS,03.20,00.00,"42,35,919.41",
13-Jul-25,NEFT,00.00,"4,70,657.71","37,65,261.70",
14-Jul-25,Cheque,00.00,"18,82,630.85","18,82,630.85",
14-Jul-25,Cash,00.00,"3,76,526.17","15,06,104.68",
14-Jul-25,Commission,"1,870.50",00.00,"15,07,975.18",
14-Jul-25,ATM,00.00,"1,67,552.80","13,40,422.38",
14-Jul-25,RTGS,43,00.00,"13,40,465.38",
14-Jul-25,Bill,00.00,"2,68,093.08","10,72,372.30",
15-Jul-25,IMPS,00.00,"3,57,457.43","7,14,914.87",
15-Jul-25,Purchase,00.00,"79,434.99","6,35,479.88",
15-Jul-25,Transportellaneous,00.00,"3,17,739.94","3,17,739.94",
15-Jul-25,Transportellaneous,93.2,00.00,"3,17,833.14",
15-Jul-25,Interest,00.00,"79,458.29","2,38,374.86",
15-Jul-25,Purchase,00.00,"1,19,187.43","1,19,187.43",
15-Jul-25,Cash,00.00,"1,19,187.43",00.00,
15-Jul-25,Purchase,"1,88,553.00",00.00,"1,88,553.00",
15-Jul-25,ATM,00.00,"23,569.13","1,64,983.88",
15-Jul-25,Purchase,00.00,"1,64,983.88",00.00,
15-Jul-25,Interest,20,00.00,20,
15-Jul-25,NEFT,00.00,05.00,15,
15-Jul-25,Tax,00.00,03.00,12,
16-Jul-25,Tax,"71,725.00",00.00,"71,737.00",
16-Jul-25,Cash,"2,739.30",00.00,"74,476.30",
16-Jul-25,Commission,"8,410.40",00.00,"82,886.70",
16-Jul-25,Bill,00.00,"27,628.90","55,257.80",
16-Jul-25,Cheque,00.00,"7,893.97","47,363.83",
16-Jul-25,Transportellaneous,01.00,00.00,"47,364.83",
16-Jul-25,RTGS,"2,183.60",00.00,"49,548.43",
16-Jul-25,Cheque,"20,27,013.20",00.00,"20,76,561.63",
16-Jul-25,Reversal,00.00,"10,38,280.82","10,38,280.82",
16-Jul-25,Purchase,00.00,"1,48,325.83","8,89,954.99",
16-Jul-25,Debit Card,00.00,"4,44,977.50","4,44,977.50",
16-Jul-25,Purchase,07.04,00.00,"4,44,984.54",
16-Jul-25,Cheque,"2,61,317.25",00.00,"7,06,301.79",
16-Jul-25,IMPS,00.00,"1,76,575.45","5,29,726.34",
16-Jul-25,Interest,"10,349.20",00.00,"5,40,075.54",
16-Jul-25,Cash,00.00,"1,08,015.11","4,32,060.43",
16-Jul-25,Interest,329.02,00.00,"4,32,389.45",
16-Jul-25,ATM,116,00.00,"4,32,505.45",
16-Jul-25,RTGS,00.00,"48,056.16","3,84,449.29",
16-Jul-25,ATM,43,00.00,"3,84,492.29",
16-Jul-25,Commission,00.00,"42,721.37","3,41,770.92",
16-Jul-25,Transportellaneous,00.00,"42,721.37","2,99,049.56",
16-Jul-25,Tax,00.00,"37,381.20","2,61,668.36",
16-Jul-25,RTGS,05.10,00.00,"2,61,673.46",
16-Jul-25,ATM,00.00,"1,30,836.73","1,30,836.73",
16-Jul-25,Cheque,"1,18,654.80",00.00,"2,49,491.53",
16-Jul-25,Transportellaneous,"16,80,540.50",00.00,"19,30,032.03",
16-Jul-25,Transfer,00.00,"19,30,032.03",00.00,
16-Jul-25,Interest,"4,008.29",00.00,"4,008.29",
16-Jul-25,Cheque,00.00,572.61,"3,435.68",
16-Jul-25,Transfer,63.9,00.00,"3,499.58",
16-Jul-25,RTGS,00.00,583.26,"2,916.32",
16-Jul-25,NEFT,18.45,00.00,"2,934.77",
16-Jul-25,Transfer,59.8,00.00,"2,994.57",
16-Jul-25,Transfer,07.80,00.00,"3,002.37",
16-Jul-25,Interest,00.00,500.4,"2,501.98",
16-Jul-25,Bill,00.00,357.43,"2,144.55",
16-Jul-25,Debit Card,00.00,357.43,"1,787.13",
16-Jul-25,Reversal,00.00,255.3,"1,531.83",
16-Jul-25,Bill,00.00,306.37,"1,225.46",
16-Jul-25,Cash,"15,27,671.00",00.00,"15,28,896.46",
16-Jul-25,Debit Card,60,00.00,"15,28,956.46",
16-Jul-25,NEFT,00.00,"3,05,791.29","12,23,165.17",
16-Jul-25,ATM,12.66,00.00,"12,23,177.83",
17-Jul-25,Cash,"7,75,426.00",00.00,"19,98,603.83",
17-Jul-25,Transportellaneous,00.00,00.00,"19,98,603.83",
17-Jul-25,Purchase,00.00,"6,66,201.28","13,32,402.55",
17-Jul-25,RTGS,00.00,"1,48,044.73","11,84,357.82",
17-Jul-25,Debit Card,00.00,"1,97,392.97","9,86,964.85",
17-Jul-25,Reversal,"1,583.41",00.00,"9,88,548.26",
17-Jul-25,Interest,00.00,"1,64,758.04","8,23,790.22",
17-Jul-25,Interest,00.00,"8,23,790.22",00.00,
17-Jul-25,NEFT,"2,744.00",00.00,"2,744.00",
17-Jul-25,Purchase,00.00,"2,744.00",00.00,
17-Jul-25,Purchase,81,00.00,81,
17-Jul-25,Transfer,00.00,13.5,67.5,
17-Jul-25,IMPS,00.00,67.5,00.00,
17-Jul-25,Reversal,06.90,00.00,06.90,
17-Jul-25,RTGS,00.00,00.69,06.21,
17-Jul-25,Tax,00.00,01.04,05.18,
17-Jul-25,Commission,32.9,00.00,38.08,
17-Jul-25,Cheque,00.00,03.81,34.27,
17-Jul-25,Tax,00.00,34.27,00.00,
17-Jul-25,Debit Card,03.60,00.00,03.60,
17-Jul-25,Debit Card,00.00,00.45,03.15,
17-Jul-25,Transportellaneous,"3,67,324.80",00.00,"3,67,327.95",
17-Jul-25,Transportellaneous,03.80,00.00,"3,67,331.75",
17-Jul-25,Commission,"64,698.00",00.00,"4,32,029.75",
17-Jul-25,Interest,36,00.00,"4,32,065.75",
17-Jul-25,ATM,"20,32,496.00",00.00,"24,64,561.75",
17-Jul-25,Transportellaneous,"2,11,133.00",00.00,"26,75,694.75",
17-Jul-25,NEFT,00.00,"2,67,569.48","24,08,125.28",
17-Jul-25,Reversal,00.00,"4,01,354.21","20,06,771.07",
17-Jul-25,NEFT,00.00,"4,01,354.21","16,05,416.86",
17-Jul-25,Reversal,00.00,"5,35,138.95","10,70,277.91",
17-Jul-25,Cheque,06.34,00.00,"10,70,284.25",
17-Jul-25,Transportellaneous,00.00,"1,33,785.53","9,36,498.72",
17-Jul-25,Tax,00.00,"93,649.87","8,42,848.85",
17-Jul-25,Interest,"18,623.40",00.00,"8,61,472.25",
17-Jul-25,Transportellaneous,"1,16,475.40",00.00,"9,77,947.65",
17-Jul-25,Debit Card,03.00,00.00,"9,77,950.65",
17-Jul-25,NEFT,"29,315.64",00.00,"10,07,266.29",
17-Jul-25,Cheque,00.00,"1,67,877.72","8,39,388.58",
17-Jul-25,Bill,00.00,"2,79,796.19","5,59,592.39",
17-Jul-25,Interest,122,00.00,"5,59,714.39",
17-Jul-25,IMPS,"3,386.00",00.00,"5,63,100.39",
17-Jul-25,RTGS,"3,314.28",00.00,"5,66,414.67",
17-Jul-25,Transportellaneous,06.20,00.00,"5,66,420.87",
17-Jul-25,Commission,"15,412.92",00.00,"5,81,833.79",
17-Jul-25,Purchase,00.00,"2,90,916.90","2,90,916.90",
17-Jul-25,Commission,00.00,"29,091.69","2,61,825.21",
17-Jul-25,Transportellaneous,00.00,"2,61,825.21",00.00,
17-Jul-25,Purchase,03.50,00.00,03.50,
17-Jul-25,Tax,06.00,00.00,09.50,
17-Jul-25,Transfer,"8,199.00",00.00,"8,208.50",
17-Jul-25,RTGS,00.00,820.85,"7,387.65",
17-Jul-25,Transportellaneous,"2,096.00",00.00,"9,483.65",
17-Jul-25,Transfer,00.00,"4,741.83","4,741.82",
17-Jul-25,Cash,04.06,00.00,"4,745.88",
18-Jul-25,Interest,"20,301.30",00.00,"25,047.18",
18-Jul-25,Debit Card,00.00,"4,174.53","20,872.65",
18-Jul-25,Transfer,"4,87,048.00",00.00,"5,07,920.65",
18-Jul-25,Cash,56,00.00,"5,07,976.65",
18-Jul-25,Interest,00.00,"2,53,988.33","2,53,988.32",
18-Jul-25,Transportellaneous,00.00,"84,662.77","1,69,325.55",
18-Jul-25,Interest,06.40,00.00,"1,69,331.95",
18-Jul-25,Tax,00.00,"84,665.98","84,665.98",
18-Jul-25,Reversal,00.00,"21,166.50","63,499.48",
18-Jul-25,RTGS,00.00,"6,349.95","57,149.53",
18-Jul-25,ATM,00.00,"5,714.95","51,434.58",
18-Jul-25,Transportellaneous,00.00,"10,286.92","41,147.66",
18-Jul-25,IMPS,"20,14,067.25",00.00,"20,55,214.91",
18-Jul-25,Cash,00.00,"2,93,602.13","17,61,612.78",
18-Jul-25,Debit Card,"2,054.00",00.00,"17,63,666.78",
18-Jul-25,IMPS,00.00,"4,40,916.70","13,22,750.08",
18-Jul-25,Tax,00.00,"1,32,275.01","11,90,475.07",
18-Jul-25,Commission,"67,413.00",00.00,"12,57,888.07",
18-Jul-25,NEFT,"2,04,386.47",00.00,"14,62,274.54",
18-Jul-25,Cheque,00.00,"1,62,474.95","12,99,799.59",
18-Jul-25,Debit Card,"4,410.00",00.00,"13,04,209.59",
18-Jul-25,ATM,00.00,"6,52,104.80","6,52,104.80",
19-Jul-25,Transportellaneous,"26,831.11",00.00,"6,78,935.91",
19-Jul-25,Interest,"19,414.57",00.00,"6,98,350.48",
19-Jul-25,RTGS,"3,87,100.25",00.00,"10,85,450.73",
19-Jul-25,Bill,00.00,"2,17,090.15","8,68,360.58",
19-Jul-25,RTGS,00.00,"8,68,360.58",00.00,
19-Jul-25,Interest,"13,211.99",00.00,"13,211.99",
19-Jul-25,ATM,43.22,00.00,"13,255.21",
19-Jul-25,RTGS,00.00,"4,418.40","8,836.81",
19-Jul-25,Reversal,00.00,"1,472.80","7,364.01",
19-Jul-25,ATM,"17,08,026.50",00.00,"17,15,390.51",
19-Jul-25,Cheque,00.00,"1,90,598.95","15,24,791.56",
19-Jul-25,Bill,00.00,"1,90,598.95","13,34,192.62",
19-Jul-25,ATM,00.00,"13,34,192.62",00.00,
19-Jul-25,Transportellaneous,"1,48,370.69",00.00,"1,48,370.69",
19-Jul-25,Commission,00.00,"16,485.63","1,31,885.06",
19-Jul-25,RTGS,00.00,"18,840.72","1,13,044.34",
19-Jul-25,ATM,00.00,"12,560.48","1,00,483.86",
19-Jul-25,Cash,00.80,00.00,"1,00,484.66",
19-Jul-25,Cash,"2,664.20",00.00,"1,03,148.86",
19-Jul-25,Interest,00.00,"17,191.48","85,957.38",
19-Jul-25,Cash,00.00,"12,279.63","73,677.75",
19-Jul-25,Reversal,00.52,00.00,"73,678.27",
19-Jul-25,Bill,00.00,"36,839.14","36,839.14",
19-Jul-25,Reversal,03.00,00.00,"36,842.14",
19-Jul-25,ATM,"31,348.00",00.00,"68,190.14",
19-Jul-25,NEFT,00.00,"7,576.68","60,613.46",
19-Jul-25,Bill,55.16,00.00,"60,668.62",
20-Jul-25,IMPS,00.00,"12,133.72","48,534.90",
20-Jul-25,Transfer,"2,765.00",00.00,"51,299.90",
20-Jul-25,ATM,00.00,"5,699.99","45,599.91",
20-Jul-25,IMPS,00.00,"11,399.98","34,199.93",
21-Jul-25,RTGS,00.00,"3,419.99","30,779.94",
21-Jul-25,Tax,245,00.00,"31,024.94",
21-Jul-25,Transportellaneous,00.00,"5,170.82","25,854.12",
21-Jul-25,Debit Card,00.00,"2,872.68","22,981.44",
21-Jul-25,Commission,00.00,"4,596.29","18,385.15",
21-Jul-25,ATM,00.00,"4,596.29","13,788.86",
21-Jul-25,Tax,00.00,"4,596.29","9,192.57",
21-Jul-25,Debit Card,"1,998.00",00.00,"11,190.57",
21-Jul-25,RTGS,00.00,"1,598.65","9,591.92",
21-Jul-25,IMPS,"7,765.00",00.00,"17,356.92",
21-Jul-25,Transportellaneous,613.16,00.00,"17,970.08",
21-Jul-25,Interest,89.73,00.00,"18,059.81",
21-Jul-25,Reversal,00.00,"2,579.97","15,479.84",
21-Jul-25,Bill,00.00,"5,159.95","10,319.89",
21-Jul-25,IMPS,05.04,00.00,"10,324.93",
21-Jul-25,NEFT,00.00,"1,290.62","9,034.31",
21-Jul-25,Debit Card,00.00,"1,806.86","7,227.45",
21-Jul-25,Cash,"10,035.70",00.00,"17,263.15",
21-Jul-25,Commission,"15,68,040.00",00.00,"15,85,303.15",
21-Jul-25,IMPS,410,00.00,"15,85,713.15",
21-Jul-25,Purchase,"2,000.00",00.00,"15,87,713.15",
21-Jul-25,Transportellaneous,00.00,"1,76,412.57","14,11,300.58",
21-Jul-25,Cash,00.00,"1,76,412.57","12,34,888.01",
21-Jul-25,IMPS,49.5,00.00,"12,34,937.51",
21-Jul-25,Debit Card,00.00,"4,11,645.84","8,23,291.67",
21-Jul-25,NEFT,"22,320.75",00.00,"8,45,612.42",
21-Jul-25,Purchase,00.00,"1,20,801.77","7,24,810.65",
21-Jul-25,Debit Card,00.00,"80,534.52","6,44,276.13",
21-Jul-25,Cheque,00.00,"92,039.45","5,52,236.68",
21-Jul-25,NEFT,135,00.00,"5,52,371.68",
21-Jul-25,Purchase,"13,84,089.50",00.00,"19,36,461.18",
21-Jul-25,ATM,00.00,"6,45,487.06","12,90,974.12",
21-Jul-25,NEFT,00.00,"2,58,194.82","10,32,779.30",
21-Jul-25,Purchase,473,00.00,"10,33,252.30",
21-Jul-25,NEFT,00.00,"1,72,208.72","8,61,043.58",
21-Jul-25,Purchase,00.00,"1,23,006.23","7,38,037.35",
21-Jul-25,Reversal,00.00,"7,38,037.35",00.00,
21-Jul-25,Interest,"1,67,017.20",00.00,"1,67,017.20",
21-Jul-25,RTGS,"16,806.74",00.00,"1,83,823.94",
21-Jul-25,Transportellaneous,00.00,"91,911.97","91,911.97",
21-Jul-25,Tax,298.53,00.00,"92,210.50",
21-Jul-25,Debit Card,00.00,"10,245.61","81,964.89",
21-Jul-25,RTGS,"1,078.33",00.00,"83,043.22",
21-Jul-25,IMPS,00.00,"8,304.32","74,738.90",
21-Jul-25,Tax,00.00,"8,304.32","66,434.58",
21-Jul-25,Transportellaneous,03.40,00.00,"66,437.98",
21-Jul-25,NEFT,07.00,00.00,"66,444.98",
21-Jul-25,Commission,46,00.00,"66,490.98",
21-Jul-25,Tax,"8,35,759.00",00.00,"9,02,249.98",
21-Jul-25,Debit Card,"19,42,786.75",00.00,"28,45,036.73",
21-Jul-25,Tax,"28,198.01",00.00,"28,73,234.74",
21-Jul-25,RTGS,00.00,"4,78,872.46","23,94,362.28",
21-Jul-25,Purchase,"1,11,335.00",00.00,"25,05,697.28",
21-Jul-25,Bill,02.62,00.00,"25,05,699.90",
21-Jul-25,NEFT,"9,709.00",00.00,"25,15,408.90",
21-Jul-25,Cash,"11,93,531.00",00.00,"37,08,939.90",
21-Jul-25,Transportellaneous,00.00,"3,70,893.99","33,38,045.91",
21-Jul-25,Transfer,03.31,00.00,"33,38,049.22",
21-Jul-25,Transfer,369,00.00,"33,38,418.22",
21-Jul-25,Cheque,"19,126.00",00.00,"33,57,544.22",
21-Jul-25,Tax,00.00,"5,59,590.70","27,97,953.52",
21-Jul-25,Commission,02.34,00.00,"27,97,955.86",
21-Jul-25,Reversal,00.00,"2,79,795.59","25,18,160.27",
21-Jul-25,Bill,"1,08,780.20",00.00,"26,26,940.47",
21-Jul-25,NEFT,00.00,"4,37,823.41","21,89,117.06",
21-Jul-25,IMPS,07.00,00.00,"21,89,124.06",
21-Jul-25,Cash,03.60,00.00,"21,89,127.66",
21-Jul-25,Bill,00.00,"4,37,825.53","17,51,302.13",
21-Jul-25,Purchase,04.00,00.00,"17,51,306.13",
21-Jul-25,Interest,33.28,00.00,"17,51,339.41",
21-Jul-25,Transfer,08.00,00.00,"17,51,347.41",
21-Jul-25,Cash,"70,240.90",00.00,"18,21,588.31",
21-Jul-25,Commission,00.00,"2,27,698.54","15,93,889.77",
21-Jul-25,Transfer,00.00,"5,31,296.59","10,62,593.18",
21-Jul-25,RTGS,"29,660.00",00.00,"10,92,253.18",
21-Jul-25,Interest,"3,502.00",00.00,"10,95,755.18",
21-Jul-25,Reversal,00.00,"10,95,755.18",00.00,
21-Jul-25,Transportellaneous,"15,020.00",00.00,"15,020.00",
21-Jul-25,Tax,00.00,"1,668.89","13,351.11",
21-Jul-25,ATM,24.9,00.00,"13,376.01",
21-Jul-25,Transportellaneous,00.00,"4,458.67","8,917.34",
21-Jul-25,Debit Card,03.66,00.00,"8,921.00",
21-Jul-25,Commission,00.00,"4,460.50","4,460.50",
21-Jul-25,Purchase,307,00.00,"4,767.50",
21-Jul-25,Bill,00.00,"2,383.75","2,383.75",
21-Jul-25,ATM,"2,11,581.72",00.00,"2,13,965.47",
21-Jul-25,Debit Card,"98,710.44",00.00,"3,12,675.91",
21-Jul-25,RTGS,00.00,"1,04,225.30","2,08,450.61",
22-Jul-25,Debit Card,00.00,"69,483.54","1,38,967.07",
22-Jul-25,ATM,00.00,"13,896.71","1,25,070.36",
22-Jul-25,NEFT,00.00,"17,867.19","1,07,203.17",
22-Jul-25,Cheque,00.00,"11,911.46","95,291.71",
22-Jul-25,Transfer,00.00,"10,587.97","84,703.74",
22-Jul-25,Cash,264,00.00,"84,967.74",
22-Jul-25,Transportellaneous,00.00,"16,993.55","67,974.19",
22-Jul-25,ATM,"24,147.90",00.00,"92,122.09",
22-Jul-25,Cash,"19,68,755.00",00.00,"20,60,877.09",
22-Jul-25,Interest,00.00,"10,30,438.55","10,30,438.54",
22-Jul-25,Debit Card,"19,26,916.50",00.00,"29,57,355.04",
22-Jul-25,Transportellaneous,"20,81,404.20",00.00,"50,38,759.24",
22-Jul-25,Bill,486.2,00.00,"50,39,245.44",
22-Jul-25,Transfer,00.00,"6,29,905.68","44,09,339.76",
22-Jul-25,Transportellaneous,23.1,00.00,"44,09,362.86",
22-Jul-25,NEFT,00.00,"5,51,170.36","38,58,192.50",
22-Jul-25,Interest,00.00,"4,28,688.06","34,29,504.44",
22-Jul-25,Tax,251.7,00.00,"34,29,756.14",
22-Jul-25,Interest,00.00,"3,81,084.02","30,48,672.12",
22-Jul-25,Tax,"21,733.54",00.00,"30,70,405.66",
22-Jul-25,Cheque,00.00,"15,35,202.83","15,35,202.83",
22-Jul-25,Cash,00.00,"15,35,202.83",00.00,
22-Jul-25,Cheque,04.40,00.00,04.40,
22-Jul-25,Debit Card,04.00,00.00,08.40,
22-Jul-25,Purchase,"27,825.50",00.00,"27,833.90",
22-Jul-25,ATM,"2,663.00",00.00,"30,496.90",
22-Jul-25,Commission,00.00,"6,099.38","24,397.52",
22-Jul-25,NEFT,00.00,"3,049.69","21,347.83",
22-Jul-25,IMPS,172,00.00,"21,519.83",
22-Jul-25,IMPS,00.00,"21,519.83",00.00,
22-Jul-25,Commission,"3,139.02",00.00,"3,139.02",
22-Jul-25,Cash,05.50,00.00,"3,144.52",
22-Jul-25,Cash,"30,012.33",00.00,"33,156.85",
22-Jul-25,Bill,02.00,00.00,"33,158.85",
22-Jul-25,NEFT,00.00,"11,052.95","22,105.90",
22-Jul-25,Transfer,"8,12,718.00",00.00,"8,34,823.90",
22-Jul-25,Commission,00.00,"2,08,705.98","6,26,117.93",
22-Jul-25,Reversal,"14,27,083.80",00.00,"20,53,201.73",
22-Jul-25,RTGS,00.00,"2,05,320.17","18,47,881.56",
22-Jul-25,Interest,472.7,00.00,"18,48,354.26",
22-Jul-25,ATM,"1,492.15",00.00,"18,49,846.41",
22-Jul-25,Purchase,00.00,"3,69,969.28","14,79,877.13",
23-Jul-25,ATM,"15,25,596.50",00.00,"30,05,473.63",
23-Jul-25,NEFT,08.00,00.00,"30,05,481.63",
23-Jul-25,Interest,07.56,00.00,"30,05,489.19",
23-Jul-25,ATM,719.3,00.00,"30,06,208.49",
23-Jul-25,Transfer,"9,15,896.00",00.00,"39,22,104.49",
23-Jul-25,IMPS,00.00,"13,07,368.16","26,14,736.33",
23-Jul-25,Cheque,00.00,"3,26,842.04","22,87,894.29",
23-Jul-25,Transfer,07.50,00.00,"22,87,901.79",
23-Jul-25,Cheque,"3,170.00",00.00,"22,91,071.79",
23-Jul-25,Commission,00.94,00.00,"22,91,072.73",
23-Jul-25,Cheque,"26,137.19",00.00,"23,17,209.92",
23-Jul-25,Transfer,"2,55,778.97",00.00,"25,72,988.89",
23-Jul-25,Cash,309.08,00.00,"25,73,297.97",
23-Jul-25,RTGS,00.00,"2,57,329.80","23,15,968.17",
23-Jul-25,IMPS,"17,36,247.00",00.00,"40,52,215.17",
23-Jul-25,Transfer,00.00,"13,50,738.39","27,01,476.78",
23-Jul-25,Purchase,"2,023.27",00.00,"27,03,500.05",
23-Jul-25,Purchase,00.00,"3,37,937.51","23,65,562.54",
23-Jul-25,Bill,00.00,"2,62,840.28","21,02,722.26",
23-Jul-25,Commission,00.00,"2,62,840.28","18,39,881.98",
23-Jul-25,Transfer,00.00,"6,13,293.99","12,26,587.99",
23-Jul-25,Commission,00.00,"2,04,431.33","10,22,156.66",
23-Jul-25,Purchase,347.68,00.00,"10,22,504.34",
23-Jul-25,Transportellaneous,871.78,00.00,"10,23,376.12",
23-Jul-25,Bill,00.00,"3,41,125.37","6,82,250.75",
23-Jul-25,Bill,00.00,"68,225.08","6,14,025.68",
23-Jul-25,Interest,"2,15,799.00",00.00,"8,29,824.68",
23-Jul-25,Commission,00.00,"1,38,304.11","6,91,520.57",
23-Jul-25,NEFT,00.00,"2,30,506.86","4,61,013.71",
23-Jul-25,Transfer,370.51,00.00,"4,61,384.22",
23-Jul-25,Bill,00.00,"76,897.37","3,84,486.85",
23-Jul-25,Purchase,"18,641.36",00.00,"4,03,128.21",
23-Jul-25,NEFT,00.00,"57,589.74","3,45,538.47",
23-Jul-25,Purchase,01.00,00.00,"3,45,539.47",
23-Jul-25,Commission,"3,093.00",00.00,"3,48,632.47",
23-Jul-25,ATM,"9,39,945.80",00.00,"12,88,578.27",
23-Jul-25,Transfer,"2,48,290.00",00.00,"15,36,868.27",
23-Jul-25,NEFT,00.00,"2,56,144.71","12,80,723.56",
23-Jul-25,Tax,"2,783.00",00.00,"12,83,506.56",
23-Jul-25,Bill,01.17,00.00,"12,83,507.73",
23-Jul-25,Debit Card,"2,051.02",00.00,"12,85,558.75",
23-Jul-25,Transportellaneous,61.83,00.00,"12,85,620.58",
23-Jul-25,Bill,"3,169.60",00.00,"12,88,790.18",
23-Jul-25,RTGS,08.00,00.00,"12,88,798.18",
23-Jul-25,IMPS,00.00,"1,61,099.77","11,27,698.41",
23-Jul-25,Transportellaneous,00.00,"2,81,924.60","8,45,773.81",
23-Jul-25,Transfer,"2,55,745.88",00.00,"11,01,519.69",
23-Jul-25,NEFT,00.00,"11,01,519.69",00.00,
23-Jul-25,Interest,08.00,00.00,08.00,
23-Jul-25,Transportellaneous,"77,823.00",00.00,"77,831.00",
23-Jul-25,Debit Card,00.00,"25,943.67","51,887.33",
24-Jul-25,RTGS,00.00,"6,485.92","45,401.41",
24-Jul-25,RTGS,"1,944.00",00.00,"47,345.41",
24-Jul-25,RTGS,00.00,"7,890.90","39,454.51",
24-Jul-25,NEFT,00.00,"13,151.50","26,303.01",
24-Jul-25,Transfer,"16,710.64",00.00,"43,013.65",
24-Jul-25,Cheque,"12,793.00",00.00,"55,806.65",
24-Jul-25,Purchase,00.00,"18,602.22","37,204.43",
24-Jul-25,Bill,"2,60,370.00",00.00,"2,97,574.43",
24-Jul-25,Cheque,429,00.00,"2,98,003.43",
24-Jul-25,Transfer,00.00,"2,98,003.43",00.00,
24-Jul-25,Commission,"2,32,888.20",00.00,"2,32,888.20",
24-Jul-25,NEFT,00.00,"58,222.05","1,74,666.15",
24-Jul-25,Cash,12.5,00.00,"1,74,678.65",
24-Jul-25,NEFT,00.00,"43,669.66","1,31,008.99",
24-Jul-25,NEFT,"74,057.00",00.00,"2,05,065.99",
24-Jul-25,RTGS,00.00,"25,633.25","1,79,432.74",
24-Jul-25,Tax,02.81,00.00,"1,79,435.55",
24-Jul-25,Tax,00.00,"25,633.65","1,53,801.90",
24-Jul-25,Transportellaneous,00.00,"30,760.38","1,23,041.52",
24-Jul-25,ATM,00.00,"17,577.36","1,05,464.16",
24-Jul-25,NEFT,00.00,"11,718.24","93,745.92",
24-Jul-25,Interest,00.00,"11,718.24","82,027.68",
24-Jul-25,Reversal,07.70,00.00,"82,035.38",
24-Jul-25,Purchase,06.60,00.00,"82,041.98",
24-Jul-25,Interest,"15,99,303.80",00.00,"16,81,345.78",
24-Jul-25,Bill,00.00,"1,86,816.20","14,94,529.58",
24-Jul-25,ATM,00.00,"2,98,905.92","11,95,623.66",
24-Jul-25,IMPS,00.00,"11,95,623.66",00.00,
24-Jul-25,Reversal,44.4,00.00,44.4,
24-Jul-25,Debit Card,00.00,06.34,38.06,
24-Jul-25,NEFT,"51,154.03",00.00,"51,192.09",
24-Jul-25,Tax,"17,925.80",00.00,"69,117.89",
24-Jul-25,Transportellaneous,00.00,"8,639.74","60,478.15",
24-Jul-25,Transfer,00.00,"20,159.38","40,318.77",
24-Jul-25,ATM,"14,816.80",00.00,"55,135.57",
24-Jul-25,NEFT,"1,37,556.00",00.00,"1,92,691.57",
24-Jul-25,Purchase,00.00,"19,269.16","1,73,422.41",
24-Jul-25,Cash,00.00,"34,684.48","1,38,737.93",
24-Jul-25,Bill,00.00,"69,368.97","69,368.96",
24-Jul-25,ATM,00.00,"9,909.85","59,459.11",
24-Jul-25,Cash,00.00,"14,864.78","44,594.33",
24-Jul-25,RTGS,00.00,"44,594.33",00.00,
24-Jul-25,Commission,01.00,00.00,01.00,
24-Jul-25,Transportellaneous,"1,06,042.00",00.00,"1,06,043.00",
24-Jul-25,Reversal,55,00.00,"1,06,098.00",
24-Jul-25,Interest,"1,83,053.00",00.00,"2,89,151.00",
24-Jul-25,Cash,"2,69,532.00",00.00,"5,58,683.00",
24-Jul-25,Purchase,00.00,"55,868.30","5,02,814.70",
24-Jul-25,Cash,"20,743.00",00.00,"5,23,557.70",
24-Jul-25,Commission,"5,69,792.00",00.00,"10,93,349.70",
24-Jul-25,Transportellaneous,00.00,"1,56,192.81","9,37,156.89",
24-Jul-25,Cash,00.00,"3,12,385.63","6,24,771.26",
24-Jul-25,Reversal,"4,095.20",00.00,"6,28,866.46",
24-Jul-25,Purchase,00.00,"2,09,622.15","4,19,244.31",
24-Jul-25,NEFT,00.00,"46,582.70","3,72,661.61",
25-Jul-25,RTGS,00.00,"46,582.70","3,26,078.91",
25-Jul-25,IMPS,00.00,"1,63,039.46","1,63,039.45",
25-Jul-25,Transfer,00.00,"32,607.89","1,30,431.56",
25-Jul-25,Cheque,"2,756.60",00.00,"1,33,188.16",
25-Jul-25,Cheque,00.00,"16,648.52","1,16,539.64",
25-Jul-25,RTGS,"64,914.75",00.00,"1,81,454.39",
25-Jul-25,RTGS,"83,826.00",00.00,"2,65,280.39",
25-Jul-25,NEFT,00.00,"1,32,640.20","1,32,640.20",
25-Jul-25,Transportellaneous,"10,145.16",00.00,"1,42,785.36",
25-Jul-25,Cheque,"11,03,205.75",00.00,"12,45,991.11",
25-Jul-25,IMPS,"1,10,445.00",00.00,"13,56,436.11",
25-Jul-25,Interest,"15,481.41",00.00,"13,71,917.52",
25-Jul-25,RTGS,"2,24,885.00",00.00,"15,96,802.52",
25-Jul-25,NEFT,"39,355.00",00.00,"16,36,157.52",
25-Jul-25,Cash,74.18,00.00,"16,36,231.70",
25-Jul-25,Purchase,00.00,"5,45,410.57","10,90,821.13",
25-Jul-25,ATM,00.00,"2,18,164.23","8,72,656.90",
25-Jul-25,Purchase,06.10,00.00,"8,72,663.00",
25-Jul-25,RTGS,"11,200.20",00.00,"8,83,863.20",
25-Jul-25,Interest,00.00,"2,20,965.80","6,62,897.40",
25-Jul-25,Cash,"10,60,779.00",00.00,"17,23,676.40",
25-Jul-25,Commission,"14,868.00",00.00,"17,38,544.40",
25-Jul-25,Bill,00.00,"4,34,636.10","13,03,908.30",
25-Jul-25,Purchase,00.00,"2,60,781.66","10,43,126.64",
25-Jul-25,Tax,00.00,"1,04,312.66","9,38,813.98",
25-Jul-25,Cheque,"1,483.78",00.00,"9,40,297.76",
25-Jul-25,Cheque,"1,53,570.90",00.00,"10,93,868.66",
25-Jul-25,Debit Card,00.00,"1,21,540.96","9,72,327.70",
25-Jul-25,Debit Card,00.00,"1,62,054.62","8,10,273.08",
25-Jul-25,Transportellaneous,05.00,00.00,"8,10,278.08",
25-Jul-25,Cash,"17,85,106.00",00.00,"25,95,384.08",
25-Jul-25,Transfer,"12,673.40",00.00,"26,08,057.48",
25-Jul-25,ATM,01.20,00.00,"26,08,058.68",
25-Jul-25,Debit Card,00.00,"2,89,784.30","23,18,274.38",
25-Jul-25,ATM,00.00,"3,86,379.06","19,31,895.32",
25-Jul-25,IMPS,00.00,"1,93,189.53","17,38,705.79",
25-Jul-25,Transportellaneous,"30,550.00",00.00,"17,69,255.79",
25-Jul-25,Reversal,00.00,"2,21,156.97","15,48,098.82",
25-Jul-25,Purchase,00.00,"2,21,156.97","13,26,941.85",
25-Jul-25,Interest,507.2,00.00,"13,27,449.05",
25-Jul-25,Tax,00.00,"3,31,862.26","9,95,586.79",
25-Jul-25,Purchase,402,00.00,"9,95,988.79",
25-Jul-25,ATM,00.00,"1,42,284.11","8,53,704.68",
25-Jul-25,Commission,47.46,00.00,"8,53,752.14",
25-Jul-25,Cash,00.00,"1,06,719.02","7,47,033.12",
25-Jul-25,Transfer,07.95,00.00,"7,47,041.07",
25-Jul-25,Commission,16.13,00.00,"7,47,057.20",
25-Jul-25,Debit Card,"7,99,142.25",00.00,"15,46,199.45",
25-Jul-25,IMPS,00.00,"5,15,399.82","10,30,799.63",
25-Jul-25,ATM,"29,192.00",00.00,"10,59,991.63",
25-Jul-25,Tax,"2,09,707.19",00.00,"12,69,698.82",
25-Jul-25,Cash,00.00,"12,69,698.82",00.00,
25-Jul-25,Cash,"13,142.00",00.00,"13,142.00",
26-Jul-25,Reversal,50.7,00.00,"13,192.70",
26-Jul-25,Purchase,544.5,00.00,"13,737.20",
26-Jul-25,Purchase,483.6,00.00,"14,220.80",
26-Jul-25,Interest,00.00,"2,031.54","12,189.26",
26-Jul-25,Purchase,00.00,"3,047.32","9,141.94",
26-Jul-25,NEFT,"7,01,552.00",00.00,"7,10,693.94",
26-Jul-25,NEFT,00.00,"78,965.99","6,31,727.95",
26-Jul-25,Cheque,00.00,"2,10,575.98","4,21,151.97",
26-Jul-25,Cash,00.00,"42,115.20","3,79,036.77",
26-Jul-25,Transfer,00.00,"1,89,518.39","1,89,518.38",
27-Jul-25,Tax,00.00,"47,379.60","1,42,138.78",
27-Jul-25,Purchase,00.00,"14,213.88","1,27,924.90",
27-Jul-25,Reversal,00.00,"21,320.82","1,06,604.08",
27-Jul-25,Cheque,"1,81,696.69",00.00,"2,88,300.77",
28-Jul-25,Bill,"3,222.00",00.00,"2,91,522.77",
28-Jul-25,Interest,130.96,00.00,"2,91,653.73",
28-Jul-25,Commission,"14,43,267.00",00.00,"17,34,920.73",
28-Jul-25,Transfer,00.00,"2,89,153.46","14,45,767.28",
28-Jul-25,RTGS,"1,589.20",00.00,"14,47,356.48",
28-Jul-25,Tax,00.00,"3,61,839.12","10,85,517.36",
28-Jul-25,Debit Card,"78,066.70",00.00,"11,63,584.06",
28-Jul-25,Cash,310.4,00.00,"11,63,894.46",
28-Jul-25,Debit Card,00.00,"2,90,973.62","8,72,920.84",
28-Jul-25,Transfer,"7,16,325.00",00.00,"15,89,245.84",
28-Jul-25,Cash,94.63,00.00,"15,89,340.47",
28-Jul-25,IMPS,262.47,00.00,"15,89,602.94",
28-Jul-25,Cheque,02.00,00.00,"15,89,604.94",
28-Jul-25,RTGS,"2,766.00",00.00,"15,92,370.94",
28-Jul-25,ATM,29.45,00.00,"15,92,400.39",
28-Jul-25,Commission,03.47,00.00,"15,92,403.86",
28-Jul-25,Purchase,00.00,"7,96,201.93","7,96,201.93",
28-Jul-25,Interest,"17,62,139.00",00.00,"25,58,340.93",
28-Jul-25,Commission,256,00.00,"25,58,596.93",
28-Jul-25,NEFT,"24,134.00",00.00,"25,82,730.93",
28-Jul-25,Cheque,212.3,00.00,"25,82,943.23",
29-Jul-25,Cash,"1,98,156.75",00.00,"27,81,099.98",
29-Jul-25,Cash,"1,063.00",00.00,"27,82,162.98",
29-Jul-25,Cheque,"5,61,607.50",00.00,"33,43,770.48",
29-Jul-25,Transfer,03.70,00.00,"33,43,774.18",
29-Jul-25,Transfer,"77,282.12",00.00,"34,21,056.30",
29-Jul-25,Transportellaneous,597.04,00.00,"34,21,653.34",
29-Jul-25,Debit Card,00.00,"34,21,653.34",00.00,
29-Jul-25,Cheque,"12,934.20",00.00,"12,934.20",
29-Jul-25,Debit Card,00.00,"1,616.78","11,317.42",
29-Jul-25,NEFT,00.00,"5,658.71","5,658.71",
29-Jul-25,NEFT,06.00,00.00,"5,664.71",
29-Jul-25,Commission,00.00,"1,416.18","4,248.53",
29-Jul-25,ATM,00.00,849.71,"3,398.82",
29-Jul-25,Transportellaneous,00.00,566.47,"2,832.35",
29-Jul-25,Tax,04.70,00.00,"2,837.05",
30-Jul-25,Cheque,01.00,00.00,"2,838.05",
30-Jul-25,Tax,00.00,"1,419.03","1,419.02",
30-Jul-25,Purchase,"17,11,277.75",00.00,"17,12,696.77",
31-Jul-25,Bill,00.00,"8,56,348.39","8,56,348.38",
31-Jul-25,Purchase,28.18,00.00,"8,56,376.56",
31-Jul-25,Transportellaneous,32,00.00,"8,56,408.56",
31-Jul-25,ATM,00.00,"1,71,281.71","6,85,126.85",
31-Jul-25,Interest,00.00,"97,875.26","5,87,251.59",
01-Aug-25,ATM,"2,957.40",00.00,"5,90,208.99",
01-Aug-25,NEFT,00.00,"98,368.17","4,91,840.82",
01-Aug-25,ATM,14.19,00.00,"4,91,855.01",
01-Aug-25,Interest,00.00,"81,975.84","4,09,879.18",
01-Aug-25,Transportellaneous,"1,11,671.16",00.00,"5,21,550.34",
01-Aug-25,Transfer,00.00,"86,925.06","4,34,625.28",
01-Aug-25,Cash,00.00,"62,089.33","3,72,535.95",
01-Aug-25,Bill,59.6,00.00,"3,72,595.55",
01-Aug-25,Transportellaneous,00.00,"62,099.26","3,10,496.29",
01-Aug-25,Cash,00.00,"31,049.63","2,79,446.66",
01-Aug-25,Bill,"1,47,143.22",00.00,"4,26,589.88",
01-Aug-25,IMPS,"4,444.50",00.00,"4,31,034.38",
01-Aug-25,ATM,00.00,"1,07,758.60","3,23,275.79",
01-Aug-25,Bill,"1,151.50",00.00,"3,24,427.29",
01-Aug-25,IMPS,00.00,"40,553.41","2,83,873.88",
01-Aug-25,Purchase,00.00,"94,624.63","1,89,249.25",
01-Aug-25,Transfer,00.00,"47,312.31","1,41,936.94",
01-Aug-25,Commission,"15,073.00",00.00,"1,57,009.94",
01-Aug-25,Debit Card,00.00,"52,336.65","1,04,673.29",
01-Aug-25,Purchase,"12,562.80",00.00,"1,17,236.09",
01-Aug-25,Bill,00.00,"23,447.22","93,788.87",
01-Aug-25,Transfer,00.00,"18,757.77","75,031.10",
01-Aug-25,Debit Card,"32,439.80",00.00,"1,07,470.90",
01-Aug-25,IMPS,00.00,"15,352.99","92,117.91",
01-Aug-25,IMPS,07.45,00.00,"92,125.36",
01-Aug-25,RTGS,03.89,00.00,"92,129.25",
01-Aug-25,Bill,00.00,"92,129.25",00.00,
01-Aug-25,Tax,01.90,00.00,01.90,
01-Aug-25,Tax,"5,33,035.20",00.00,"5,33,037.10",
01-Aug-25,Transportellaneous,00.00,"5,33,037.10",00.00,
01-Aug-25,NEFT,"2,515.00",00.00,"2,515.00",
01-Aug-25,Commission,252.8,00.00,"2,767.80",
01-Aug-25,Debit Card,216.71,00.00,"2,984.51",
01-Aug-25,Purchase,"15,04,672.00",00.00,"15,07,656.51",
01-Aug-25,Cheque,"2,42,665.47",00.00,"17,50,321.98",
01-Aug-25,Debit Card,"14,188.20",00.00,"17,64,510.18",
01-Aug-25,NEFT,04.21,00.00,"17,64,514.39",
01-Aug-25,Cheque,"7,34,987.00",00.00,"24,99,501.39",
01-Aug-25,Cash,"6,980.00",00.00,"25,06,481.39",
01-Aug-25,ATM,"9,77,436.00",00.00,"34,83,917.39",
01-Aug-25,Reversal,14.64,00.00,"34,83,932.03",
01-Aug-25,Bill,01.00,00.00,"34,83,933.03",
01-Aug-25,Interest,00.00,"3,48,393.30","31,35,539.73",
01-Aug-25,Commission,"1,80,367.00",00.00,"33,15,906.73",
02-Aug-25,Purchase,00.00,"11,05,302.24","22,10,604.49",
02-Aug-25,Tax,00.00,"2,21,060.45","19,89,544.04",
02-Aug-25,NEFT,00.00,"2,84,220.58","17,05,323.46",
02-Aug-25,Transportellaneous,00.00,"4,26,330.87","12,78,992.60",
02-Aug-25,ATM,00.00,"1,27,899.26","11,51,093.34",
02-Aug-25,IMPS,"1,86,786.00",00.00,"13,37,879.34",
02-Aug-25,Debit Card,"1,94,107.00",00.00,"15,31,986.34",
02-Aug-25,Interest,00.00,"3,06,397.27","12,25,589.07",
02-Aug-25,Interest,00.00,"1,53,198.63","10,72,390.44",
02-Aug-25,Cheque,00.00,"1,34,048.81","9,38,341.64",
02-Aug-25,Debit Card,"2,31,361.00",00.00,"11,69,702.64",
02-Aug-25,Tax,02.80,00.00,"11,69,705.44",
02-Aug-25,Debit Card,00.00,"1,94,950.91","9,74,754.53",
02-Aug-25,Tax,257.25,00.00,"9,75,011.78",
02-Aug-25,Cheque,06.90,00.00,"9,75,018.68",
03-Aug-25,ATM,"2,50,436.40",00.00,"12,25,455.08",
03-Aug-25,Cash,04.00,00.00,"12,25,459.08",
03-Aug-25,Interest,00.00,"1,75,065.58","10,50,393.50",
03-Aug-25,IMPS,"7,37,360.75",00.00,"17,87,754.25",
03-Aug-25,NEFT,00.00,"2,23,469.28","15,64,284.97",
03-Aug-25,Interest,00.00,"7,82,142.49","7,82,142.48",
03-Aug-25,Transportellaneous,50.49,00.00,"7,82,192.97",
03-Aug-25,RTGS,21,00.00,"7,82,213.97",
03-Aug-25,Interest,00.00,"2,60,737.99","5,21,475.98",
03-Aug-25,Cash,00.00,"1,73,825.33","3,47,650.65",
03-Aug-25,Interest,59,00.00,"3,47,709.65",
03-Aug-25,RTGS,00.00,"57,951.61","2,89,758.04",
03-Aug-25,Transportellaneous,"3,017.80",00.00,"2,92,775.84",
03-Aug-25,Bill,"2,385.69",00.00,"2,95,161.53",
03-Aug-25,Bill,00.00,"32,795.73","2,62,365.80",
03-Aug-25,Bill,02.40,00.00,"2,62,368.20",
03-Aug-25,Debit Card,05.40,00.00,"2,62,373.60",
03-Aug-25,Commission,00.00,"2,62,373.60",00.00,
03-Aug-25,Transfer,13,00.00,13,
03-Aug-25,Purchase,00.00,02.60,10.4,
03-Aug-25,Debit Card,00.00,02.60,07.80,
03-Aug-25,Cash,00.00,00.78,07.02,
03-Aug-25,IMPS,00.00,02.34,04.68,
03-Aug-25,Cheque,00.00,01.56,03.12,
04-Aug-25,RTGS,04.50,00.00,07.62,
04-Aug-25,Transportellaneous,04.02,00.00,11.64,
04-Aug-25,Transportellaneous,"62,682.00",00.00,"62,693.64",
04-Aug-25,Bill,00.00,"6,269.36","56,424.28",
04-Aug-25,RTGS,00.00,"9,404.05","47,020.23",
04-Aug-25,Cheque,00.00,"5,224.47","41,795.76",
04-Aug-25,ATM,00.00,"5,970.82","35,824.94",
04-Aug-25,Bill,"2,35,902.70",00.00,"2,71,727.64",
04-Aug-25,Cheque,354,00.00,"2,72,081.64",
04-Aug-25,IMPS,00.00,"27,208.16","2,44,873.48",
04-Aug-25,ATM,00.00,"2,44,873.48",00.00,
04-Aug-25,Cheque,28.02,00.00,28.02,
04-Aug-25,Reversal,00.00,28.02,00.00,
04-Aug-25,Interest,"2,610.00",00.00,"2,610.00",
04-Aug-25,IMPS,287,00.00,"2,897.00",
04-Aug-25,Debit Card,"5,269.93",00.00,"8,166.93",
04-Aug-25,IMPS,02.70,00.00,"8,169.63",
04-Aug-25,Transportellaneous,00.00,"2,042.41","6,127.22",
04-Aug-25,Bill,"76,475.00",00.00,"82,602.22",
04-Aug-25,Purchase,00.00,"13,767.04","68,835.18",
04-Aug-25,RTGS,00.00,"11,472.53","57,362.65",
04-Aug-25,Transportellaneous,00.00,"6,373.63","50,989.02",
04-Aug-25,NEFT,"19,60,902.00",00.00,"20,11,891.02",
04-Aug-25,Transfer,"1,009.00",00.00,"20,12,900.02",
04-Aug-25,ATM,00.00,"2,23,655.56","17,89,244.46",
04-Aug-25,Tax,00.00,"5,96,414.82","11,92,829.64",
04-Aug-25,NEFT,"20,601.77",00.00,"12,13,431.41",
05-Aug-25,Transportellaneous,"3,977.20",00.00,"12,17,408.61",
05-Aug-25,Commission,00.00,"1,35,267.62","10,82,140.99",
05-Aug-25,IMPS,01.00,00.00,"10,82,141.99",
05-Aug-25,Interest,482.9,00.00,"10,82,624.89",
05-Aug-25,Tax,"2,480.00",00.00,"10,85,104.89",
05-Aug-25,Bill,"2,393.40",00.00,"10,87,498.29",
05-Aug-25,Transfer,"27,529.70",00.00,"11,15,027.99",
05-Aug-25,Purchase,00.00,"1,59,289.71","9,55,738.28",
05-Aug-25,IMPS,00.00,"95,573.83","8,60,164.45",
05-Aug-25,Cash,495,00.00,"8,60,659.45",
05-Aug-25,Transportellaneous,00.00,"2,15,164.86","6,45,494.59",
05-Aug-25,Tax,00.00,"6,45,494.59",00.00,
05-Aug-25,Transfer,"19,66,349.80",00.00,"19,66,349.80",
05-Aug-25,Transportellaneous,00.00,"1,96,634.98","17,69,714.82",
05-Aug-25,Cash,02.05,00.00,"17,69,716.87",
05-Aug-25,Transfer,00.00,"8,84,858.44","8,84,858.44",
05-Aug-25,NEFT,00.00,"1,26,408.35","7,58,450.09",
05-Aug-25,IMPS,187,00.00,"7,58,637.09",
05-Aug-25,Reversal,00.00,"1,08,376.73","6,50,260.36",
05-Aug-25,IMPS,06.00,00.00,"6,50,266.36",
06-Aug-25,Reversal,00.00,"3,25,133.18","3,25,133.18",
06-Aug-25,Tax,00.00,"3,25,133.18",00.00,
06-Aug-25,Interest,"10,75,225.25",00.00,"10,75,225.25",
06-Aug-25,Purchase,"9,34,035.00",00.00,"20,09,260.25",
06-Aug-25,ATM,"23,253.10",00.00,"20,32,513.35",
06-Aug-25,Bill,04.93,00.00,"20,32,518.28",
06-Aug-25,Bill,"1,576.80",00.00,"20,34,095.08",
06-Aug-25,NEFT,02.00,00.00,"20,34,097.08",
06-Aug-25,Bill,"2,325.30",00.00,"20,36,422.38",
06-Aug-25,Tax,00.00,"2,03,642.24","18,32,780.14",
06-Aug-25,Transfer,00.00,"2,03,642.24","16,29,137.90",
06-Aug-25,ATM,"1,337.10",00.00,"16,30,475.00",
06-Aug-25,Debit Card,"32,322.20",00.00,"16,62,797.20",
06-Aug-25,Interest,36.92,00.00,"16,62,834.12",
06-Aug-25,Commission,00.00,"5,54,278.04","11,08,556.08",
06-Aug-25,Debit Card,00.00,"2,21,711.22","8,86,844.86",
06-Aug-25,Interest,"16,844.00",00.00,"9,03,688.86",
06-Aug-25,Reversal,"4,79,766.00",00.00,"13,83,454.86",
06-Aug-25,Tax,41,00.00,"13,83,495.86",
06-Aug-25,RTGS,06.00,00.00,"13,83,501.86",
06-Aug-25,Debit Card,270,00.00,"13,83,771.86",
06-Aug-25,Cash,00.00,"3,45,942.97","10,37,828.90",
06-Aug-25,Purchase,00.00,"10,37,828.90",00.00,
07-Aug-25,Transportellaneous,"2,27,297.20",00.00,"2,27,297.20",
07-Aug-25,Transfer,"23,928.59",00.00,"2,51,225.79",
07-Aug-25,Bill,00.00,"41,870.97","2,09,354.82",
07-Aug-25,ATM,142,00.00,"2,09,496.82",
07-Aug-25,Reversal,00.00,"34,916.14","1,74,580.68",
07-Aug-25,Tax,335.91,00.00,"1,74,916.59",
07-Aug-25,Cash,00.00,"58,305.53","1,16,611.06",
07-Aug-25,Reversal,00.00,"11,661.11","1,04,949.95",
08-Aug-25,Reversal,00.00,"34,983.32","69,966.63",
08-Aug-25,Cash,00.00,"34,983.32","34,983.32",
09-Aug-25,RTGS,00.00,"34,983.32",00.00,
09-Aug-25,RTGS,"18,678.80",00.00,"18,678.80",
09-Aug-25,ATM,"2,35,469.38",00.00,"2,54,148.18",
09-Aug-25,NEFT,00.00,"25,414.82","2,28,733.36",
09-Aug-25,Cheque,00.00,"2,28,733.36",00.00,
09-Aug-25,NEFT,22.6,00.00,22.6,
09-Aug-25,Cash,"91,951.00",00.00,"91,973.60",
09-Aug-25,ATM,00.00,"91,973.60",00.00,
09-Aug-25,NEFT,"24,359.40",00.00,"24,359.40",
09-Aug-25,Purchase,"1,37,898.91",00.00,"1,62,258.31",
09-Aug-25,Tax,00.00,"81,129.16","81,129.16",
09-Aug-25,Transportellaneous,00.00,"27,043.05","54,086.11",
09-Aug-25,Tax,00.00,"13,521.53","40,564.58",
09-Aug-25,Purchase,00.00,"4,056.46","36,508.12",
09-Aug-25,IMPS,00.00,"7,301.62","29,206.50",
09-Aug-25,Transfer,47.36,00.00,"29,253.86",
09-Aug-25,Transportellaneous,00.00,"9,751.29","19,502.57",
09-Aug-25,Tax,03.00,00.00,"19,505.57",
09-Aug-25,Bill,16.03,00.00,"19,521.60",
09-Aug-25,Tax,00.00,"3,253.60","16,268.00",
09-Aug-25,Transfer,03.61,00.00,"16,271.61",
09-Aug-25,Purchase,00.00,"3,254.32","13,017.29",
09-Aug-25,Tax,00.00,"1,301.73","11,715.56",
09-Aug-25,Cash,00.00,"11,715.56",00.00,
09-Aug-25,Reversal,"5,34,403.50",00.00,"5,34,403.50",
09-Aug-25,Purchase,00.00,"66,800.44","4,67,603.06",
09-Aug-25,Purchase,"4,580.20",00.00,"4,72,183.26",
09-Aug-25,Transfer,"75,542.10",00.00,"5,47,725.36",
09-Aug-25,Transportellaneous,"13,19,934.50",00.00,"18,67,659.86",
09-Aug-25,RTGS,00.00,"6,22,553.29","12,45,106.57",
09-Aug-25,Purchase,00.00,"2,07,517.76","10,37,588.81",
09-Aug-25,Purchase,00.00,"1,15,287.65","9,22,301.16",
09-Aug-25,Purchase,00.00,"1,15,287.65","8,07,013.52",
09-Aug-25,Transportellaneous,00.00,"2,69,004.51","5,38,009.01",
09-Aug-25,Cash,594.1,00.00,"5,38,603.11",
09-Aug-25,RTGS,00.00,"53,860.31","4,84,742.80",
09-Aug-25,Bill,258,00.00,"4,85,000.80",
09-Aug-25,Commission,"11,09,708.20",00.00,"15,94,709.00",
09-Aug-25,Cash,00.00,"7,97,354.50","7,97,354.50",
09-Aug-25,Bill,00.00,"1,99,338.63","5,98,015.88",
10-Aug-25,Commission,00.00,"59,801.59","5,38,214.29",
10-Aug-25,Reversal,"31,731.70",00.00,"5,69,945.99",
10-Aug-25,IMPS,00.00,"63,327.33","5,06,618.66",
10-Aug-25,Transfer,224.3,00.00,"5,06,842.96",
10-Aug-25,Cash,00.00,"50,684.30","4,56,158.66",
10-Aug-25,NEFT,24.85,00.00,"4,56,183.51",
10-Aug-25,Debit Card,00.00,"50,687.06","4,05,496.45",
10-Aug-25,Debit Card,"1,093.25",00.00,"4,06,589.70",
11-Aug-25,Tax,00.00,"1,01,647.43","3,04,942.28",
11-Aug-25,Commission,85.57,00.00,"3,05,027.85",
11-Aug-25,Bill,"19,41,039.00",00.00,"22,46,066.85",
11-Aug-25,Interest,390.4,00.00,"22,46,457.25",
11-Aug-25,Cheque,00.00,"22,46,457.25",00.00,
11-Aug-25,Interest,283.94,00.00,283.94,
11-Aug-25,Bill,00.00,141.97,141.97,
12-Aug-25,Reversal,00.00,23.66,118.31,
12-Aug-25,Cash,00.00,14.79,103.52,
12-Aug-25,ATM,22.37,00.00,125.89,
12-Aug-25,Reversal,00.00,20.98,104.91,
12-Aug-25,Cheque,02.20,00.00,107.11,
12-Aug-25,Purchase,59.6,00.00,166.71,
12-Aug-25,RTGS,00.00,41.68,125.03,
12-Aug-25,Debit Card,"2,657.00",00.00,"2,782.03",
12-Aug-25,Reversal,"2,46,331.50",00.00,"2,49,113.53",
12-Aug-25,Bill,62.9,00.00,"2,49,176.43",
13-Aug-25,Reversal,00.00,"83,058.81","1,66,117.62",
13-Aug-25,Transportellaneous,"30,664.40",00.00,"1,96,782.02",
13-Aug-25,Bill,00.00,"32,797.00","1,63,985.02",
13-Aug-25,Transportellaneous,53.41,00.00,"1,64,038.43",
13-Aug-25,Reversal,42.4,00.00,"1,64,080.83",
13-Aug-25,Cheque,162.45,00.00,"1,64,243.28",
13-Aug-25,Cash,19.9,00.00,"1,64,263.18",
13-Aug-25,Transfer,00.00,"41,065.80","1,23,197.38",
13-Aug-25,Transportellaneous,"2,52,305.00",00.00,"3,75,502.38",
13-Aug-25,Transportellaneous,00.00,"53,643.20","3,21,859.18",
13-Aug-25,ATM,"1,533.42",00.00,"3,23,392.60",
13-Aug-25,Tax,00.00,"3,23,392.60",00.00,
13-Aug-25,Interest,126.39,00.00,126.39,
13-Aug-25,NEFT,"1,257.05",00.00,"1,383.44",
13-Aug-25,Transportellaneous,00.00,691.72,691.72,
14-Aug-25,Tax,"1,03,428.00",00.00,"1,04,119.72",
14-Aug-25,Interest,00.00,"14,874.25","89,245.47",
14-Aug-25,NEFT,00.00,"14,874.25","74,371.23",
14-Aug-25,Cheque,"3,571.30",00.00,"77,942.53",
14-Aug-25,Cash,51.15,00.00,"77,993.68",
14-Aug-25,Reversal,"3,887.00",00.00,"81,880.68",
14-Aug-25,Bill,00.00,"81,880.68",00.00,
14-Aug-25,NEFT,"4,501.70",00.00,"4,501.70",
14-Aug-25,Transportellaneous,390.1,00.00,"4,891.80",
14-Aug-25,Reversal,00.00,489.18,"4,402.62",
14-Aug-25,RTGS,35,00.00,"4,437.62",
15-Aug-25,Bill,00.00,"1,109.41","3,328.22",
15-Aug-25,Cheque,"1,32,886.00",00.00,"1,36,214.22",
15-Aug-25,Bill,00.00,"13,621.42","1,22,592.80",
15-Aug-25,Cash,"44,913.00",00.00,"1,67,505.80",
15-Aug-25,IMPS,00.00,"55,835.27","1,11,670.53",
15-Aug-25,IMPS,"9,67,369.50",00.00,"10,79,040.03",
15-Aug-25,Cheque,00.00,"2,15,808.01","8,63,232.02",
15-Aug-25,RTGS,00.00,00.00,"8,63,232.02",
15-Aug-25,IMPS,"7,91,974.80",00.00,"16,55,206.82",
15-Aug-25,Reversal,00.00,"2,06,900.85","14,48,305.97",
15-Aug-25,IMPS,04.00,00.00,"14,48,309.97",
15-Aug-25,Cheque,"1,65,695.75",00.00,"16,14,005.72",
15-Aug-25,RTGS,"13,67,801.80",00.00,"29,81,807.52",
15-Aug-25,Bill,00.00,"3,72,725.94","26,09,081.58",
15-Aug-25,Cash,00.00,"8,69,693.86","17,39,387.72",
15-Aug-25,NEFT,00.00,"2,89,897.95","14,49,489.77",
15-Aug-25,NEFT,00.00,"1,81,186.22","12,68,303.55",
15-Aug-25,Debit Card,03.20,00.00,"12,68,306.75",
15-Aug-25,Interest,196,00.00,"12,68,502.75",
15-Aug-25,Cash,"19,195.80",00.00,"12,87,698.55",
15-Aug-25,ATM,00.00,"1,43,077.62","11,44,620.93",
15-Aug-25,Reversal,00.00,"11,44,620.93",00.00,
15-Aug-25,IMPS,"13,73,253.00",00.00,"13,73,253.00",
15-Aug-25,IMPS,00.00,"1,71,656.63","12,01,596.38",
15-Aug-25,RTGS,41.1,00.00,"12,01,637.48",
15-Aug-25,Bill,"2,239.80",00.00,"12,03,877.28",
15-Aug-25,Interest,00.00,"2,40,775.46","9,63,101.82",
15-Aug-25,IMPS,"1,18,093.25",00.00,"10,81,195.07",
15-Aug-25,ATM,"1,841.30",00.00,"10,83,036.37",
15-Aug-25,IMPS,00.84,00.00,"10,83,037.21",
15-Aug-25,NEFT,00.00,"5,41,518.61","5,41,518.60",
15-Aug-25,ATM,00.00,"60,168.73","4,81,349.87",
15-Aug-25,IMPS,141.4,00.00,"4,81,491.27",
15-Aug-25,ATM,00.00,"80,248.55","4,01,242.72",
15-Aug-25,Bill,00.00,"50,155.34","3,51,087.38",
15-Aug-25,Debit Card,57.22,00.00,"3,51,144.60",
15-Aug-25,Bill,00.00,"70,228.92","2,80,915.68",
15-Aug-25,Bill,"30,680.50",00.00,"3,11,596.18",
15-Aug-25,ATM,"1,810.00",00.00,"3,13,406.18",
15-Aug-25,Commission,610.9,00.00,"3,14,017.08",
15-Aug-25,RTGS,"68,151.84",00.00,"3,82,168.92",
15-Aug-25,Cheque,"36,060.50",00.00,"4,18,229.42",
15-Aug-25,Commission,06.40,00.00,"4,18,235.82",
15-Aug-25,ATM,"2,18,778.75",00.00,"6,37,014.57",
15-Aug-25,Purchase,"2,58,066.00",00.00,"8,95,080.57",
15-Aug-25,Cash,00.00,"1,11,885.07","7,83,195.50",
15-Aug-25,Cheque,00.00,"1,11,885.07","6,71,310.43",
15-Aug-25,Debit Card,05.00,00.00,"6,71,315.43",
15-Aug-25,Reversal,00.00,"1,34,263.09","5,37,052.34",
16-Aug-25,Tax,51,00.00,"5,37,103.34",
16-Aug-25,Transportellaneous,"5,405.91",00.00,"5,42,509.25",
16-Aug-25,IMPS,"9,22,572.00",00.00,"14,65,081.25",
16-Aug-25,Bill,00.00,"1,62,786.81","13,02,294.44",
16-Aug-25,Reversal,00.00,"13,02,294.44",00.00,
16-Aug-25,ATM,"2,31,356.00",00.00,"2,31,356.00",
16-Aug-25,Bill,30,00.00,"2,31,386.00",
16-Aug-25,Bill,00.00,"25,709.56","2,05,676.44",
16-Aug-25,Purchase,00.00,"2,05,676.44",00.00,
16-Aug-25,Transfer,377.2,00.00,377.2,
16-Aug-25,Purchase,"2,68,610.00",00.00,"2,68,987.20",
16-Aug-25,Purchase,00.00,"89,662.40","1,79,324.80",
16-Aug-25,ATM,00.00,"29,887.47","1,49,437.33",
16-Aug-25,NEFT,"25,674.05",00.00,"1,75,111.38",
16-Aug-25,Commission,"7,68,109.00",00.00,"9,43,220.38",
16-Aug-25,Transfer,"16,83,729.00",00.00,"26,26,949.38",
16-Aug-25,Interest,00.00,"2,62,694.94","23,64,254.44",
16-Aug-25,NEFT,00.00,"3,37,750.63","20,26,503.81",
16-Aug-25,Transfer,00.00,"3,37,750.64","16,88,753.18",
16-Aug-25,Cash,214.45,00.00,"16,88,967.63",
16-Aug-25,Cheque,10,00.00,"16,88,977.63",
16-Aug-25,Cheque,"1,47,881.25",00.00,"18,36,858.88",
16-Aug-25,Bill,293.8,00.00,"18,37,152.68",
17-Aug-25,Commission,00.00,"1,83,715.27","16,53,437.41",
17-Aug-25,Cash,"1,514.60",00.00,"16,54,952.01",
17-Aug-25,Cheque,00.00,"4,13,738.00","12,41,214.01",
17-Aug-25,ATM,00.00,"1,77,316.29","10,63,897.72",
17-Aug-25,IMPS,"1,24,197.20",00.00,"11,88,094.92",
17-Aug-25,Debit Card,882,00.00,"11,88,976.92",
17-Aug-25,Bill,00.00,"1,48,622.12","10,40,354.80",
17-Aug-25,Debit Card,01.00,00.00,"10,40,355.80",
17-Aug-25,Commission,00.00,"10,40,355.80",00.00,
17-Aug-25,Transportellaneous,"20,59,146.50",00.00,"20,59,146.50",
17-Aug-25,ATM,00.00,"5,14,786.63","15,44,359.88",
17-Aug-25,Reversal,05.00,00.00,"15,44,364.88",
17-Aug-25,Transfer,07.00,00.00,"15,44,371.88",
17-Aug-25,RTGS,00.00,"7,72,185.94","7,72,185.94",
17-Aug-25,ATM,00.00,"7,72,185.94",00.00,
17-Aug-25,Interest,"82,610.00",00.00,"82,610.00",
17-Aug-25,ATM,"43,740.30",00.00,"1,26,350.30",
17-Aug-25,Transportellaneous,"19,70,272.00",00.00,"20,96,622.30",
17-Aug-25,Purchase,00.00,"2,99,517.47","17,97,104.83",
17-Aug-25,Transfer,00.00,"1,99,678.31","15,97,426.52",
17-Aug-25,Transfer,173.29,00.00,"15,97,599.81",
17-Aug-25,Cash,46,00.00,"15,97,645.81",
17-Aug-25,Purchase,00.00,"2,28,235.12","13,69,410.69",
17-Aug-25,Transportellaneous,"2,822.13",00.00,"13,72,232.82",
17-Aug-25,Cash,43,00.00,"13,72,275.82",
17-Aug-25,RTGS,00.00,"2,28,712.64","11,43,563.18",
17-Aug-25,NEFT,00.00,"2,85,890.80","8,57,672.38",
17-Aug-25,Reversal,08.00,00.00,"8,57,680.38",
17-Aug-25,RTGS,"26,104.90",00.00,"8,83,785.28",
17-Aug-25,Purchase,56.16,00.00,"8,83,841.44",
17-Aug-25,Cash,00.00,"8,83,841.44",00.00,
17-Aug-25,Interest,34,00.00,34,
17-Aug-25,Transfer,00.00,17,17,
17-Aug-25,Purchase,00.00,02.83,14.17,
17-Aug-25,Transportellaneous,"3,193.88",00.00,"3,208.05",
17-Aug-25,Reversal,07.00,00.00,"3,215.05",
17-Aug-25,Tax,"14,889.00",00.00,"18,104.05",
17-Aug-25,RTGS,55.3,00.00,"18,159.35",
17-Aug-25,Commission,"1,19,645.00",00.00,"1,37,804.35",
17-Aug-25,Debit Card,"1,06,406.10",00.00,"2,44,210.45",
18-Aug-25,Reversal,"93,287.00",00.00,"3,37,497.45",
18-Aug-25,Tax,00.00,"48,213.92","2,89,283.53",
19-Aug-25,Debit Card,00.00,"41,326.22","2,47,957.31",
19-Aug-25,Interest,"2,29,039.50",00.00,"4,76,996.81",
19-Aug-25,Transfer,"24,931.00",00.00,"5,01,927.81",
19-Aug-25,RTGS,00.00,"2,50,963.91","2,50,963.90",
19-Aug-25,Cheque,00.45,00.00,"2,50,964.35",
19-Aug-25,RTGS,00.00,"2,50,964.35",00.00,
19-Aug-25,Debit Card,26.9,00.00,26.9,
19-Aug-25,Purchase,"2,771.00",00.00,"2,797.90",
19-Aug-25,Transportellaneous,"3,508.03",00.00,"6,305.93",
19-Aug-25,RTGS,"71,134.25",00.00,"77,440.18",
19-Aug-25,IMPS,00.00,"15,488.04","61,952.14",
19-Aug-25,Tax,00.00,"12,390.43","49,561.71",
19-Aug-25,Reversal,02.99,00.00,"49,564.70",
19-Aug-25,RTGS,"12,96,413.00",00.00,"13,45,977.70",
19-Aug-25,NEFT,41.7,00.00,"13,46,019.40",
19-Aug-25,Transfer,00.00,"6,73,009.70","6,73,009.70",
19-Aug-25,Cash,31,00.00,"6,73,040.70",
19-Aug-25,IMPS,00.00,"84,130.09","5,88,910.61",
19-Aug-25,Tax,"1,502.70",00.00,"5,90,413.31",
19-Aug-25,Tax,00.00,"65,601.48","5,24,811.83",
19-Aug-25,Transportellaneous,00.00,"2,62,405.92","2,62,405.91",
19-Aug-25,Reversal,02.00,00.00,"2,62,407.91",
19-Aug-25,Commission,00.00,"37,486.84","2,24,921.07",
19-Aug-25,NEFT,00.00,"56,230.27","1,68,690.80",
19-Aug-25,Debit Card,"3,907.20",00.00,"1,72,598.00",
19-Aug-25,Commission,00.00,"57,532.67","1,15,065.33",
19-Aug-25,ATM,00.00,"12,785.04","1,02,280.29",
19-Aug-25,NEFT,"14,620.99",00.00,"1,16,901.28",
19-Aug-25,Cash,"9,63,199.25",00.00,"10,80,100.53",
19-Aug-25,Commission,42.85,00.00,"10,80,143.38",
19-Aug-25,Interest,00.00,"5,40,071.69","5,40,071.69",
19-Aug-25,Interest,00.00,"77,153.10","4,62,918.59",
19-Aug-25,Tax,00.00,"51,435.40","4,11,483.19",
19-Aug-25,Bill,07.63,00.00,"4,11,490.82",
20-Aug-25,RTGS,"6,831.00",00.00,"4,18,321.82",
20-Aug-25,Purchase,00.00,"52,290.23","3,66,031.59",
20-Aug-25,Purchase,32.1,00.00,"3,66,063.69",
20-Aug-25,Tax,"10,98,047.00",00.00,"14,64,110.69",
20-Aug-25,Cheque,21,00.00,"14,64,131.69",
20-Aug-25,Cheque,"6,404.26",00.00,"14,70,535.95",
20-Aug-25,Cheque,00.00,"7,35,267.98","7,35,267.98",
20-Aug-25,Interest,00.00,"2,45,089.33","4,90,178.65",
20-Aug-25,NEFT,00.00,"1,63,392.88","3,26,785.77",
20-Aug-25,Interest,00.00,"54,464.30","2,72,321.48",
20-Aug-25,Transportellaneous,00.00,"30,257.94","2,42,063.54",
20-Aug-25,Cheque,00.00,"24,206.35","2,17,857.19",
20-Aug-25,IMPS,"15,549.40",00.00,"2,33,406.59",
20-Aug-25,ATM,00.00,"77,802.20","1,55,604.39",
20-Aug-25,RTGS,"3,841.00",00.00,"1,59,445.39",
20-Aug-25,IMPS,"2,06,328.00",00.00,"3,65,773.39",
20-Aug-25,Bill,00.00,"40,641.49","3,25,131.90",
20-Aug-25,IMPS,"26,446.00",00.00,"3,51,577.90",
20-Aug-25,RTGS,00.00,"1,75,788.95","1,75,788.95",
20-Aug-25,Commission,"27,045.00",00.00,"2,02,833.95",
20-Aug-25,Cheque,01.20,00.00,"2,02,835.15",
20-Aug-25,IMPS,30.24,00.00,"2,02,865.39",
20-Aug-25,IMPS,00.00,"33,810.90","1,69,054.49",
20-Aug-25,Transportellaneous,00.00,"28,175.75","1,40,878.74",
20-Aug-25,Interest,"1,250.00",00.00,"1,42,128.74",
20-Aug-25,NEFT,"23,378.40",00.00,"1,65,507.14",
20-Aug-25,ATM,"1,34,723.00",00.00,"3,00,230.14",
20-Aug-25,Transfer,00.00,"42,890.02","2,57,340.12",
20-Aug-25,Debit Card,771.7,00.00,"2,58,111.82",
20-Aug-25,Commission,00.00,"36,873.12","2,21,238.70",
20-Aug-25,Cash,00.00,"27,654.84","1,93,583.86",
21-Aug-25,IMPS,00.00,"27,654.84","1,65,929.02",
21-Aug-25,Debit Card,00.00,"16,592.90","1,49,336.12",
21-Aug-25,RTGS,00.00,"18,667.02","1,30,669.10",
21-Aug-25,IMPS,"48,775.70",00.00,"1,79,444.80",
21-Aug-25,Transfer,00.00,"44,861.20","1,34,583.60",
21-Aug-25,Commission,338.9,00.00,"1,34,922.50",
21-Aug-25,IMPS,00.00,"1,34,922.50",00.00,
21-Aug-25,Bill,"6,46,464.25",00.00,"6,46,464.25",
22-Aug-25,Cash,03.72,00.00,"6,46,467.97",
22-Aug-25,Bill,04.70,00.00,"6,46,472.67",
22-Aug-25,NEFT,365.1,00.00,"6,46,837.77",
22-Aug-25,Bill,"2,744.44",00.00,"6,49,582.21",
22-Aug-25,RTGS,02.37,00.00,"6,49,584.58",
22-Aug-25,IMPS,07.00,00.00,"6,49,591.58",
22-Aug-25,Commission,00.00,"72,176.84","5,77,414.74",
22-Aug-25,Debit Card,"13,292.60",00.00,"5,90,707.34",
22-Aug-25,RTGS,00.00,"73,838.42","5,16,868.92",
22-Aug-25,Debit Card,00.00,"5,16,868.92",00.00,
22-Aug-25,NEFT,"16,955.00",00.00,"16,955.00",
22-Aug-25,Interest,00.00,"2,119.38","14,835.62",
22-Aug-25,NEFT,359.19,00.00,"15,194.81",
22-Aug-25,Cash,00.00,"3,038.96","12,155.85",
22-Aug-25,RTGS,44.05,00.00,"12,199.90",
22-Aug-25,Cash,00.00,"2,439.98","9,759.92",
22-Aug-25,Transportellaneous,"8,65,038.00",00.00,"8,74,797.92",
22-Aug-25,Transportellaneous,00.00,"1,24,971.13","7,49,826.79",
22-Aug-25,Debit Card,"13,607.70",00.00,"7,63,434.49",
22-Aug-25,Reversal,00.00,"1,90,858.62","5,72,575.87",
22-Aug-25,Cash,00.00,"2,86,287.94","2,86,287.94",
22-Aug-25,Transportellaneous,"3,98,716.80",00.00,"6,85,004.74",
22-Aug-25,Bill,00.00,"1,37,000.95","5,48,003.79",
22-Aug-25,Debit Card,"13,938.20",00.00,"5,61,941.99",
22-Aug-25,Bill,"19,280.10",00.00,"5,81,222.09",
22-Aug-25,Tax,52,00.00,"5,81,274.09",
22-Aug-25,Transfer,00.00,"64,586.01","5,16,688.08",
22-Aug-25,NEFT,00.00,"57,409.79","4,59,278.29",
22-Aug-25,NEFT,"1,670.50",00.00,"4,60,948.79",
22-Aug-25,Transfer,00.00,"2,30,474.40","2,30,474.40",
22-Aug-25,Transfer,"6,59,904.50",00.00,"8,90,378.90",
22-Aug-25,IMPS,00.00,"8,90,378.90",00.00,
22-Aug-25,Cash,45.2,00.00,45.2,
22-Aug-25,Transfer,00.00,22.6,22.6,
22-Aug-25,ATM,00.00,03.23,19.37,
22-Aug-25,Purchase,00.00,02.42,16.95,
22-Aug-25,Purchase,279,00.00,295.95,
22-Aug-25,Cheque,"2,726.00",00.00,"3,021.95",
22-Aug-25,Purchase,"2,182.50",00.00,"5,204.45",
22-Aug-25,Debit Card,"2,637.90",00.00,"7,842.35",
22-Aug-25,Purchase,00.00,"1,568.47","6,273.88",
22-Aug-25,Transportellaneous,06.00,00.00,"6,279.88",
22-Aug-25,Debit Card,00.00,784.99,"5,494.90",
22-Aug-25,RTGS,"22,198.52",00.00,"27,693.42",
22-Aug-25,Transfer,"3,456.43",00.00,"31,149.85",
22-Aug-25,Tax,00.00,"7,787.46","23,362.39",
22-Aug-25,Cash,"1,95,294.00",00.00,"2,18,656.39",
22-Aug-25,Transfer,"58,821.00",00.00,"2,77,477.39",
22-Aug-25,Purchase,00.00,"39,639.63","2,37,837.76",
22-Aug-25,Interest,00.00,"33,976.82","2,03,860.94",
22-Aug-25,Interest,"9,885.10",00.00,"2,13,746.04",
22-Aug-25,ATM,00.00,"26,718.26","1,87,027.78",
22-Aug-25,Interest,06.80,00.00,"1,87,034.58",
22-Aug-25,Commission,00.00,"18,703.46","1,68,331.12",
22-Aug-25,Transportellaneous,00.00,"18,703.46","1,49,627.66",
22-Aug-25,Tax,"1,685.52",00.00,"1,51,313.18",
22-Aug-25,Debit Card,"2,636.43",00.00,"1,53,949.61",
22-Aug-25,Transportellaneous,04.00,00.00,"1,53,953.61",
22-Aug-25,Transportellaneous,"3,581.00",00.00,"1,57,534.61",
22-Aug-25,Transfer,"5,73,293.00",00.00,"7,30,827.61",
22-Aug-25,ATM,00.00,"1,82,706.90","5,48,120.71",
22-Aug-25,Purchase,35.06,00.00,"5,48,155.77",
22-Aug-25,Transportellaneous,"3,371.00",00.00,"5,51,526.77",
22-Aug-25,Cheque,377.22,00.00,"5,51,903.99",
22-Aug-25,IMPS,"2,909.16",00.00,"5,54,813.15",
22-Aug-25,NEFT,"16,17,453.75",00.00,"21,72,266.90",
22-Aug-25,Cheque,"3,63,763.50",00.00,"25,36,030.40",
22-Aug-25,RTGS,05.40,00.00,"25,36,035.80",
22-Aug-25,Reversal,00.00,"6,34,008.95","19,02,026.85",
22-Aug-25,NEFT,"2,187.00",00.00,"19,04,213.85",
22-Aug-25,ATM,01.00,00.00,"19,04,214.85",
22-Aug-25,IMPS,00.00,"3,80,842.97","15,23,371.88",
22-Aug-25,NEFT,00.00,"2,53,895.31","12,69,476.57",
22-Aug-25,Commission,00.00,"2,11,579.43","10,57,897.14",
22-Aug-25,Interest,"3,76,201.50",00.00,"14,34,098.64",
22-Aug-25,RTGS,"24,301.00",00.00,"14,58,399.64",
22-Aug-25,Interest,00.00,"4,86,133.21","9,72,266.43",
22-Aug-25,Bill,04.00,00.00,"9,72,270.43",
22-Aug-25,Transportellaneous,00.00,"2,43,067.61","7,29,202.82",
22-Aug-25,Transfer,00.00,"91,150.35","6,38,052.47",
22-Aug-25,Purchase,00.00,"3,19,026.24","3,19,026.24",
22-Aug-25,Interest,00.00,"3,19,026.24",00.00,
22-Aug-25,Tax,63,00.00,63,
22-Aug-25,Transportellaneous,00.00,12.6,50.4,
22-Aug-25,Commission,"17,650.00",00.00,"17,700.40",
22-Aug-25,Purchase,"2,40,045.00",00.00,"2,57,745.40",
22-Aug-25,Purchase,26.01,00.00,"2,57,771.41",
22-Aug-25,Tax,00.00,"32,221.43","2,25,549.98",
22-Aug-25,Commission,"17,174.81",00.00,"2,42,724.79",
22-Aug-25,Bill,00.00,"34,674.97","2,08,049.82",
22-Aug-25,Transportellaneous,00.00,"41,609.96","1,66,439.86",
23-Aug-25,IMPS,00.00,"83,219.93","83,219.93",
23-Aug-25,RTGS,00.00,"8,321.99","74,897.94",
23-Aug-25,Cheque,00.00,"10,699.71","64,198.23",
23-Aug-25,Interest,"1,217.20",00.00,"65,415.43",
23-Aug-25,Cash,119.6,00.00,"65,535.03",
23-Aug-25,Transfer,"7,429.00",00.00,"72,964.03",
23-Aug-25,Debit Card,01.00,00.00,"72,965.03",
23-Aug-25,Commission,08.00,00.00,"72,973.03",
23-Aug-25,ATM,00.00,"18,243.26","54,729.77",
23-Aug-25,IMPS,00.00,"7,818.54","46,911.23",
23-Aug-25,Tax,"5,26,265.00",00.00,"5,73,176.23",
23-Aug-25,Cash,"1,720.89",00.00,"5,74,897.12",
23-Aug-25,Cash,00.00,"1,14,979.42","4,59,917.70",
23-Aug-25,RTGS,"28,940.00",00.00,"4,88,857.70",
23-Aug-25,Cash,00.00,"1,22,214.43","3,66,643.28",
23-Aug-25,Reversal,00.00,"52,377.61","3,14,265.67",
23-Aug-25,IMPS,343.1,00.00,"3,14,608.77",
23-Aug-25,NEFT,00.00,"39,326.10","2,75,282.67",
23-Aug-25,Transportellaneous,00.00,"39,326.10","2,35,956.57",
23-Aug-25,Interest,03.05,00.00,"2,35,959.62",
23-Aug-25,Transfer,355.71,00.00,"2,36,315.33",
23-Aug-25,Tax,00.00,"47,263.07","1,89,052.26",
23-Aug-25,Tax,"11,86,001.75",00.00,"13,75,054.01",
23-Aug-25,Commission,"2,573.00",00.00,"13,77,627.01",
23-Aug-25,Reversal,00.00,"4,59,209.00","9,18,418.01",
23-Aug-25,IMPS,00.00,"91,841.80","8,26,576.21",
23-Aug-25,Commission,"11,26,341.00",00.00,"19,52,917.21",
23-Aug-25,Debit Card,00.00,"19,52,917.21",00.00,
23-Aug-25,Transportellaneous,"1,72,423.30",00.00,"1,72,423.30",
23-Aug-25,NEFT,08.00,00.00,"1,72,431.30",
23-Aug-25,Cash,13,00.00,"1,72,444.30",
23-Aug-25,Commission,"1,905.00",00.00,"1,74,349.30",
23-Aug-25,Cheque,00.00,"43,587.33","1,30,761.98",
23-Aug-25,Transportellaneous,00.00,"1,30,761.98",00.00,
23-Aug-25,IMPS,"20,465.00",00.00,"20,465.00",
23-Aug-25,NEFT,"1,995.00",00.00,"22,460.00",
23-Aug-25,NEFT,13.31,00.00,"22,473.31",
23-Aug-25,ATM,03.00,00.00,"22,476.31",
23-Aug-25,Cash,501,00.00,"22,977.31",
23-Aug-25,Cheque,00.00,"2,553.03","20,424.28",
23-Aug-25,RTGS,"1,00,840.00",00.00,"1,21,264.28",
23-Aug-25,Tax,00.00,"12,126.43","1,09,137.85",
23-Aug-25,Transfer,"2,320.91",00.00,"1,11,458.76",
23-Aug-25,Cheque,384.06,00.00,"1,11,842.82",
23-Aug-25,Cheque,00.00,"22,368.56","89,474.26",
23-Aug-25,Reversal,80.75,00.00,"89,555.01",
23-Aug-25,Tax,00.00,"9,950.56","79,604.45",
23-Aug-25,ATM,53,00.00,"79,657.45",
23-Aug-25,Transfer,00.00,"26,552.48","53,104.97",
23-Aug-25,IMPS,"72,291.00",00.00,"1,25,395.97",
23-Aug-25,Cash,"1,51,251.00",00.00,"2,76,646.97",
23-Aug-25,Tax,00.00,"55,329.39","2,21,317.58",
23-Aug-25,Commission,00.00,"24,590.84","1,96,726.74",
23-Aug-25,Bill,"7,40,974.00",00.00,"9,37,700.74",
23-Aug-25,Cash,61.1,00.00,"9,37,761.84",
23-Aug-25,Reversal,00.00,"1,56,293.64","7,81,468.20",
23-Aug-25,Tax,"26,656.20",00.00,"8,08,124.40",
23-Aug-25,Cheque,"18,07,385.00",00.00,"26,15,509.40",
23-Aug-25,Cash,"19,57,341.00",00.00,"45,72,850.40",
23-Aug-25,Purchase,"14,457.00",00.00,"45,87,307.40",
23-Aug-25,NEFT,"20,95,314.20",00.00,"66,82,621.60",
23-Aug-25,NEFT,00.00,"8,35,327.70","58,47,293.90",
23-Aug-25,ATM,"16,97,391.75",00.00,"75,44,685.65",
23-Aug-25,NEFT,00.00,"12,57,447.61","62,87,238.04",
23-Aug-25,Reversal,00.00,"12,57,447.61","50,29,790.43",
23-Aug-25,NEFT,"4,27,087.00",00.00,"54,56,877.43",
23-Aug-25,Debit Card,06.00,00.00,"54,56,883.43",
23-Aug-25,NEFT,00.00,"27,28,441.72","27,28,441.72",
23-Aug-25,NEFT,"16,05,176.00",00.00,"43,33,617.72",
23-Aug-25,Tax,00.00,"5,41,702.22","37,91,915.50",
23-Aug-25,Commission,00.00,"37,91,915.50",00.00,
23-Aug-25,Bill,35.9,00.00,35.9,
23-Aug-25,Cheque,00.00,05.13,30.77,
23-Aug-25,Purchase,"26,976.62",00.00,"27,007.39",
23-Aug-25,Cheque,"4,84,328.75",00.00,"5,11,336.14",
23-Aug-25,Reversal,00.00,"51,133.61","4,60,202.53",
23-Aug-25,Debit Card,00.00,"1,15,050.63","3,45,151.90",
23-Aug-25,ATM,"4,339.00",00.00,"3,49,490.90",
23-Aug-25,Debit Card,05.96,00.00,"3,49,496.86",
23-Aug-25,RTGS,00.00,"58,249.48","2,91,247.38",
23-Aug-25,Debit Card,"2,50,881.00",00.00,"5,42,128.38",
23-Aug-25,Tax,00.00,"60,236.49","4,81,891.89",
23-Aug-25,Interest,01.00,00.00,"4,81,892.89",
23-Aug-25,Cash,194.5,00.00,"4,82,087.39",
23-Aug-25,ATM,"2,61,392.53",00.00,"7,43,479.92",
23-Aug-25,ATM,00.00,"1,06,211.42","6,37,268.50",
23-Aug-25,Bill,00.00,"63,726.85","5,73,541.65",
23-Aug-25,Bill,00.00,"81,934.52","4,91,607.13",
23-Aug-25,ATM,00.00,"49,160.71","4,42,446.42",
23-Aug-25,Commission,"20,87,921.00",00.00,"25,30,367.42",
23-Aug-25,Cheque,00.00,"25,30,367.42",00.00,
23-Aug-25,Cash,"12,322.50",00.00,"12,322.50",
23-Aug-25,NEFT,00.00,"2,464.50","9,858.00",
23-Aug-25,Purchase,00.00,"1,408.29","8,449.71",
23-Aug-25,Tax,00.00,"2,816.57","5,633.14",
23-Aug-25,Debit Card,"11,40,797.50",00.00,"11,46,430.64",
23-Aug-25,Purchase,00.00,"2,86,607.66","8,59,822.98",
23-Aug-25,IMPS,"85,188.88",00.00,"9,45,011.86",
23-Aug-25,NEFT,16.19,00.00,"9,45,028.05",
23-Aug-25,RTGS,00.00,"9,45,028.05",00.00,
23-Aug-25,NEFT,41.98,00.00,41.98,
23-Aug-25,Debit Card,"1,442.80",00.00,"1,484.78",
23-Aug-25,Transfer,00.00,494.93,989.85,
23-Aug-25,ATM,"26,505.30",00.00,"27,495.15",
23-Aug-25,Tax,00.00,"3,055.02","24,440.13",
23-Aug-25,Interest,"28,955.00",00.00,"53,395.13",
24-Aug-25,Bill,"20,84,352.75",00.00,"21,37,747.88",
24-Aug-25,Purchase,05.20,00.00,"21,37,753.08",
24-Aug-25,IMPS,"2,635.40",00.00,"21,40,388.48",
24-Aug-25,ATM,"18,262.60",00.00,"21,58,651.08",
24-Aug-25,Interest,"2,23,938.47",00.00,"23,82,589.55",
24-Aug-25,Purchase,00.00,"4,76,517.91","19,06,071.64",
24-Aug-25,Purchase,00.00,"9,53,035.82","9,53,035.82",
24-Aug-25,Cheque,61.7,00.00,"9,53,097.52",
25-Aug-25,Interest,00.00,"1,05,899.72","8,47,197.80",
26-Aug-25,Interest,"2,33,493.00",00.00,"10,80,690.80",
26-Aug-25,Transportellaneous,53.5,00.00,"10,80,744.30",
26-Aug-25,ATM,614,00.00,"10,81,358.30",
26-Aug-25,Cheque,"7,85,433.75",00.00,"18,66,792.05",
26-Aug-25,Commission,48.14,00.00,"18,66,840.19",
26-Aug-25,Cheque,00.00,"4,66,710.05","14,00,130.14",
26-Aug-25,NEFT,00.00,"7,00,065.07","7,00,065.07",
26-Aug-25,Bill,05.00,00.00,"7,00,070.07",
27-Aug-25,Purchase,00.00,"1,16,678.35","5,83,391.72",
27-Aug-25,Commission,00.00,"64,821.30","5,18,570.42",
27-Aug-25,Transportellaneous,"9,764.30",00.00,"5,28,334.72",
27-Aug-25,Purchase,01.72,00.00,"5,28,336.44",
28-Aug-25,Cheque,579.8,00.00,"5,28,916.24",
28-Aug-25,Interest,"1,77,900.66",00.00,"7,06,816.90",
28-Aug-25,Interest,"30,208.00",00.00,"7,37,024.90",
28-Aug-25,IMPS,00.00,"1,47,404.98","5,89,619.92",
28-Aug-25,Bill,00.00,"65,513.32","5,24,106.60",
28-Aug-25,Reversal,00.00,"74,872.37","4,49,234.23",
28-Aug-25,IMPS,00.00,"89,846.85","3,59,387.38",
28-Aug-25,Reversal,00.00,"3,59,387.38",00.00,
28-Aug-25,Bill,"12,015.00",00.00,"12,015.00",
28-Aug-25,Cheque,00.00,"1,716.43","10,298.57",
28-Aug-25,Cheque,00.00,"10,298.57",00.00,
28-Aug-25,IMPS,310.01,00.00,310.01,
28-Aug-25,Reversal,02.20,00.00,312.21,
28-Aug-25,Cash,"8,349.22",00.00,"8,661.43",
28-Aug-25,Bill,"47,824.00",00.00,"56,485.43",
28-Aug-25,Cheque,"2,37,477.47",00.00,"2,93,962.90",
28-Aug-25,Transfer,00.00,"58,792.58","2,35,170.32",
28-Aug-25,Commission,13.45,00.00,"2,35,183.77",
28-Aug-25,ATM,00.00,"1,17,591.89","1,17,591.88",
28-Aug-25,Debit Card,"13,97,470.75",00.00,"15,15,062.63",
29-Aug-25,Cash,00.00,"1,89,382.83","13,25,679.80",
30-Aug-25,Interest,"2,75,892.20",00.00,"16,01,572.00",
30-Aug-25,NEFT,"2,067.00",00.00,"16,03,639.00",
31-Aug-25,RTGS,"2,36,966.22",00.00,"18,40,605.22",
31-Aug-25,Cheque,00.00,"3,68,121.04","14,72,484.18",
31-Aug-25,Debit Card,00.00,"1,63,609.35","13,08,874.83",
31-Aug-25,Debit Card,07.66,00.00,"13,08,882.49",
31-Aug-25,Interest,"1,900.10",00.00,"13,10,782.59",
31-Aug-25,Interest,53.17,00.00,"13,10,835.76",
31-Aug-25,Bill,00.00,"1,45,648.42","11,65,187.34",
31-Aug-25,Cheque,04.40,00.00,"11,65,191.74",
31-Aug-25,Purchase,00.00,"1,94,198.62","9,70,993.12",
31-Aug-25,Commission,00.00,"4,85,496.56","4,85,496.56",
31-Aug-25,IMPS,00.00,"1,61,832.19","3,23,664.37",
31-Aug-25,NEFT,00.00,"80,916.09","2,42,748.28",
31-Aug-25,ATM,37,00.00,"2,42,785.28",
31-Aug-25,RTGS,00.00,"48,557.06","1,94,228.22",
31-Aug-25,Transfer,"1,785.00",00.00,"1,96,013.22",
31-Aug-25,Transfer,"15,71,682.00",00.00,"17,67,695.22",
31-Aug-25,Cheque,00.00,"3,53,539.04","14,14,156.18",
31-Aug-25,Purchase,00.00,"1,41,415.62","12,72,740.56",
31-Aug-25,Transfer,00.00,"1,27,274.06","11,45,466.50",
31-Aug-25,NEFT,00.00,"3,81,822.17","7,63,644.33",
31-Aug-25,Transfer,"17,10,640.80",00.00,"24,74,285.13",
31-Aug-25,Purchase,00.00,"2,74,920.57","21,99,364.56",
31-Aug-25,Cheque,"2,32,444.80",00.00,"24,31,809.36",
31-Aug-25,ATM,"15,89,080.00",00.00,"40,20,889.36",
31-Aug-25,Transfer,"13,63,011.75",00.00,"53,83,901.11",
31-Aug-25,Commission,00.00,"53,83,901.11",00.00,
31-Aug-25,Reversal,"11,03,049.25",00.00,"11,03,049.25",
31-Aug-25,Reversal,36,00.00,"11,03,085.25",
31-Aug-25,Tax,17.2,00.00,"11,03,102.45",
31-Aug-25,Debit Card,05.48,00.00,"11,03,107.93",
31-Aug-25,IMPS,00.00,"1,57,586.85","9,45,521.08",
31-Aug-25,NEFT,00.00,"1,89,104.22","7,56,416.86",
31-Aug-25,Tax,00.00,"1,89,104.22","5,67,312.64",
31-Aug-25,IMPS,00.00,"81,044.66","4,86,267.98",
31-Aug-25,Debit Card,00.00,"4,86,267.98",00.00,
31-Aug-25,NEFT,146.22,00.00,146.22,
31-Aug-25,ATM,00.00,48.74,97.48,
31-Aug-25,Tax,00.00,10.83,86.65,
31-Aug-25,Cash,"83,814.00",00.00,"83,900.65",
31-Aug-25,Reversal,00.00,"41,950.33","41,950.32",
31-Aug-25,Purchase,00.00,"4,661.15","37,289.17",
31-Aug-25,ATM,00.00,"12,429.72","24,859.45",
01-Sep-25,Transfer,00.00,"2,762.16","22,097.29",
01-Sep-25,Interest,00.00,"2,762.16","19,335.13",
01-Sep-25,Bill,"17,79,715.00",00.00,"17,99,050.13",
02-Sep-25,Interest,217,00.00,"17,99,267.13",
02-Sep-25,NEFT,"17,30,712.20",00.00,"35,29,979.33",
02-Sep-25,Transportellaneous,"24,135.20",00.00,"35,54,114.53",
02-Sep-25,Cash,00.00,"35,54,114.53",00.00,
02-Sep-25,Commission,26.3,00.00,26.3,
02-Sep-25,ATM,"7,96,987.25",00.00,"7,97,013.55",
02-Sep-25,Transfer,00.00,"1,99,253.39","5,97,760.16",
02-Sep-25,Cash,192,00.00,"5,97,952.16",
02-Sep-25,Cash,"24,959.35",00.00,"6,22,911.51",
02-Sep-25,Debit Card,"9,473.97",00.00,"6,32,385.48",
02-Sep-25,Commission,00.00,"6,32,385.48",00.00,
02-Sep-25,ATM,"2,19,243.50",00.00,"2,19,243.50",
02-Sep-25,Purchase,17.85,00.00,"2,19,261.35",
02-Sep-25,Cash,"12,777.50",00.00,"2,32,038.85",
02-Sep-25,Commission,36.1,00.00,"2,32,074.95",
02-Sep-25,Debit Card,26,00.00,"2,32,100.95",
02-Sep-25,Tax,00.00,"46,420.19","1,85,680.76",
02-Sep-25,RTGS,00.00,"1,85,680.76",00.00,
02-Sep-25,Reversal,"28,754.59",00.00,"28,754.59",
02-Sep-25,IMPS,00.00,"7,188.65","21,565.94",
02-Sep-25,NEFT,00.00,"21,565.94",00.00,
02-Sep-25,Interest,58,00.00,58,
02-Sep-25,IMPS,00.00,06.44,51.56,
02-Sep-25,Interest,394,00.00,445.56,
02-Sep-25,Cheque,00.00,111.39,334.17,
02-Sep-25,Transportellaneous,455,00.00,789.17,
02-Sep-25,Reversal,00.00,98.65,690.52,
02-Sep-25,ATM,01.00,00.00,691.52,
02-Sep-25,Transfer,85.4,00.00,776.92,
02-Sep-25,Bill,"6,320.71",00.00,"7,097.63",
02-Sep-25,Reversal,"20,96,519.00",00.00,"21,03,616.63",
02-Sep-25,NEFT,275,00.00,"21,03,891.63",
02-Sep-25,NEFT,00.00,"3,00,555.95","18,03,335.68",
02-Sep-25,Purchase,00.00,"3,00,555.95","15,02,779.73",
02-Sep-25,Reversal,"51,746.20",00.00,"15,54,525.93",
02-Sep-25,Bill,00.00,"1,94,315.74","13,60,210.19",
02-Sep-25,Cheque,00.00,"3,40,052.55","10,20,157.64",
02-Sep-25,Cash,388.8,00.00,"10,20,546.44",
02-Sep-25,Cheque,291.1,00.00,"10,20,837.54",
02-Sep-25,NEFT,131.2,00.00,"10,20,968.74",
02-Sep-25,Cheque,00.00,"1,45,852.68","8,75,116.06",
02-Sep-25,IMPS,01.70,00.00,"8,75,117.76",
02-Sep-25,Transfer,388.6,00.00,"8,75,506.36",
02-Sep-25,Purchase,00.00,"2,91,835.45","5,83,670.91",
02-Sep-25,Transfer,05.70,00.00,"5,83,676.61",
02-Sep-25,Debit Card,00.00,"1,45,919.15","4,37,757.46",
02-Sep-25,Commission,"1,442.72",00.00,"4,39,200.18",
02-Sep-25,ATM,00.00,"48,800.02","3,90,400.16",
02-Sep-25,Commission,00.00,"43,377.80","3,47,022.36",
02-Sep-25,Transportellaneous,"1,098.74",00.00,"3,48,121.10",
03-Sep-25,Commission,00.00,"87,030.28","2,61,090.82",
03-Sep-25,ATM,"2,02,255.00",00.00,"4,63,345.82",
03-Sep-25,Purchase,00.00,"1,15,836.46","3,47,509.36",
03-Sep-25,Commission,00.00,"3,47,509.36",00.00,
03-Sep-25,Debit Card,"1,01,221.00",00.00,"1,01,221.00",
03-Sep-25,Cheque,00.00,"12,652.63","88,568.38",
03-Sep-25,Commission,922.18,00.00,"89,490.56",
03-Sep-25,Transfer,180.8,00.00,"89,671.36",
03-Sep-25,Transfer,"5,76,628.00",00.00,"6,66,299.36",
03-Sep-25,NEFT,00.00,"74,033.26","5,92,266.10",
03-Sep-25,Reversal,00.00,"74,033.26","5,18,232.84",
03-Sep-25,Interest,00.61,00.00,"5,18,233.45",
03-Sep-25,Cash,"20,25,311.00",00.00,"25,43,544.45",
03-Sep-25,Transfer,00.00,"2,82,616.05","22,60,928.40",
03-Sep-25,Tax,00.00,"2,51,214.27","20,09,714.13",
03-Sep-25,Cash,00.00,"5,02,428.53","15,07,285.60",
03-Sep-25,Purchase,"3,340.00",00.00,"15,10,625.60",
03-Sep-25,Cash,00.00,"7,55,312.80","7,55,312.80",
03-Sep-25,Debit Card,00.00,"1,07,901.83","6,47,410.97",
03-Sep-25,RTGS,"26,722.00",00.00,"6,74,132.97",
03-Sep-25,NEFT,549,00.00,"6,74,681.97",
03-Sep-25,NEFT,"11,28,568.80",00.00,"18,03,250.77",
03-Sep-25,RTGS,00.00,"9,01,625.39","9,01,625.38",
03-Sep-25,RTGS,"13,286.72",00.00,"9,14,912.10",
03-Sep-25,Tax,05.48,00.00,"9,14,917.58",
03-Sep-25,Bill,274.6,00.00,"9,15,192.18",
03-Sep-25,Transportellaneous,00.00,"4,57,596.09","4,57,596.09",
03-Sep-25,Reversal,"55,218.00",00.00,"5,12,814.09",
03-Sep-25,Purchase,00.00,"2,56,407.05","2,56,407.04",
03-Sep-25,Tax,00.00,"85,469.01","1,70,938.03",
03-Sep-25,NEFT,36,00.00,"1,70,974.03",
03-Sep-25,Purchase,459,00.00,"1,71,433.03",
03-Sep-25,Reversal,"26,249.34",00.00,"1,97,682.37",
03-Sep-25,Debit Card,00.00,"49,420.59","1,48,261.78",
03-Sep-25,Cheque,00.00,"37,065.45","1,11,196.34",
03-Sep-25,Transfer,00.00,"37,065.45","74,130.89",
03-Sep-25,Cash,42.1,00.00,"74,172.99",
03-Sep-25,Transfer,00.00,"7,417.30","66,755.69",
03-Sep-25,RTGS,40.9,00.00,"66,796.59",
03-Sep-25,IMPS,"1,896.49",00.00,"68,693.08",
04-Sep-25,Transportellaneous,170.1,00.00,"68,863.18",
04-Sep-25,Purchase,"2,38,467.00",00.00,"3,07,330.18",
04-Sep-25,Purchase,363.77,00.00,"3,07,693.95",
04-Sep-25,ATM,00.00,"3,07,693.95",00.00,
04-Sep-25,Cheque,"11,492.86",00.00,"11,492.86",
04-Sep-25,Cash,00.00,"1,641.84","9,851.02",
04-Sep-25,Commission,00.00,"1,231.38","8,619.64",
04-Sep-25,Commission,"32,498.00",00.00,"41,117.64",
04-Sep-25,Interest,00.00,"5,873.95","35,243.69",
04-Sep-25,Purchase,00.00,"35,243.69",00.00,
04-Sep-25,Interest,00.00,00.00,00.00,
04-Sep-25,Transfer,"1,222.00",00.00,"1,222.00",
04-Sep-25,IMPS,"79,549.60",00.00,"80,771.60",
04-Sep-25,IMPS,"21,066.26",00.00,"1,01,837.86",
04-Sep-25,ATM,09.43,00.00,"1,01,847.29",
05-Sep-25,ATM,39.64,00.00,"1,01,886.93",
05-Sep-25,Purchase,00.00,"16,981.16","84,905.78",
05-Sep-25,ATM,282,00.00,"85,187.78",
05-Sep-25,Debit Card,00.00,"21,296.95","63,890.84",
05-Sep-25,IMPS,00.00,"9,127.26","54,763.58",
05-Sep-25,Reversal,"3,316.57",00.00,"58,080.15",
05-Sep-25,IMPS,"17,629.36",00.00,"75,709.51",
05-Sep-25,Commission,00.00,"18,927.38","56,782.13",
05-Sep-25,Reversal,06.00,00.00,"56,788.13",
05-Sep-25,Reversal,00.00,"6,309.79","50,478.34",
05-Sep-25,Interest,06.00,00.00,"50,484.34",
05-Sep-25,RTGS,"3,005.00",00.00,"53,489.34",
05-Sep-25,Debit Card,00.00,"26,744.67","26,744.67",
05-Sep-25,Reversal,00.00,"5,348.93","21,395.74",
05-Sep-25,NEFT,00.00,"10,697.87","10,697.87",
05-Sep-25,Transportellaneous,"2,921.00",00.00,"13,618.87",
05-Sep-25,Bill,00.00,"1,361.89","12,256.98",
06-Sep-25,Cash,"1,87,332.00",00.00,"1,99,588.98",
06-Sep-25,Interest,25.95,00.00,"1,99,614.93",
06-Sep-25,Reversal,405,00.00,"2,00,019.93",
06-Sep-25,Commission,"2,31,669.00",00.00,"4,31,688.93",
06-Sep-25,Tax,00.00,"43,168.89","3,88,520.04",
06-Sep-25,Cash,00.00,"64,753.34","3,23,766.70",
06-Sep-25,Cash,00.00,"1,61,883.35","1,61,883.35",
06-Sep-25,IMPS,"55,903.00",00.00,"2,17,786.35",
06-Sep-25,Debit Card,"2,414.80",00.00,"2,20,201.15",
06-Sep-25,Reversal,00.00,"1,10,100.58","1,10,100.58",
06-Sep-25,Tax,13.7,00.00,"1,10,114.28",
06-Sep-25,Reversal,"3,923.80",00.00,"1,14,038.08",
06-Sep-25,Transportellaneous,21,00.00,"1,14,059.08",
06-Sep-25,Cheque,00.00,"1,14,059.08",00.00,
06-Sep-25,Cheque,"1,17,046.00",00.00,"1,17,046.00",
06-Sep-25,NEFT,00.00,"16,720.86","1,00,325.14",
06-Sep-25,IMPS,00.00,"50,162.57","50,162.57",
06-Sep-25,Debit Card,00.00,00.00,"50,162.57",
06-Sep-25,NEFT,00.00,"5,016.26","45,146.31",
06-Sep-25,ATM,"1,28,024.00",00.00,"1,73,170.31",
06-Sep-25,Cash,"2,56,735.40",00.00,"4,29,905.71",
06-Sep-25,Commission,"1,313.70",00.00,"4,31,219.41",
06-Sep-25,Debit Card,00.00,"4,31,219.41",00.00,
06-Sep-25,Commission,"17,269.07",00.00,"17,269.07",
07-Sep-25,RTGS,"1,128.00",00.00,"18,397.07",
07-Sep-25,Reversal,00.00,"2,044.12","16,352.95",
07-Sep-25,Purchase,00.00,"4,088.24","12,264.71",
07-Sep-25,Transportellaneous,"1,87,020.91",00.00,"1,99,285.62",
07-Sep-25,IMPS,00.00,"49,821.41","1,49,464.22",
07-Sep-25,Tax,04.00,00.00,"1,49,468.22",
07-Sep-25,Transportellaneous,00.00,"16,607.58","1,32,860.64",
07-Sep-25,Tax,39.6,00.00,"1,32,900.24",
07-Sep-25,ATM,00.00,"66,450.12","66,450.12",
08-Sep-25,Bill,00.00,"66,450.12",00.00,
08-Sep-25,Bill,"1,94,655.69",00.00,"1,94,655.69",
08-Sep-25,ATM,"3,665.28",00.00,"1,98,320.97",
08-Sep-25,Transportellaneous,"7,91,783.00",00.00,"9,90,103.97",
08-Sep-25,Tax,00.00,"2,47,525.99","7,42,577.98",
08-Sep-25,ATM,00.00,"92,822.25","6,49,755.73",
08-Sep-25,Reversal,00.00,"81,219.47","5,68,536.26",
08-Sep-25,Purchase,00.00,"1,89,512.09","3,79,024.17",
08-Sep-25,Transfer,00.00,"94,756.04","2,84,268.13",
08-Sep-25,Bill,00.00,"28,426.81","2,55,841.32",
08-Sep-25,Commission,00.00,"42,640.22","2,13,201.10",
08-Sep-25,Reversal,00.00,"21,320.11","1,91,880.99",
08-Sep-25,ATM,41.49,00.00,"1,91,922.48",
08-Sep-25,Reversal,00.00,"1,91,922.48",00.00,
08-Sep-25,RTGS,55.72,00.00,55.72,
08-Sep-25,Commission,670,00.00,725.72,
08-Sep-25,Debit Card,"21,435.31",00.00,"22,161.03",
08-Sep-25,Debit Card,"3,707.00",00.00,"25,868.03",
08-Sep-25,Cash,00.00,"5,173.61","20,694.42",
08-Sep-25,Transfer,"1,814.40",00.00,"22,508.82",
08-Sep-25,Transfer,"1,02,128.84",00.00,"1,24,637.66",
08-Sep-25,Cheque,00.00,"41,545.89","83,091.77",
08-Sep-25,Cheque,120,00.00,"83,211.77",
08-Sep-25,Cash,00.00,"9,245.75","73,966.02",
08-Sep-25,NEFT,00.00,"24,655.34","49,310.68",
08-Sep-25,Cheque,00.00,"5,478.96","43,831.72",
08-Sep-25,Cheque,00.00,"7,305.29","36,526.43",
08-Sep-25,RTGS,"1,493.30",00.00,"38,019.73",
08-Sep-25,Reversal,"1,825.40",00.00,"39,845.13",
08-Sep-25,ATM,"6,58,874.50",00.00,"6,98,719.63",
08-Sep-25,NEFT,00.00,"3,49,359.82","3,49,359.82",
08-Sep-25,Transfer,00.00,"69,871.96","2,79,487.86",
08-Sep-25,Reversal,34.2,00.00,"2,79,522.06",
08-Sep-25,IMPS,00.00,"69,880.52","2,09,641.54",
08-Sep-25,NEFT,"3,53,317.25",00.00,"5,62,958.79",
08-Sep-25,Purchase,"1,36,151.88",00.00,"6,99,110.67",
08-Sep-25,Transportellaneous,"29,186.30",00.00,"7,28,296.97",
08-Sep-25,Transportellaneous,"84,178.10",00.00,"8,12,475.07",
08-Sep-25,Cheque,"1,660.08",00.00,"8,14,135.15",
08-Sep-25,Interest,"8,69,194.00",00.00,"16,83,329.15",
08-Sep-25,Interest,111.52,00.00,"16,83,440.67",
08-Sep-25,IMPS,00.00,"1,68,344.07","15,15,096.60",
08-Sep-25,RTGS,"3,307.00",00.00,"15,18,403.60",
08-Sep-25,Transportellaneous,"19,93,077.00",00.00,"35,11,480.60",
08-Sep-25,Bill,"12,827.09",00.00,"35,24,307.69",
08-Sep-25,NEFT,"1,63,261.00",00.00,"36,87,568.69",
08-Sep-25,Bill,"3,622.00",00.00,"36,91,190.69",
08-Sep-25,Interest,00.00,"9,22,797.67","27,68,393.02",
08-Sep-25,Reversal,00.00,"9,22,797.67","18,45,595.35",
08-Sep-25,Purchase,00.00,"2,05,066.15","16,40,529.20",
08-Sep-25,RTGS,"7,312.00",00.00,"16,47,841.20",
08-Sep-25,Cash,00.00,"1,64,784.12","14,83,057.08",
08-Sep-25,Purchase,"2,025.81",00.00,"14,85,082.89",
08-Sep-25,NEFT,"27,022.90",00.00,"15,12,105.79",
08-Sep-25,Cash,00.00,"1,51,210.58","13,60,895.21",
08-Sep-25,RTGS,00.00,"3,40,223.80","10,20,671.41",
08-Sep-25,Bill,00.00,"1,13,407.93","9,07,263.48",
08-Sep-25,Interest,"2,984.40",00.00,"9,10,247.88",
08-Sep-25,RTGS,218.7,00.00,"9,10,466.58",
08-Sep-25,Cheque,00.50,00.00,"9,10,467.08",
08-Sep-25,Bill,00.00,"9,10,467.08",00.00,
08-Sep-25,RTGS,"16,40,466.00",00.00,"16,40,466.00",
08-Sep-25,Cheque,23,00.00,"16,40,489.00",
08-Sep-25,Tax,"6,56,556.00",00.00,"22,97,045.00",
08-Sep-25,IMPS,03.00,00.00,"22,97,048.00",
08-Sep-25,Transfer,00.00,"7,65,682.67","15,31,365.33",
08-Sep-25,Tax,"14,28,925.00",00.00,"29,60,290.33",
08-Sep-25,IMPS,328.3,00.00,"29,60,618.63",
08-Sep-25,Transportellaneous,"16,67,242.75",00.00,"46,27,861.38",
08-Sep-25,Cash,"2,461.00",00.00,"46,30,322.38",
08-Sep-25,Tax,00.00,"5,14,480.26","41,15,842.12",
08-Sep-25,Cash,06.80,00.00,"41,15,848.92",
08-Sep-25,Reversal,00.00,"5,87,978.42","35,27,870.50",
08-Sep-25,Bill,00.00,"35,27,870.50",00.00,
08-Sep-25,Tax,"10,43,043.20",00.00,"10,43,043.20",
08-Sep-25,Commission,00.00,"10,43,043.20",00.00,
08-Sep-25,Transportellaneous,24.7,00.00,24.7,
08-Sep-25,Cheque,00.00,03.53,21.17,
08-Sep-25,IMPS,00.00,03.02,18.15,
08-Sep-25,Commission,00.00,03.03,15.12,
08-Sep-25,NEFT,00.00,02.52,12.6,
08-Sep-25,Debit Card,"1,27,115.19",00.00,"1,27,127.79",
08-Sep-25,IMPS,"13,35,689.20",00.00,"14,62,816.99",
08-Sep-25,NEFT,129,00.00,"14,62,945.99",
08-Sep-25,NEFT,00.00,"3,65,736.50","10,97,209.49",
08-Sep-25,Bill,04.00,00.00,"10,97,213.49",
08-Sep-25,Purchase,00.00,"5,48,606.75","5,48,606.74",
08-Sep-25,Cash,03.16,00.00,"5,48,609.90",
08-Sep-25,Tax,00.00,"1,82,869.97","3,65,739.93",
08-Sep-25,IMPS,"24,445.74",00.00,"3,90,185.67",
08-Sep-25,Interest,00.00,"1,95,092.84","1,95,092.84",
08-Sep-25,Transportellaneous,00.00,"65,030.95","1,30,061.89",
08-Sep-25,Interest,"1,65,599.60",00.00,"2,95,661.49",
08-Sep-25,RTGS,00.00,"2,95,661.49",00.00,
08-Sep-25,Transportellaneous,60.5,00.00,60.5,
08-Sep-25,Transportellaneous,"2,033.00",00.00,"2,093.50",
08-Sep-25,Interest,00.00,697.83,"1,395.67",
09-Sep-25,NEFT,00.00,348.92,"1,046.75",
09-Sep-25,Debit Card,94,00.00,"1,140.75",
09-Sep-25,Cheque,"2,12,301.90",00.00,"2,13,442.65",
09-Sep-25,Purchase,06.88,00.00,"2,13,449.53",
09-Sep-25,NEFT,02.77,00.00,"2,13,452.30",
09-Sep-25,Purchase,"3,807.00",00.00,"2,17,259.30",
09-Sep-25,IMPS,"1,188.50",00.00,"2,18,447.80",
09-Sep-25,Debit Card,"79,186.70",00.00,"2,97,634.50",
09-Sep-25,ATM,62.1,00.00,"2,97,696.60",
09-Sep-25,Debit Card,"1,491.00",00.00,"2,99,187.60",
09-Sep-25,NEFT,00.00,"29,918.76","2,69,268.84",
09-Sep-25,Transfer,00.00,"67,317.21","2,01,951.63",
09-Sep-25,Transfer,00.00,"22,439.07","1,79,512.56",
09-Sep-25,RTGS,00.00,"59,837.52","1,19,675.04",
09-Sep-25,Reversal,00.00,"23,935.01","95,740.03",
09-Sep-25,Reversal,00.00,"31,913.34","63,826.69",
09-Sep-25,Interest,00.00,"9,118.10","54,708.59",
09-Sep-25,Tax,212,00.00,"54,920.59",
09-Sep-25,RTGS,06.20,00.00,"54,926.79",
09-Sep-25,Reversal,"17,04,910.80",00.00,"17,59,837.59",
09-Sep-25,Interest,00.00,"17,59,837.59",00.00,
10-Sep-25,ATM,145.48,00.00,145.48,
10-Sep-25,Transfer,00.00,16.16,129.32,
10-Sep-25,NEFT,02.70,00.00,132.02,
10-Sep-25,Bill,"1,53,497.00",00.00,"1,53,629.02",
10-Sep-25,Bill,00.00,"38,407.26","1,15,221.76",
10-Sep-25,Interest,"2,677.00",00.00,"1,17,898.76",
10-Sep-25,Transportellaneous,59.9,00.00,"1,17,958.66",
10-Sep-25,Transfer,"26,323.04",00.00,"1,44,281.70",
10-Sep-25,Purchase,00.00,"20,611.67","1,23,670.03",
10-Sep-25,RTGS,"3,091.00",00.00,"1,26,761.03",
10-Sep-25,Commission,00.00,"1,26,761.03",00.00,
10-Sep-25,Reversal,17.4,00.00,17.4,
10-Sep-25,RTGS,"1,11,390.00",00.00,"1,11,407.40",
10-Sep-25,Cash,00.00,"22,281.48","89,125.92",
10-Sep-25,IMPS,00.00,"9,902.88","79,223.04",
10-Sep-25,Cash,02.50,00.00,"79,225.54",
10-Sep-25,NEFT,00.00,"19,806.39","59,419.16",
10-Sep-25,ATM,03.98,00.00,"59,423.14",
10-Sep-25,ATM,00.00,"5,942.31","53,480.83",
10-Sep-25,Commission,00.00,"10,696.17","42,784.66",
10-Sep-25,Tax,00.00,"21,392.33","21,392.33",
10-Sep-25,Debit Card,00.00,"3,565.39","17,826.94",
11-Sep-25,Purchase,06.70,00.00,"17,833.64",
11-Sep-25,Commission,06.99,00.00,"17,840.63",
11-Sep-25,Interest,"10,935.35",00.00,"28,775.98",
11-Sep-25,Purchase,00.00,"3,597.00","25,178.98",
11-Sep-25,Purchase,"5,612.80",00.00,"30,791.78",
11-Sep-25,Transfer,00.42,00.00,"30,792.20",
11-Sep-25,ATM,"80,535.16",00.00,"1,11,327.36",
11-Sep-25,Tax,15.16,00.00,"1,11,342.52",
11-Sep-25,Debit Card,04.20,00.00,"1,11,346.72",
11-Sep-25,RTGS,00.00,"55,673.36","55,673.36",
11-Sep-25,NEFT,485,00.00,"56,158.36",
11-Sep-25,Transportellaneous,00.00,"11,231.67","44,926.69",
11-Sep-25,Cheque,00.00,"5,615.84","39,310.85",
11-Sep-25,NEFT,00.00,"9,827.71","29,483.14",
11-Sep-25,Transportellaneous,00.00,"3,275.90","26,207.24",
11-Sep-25,NEFT,00.00,"26,207.24",00.00,
11-Sep-25,Transportellaneous,06.00,00.00,06.00,
11-Sep-25,Commission,"17,95,866.00",00.00,"17,95,872.00",
11-Sep-25,Bill,"80,420.30",00.00,"18,76,292.30",
11-Sep-25,Transfer,06.71,00.00,"18,76,299.01",
11-Sep-25,NEFT,00.00,"4,69,074.75","14,07,224.26",
11-Sep-25,Purchase,00.00,"1,56,358.25","12,50,866.01",
11-Sep-25,Cash,00.00,"6,25,433.01","6,25,433.00",
11-Sep-25,Debit Card,00.00,"78,179.13","5,47,253.88",
11-Sep-25,ATM,243.1,00.00,"5,47,496.98",
11-Sep-25,Cash,00.00,"1,82,498.99","3,64,997.99",
11-Sep-25,Interest,"2,05,905.00",00.00,"5,70,902.99",
11-Sep-25,Reversal,887.3,00.00,"5,71,790.29",
11-Sep-25,Transportellaneous,"8,51,142.00",00.00,"14,22,932.29",
11-Sep-25,NEFT,00.00,"4,74,310.76","9,48,621.53",
11-Sep-25,Transfer,"1,64,517.40",00.00,"11,13,138.93",
11-Sep-25,Transfer,00.00,"2,22,627.79","8,90,511.14",
11-Sep-25,NEFT,00.00,"4,45,255.57","4,45,255.57",
11-Sep-25,NEFT,"12,51,142.50",00.00,"16,96,398.07",
11-Sep-25,Reversal,00.00,"2,42,342.58","14,54,055.49",
11-Sep-25,Tax,"9,794.50",00.00,"14,63,849.99",
11-Sep-25,Cheque,00.00,"14,63,849.99",00.00,
11-Sep-25,Commission,"9,60,097.50",00.00,"9,60,097.50",
11-Sep-25,Tax,"1,33,713.00",00.00,"10,93,810.50",
11-Sep-25,Tax,26.9,00.00,"10,93,837.40",
11-Sep-25,Interest,00.00,"3,64,612.47","7,29,224.93",
11-Sep-25,Purchase,00.00,"1,21,537.49","6,07,687.44",
11-Sep-25,IMPS,"1,07,674.53",00.00,"7,15,361.97",
11-Sep-25,Transportellaneous,00.00,"7,15,361.97",00.00,
11-Sep-25,Reversal,"12,713.30",00.00,"12,713.30",
11-Sep-25,Debit Card,00.00,"1,412.59","11,300.71",
12-Sep-25,RTGS,"1,948.98",00.00,"13,249.69",
12-Sep-25,NEFT,00.00,"6,624.85","6,624.84",
12-Sep-25,Purchase,46,00.00,"6,670.84",
12-Sep-25,Bill,"19,66,450.50",00.00,"19,73,121.34",
12-Sep-25,Transfer,00.00,"3,28,853.56","16,44,267.78",
12-Sep-25,Cash,"1,30,305.50",00.00,"17,74,573.28",
12-Sep-25,Transportellaneous,"19,38,647.75",00.00,"37,13,221.03",
12-Sep-25,Debit Card,49.18,00.00,"37,13,270.21",
12-Sep-25,Tax,"2,63,197.20",00.00,"39,76,467.41",
12-Sep-25,Cheque,04.10,00.00,"39,76,471.51",
13-Sep-25,Commission,00.00,"6,62,745.25","33,13,726.26",
13-Sep-25,ATM,56,00.00,"33,13,782.26",
13-Sep-25,Tax,"2,884.50",00.00,"33,16,666.76",
13-Sep-25,Transfer,00.00,"16,58,333.38","16,58,333.38",
13-Sep-25,Transfer,00.00,"4,14,583.35","12,43,750.03",
13-Sep-25,ATM,00.00,"12,43,750.03",00.00,
13-Sep-25,Reversal,"1,37,496.40",00.00,"1,37,496.40",
13-Sep-25,Commission,00.00,"27,499.28","1,09,997.12",
13-Sep-25,Transportellaneous,00.00,"1,09,997.12",00.00,
13-Sep-25,Debit Card,"2,963.00",00.00,"2,963.00",
13-Sep-25,Bill,00.00,"2,963.00",00.00,
13-Sep-25,Transfer,"3,181.00",00.00,"3,181.00",
13-Sep-25,Cheque,00.00,530.17,"2,650.83",
13-Sep-25,Reversal,00.00,378.69,"2,272.14",
13-Sep-25,Transportellaneous,"1,779.96",00.00,"4,052.10",
13-Sep-25,ATM,03.18,00.00,"4,055.28",
13-Sep-25,Purchase,00.00,450.59,"3,604.69",
13-Sep-25,Tax,39.8,00.00,"3,644.49",
13-Sep-25,NEFT,00.00,364.45,"3,280.04",
13-Sep-25,Reversal,01.18,00.00,"3,281.22",
13-Sep-25,Cash,"3,505.70",00.00,"6,786.92",
13-Sep-25,Reversal,05.69,00.00,"6,792.61",
13-Sep-25,Reversal,00.00,754.73,"6,037.88",
13-Sep-25,RTGS,00.00,754.74,"5,283.14",
13-Sep-25,RTGS,351.96,00.00,"5,635.10",
13-Sep-25,ATM,00.00,704.39,"4,930.71",
13-Sep-25,IMPS,"65,610.00",00.00,"70,540.71",
13-Sep-25,Cash,246.31,00.00,"70,787.02",
13-Sep-25,Purchase,00.00,"10,112.43","60,674.59",
13-Sep-25,IMPS,52.8,00.00,"60,727.39",
13-Sep-25,Cheque,05.42,00.00,"60,732.81",
13-Sep-25,Reversal,00.00,"12,146.56","48,586.25",
13-Sep-25,Transportellaneous,375.6,00.00,"48,961.85",
13-Sep-25,Cash,"32,354.50",00.00,"81,316.35",
13-Sep-25,Interest,00.00,"8,131.64","73,184.72",
14-Sep-25,Cash,"50,827.00",00.00,"1,24,011.72",
15-Sep-25,ATM,00.00,"20,668.62","1,03,343.10",
15-Sep-25,RTGS,348.41,00.00,"1,03,691.51",
15-Sep-25,Transfer,"12,54,491.00",00.00,"13,58,182.51",
15-Sep-25,Debit Card,"1,508.00",00.00,"13,59,690.51",
15-Sep-25,IMPS,00.00,"4,53,230.17","9,06,460.34",
15-Sep-25,Debit Card,00.00,"9,06,460.34",00.00,
15-Sep-25,Interest,"4,56,606.25",00.00,"4,56,606.25",
15-Sep-25,NEFT,00.00,"45,660.63","4,10,945.62",
15-Sep-25,Cash,00.00,"68,490.94","3,42,454.68",
15-Sep-25,Reversal,"1,058.53",00.00,"3,43,513.21",
15-Sep-25,Bill,00.00,"1,71,756.61","1,71,756.60",
15-Sep-25,Transfer,00.00,"17,175.66","1,54,580.94",
15-Sep-25,ATM,"3,618.10",00.00,"1,58,199.04",
15-Sep-25,Bill,00.00,"31,639.81","1,26,559.23",
15-Sep-25,Interest,00.00,"31,639.81","94,919.42",
15-Sep-25,RTGS,00.00,"13,559.92","81,359.50",
15-Sep-25,RTGS,61,00.00,"81,420.50",
15-Sep-25,IMPS,00.00,"10,177.56","71,242.94",
15-Sep-25,Transportellaneous,00.00,"7,915.88","63,327.06",
15-Sep-25,Bill,"20,069.77",00.00,"83,396.83",
15-Sep-25,Purchase,00.00,"20,849.21","62,547.62",
15-Sep-25,NEFT,00.00,"31,273.81","31,273.81",
15-Sep-25,Cash,00.00,"31,273.81",00.00,
15-Sep-25,Tax,"2,212.90",00.00,"2,212.90",
15-Sep-25,Commission,52.19,00.00,"2,265.09",
15-Sep-25,Reversal,00.00,283.14,"1,981.95",
15-Sep-25,NEFT,00.00,247.74,"1,734.21",
15-Sep-25,IMPS,00.00,578.07,"1,156.14",
15-Sep-25,Cash,00.00,128.46,"1,027.68",
15-Sep-25,Interest,"10,227.88",00.00,"11,255.56",
15-Sep-25,Commission,00.00,"5,627.78","5,627.78",
15-Sep-25,Commission,00.00,562.78,"5,065.00",
15-Sep-25,NEFT,370.25,00.00,"5,435.25",
15-Sep-25,Interest,"2,31,162.40",00.00,"2,36,597.65",
15-Sep-25,ATM,38.31,00.00,"2,36,635.96",
15-Sep-25,Commission,00.00,"26,292.88","2,10,343.08",
15-Sep-25,ATM,00.00,"30,049.01","1,80,294.07",
15-Sep-25,Transfer,00.00,"90,147.04","90,147.04",
15-Sep-25,Transfer,"2,32,454.78",00.00,"3,22,601.82",
15-Sep-25,NEFT,00.00,"53,766.97","2,68,834.85",
16-Sep-25,Commission,06.10,00.00,"2,68,840.95",
16-Sep-25,Bill,"40,461.00",00.00,"3,09,301.95",
16-Sep-25,Purchase,00.00,"3,09,301.95",00.00,
16-Sep-25,Commission,"1,92,370.40",00.00,"1,92,370.40",
16-Sep-25,Purchase,00.00,"64,123.47","1,28,246.93",
17-Sep-25,Debit Card,00.00,"25,649.39","1,02,597.54",
17-Sep-25,Purchase,00.00,"17,099.59","85,497.95",
17-Sep-25,Cash,00.00,"21,374.49","64,123.46",
17-Sep-25,Interest,"1,766.80",00.00,"65,890.26",
17-Sep-25,Debit Card,00.00,"7,321.14","58,569.12",
17-Sep-25,Cash,"14,616.00",00.00,"73,185.12",
17-Sep-25,Purchase,00.00,"14,637.02","58,548.10",
17-Sep-25,Cash,00.00,"9,758.02","48,790.08",
17-Sep-25,Bill,436,00.00,"49,226.08",
17-Sep-25,Cheque,49.65,00.00,"49,275.73",
17-Sep-25,Transportellaneous,00.00,"9,855.15","39,420.58",
17-Sep-25,Purchase,"43,715.97",00.00,"83,136.55",
17-Sep-25,RTGS,00.00,"20,784.14","62,352.41",
17-Sep-25,Cheque,"31,811.58",00.00,"94,163.99",
17-Sep-25,ATM,"1,92,943.88",00.00,"2,87,107.87",
17-Sep-25,Commission,00.00,"41,015.41","2,46,092.46",
17-Sep-25,Debit Card,00.00,"35,156.07","2,10,936.39",
17-Sep-25,Purchase,"10,35,496.20",00.00,"12,46,432.59",
17-Sep-25,Transportellaneous,113.63,00.00,"12,46,546.22",
17-Sep-25,Transportellaneous,00.00,"1,78,078.03","10,68,468.19",
17-Sep-25,Reversal,"12,869.00",00.00,"10,81,337.19",
18-Sep-25,Debit Card,00.00,"3,60,445.73","7,20,891.46",
18-Sep-25,Bill,00.00,"1,02,984.49","6,17,906.97",
18-Sep-25,ATM,00.00,"68,656.33","5,49,250.64",
18-Sep-25,Purchase,00.00,"5,49,250.64",00.00,
18-Sep-25,Debit Card,"2,16,601.80",00.00,"2,16,601.80",
18-Sep-25,Bill,00.00,"43,320.36","1,73,281.44",
18-Sep-25,Transfer,00.00,"19,253.49","1,54,027.95",
18-Sep-25,Commission,00.40,00.00,"1,54,028.35",
18-Sep-25,RTGS,00.00,"19,253.54","1,34,774.81",
18-Sep-25,Cash,00.00,"22,462.47","1,12,312.34",
19-Sep-25,NEFT,"20,817.48",00.00,"1,33,129.82",
19-Sep-25,Transfer,"15,08,988.50",00.00,"16,42,118.32",
19-Sep-25,Cash,"3,35,668.20",00.00,"19,77,786.52",
19-Sep-25,Cash,00.00,"1,97,778.65","17,80,007.87",
19-Sep-25,Transfer,00.00,"17,80,007.87",00.00,
19-Sep-25,ATM,"16,339.40",00.00,"16,339.40",
19-Sep-25,Cheque,02.80,00.00,"16,342.20",
19-Sep-25,Reversal,00.00,"1,634.22","14,707.98",
19-Sep-25,Commission,488,00.00,"15,195.98",
19-Sep-25,Transfer,"2,237.41",00.00,"17,433.39",
19-Sep-25,Transportellaneous,68,00.00,"17,501.39",
19-Sep-25,Cheque,00.00,"1,944.60","15,556.79",
19-Sep-25,Cash,"2,248.60",00.00,"17,805.39",
19-Sep-25,Transfer,"7,441.70",00.00,"25,247.09",
19-Sep-25,NEFT,204,00.00,"25,451.09",
19-Sep-25,NEFT,00.00,"3,635.87","21,815.22",
19-Sep-25,Transfer,06.60,00.00,"21,821.82",
19-Sep-25,Debit Card,311.85,00.00,"22,133.67",
19-Sep-25,Tax,00.00,"3,161.95","18,971.72",
19-Sep-25,Bill,48.3,00.00,"19,020.02",
19-Sep-25,Transfer,64.4,00.00,"19,084.42",
19-Sep-25,RTGS,00.00,"1,908.44","17,175.98",
19-Sep-25,Tax,00.00,"4,294.00","12,881.98",
19-Sep-25,ATM,00.00,"1,840.28","11,041.70",
19-Sep-25,NEFT,00.00,"1,840.28","9,201.42",
19-Sep-25,Cash,"69,087.80",00.00,"78,289.22",
20-Sep-25,Transportellaneous,00.00,"9,786.15","68,503.07",
20-Sep-25,ATM,97,00.00,"68,600.07",
20-Sep-25,Commission,"2,942.90",00.00,"71,542.97",
20-Sep-25,NEFT,05.00,00.00,"71,547.97",
20-Sep-25,Cheque,00.00,"71,547.97",00.00,
20-Sep-25,Purchase,126,00.00,126,
20-Sep-25,Debit Card,"17,10,198.80",00.00,"17,10,324.80",
20-Sep-25,Transportellaneous,00.00,"8,55,162.40","8,55,162.40",
20-Sep-25,Cheque,00.00,"85,516.24","7,69,646.16",
20-Sep-25,IMPS,53,00.00,"7,69,699.16",
20-Sep-25,Transfer,00.00,"1,28,283.19","6,41,415.97",
20-Sep-25,Debit Card,322.64,00.00,"6,41,738.61",
20-Sep-25,Bill,00.00,"1,28,347.72","5,13,390.89",
20-Sep-25,Cash,00.00,"5,13,390.89",00.00,
20-Sep-25,Bill,02.60,00.00,02.60,
20-Sep-25,Debit Card,00.20,00.00,02.80,
20-Sep-25,Commission,56.5,00.00,59.3,
20-Sep-25,Commission,"2,740.13",00.00,"2,799.43",
20-Sep-25,ATM,63.9,00.00,"2,863.33",
20-Sep-25,Cheque,00.00,954.44,"1,908.89",
20-Sep-25,Purchase,"3,334.00",00.00,"5,242.89",
20-Sep-25,ATM,00.00,655.36,"4,587.53",
20-Sep-25,Interest,00.00,"2,293.77","2,293.76",
20-Sep-25,Tax,"2,664.00",00.00,"4,957.76",
20-Sep-25,Cheque,"90,691.00",00.00,"95,648.76",
20-Sep-25,RTGS,19,00.00,"95,667.76",
20-Sep-25,Debit Card,"3,418.00",00.00,"99,085.76",
20-Sep-25,Cash,00.00,"24,771.44","74,314.32",
20-Sep-25,RTGS,00.00,"10,616.33","63,697.99",
20-Sep-25,Cash,"9,27,717.00",00.00,"9,91,414.99",
20-Sep-25,Transportellaneous,00.00,"1,23,926.87","8,67,488.12",
20-Sep-25,RTGS,00.00,"1,23,926.87","7,43,561.25",
20-Sep-25,Cheque,"2,117.00",00.00,"7,45,678.25",
20-Sep-25,Interest,00.00,"1,06,525.46","6,39,152.79",
20-Sep-25,Commission,00.00,"63,915.28","5,75,237.51",
20-Sep-25,Interest,"3,377.20",00.00,"5,78,614.71",
20-Sep-25,ATM,00.00,"72,326.84","5,06,287.87",
20-Sep-25,Transportellaneous,00.00,"1,01,257.57","4,05,030.30",
20-Sep-25,Transportellaneous,04.00,00.00,"4,05,034.30",
20-Sep-25,Tax,00.00,"1,01,258.58","3,03,775.72",
20-Sep-25,IMPS,"3,206.20",00.00,"3,06,981.92",
20-Sep-25,Reversal,44,00.00,"3,07,025.92",
20-Sep-25,RTGS,00.00,"43,860.85","2,63,165.07",
20-Sep-25,Interest,"19,84,391.50",00.00,"22,47,556.57",
20-Sep-25,Commission,00.00,"11,23,778.29","11,23,778.28",
20-Sep-25,Transportellaneous,140.6,00.00,"11,23,918.88",
20-Sep-25,RTGS,"1,694.92",00.00,"11,25,613.80",
21-Sep-25,Interest,00.00,"11,25,613.80",00.00,
21-Sep-25,Cash,"2,04,585.28",00.00,"2,04,585.28",
21-Sep-25,Commission,00.00,"34,097.55","1,70,487.73",
21-Sep-25,Tax,"8,701.60",00.00,"1,79,189.33",
22-Sep-25,Purchase,12.1,00.00,"1,79,201.43",
22-Sep-25,Tax,"31,767.00",00.00,"2,10,968.43",
22-Sep-25,Interest,47,00.00,"2,11,015.43",
22-Sep-25,Interest,00.00,"42,203.09","1,68,812.34",
22-Sep-25,IMPS,00.00,"21,101.54","1,47,710.80",
22-Sep-25,Cash,"12,995.00",00.00,"1,60,705.80",
22-Sep-25,Cash,00.00,"22,957.97","1,37,747.83",
22-Sep-25,Debit Card,35.1,00.00,"1,37,782.93",
22-Sep-25,Cash,"1,159.00",00.00,"1,38,941.93",
22-Sep-25,NEFT,00.00,"15,437.99","1,23,503.94",
22-Sep-25,Transportellaneous,07.00,00.00,"1,23,510.94",
22-Sep-25,Debit Card,00.00,"12,351.09","1,11,159.85",
22-Sep-25,Cash,00.00,"11,115.99","1,00,043.86",
22-Sep-25,Cash,00.00,"12,505.48","87,538.38",
22-Sep-25,Reversal,38,00.00,"87,576.38",
22-Sep-25,Transportellaneous,225,00.00,"87,801.38",
23-Sep-25,Reversal,106.9,00.00,"87,908.28",
23-Sep-25,Purchase,00.00,"14,651.38","73,256.90",
23-Sep-25,Cash,07.00,00.00,"73,263.90",
23-Sep-25,IMPS,00.00,"12,210.65","61,053.25",
23-Sep-25,Transfer,00.00,"30,526.63","30,526.62",
23-Sep-25,Reversal,00.00,"10,175.54","20,351.08",
23-Sep-25,Commission,00.00,"4,070.22","16,280.86",
23-Sep-25,ATM,00.00,"8,140.43","8,140.43",
23-Sep-25,Interest,00.00,"4,070.22","4,070.22",
23-Sep-25,RTGS,00.00,"4,070.22",00.00,
23-Sep-25,ATM,33.19,00.00,33.19,
23-Sep-25,Debit Card,00.00,03.32,29.87,
24-Sep-25,Tax,153.62,00.00,183.49,
24-Sep-25,Purchase,"18,775.50",00.00,"18,958.99",
24-Sep-25,Reversal,110,00.00,"19,068.99",
24-Sep-25,Bill,00.00,"19,068.99",00.00,
24-Sep-25,Cheque,"1,90,798.69",00.00,"1,90,798.69",
24-Sep-25,IMPS,"20,125.10",00.00,"2,10,923.79",
24-Sep-25,Interest,00.00,"52,730.95","1,58,192.84",
24-Sep-25,Interest,00.00,"39,548.21","1,18,644.63",
24-Sep-25,Transfer,00.00,"23,728.93","94,915.70",
24-Sep-25,Cash,00.00,"15,819.28","79,096.42",
24-Sep-25,Transfer,00.00,"15,819.28","63,277.14",
24-Sep-25,Commission,00.00,"63,277.14",00.00,
24-Sep-25,ATM,34,00.00,34,
25-Sep-25,Reversal,385.12,00.00,419.12,
25-Sep-25,Bill,00.00,59.87,359.25,
25-Sep-25,Purchase,00.00,359.25,00.00,
25-Sep-25,Transportellaneous,"2,36,865.00",00.00,"2,36,865.00",
25-Sep-25,Purchase,148.2,00.00,"2,37,013.20",
25-Sep-25,Purchase,00.00,"29,626.65","2,07,386.55",
25-Sep-25,Commission,00.00,"23,042.95","1,84,343.60",
25-Sep-25,Purchase,00.00,"30,723.93","1,53,619.67",
25-Sep-25,Commission,00.00,"51,206.56","1,02,413.11",
25-Sep-25,Bill,"9,83,243.00",00.00,"10,85,656.11",
25-Sep-25,Debit Card,00.00,"1,80,942.69","9,04,713.42",
25-Sep-25,Tax,00.00,"2,26,178.36","6,78,535.06",
25-Sep-25,RTGS,"62,258.53",00.00,"7,40,793.59",
25-Sep-25,Reversal,00.00,"7,40,793.59",00.00,
25-Sep-25,Transportellaneous,49.1,00.00,49.1,
25-Sep-25,Transportellaneous,00.00,24.55,24.55,
25-Sep-25,ATM,00.00,00.00,24.55,
25-Sep-25,Transportellaneous,253,00.00,277.55,
25-Sep-25,Cash,00.00,34.69,242.86,
25-Sep-25,Purchase,00.00,34.69,208.17,
25-Sep-25,Transportellaneous,361.9,00.00,570.07,
25-Sep-25,Interest,30.4,00.00,600.47,
25-Sep-25,Tax,00.00,200.16,400.31,
25-Sep-25,Purchase,41,00.00,441.31,
25-Sep-25,Cash,31.88,00.00,473.19,
25-Sep-25,Reversal,00.00,94.64,378.55,
25-Sep-25,Purchase,366.11,00.00,744.66,
25-Sep-25,IMPS,06.30,00.00,750.96,
25-Sep-25,Commission,04.00,00.00,754.96,
25-Sep-25,Debit Card,04.11,00.00,759.07,
25-Sep-25,Commission,"4,053.30",00.00,"4,812.37",
25-Sep-25,RTGS,430.49,00.00,"5,242.86",
25-Sep-25,Transfer,259,00.00,"5,501.86",
26-Sep-25,Cheque,00.00,"1,100.37","4,401.49",
26-Sep-25,Reversal,"3,002.03",00.00,"7,403.52",
26-Sep-25,Reversal,00.00,"2,467.84","4,935.68",
26-Sep-25,IMPS,00.00,548.41,"4,387.27",
26-Sep-25,IMPS,412.01,00.00,"4,799.28",
26-Sep-25,NEFT,"3,813.07",00.00,"8,612.35",
26-Sep-25,Cash,"23,538.00",00.00,"32,150.35",
26-Sep-25,Commission,"1,34,805.20",00.00,"1,66,955.55",
26-Sep-25,IMPS,00.00,"20,869.44","1,46,086.11",
26-Sep-25,Cheque,03.20,00.00,"1,46,089.31",
26-Sep-25,Cash,00.00,"20,869.90","1,25,219.41",
26-Sep-25,Transportellaneous,"1,646.09",00.00,"1,26,865.50",
26-Sep-25,Interest,00.00,"42,288.50","84,577.00",
26-Sep-25,Cash,"1,126.08",00.00,"85,703.08",
26-Sep-25,Cheque,00.00,"14,283.85","71,419.23",
26-Sep-25,Transportellaneous,"18,09,999.20",00.00,"18,81,418.43",
26-Sep-25,Reversal,00.00,"1,88,141.84","16,93,276.59",
26-Sep-25,Transfer,00.00,"2,82,212.77","14,11,063.83",
26-Sep-25,NEFT,44.4,00.00,"14,11,108.23",
26-Sep-25,IMPS,00.00,"1,56,789.80","12,54,318.43",
26-Sep-25,Debit Card,00.00,"12,54,318.43",00.00,
26-Sep-25,Tax,"1,23,414.00",00.00,"1,23,414.00",
26-Sep-25,Purchase,43,00.00,"1,23,457.00",
26-Sep-25,Bill,03.00,00.00,"1,23,460.00",
26-Sep-25,Transportellaneous,00.00,"15,432.50","1,08,027.50",
26-Sep-25,Reversal,00.00,"36,009.17","72,018.33",
26-Sep-25,Debit Card,40.2,00.00,"72,058.53",
26-Sep-25,RTGS,03.00,00.00,"72,061.53",
26-Sep-25,Purchase,00.00,"10,294.50","61,767.03",
26-Sep-25,Transportellaneous,00.00,"20,589.01","41,178.02",
26-Sep-25,Cheque,00.00,"4,117.80","37,060.22",
26-Sep-25,RTGS,00.00,"6,176.70","30,883.52",
26-Sep-25,Debit Card,02.00,00.00,"30,885.52",
26-Sep-25,Transportellaneous,48.92,00.00,"30,934.44",
26-Sep-25,Transfer,"3,127.36",00.00,"34,061.80",
26-Sep-25,Purchase,"3,02,174.00",00.00,"3,36,235.80",
26-Sep-25,Cheque,04.67,00.00,"3,36,240.47",
26-Sep-25,Cheque,00.00,"67,248.09","2,68,992.38",
26-Sep-25,NEFT,"11,263.30",00.00,"2,80,255.68",
26-Sep-25,IMPS,10.46,00.00,"2,80,266.14",
26-Sep-25,Cash,"1,75,759.38",00.00,"4,56,025.52",
26-Sep-25,Transportellaneous,"15,90,511.00",00.00,"20,46,536.52",
26-Sep-25,Transportellaneous,00.00,"2,55,817.07","17,90,719.46",
26-Sep-25,Transportellaneous,00.00,"2,98,453.24","14,92,266.22",
26-Sep-25,NEFT,07.00,00.00,"14,92,273.22",
26-Sep-25,IMPS,00.00,"2,98,454.64","11,93,818.58",
26-Sep-25,Reversal,230.5,00.00,"11,94,049.08",
26-Sep-25,NEFT,"4,62,311.00",00.00,"16,56,360.08",
27-Sep-25,Interest,00.00,"2,36,622.87","14,19,737.21",
27-Sep-25,Interest,"42,548.75",00.00,"14,62,285.96",
27-Sep-25,Cash,00.00,"3,65,571.49","10,96,714.47",
27-Sep-25,RTGS,00.00,"1,21,857.16","9,74,857.31",
27-Sep-25,Reversal,46.13,00.00,"9,74,903.44",
27-Sep-25,Cash,00.00,"1,62,483.91","8,12,419.53",
27-Sep-25,Transportellaneous,00.00,"1,35,403.26","6,77,016.28",
27-Sep-25,Bill,08.00,00.00,"6,77,024.28",
27-Sep-25,Bill,00.00,"67,702.43","6,09,321.85",
27-Sep-25,Cash,00.00,"87,045.98","5,22,275.87",
27-Sep-25,Debit Card,00.00,"74,610.84","4,47,665.03",
27-Sep-25,Cheque,"2,43,554.00",00.00,"6,91,219.03",
28-Sep-25,Reversal,00.00,"1,38,243.81","5,52,975.22",
28-Sep-25,Reversal,"14,771.20",00.00,"5,67,746.42",
28-Sep-25,Interest,00.00,"81,106.63","4,86,639.79",
28-Sep-25,Transportellaneous,00.00,"48,663.98","4,37,975.81",
28-Sep-25,Purchase,"11,64,061.00",00.00,"16,02,036.81",
29-Sep-25,RTGS,00.00,"1,78,004.09","14,24,032.72",
29-Sep-25,Transportellaneous,"5,684.23",00.00,"14,29,716.95",
29-Sep-25,Commission,00.00,"1,42,971.70","12,86,745.25",
29-Sep-25,RTGS,00.00,"1,42,971.69","11,43,773.56",
29-Sep-25,Reversal,02.00,00.00,"11,43,775.56",
29-Sep-25,Reversal,00.00,"3,81,258.52","7,62,517.04",
29-Sep-25,Cheque,00.00,"76,251.70","6,86,265.34",
29-Sep-25,Cash,00.00,"76,251.70","6,10,013.64",
29-Sep-25,Cash,"1,660.50",00.00,"6,11,674.14",
29-Sep-25,Cheque,00.00,"1,52,918.54","4,58,755.60",
29-Sep-25,NEFT,00.00,"1,14,688.90","3,44,066.70",
29-Sep-25,ATM,00.00,"49,152.39","2,94,914.31",
29-Sep-25,Purchase,59.4,00.00,"2,94,973.71",
29-Sep-25,Cheque,"11,43,359.50",00.00,"14,38,333.21",
29-Sep-25,Cheque,00.00,"1,59,814.80","12,78,518.41",
29-Sep-25,IMPS,"6,49,225.00",00.00,"19,27,743.41",
29-Sep-25,ATM,502.27,00.00,"19,28,245.68",
29-Sep-25,Reversal,00.00,"6,42,748.56","12,85,497.12",
29-Sep-25,Debit Card,00.00,"1,83,642.45","11,01,854.67",
29-Sep-25,Tax,"4,33,492.00",00.00,"15,35,346.67",
29-Sep-25,Purchase,00.00,"7,67,673.34","7,67,673.34",
29-Sep-25,Cash,06.69,00.00,"7,67,680.03",
29-Sep-25,ATM,00.00,"7,67,680.03",00.00,
29-Sep-25,Tax,"2,00,583.88",00.00,"2,00,583.88",
29-Sep-25,Transfer,356,00.00,"2,00,939.88",
29-Sep-25,Cheque,45,00.00,"2,00,984.88",
29-Sep-25,IMPS,"2,34,549.03",00.00,"4,35,533.91",
29-Sep-25,Transfer,"17,65,578.00",00.00,"22,01,111.91",
30-Sep-25,RTGS,"9,20,038.00",00.00,"31,21,149.91",
30-Sep-25,ATM,00.00,"4,45,878.56","26,75,271.35",
30-Sep-25,ATM,"14,857.40",00.00,"26,90,128.75",
30-Sep-25,Cheque,126.4,00.00,"26,90,255.15",
30-Sep-25,Debit Card,00.00,"2,98,917.24","23,91,337.91",
30-Sep-25,Purchase,969.7,00.00,"23,92,307.61",
30-Sep-25,Transfer,"2,646.22",00.00,"23,94,953.83",
01-Oct-25,IMPS,"5,10,656.00",00.00,"29,05,609.83",
01-Oct-25,RTGS,"28,190.00",00.00,"29,33,799.83",
01-Oct-25,Transportellaneous,05.50,00.00,"29,33,805.33",
01-Oct-25,Interest,00.00,"4,88,967.56","24,44,837.78",
01-Oct-25,NEFT,196.08,00.00,"24,45,033.86",
01-Oct-25,IMPS,45.3,00.00,"24,45,079.16",
01-Oct-25,Purchase,27.3,00.00,"24,45,106.46",
01-Oct-25,Tax,"1,68,574.50",00.00,"26,13,680.96",
01-Oct-25,ATM,21,00.00,"26,13,701.96",
01-Oct-25,Interest,00.00,"4,35,616.99","21,78,084.97",
01-Oct-25,RTGS,00.00,"2,72,260.62","19,05,824.35",
01-Oct-25,Transportellaneous,302,00.00,"19,06,126.35",
01-Oct-25,RTGS,00.00,"2,38,265.79","16,67,860.56",
01-Oct-25,IMPS,00.00,"8,33,930.28","8,33,930.28",
01-Oct-25,IMPS,00.00,"4,16,965.14","4,16,965.14",
01-Oct-25,Cheque,"4,57,946.20",00.00,"8,74,911.34",
01-Oct-25,IMPS,"70,214.00",00.00,"9,45,125.34",
01-Oct-25,Commission,133,00.00,"9,45,258.34",
01-Oct-25,Interest,124.7,00.00,"9,45,383.04",
01-Oct-25,ATM,00.00,"1,89,076.61","7,56,306.43",
01-Oct-25,Transportellaneous,14.88,00.00,"7,56,321.31",
01-Oct-25,Cash,"46,661.00",00.00,"8,02,982.31",
01-Oct-25,Interest,220.03,00.00,"8,03,202.34",
01-Oct-25,Transfer,"22,721.00",00.00,"8,25,923.34",
01-Oct-25,Bill,244,00.00,"8,26,167.34",
01-Oct-25,Cash,476.94,00.00,"8,26,644.28",
01-Oct-25,ATM,00.00,"1,18,092.04","7,08,552.24",
01-Oct-25,Transfer,"2,354.00",00.00,"7,10,906.24",
02-Oct-25,Cash,00.00,"7,10,906.24",00.00,
02-Oct-25,Reversal,"9,45,265.00",00.00,"9,45,265.00",
02-Oct-25,Purchase,00.00,"1,18,158.13","8,27,106.88",
02-Oct-25,Commission,00.00,"2,75,702.29","5,51,404.59",
02-Oct-25,Cash,"2,554.00",00.00,"5,53,958.59",
02-Oct-25,Bill,00.00,"1,84,652.86","3,69,305.73",
02-Oct-25,NEFT,00.00,"46,163.22","3,23,142.51",
02-Oct-25,Debit Card,00.00,"40,392.81","2,82,749.70",
02-Oct-25,Bill,00.00,"2,82,749.70",00.00,
02-Oct-25,IMPS,35.7,00.00,35.7,
02-Oct-25,Cheque,00.00,05.95,29.75,
02-Oct-25,Transportellaneous,00.00,14.88,14.88,
02-Oct-25,Debit Card,00.00,02.13,12.75,
02-Oct-25,Tax,00.81,00.00,13.56,
02-Oct-25,Interest,00.00,03.39,10.17,
02-Oct-25,Commission,06.60,00.00,16.77,
03-Oct-25,Interest,00.00,02.80,13.98,
03-Oct-25,Interest,"6,78,012.80",00.00,"6,78,026.78",
03-Oct-25,Bill,06.60,00.00,"6,78,033.38",
03-Oct-25,Transportellaneous,"35,118.30",00.00,"7,13,151.68",
03-Oct-25,RTGS,"2,680.00",00.00,"7,15,831.68",
03-Oct-25,Transfer,00.00,"7,15,831.68",00.00,
04-Oct-25,Interest,"6,608.70",00.00,"6,608.70",
04-Oct-25,NEFT,00.00,826.09,"5,782.61",
04-Oct-25,Cheque,"1,891.97",00.00,"7,674.58",
04-Oct-25,NEFT,07.00,00.00,"7,681.58",
04-Oct-25,Commission,321.8,00.00,"8,003.38",
04-Oct-25,Transportellaneous,307.4,00.00,"8,310.78",
04-Oct-25,RTGS,01.00,00.00,"8,311.78",
04-Oct-25,RTGS,00.00,"1,187.40","7,124.38",
04-Oct-25,RTGS,"2,163.30",00.00,"9,287.68",
04-Oct-25,Cheque,00.00,"3,095.89","6,191.79",
04-Oct-25,IMPS,"14,68,069.00",00.00,"14,74,260.79",
04-Oct-25,ATM,"1,543.00",00.00,"14,75,803.79",
04-Oct-25,Interest,"1,324.00",00.00,"14,77,127.79",
04-Oct-25,Transfer,51,00.00,"14,77,178.79",
04-Oct-25,Cash,00.00,"1,84,647.35","12,92,531.44",
04-Oct-25,Cheque,822,00.00,"12,93,353.44",
04-Oct-25,Purchase,"2,13,926.19",00.00,"15,07,279.63",
04-Oct-25,Cheque,00.00,"3,01,455.93","12,05,823.70",
04-Oct-25,NEFT,00.00,"1,72,260.53","10,33,563.17",
04-Oct-25,NEFT,"11,81,006.75",00.00,"22,14,569.92",
05-Oct-25,Cash,00.00,"3,69,094.99","18,45,474.93",
05-Oct-25,Tax,00.00,"3,07,579.16","15,37,895.78",
05-Oct-25,Bill,00.00,"3,84,473.95","11,53,421.84",
05-Oct-25,Cheque,"67,636.20",00.00,"12,21,058.04",
05-Oct-25,Tax,01.00,00.00,"12,21,059.04",
05-Oct-25,IMPS,00.00,"6,10,529.52","6,10,529.52",
05-Oct-25,Transfer,362.5,00.00,"6,10,892.02",
05-Oct-25,NEFT,00.00,"2,03,630.67","4,07,261.35",
05-Oct-25,IMPS,"1,05,026.00",00.00,"5,12,287.35",
05-Oct-25,Bill,00.00,"2,56,143.68","2,56,143.68",
05-Oct-25,Transportellaneous,"2,42,652.00",00.00,"4,98,795.68",
06-Oct-25,Transportellaneous,00.00,"55,421.74","4,43,373.94",
06-Oct-25,Transfer,58.8,00.00,"4,43,432.74",
06-Oct-25,Debit Card,"17,33,229.00",00.00,"21,76,661.74",
06-Oct-25,Reversal,00.00,"2,41,851.30","19,34,810.44",
06-Oct-25,Cash,00.00,"4,83,702.61","14,51,107.83",
06-Oct-25,Debit Card,00.00,"14,51,107.83",00.00,
06-Oct-25,Commission,"2,07,022.00",00.00,"2,07,022.00",
06-Oct-25,IMPS,00.00,"34,503.67","1,72,518.33",
06-Oct-25,Cash,"14,149.00",00.00,"1,86,667.33",
06-Oct-25,Commission,60.4,00.00,"1,86,727.73",
07-Oct-25,Debit Card,00.00,"20,747.53","1,65,980.20",
07-Oct-25,Bill,"3,937.24",00.00,"1,69,917.44",
07-Oct-25,Cheque,"1,05,236.00",00.00,"2,75,153.44",
07-Oct-25,Interest,54.18,00.00,"2,75,207.62",
07-Oct-25,IMPS,"2,107.70",00.00,"2,77,315.32",
07-Oct-25,Cheque,00.00,"92,438.44","1,84,876.88",
07-Oct-25,Bill,00.00,"1,84,876.88",00.00,
07-Oct-25,Purchase,"5,794.10",00.00,"5,794.10",
07-Oct-25,Debit Card,01.00,00.00,"5,795.10",
07-Oct-25,Transportellaneous,"9,30,227.00",00.00,"9,36,022.10",
07-Oct-25,Reversal,55,00.00,"9,36,077.10",
07-Oct-25,IMPS,00.00,"9,36,077.10",00.00,
08-Oct-25,Commission,48.4,00.00,48.4,
08-Oct-25,Purchase,"4,399.00",00.00,"4,447.40",
08-Oct-25,Tax,"16,65,721.80",00.00,"16,70,169.20",
08-Oct-25,Cheque,00.00,"1,85,574.36","14,84,594.84",
08-Oct-25,ATM,273,00.00,"14,84,867.84",
08-Oct-25,Transportellaneous,"3,291.70",00.00,"14,88,159.54",
08-Oct-25,Tax,287,00.00,"14,88,446.54",
08-Oct-25,IMPS,00.00,"2,48,074.42","12,40,372.12",
08-Oct-25,Commission,00.00,"6,20,186.06","6,20,186.06",
08-Oct-25,RTGS,"13,187.00",00.00,"6,33,373.06",
08-Oct-25,ATM,00.00,"2,11,124.35","4,22,248.71",
08-Oct-25,RTGS,00.00,"84,449.74","3,37,798.97",
08-Oct-25,Tax,"12,624.10",00.00,"3,50,423.07",
08-Oct-25,Debit Card,"3,418.00",00.00,"3,53,841.07",
08-Oct-25,Bill,"19,402.00",00.00,"3,73,243.07",
08-Oct-25,IMPS,00.00,"74,648.61","2,98,594.46",
08-Oct-25,IMPS,00.00,"49,765.74","2,48,828.72",
08-Oct-25,Transportellaneous,00.00,"49,765.74","1,99,062.98",
08-Oct-25,Transportellaneous,08.00,00.00,"1,99,070.98",
08-Oct-25,Transportellaneous,"2,744.65",00.00,"2,01,815.63",
08-Oct-25,Cheque,775.33,00.00,"2,02,590.96",
08-Oct-25,Transportellaneous,00.00,"33,765.16","1,68,825.80",
08-Oct-25,Debit Card,"1,125.00",00.00,"1,69,950.80",
08-Oct-25,Cash,00.00,"1,69,950.80",00.00,
08-Oct-25,Purchase,"4,19,822.25",00.00,"4,19,822.25",
08-Oct-25,Debit Card,00.00,"41,982.23","3,77,840.02",
08-Oct-25,Transportellaneous,"20,12,108.00",00.00,"23,89,948.02",
08-Oct-25,Cheque,273.7,00.00,"23,90,221.72",
08-Oct-25,NEFT,00.00,"2,98,777.72","20,91,444.00",
08-Oct-25,IMPS,00.00,"5,22,861.00","15,68,583.00",
08-Oct-25,Commission,00.00,"7,84,291.50","7,84,291.50",
08-Oct-25,Bill,61.46,00.00,"7,84,352.96",
08-Oct-25,Transportellaneous,00.00,"1,96,088.24","5,88,264.72",
08-Oct-25,Purchase,00.00,"65,362.75","5,22,901.97",
08-Oct-25,IMPS,"1,885.90",00.00,"5,24,787.87",
08-Oct-25,Bill,"5,41,943.50",00.00,"10,66,731.37",
08-Oct-25,NEFT,00.00,"1,06,673.14","9,60,058.23",
08-Oct-25,Cash,00.00,"1,37,151.18","8,22,907.05",
08-Oct-25,Bill,"4,555.00",00.00,"8,27,462.05",
08-Oct-25,IMPS,00.00,"8,27,462.05",00.00,
08-Oct-25,ATM,06.00,00.00,06.00,
08-Oct-25,Reversal,00.00,02.00,04.00,
08-Oct-25,Interest,00.00,00.44,03.56,
08-Oct-25,Interest,00.00,00.89,02.67,
08-Oct-25,Purchase,00.00,01.34,01.34,
08-Oct-25,RTGS,00.00,00.45,00.89,
08-Oct-25,Purchase,00.00,00.30,00.59,
08-Oct-25,IMPS,04.00,00.00,04.59,
08-Oct-25,NEFT,00.00,01.53,03.06,
08-Oct-25,Cheque,"1,68,288.25",00.00,"1,68,291.31",
08-Oct-25,Reversal,"31,181.50",00.00,"1,99,472.81",
08-Oct-25,Bill,03.64,00.00,"1,99,476.45",
08-Oct-25,RTGS,00.00,"19,947.65","1,79,528.81",
08-Oct-25,Debit Card,02.00,00.00,"1,79,530.81",
08-Oct-25,Debit Card,382.3,00.00,"1,79,913.11",
08-Oct-25,RTGS,"19,756.48",00.00,"1,99,669.59",
08-Oct-25,Cash,464,00.00,"2,00,133.59",
08-Oct-25,RTGS,00.00,"28,590.51","1,71,543.08",
08-Oct-25,Commission,00.00,"28,590.51","1,42,952.57",
08-Oct-25,Commission,00.00,"20,421.80","1,22,530.77",
08-Oct-25,Cheque,"29,702.00",00.00,"1,52,232.77",
08-Oct-25,IMPS,00.00,"1,52,232.77",00.00,
08-Oct-25,Transportellaneous,"1,212.79",00.00,"1,212.79",
08-Oct-25,Transportellaneous,"3,873.50",00.00,"5,086.29",
08-Oct-25,Transportellaneous,00.00,"1,695.43","3,390.86",
09-Oct-25,Cash,789,00.00,"4,179.86",
09-Oct-25,Interest,00.05,00.00,"4,179.91",
09-Oct-25,Cheque,53.6,00.00,"4,233.51",
09-Oct-25,NEFT,00.00,"2,116.76","2,116.76",
09-Oct-25,Cheque,00.00,211.68,"1,905.08",
09-Oct-25,Reversal,"14,50,205.00",00.00,"14,52,110.08",
09-Oct-25,Debit Card,00.00,"2,90,422.02","11,61,688.06",
09-Oct-25,Tax,"15,75,890.25",00.00,"27,37,578.31",
09-Oct-25,Interest,00.00,"5,47,515.66","21,90,062.65",
09-Oct-25,Debit Card,00.00,"3,12,866.09","18,77,196.56",
09-Oct-25,Bill,21.2,00.00,"18,77,217.76",
09-Oct-25,RTGS,"3,975.60",00.00,"18,81,193.36",
09-Oct-25,Interest,"18,51,215.00",00.00,"37,32,408.36",
09-Oct-25,Transfer,"15,010.75",00.00,"37,47,419.11",
09-Oct-25,Interest,00.00,"37,47,419.11",00.00,
09-Oct-25,RTGS,"14,148.88",00.00,"14,148.88",
09-Oct-25,Cash,00.00,"1,572.10","12,576.78",
09-Oct-25,Transportellaneous,00.00,"4,192.26","8,384.52",
09-Oct-25,Purchase,00.00,"8,384.52",00.00,
09-Oct-25,ATM,"3,342.93",00.00,"3,342.93",
09-Oct-25,Transportellaneous,"3,619.00",00.00,"6,961.93",
09-Oct-25,Reversal,04.50,00.00,"6,966.43",
09-Oct-25,Tax,00.00,"1,741.61","5,224.82",
09-Oct-25,Bill,00.00,"1,306.21","3,918.62",
09-Oct-25,Tax,00.00,00.00,"3,918.62",
09-Oct-25,Transportellaneous,"1,73,887.47",00.00,"1,77,806.09",
09-Oct-25,RTGS,00.00,"59,268.70","1,18,537.39",
09-Oct-25,IMPS,00.00,"23,707.48","94,829.91",
09-Oct-25,Purchase,00.00,"31,609.97","63,219.94",
09-Oct-25,Transportellaneous,07.57,00.00,"63,227.51",
09-Oct-25,Cheque,00.00,"7,903.44","55,324.07",
09-Oct-25,RTGS,00.00,"5,532.41","49,791.66",
09-Oct-25,Transportellaneous,"3,802.14",00.00,"53,593.80",
09-Oct-25,Bill,747,00.00,"54,340.80",
09-Oct-25,NEFT,00.00,"27,170.40","27,170.40",
09-Oct-25,Transportellaneous,00.00,"2,717.04","24,453.36",
09-Oct-25,Tax,00.00,"4,890.67","19,562.69",
09-Oct-25,ATM,00.00,"1,956.27","17,606.42",
09-Oct-25,Cash,125,00.00,"17,731.42",
09-Oct-25,Reversal,458,00.00,"18,189.42",
09-Oct-25,Transfer,00.00,"2,273.68","15,915.74",
09-Oct-25,NEFT,922.27,00.00,"16,838.01",
10-Oct-25,Commission,"6,988.96",00.00,"23,826.97",
10-Oct-25,NEFT,00.00,"4,765.39","19,061.58",
10-Oct-25,Tax,00.00,"3,812.32","15,249.26",
10-Oct-25,Interest,00.00,"1,906.16","13,343.10",
10-Oct-25,IMPS,00.00,"1,482.57","11,860.53",
10-Oct-25,Bill,"2,56,506.03",00.00,"2,68,366.56",
10-Oct-25,Commission,00.00,"29,818.51","2,38,548.05",
10-Oct-25,Commission,00.00,"47,709.61","1,90,838.44",
10-Oct-25,Purchase,00.00,"63,612.81","1,27,225.63",
10-Oct-25,Transfer,41.26,00.00,"1,27,266.89",
10-Oct-25,Cheque,00.00,"1,27,266.89",00.00,
10-Oct-25,Transfer,249.1,00.00,249.1,
10-Oct-25,Interest,62.25,00.00,311.35,
10-Oct-25,Transportellaneous,00.00,77.84,233.51,
10-Oct-25,Purchase,00.00,25.95,207.56,
10-Oct-25,ATM,"30,436.30",00.00,"30,643.86",
10-Oct-25,Transportellaneous,00.00,"30,643.86",00.00,
10-Oct-25,Reversal,"3,08,377.25",00.00,"3,08,377.25",
10-Oct-25,Reversal,"3,084.50",00.00,"3,11,461.75",
10-Oct-25,Bill,00.00,"34,606.86","2,76,854.89",
10-Oct-25,Commission,00.00,"1,38,427.45","1,38,427.44",
10-Oct-25,IMPS,"15,928.00",00.00,"1,54,355.44",
10-Oct-25,Commission,00.00,"17,150.60","1,37,204.84",
10-Oct-25,Tax,00.00,"17,150.61","1,20,054.24",
10-Oct-25,Commission,00.00,"60,027.12","60,027.12",
10-Oct-25,Transfer,00.00,"60,027.12",00.00,
10-Oct-25,Transfer,217.1,00.00,217.1,
10-Oct-25,Cash,"23,508.20",00.00,"23,725.30",
10-Oct-25,Transportellaneous,00.00,"5,931.33","17,793.97",
10-Oct-25,Purchase,00.00,"1,779.40","16,014.57",
10-Oct-25,NEFT,"2,10,050.00",00.00,"2,26,064.57",
10-Oct-25,Commission,00.00,"56,516.14","1,69,548.43",
10-Oct-25,Debit Card,45.9,00.00,"1,69,594.33",
10-Oct-25,Tax,00.00,"28,265.72","1,41,328.61",
10-Oct-25,Transfer,00.00,"20,189.80","1,21,138.81",
10-Oct-25,Purchase,00.00,"1,21,138.81",00.00,
10-Oct-25,Reversal,309,00.00,309,
10-Oct-25,Cash,00.00,44.14,264.86,
10-Oct-25,Reversal,"1,123.77",00.00,"1,388.63",
10-Oct-25,NEFT,00.00,231.44,"1,157.19",
10-Oct-25,IMPS,00.00,165.31,991.88,
10-Oct-25,Purchase,00.00,495.94,495.94,
11-Oct-25,IMPS,"20,118.83",00.00,"20,614.77",
11-Oct-25,Cash,02.00,00.00,"20,616.77",
11-Oct-25,Cash,00.00,"6,872.26","13,744.51",
11-Oct-25,ATM,41.46,00.00,"13,785.97",
11-Oct-25,Reversal,00.00,"1,531.77","12,254.20",
11-Oct-25,ATM,"2,86,763.80",00.00,"2,99,018.00",
11-Oct-25,Reversal,00.00,"29,901.80","2,69,116.20",
11-Oct-25,IMPS,"1,80,550.00",00.00,"4,49,666.20",
11-Oct-25,Reversal,"82,653.38",00.00,"5,32,319.58",
11-Oct-25,Tax,"3,498.94",00.00,"5,35,818.52",
11-Oct-25,Reversal,00.00,"53,581.85","4,82,236.67",
11-Oct-25,IMPS,00.00,"96,447.33","3,85,789.34",
11-Oct-25,Commission,"1,47,518.80",00.00,"5,33,308.14",
11-Oct-25,Interest,00.00,"1,06,661.63","4,26,646.51",
11-Oct-25,Purchase,06.00,00.00,"4,26,652.51",
11-Oct-25,ATM,00.00,"2,13,326.26","2,13,326.26",
11-Oct-25,Commission,"1,039.31",00.00,"2,14,365.57",
12-Oct-25,Debit Card,00.00,"30,623.65","1,83,741.92",
12-Oct-25,Purchase,04.10,00.00,"1,83,746.02",
12-Oct-25,RTGS,00.00,"26,249.43","1,57,496.59",
12-Oct-25,IMPS,00.00,"31,499.32","1,25,997.27",
12-Oct-25,RTGS,07.00,00.00,"1,26,004.27",
12-Oct-25,IMPS,00.00,"21,000.71","1,05,003.56",
12-Oct-25,Cash,00.00,"13,125.45","91,878.12",
12-Oct-25,RTGS,00.00,"30,626.04","61,252.08",
12-Oct-25,Cheque,06.71,00.00,"61,258.79",
12-Oct-25,Cheque,32,00.00,"61,290.79",
12-Oct-25,Tax,00.00,"61,290.79",00.00,
12-Oct-25,RTGS,43,00.00,43,
12-Oct-25,Debit Card,00.00,43,00.00,
12-Oct-25,Tax,98.5,00.00,98.5,
12-Oct-25,Bill,"2,691.00",00.00,"2,789.50",
12-Oct-25,Cash,00.00,929.83,"1,859.67",
12-Oct-25,Interest,00.00,265.67,"1,594.00",
12-Oct-25,Purchase,"20,04,094.50",00.00,"20,05,688.50",
12-Oct-25,Transfer,00.00,"2,00,568.85","18,05,119.65",
12-Oct-25,Cash,"18,25,368.00",00.00,"36,30,487.65",
12-Oct-25,Commission,19,00.00,"36,30,506.65",
12-Oct-25,Transfer,00.00,"6,05,084.44","30,25,422.21",
12-Oct-25,Purchase,06.76,00.00,"30,25,428.97",
12-Oct-25,RTGS,00.00,"4,32,204.14","25,93,224.83",
12-Oct-25,Reversal,04.90,00.00,"25,93,229.73",
13-Oct-25,Transfer,407,00.00,"25,93,636.73",
13-Oct-25,Cheque,00.00,"4,32,272.79","21,61,363.94",
13-Oct-25,Tax,"2,52,058.00",00.00,"24,13,421.94",
13-Oct-25,Bill,"20,74,953.80",00.00,"44,88,375.74",
13-Oct-25,Debit Card,00.00,"4,98,708.42","39,89,667.32",
13-Oct-25,IMPS,00.00,"39,89,667.32",00.00,
13-Oct-25,Reversal,"4,047.00",00.00,"4,047.00",
13-Oct-25,NEFT,40.8,00.00,"4,087.80",
13-Oct-25,Reversal,00.00,817.56,"3,270.24",
13-Oct-25,Cash,"14,61,810.00",00.00,"14,65,080.24",
13-Oct-25,Transfer,"14,807.10",00.00,"14,79,887.34",
13-Oct-25,Debit Card,00.00,"3,69,971.84","11,09,915.51",
13-Oct-25,ATM,"1,54,920.70",00.00,"12,64,836.21",
13-Oct-25,NEFT,06.35,00.00,"12,64,842.56",
13-Oct-25,Commission,00.00,"12,64,842.56",00.00,
13-Oct-25,Debit Card,"16,16,643.00",00.00,"16,16,643.00",
13-Oct-25,Commission,00.00,"1,61,664.30","14,54,978.70",
13-Oct-25,Cheque,"30,579.00",00.00,"14,85,557.70",
13-Oct-25,IMPS,00.00,"1,85,694.71","12,99,862.99",
13-Oct-25,Debit Card,00.00,"1,44,429.22","11,55,433.77",
13-Oct-25,IMPS,00.00,"1,92,572.30","9,62,861.48",
13-Oct-25,Transportellaneous,"4,00,443.25",00.00,"13,63,304.73",
13-Oct-25,Cheque,"16,15,205.00",00.00,"29,78,509.73",
13-Oct-25,Commission,00.00,"7,44,627.43","22,33,882.30",
13-Oct-25,Commission,"16,82,134.00",00.00,"39,16,016.30",
13-Oct-25,NEFT,"32,589.97",00.00,"39,48,606.27",
13-Oct-25,Reversal,00.00,"6,58,101.05","32,90,505.22",
13-Oct-25,Tax,00.00,"8,22,626.31","24,67,878.92",
13-Oct-25,Debit Card,00.00,"3,52,554.13","21,15,324.79",
13-Oct-25,ATM,"11,957.50",00.00,"21,27,282.29",
14-Oct-25,IMPS,36.58,00.00,"21,27,318.87",
14-Oct-25,Transportellaneous,464.4,00.00,"21,27,783.27",
14-Oct-25,Transportellaneous,"15,890.70",00.00,"21,43,673.97",
14-Oct-25,Cash,"2,938.90",00.00,"21,46,612.87",
14-Oct-25,ATM,00.00,"2,68,326.61","18,78,286.26",
14-Oct-25,Transportellaneous,00.00,"9,39,143.13","9,39,143.13",
14-Oct-25,RTGS,54,00.00,"9,39,197.13",
14-Oct-25,Debit Card,"17,892.10",00.00,"9,57,089.23",
14-Oct-25,Commission,488,00.00,"9,57,577.23",
14-Oct-25,RTGS,"80,874.60",00.00,"10,38,451.83",
14-Oct-25,Tax,57.1,00.00,"10,38,508.93",
14-Oct-25,Debit Card,00.00,"1,03,850.89","9,34,658.04",
15-Oct-25,Transportellaneous,33,00.00,"9,34,691.04",
15-Oct-25,RTGS,"2,872.00",00.00,"9,37,563.04",
15-Oct-25,IMPS,00.00,"1,87,512.61","7,50,050.43",
15-Oct-25,Transfer,00.00,"75,005.04","6,75,045.39",
15-Oct-25,Reversal,00.00,"84,380.67","5,90,664.72",
15-Oct-25,Cash,00.00,"84,380.67","5,06,284.05",
15-Oct-25,Tax,00.00,"2,53,142.03","2,53,142.02",
15-Oct-25,RTGS,00.00,"50,628.40","2,02,513.62",
15-Oct-25,Debit Card,138.75,00.00,"2,02,652.37",
15-Oct-25,Transfer,00.00,"28,950.34","1,73,702.03",
15-Oct-25,Transfer,"8,77,235.50",00.00,"10,50,937.53",
15-Oct-25,Cash,00.00,"3,50,312.51","7,00,625.02",
15-Oct-25,Cheque,00.00,"77,847.22","6,22,777.80",
15-Oct-25,NEFT,01.20,00.00,"6,22,779.00",
15-Oct-25,Reversal,00.00,"1,03,796.50","5,18,982.50",
15-Oct-25,Bill,"1,50,402.80",00.00,"6,69,385.30",
15-Oct-25,Transfer,00.00,"95,626.47","5,73,758.83",
15-Oct-25,Bill,00.00,"57,375.88","5,16,382.95",
15-Oct-25,Transfer,"20,07,881.50",00.00,"25,24,264.45",
16-Oct-25,Debit Card,64,00.00,"25,24,328.45",
16-Oct-25,ATM,"16,05,747.00",00.00,"41,30,075.45",
16-Oct-25,Tax,00.00,"8,26,015.09","33,04,060.36",
16-Oct-25,RTGS,00.00,"4,13,007.55","28,91,052.82",
16-Oct-25,Transfer,00.00,"4,81,842.14","24,09,210.68",
16-Oct-25,Cheque,00.00,"3,44,172.95","20,65,037.73",
16-Oct-25,RTGS,"3,113.74",00.00,"20,68,151.47",
16-Oct-25,ATM,00.00,"5,17,037.87","15,51,113.60",
16-Oct-25,IMPS,"85,523.90",00.00,"16,36,637.50",
16-Oct-25,Purchase,"18,89,833.00",00.00,"35,26,470.50",
16-Oct-25,RTGS,00.00,"7,05,294.10","28,21,176.40",
16-Oct-25,Commission,319.96,00.00,"28,21,496.36",
16-Oct-25,IMPS,00.00,"28,21,496.36",00.00,
16-Oct-25,Transportellaneous,03.00,00.00,03.00,
16-Oct-25,ATM,04.90,00.00,07.90,
16-Oct-25,Bill,00.00,00.79,07.11,
16-Oct-25,NEFT,00.00,01.42,05.69,
16-Oct-25,NEFT,00.00,05.69,00.00,
16-Oct-25,Commission,"3,917.00",00.00,"3,917.00",
16-Oct-25,Purchase,00.00,"1,305.67","2,611.33",
16-Oct-25,Bill,00.00,261.13,"2,350.20",
16-Oct-25,Interest,"9,675.66",00.00,"12,025.86",
16-Oct-25,RTGS,716,00.00,"12,741.86",
16-Oct-25,RTGS,00.00,"1,820.27","10,921.59",
16-Oct-25,Purchase,00.00,"1,092.16","9,829.43",
16-Oct-25,Debit Card,00.00,"2,457.36","7,372.07",
16-Oct-25,Transfer,00.00,819.12,"6,552.95",
16-Oct-25,Tax,"31,294.10",00.00,"37,847.05",
16-Oct-25,Reversal,27,00.00,"37,874.05",
16-Oct-25,Bill,531.5,00.00,"38,405.55",
16-Oct-25,IMPS,"12,850.00",00.00,"51,255.55",
16-Oct-25,Cash,00.00,"17,085.18","34,170.37",
16-Oct-25,Transfer,255,00.00,"34,425.37",
16-Oct-25,Transportellaneous,00.00,"34,425.37",00.00,
16-Oct-25,Commission,53,00.00,53,
16-Oct-25,IMPS,"12,661.40",00.00,"12,714.40",
16-Oct-25,Interest,00.00,"1,412.71","11,301.69",
16-Oct-25,Cheque,03.87,00.00,"11,305.56",
16-Oct-25,Transfer,238,00.00,"11,543.56",
16-Oct-25,Debit Card,00.00,"5,771.78","5,771.78",
16-Oct-25,Tax,"5,185.00",00.00,"10,956.78",
16-Oct-25,Tax,00.00,"1,826.13","9,130.65",
16-Oct-25,Cheque,00.00,"1,014.52","8,116.13",
16-Oct-25,Reversal,25,00.00,"8,141.13",
16-Oct-25,Commission,00.00,904.57,"7,236.56",
16-Oct-25,Commission,00.00,804.06,"6,432.50",
16-Oct-25,Cheque,00.00,714.72,"5,717.78",
16-Oct-25,Interest,52.31,00.00,"5,770.09",
16-Oct-25,Transportellaneous,12,00.00,"5,782.09",
16-Oct-25,Reversal,"3,578.11",00.00,"9,360.20",
16-Oct-25,Reversal,00.00,"9,360.20",00.00,
16-Oct-25,Cheque,04.00,00.00,04.00,
16-Oct-25,Cheque,00.00,01.33,02.67,
16-Oct-25,Commission,00.00,00.45,02.22,
16-Oct-25,NEFT,926.06,00.00,928.28,
16-Oct-25,RTGS,00.00,103.14,825.14,
16-Oct-25,NEFT,00.00,825.14,00.00,
16-Oct-25,Cheque,59,00.00,59,
16-Oct-25,Tax,00.00,59,00.00,
16-Oct-25,Commission,"1,99,612.00",00.00,"1,99,612.00",
16-Oct-25,Interest,00.00,"66,537.33","1,33,074.67",
16-Oct-25,IMPS,00.00,"44,358.22","88,716.45",
16-Oct-25,Bill,"11,78,531.80",00.00,"12,67,248.25",
16-Oct-25,Transportellaneous,24,00.00,"12,67,272.25",
16-Oct-25,Bill,04.90,00.00,"12,67,277.15",
16-Oct-25,Cheque,00.30,00.00,"12,67,277.45",
16-Oct-25,Cheque,"16,617.40",00.00,"12,83,894.85",
16-Oct-25,NEFT,00.00,"12,83,894.85",00.00,
16-Oct-25,NEFT,20.5,00.00,20.5,
16-Oct-25,Transportellaneous,00.00,02.05,18.45,
16-Oct-25,IMPS,00.00,18.45,00.00,
16-Oct-25,Transportellaneous,04.00,00.00,04.00,
16-Oct-25,Transportellaneous,"16,60,879.25",00.00,"16,60,883.25",
16-Oct-25,Cheque,00.00,"2,07,610.41","14,53,272.84",
16-Oct-25,Transfer,00.00,"7,26,636.42","7,26,636.42",
16-Oct-25,Commission,474,00.00,"7,27,110.42",
16-Oct-25,NEFT,"2,54,482.00",00.00,"9,81,592.42",
16-Oct-25,ATM,05.24,00.00,"9,81,597.66",
16-Oct-25,Transportellaneous,00.00,"4,90,798.83","4,90,798.83",
16-Oct-25,RTGS,411,00.00,"4,91,209.83",
17-Oct-25,Tax,"28,911.80",00.00,"5,20,121.63",
17-Oct-25,Cash,00.00,"57,791.29","4,62,330.34",
17-Oct-25,Purchase,00.00,"2,31,165.17","2,31,165.17",
17-Oct-25,Cheque,00.00,"57,791.29","1,73,373.88",
17-Oct-25,Commission,00.00,"86,686.94","86,686.94",
17-Oct-25,Debit Card,00.00,"9,631.88","77,055.06",
17-Oct-25,ATM,00.00,"12,842.51","64,212.55",
17-Oct-25,Commission,"20,00,571.50",00.00,"20,64,784.05",
17-Oct-25,NEFT,"12,906.43",00.00,"20,77,690.48",
17-Oct-25,Bill,03.00,00.00,"20,77,693.48",
17-Oct-25,Cheque,00.00,"2,96,813.35","17,80,880.13",
17-Oct-25,Debit Card,00.00,"2,22,610.02","15,58,270.11",
17-Oct-25,Transfer,"2,44,923.80",00.00,"18,03,193.91",
17-Oct-25,Cheque,00.00,"6,01,064.64","12,02,129.27",
17-Oct-25,ATM,00.00,"6,01,064.64","6,01,064.64",
17-Oct-25,Purchase,60.92,00.00,"6,01,125.56",
17-Oct-25,Tax,00.00,"6,01,125.56",00.00,
17-Oct-25,Bill,"12,82,555.00",00.00,"12,82,555.00",
17-Oct-25,NEFT,"1,16,942.00",00.00,"13,99,497.00",
17-Oct-25,Transfer,333,00.00,"13,99,830.00",
17-Oct-25,IMPS,00.00,"1,74,978.75","12,24,851.25",
17-Oct-25,Cash,00.00,"1,53,106.41","10,71,744.84",
17-Oct-25,Cheque,00.00,"3,57,248.28","7,14,496.56",
17-Oct-25,Cash,"57,959.50",00.00,"7,72,456.06",
17-Oct-25,Reversal,00.00,"77,245.61","6,95,210.45",
17-Oct-25,Cash,00.00,"3,47,605.23","3,47,605.22",
17-Oct-25,Transfer,00.00,"1,15,868.41","2,31,736.81",
17-Oct-25,Debit Card,"32,537.54",00.00,"2,64,274.35",
17-Oct-25,Purchase,17.8,00.00,"2,64,292.15",
17-Oct-25,Reversal,00.00,"44,048.69","2,20,243.46",
17-Oct-25,RTGS,00.00,"73,414.49","1,46,828.97",
17-Oct-25,Purchase,00.00,"20,975.57","1,25,853.40",
17-Oct-25,NEFT,00.00,"31,463.35","94,390.05",
17-Oct-25,Purchase,00.00,"11,798.76","82,591.29",
17-Oct-25,Cash,"2,11,834.75",00.00,"2,94,426.04",
17-Oct-25,NEFT,00.00,"32,714.00","2,61,712.04",
17-Oct-25,RTGS,174,00.00,"2,61,886.04",
17-Oct-25,RTGS,08.00,00.00,"2,61,894.04",
17-Oct-25,Transfer,"2,21,129.72",00.00,"4,83,023.76",
17-Oct-25,Debit Card,"12,26,771.50",00.00,"17,09,795.26",
17-Oct-25,IMPS,00.00,"2,44,256.47","14,65,538.79",
17-Oct-25,RTGS,"1,04,467.62",00.00,"15,70,006.41",
17-Oct-25,Transportellaneous,00.00,"3,92,501.60","11,77,504.81",
17-Oct-25,NEFT,00.00,"1,96,250.80","9,81,254.01",
17-Oct-25,Cash,48.9,00.00,"9,81,302.91",
17-Oct-25,RTGS,00.00,"1,22,662.86","8,58,640.05",
17-Oct-25,Commission,00.00,"85,864.01","7,72,776.04",
17-Oct-25,Commission,00.00,"96,597.01","6,76,179.04",
17-Oct-25,Transfer,"1,78,219.20",00.00,"8,54,398.24",
17-Oct-25,Cheque,00.00,"1,70,879.65","6,83,518.59",
17-Oct-25,Cheque,343.7,00.00,"6,83,862.29",
17-Oct-25,IMPS,"26,041.57",00.00,"7,09,903.86",
17-Oct-25,Interest,00.00,"70,990.39","6,38,913.47",
17-Oct-25,NEFT,381.9,00.00,"6,39,295.37",
17-Oct-25,Debit Card,00.00,"71,032.82","5,68,262.55",
17-Oct-25,IMPS,"1,923.90",00.00,"5,70,186.45",
17-Oct-25,ATM,"1,903.00",00.00,"5,72,089.45",
17-Oct-25,RTGS,"16,534.14",00.00,"5,88,623.59",
17-Oct-25,Reversal,00.00,"73,577.95","5,15,045.64",
17-Oct-25,Commission,00.00,"1,28,761.41","3,86,284.23",
17-Oct-25,NEFT,"10,08,066.25",00.00,"13,94,350.48",
17-Oct-25,Bill,"54,618.50",00.00,"14,48,968.98",
17-Oct-25,Cash,"19,66,176.00",00.00,"34,15,144.98",
17-Oct-25,Interest,72.8,00.00,"34,15,217.78",
17-Oct-25,RTGS,16,00.00,"34,15,233.78",
17-Oct-25,Cheque,02.00,00.00,"34,15,235.78",
17-Oct-25,IMPS,384.22,00.00,"34,15,620.00",
17-Oct-25,RTGS,"84,530.10",00.00,"35,00,150.10",
17-Oct-25,Commission,05.10,00.00,"35,00,155.20",
17-Oct-25,Purchase,04.15,00.00,"35,00,159.35",
17-Oct-25,RTGS,00.00,"3,50,015.94","31,50,143.42",
17-Oct-25,IMPS,269,00.00,"31,50,412.42",
17-Oct-25,ATM,00.00,"5,25,068.74","26,25,343.68",
17-Oct-25,Cash,00.00,"3,28,167.96","22,97,175.72",
17-Oct-25,Transportellaneous,00.00,"2,29,717.57","20,67,458.15",
17-Oct-25,Debit Card,51.6,00.00,"20,67,509.75",
17-Oct-25,Tax,33.7,00.00,"20,67,543.45",
17-Oct-25,NEFT,178,00.00,"20,67,721.45",
17-Oct-25,NEFT,"15,21,899.80",00.00,"35,89,621.25",
17-Oct-25,Bill,00.00,"5,12,803.04","30,76,818.21",
17-Oct-25,NEFT,69.4,00.00,"30,76,887.61",
17-Oct-25,IMPS,25.29,00.00,"30,76,912.90",
17-Oct-25,IMPS,477,00.00,"30,77,389.90",
17-Oct-25,Transfer,00.00,"10,25,796.63","20,51,593.27",
17-Oct-25,ATM,00.00,"3,41,932.21","17,09,661.06",
17-Oct-25,ATM,00.00,"2,44,237.29","14,65,423.77",
17-Oct-25,Debit Card,00.00,"2,44,237.30","12,21,186.48",
17-Oct-25,Cash,00.00,"2,03,531.08","10,17,655.40",
17-Oct-25,Interest,00.00,"10,17,655.40",00.00,
17-Oct-25,Transfer,"1,59,660.10",00.00,"1,59,660.10",
17-Oct-25,NEFT,270.74,00.00,"1,59,930.84",
17-Oct-25,RTGS,00.00,"19,991.36","1,39,939.48",
17-Oct-25,ATM,"6,89,754.00",00.00,"8,29,693.48",
17-Oct-25,ATM,"1,23,893.50",00.00,"9,53,586.98",
17-Oct-25,Purchase,59.96,00.00,"9,53,646.94",
17-Oct-25,Commission,00.00,"95,364.69","8,58,282.25",
17-Oct-25,Transfer,00.00,"1,71,656.45","6,86,625.80",
17-Oct-25,Commission,117,00.00,"6,86,742.80",
17-Oct-25,Cheque,"17,00,779.00",00.00,"23,87,521.80",
17-Oct-25,NEFT,"2,082.95",00.00,"23,89,604.75",
18-Oct-25,Bill,00.00,"2,98,700.59","20,90,904.16",
18-Oct-25,Debit Card,"93,604.25",00.00,"21,84,508.41",
18-Oct-25,ATM,00.00,"4,36,901.68","17,47,606.73",
18-Oct-25,Transfer,33.6,00.00,"17,47,640.33",
18-Oct-25,Purchase,00.00,"1,74,764.03","15,72,876.30",
18-Oct-25,ATM,"1,208.15",00.00,"15,74,084.45",
18-Oct-25,Transportellaneous,00.00,"7,87,042.23","7,87,042.22",
18-Oct-25,IMPS,01.30,00.00,"7,87,043.52",
18-Oct-25,Purchase,00.00,"78,704.35","7,08,339.17",
18-Oct-25,NEFT,00.00,"70,833.92","6,37,505.25",
18-Oct-25,NEFT,11,00.00,"6,37,516.25",
18-Oct-25,Bill,"3,56,185.50",00.00,"9,93,701.75",
18-Oct-25,NEFT,00.00,"3,31,233.92","6,62,467.83",
18-Oct-25,ATM,00.00,"3,31,233.92","3,31,233.91",
18-Oct-25,Tax,00.00,"33,123.39","2,98,110.52",
18-Oct-25,Interest,"3,499.54",00.00,"3,01,610.06",
18-Oct-25,Purchase,"7,78,252.00",00.00,"10,79,862.06",
18-Oct-25,Cheque,00.00,"5,39,931.03","5,39,931.03",
18-Oct-25,Reversal,00.00,"2,69,965.52","2,69,965.52",
18-Oct-25,Cash,645,00.00,"2,70,610.52",
18-Oct-25,Debit Card,00.00,"67,652.63","2,02,957.89",
18-Oct-25,Commission,12.5,00.00,"2,02,970.39",
18-Oct-25,Cheque,00.00,"67,656.80","1,35,313.59",
18-Oct-25,Transportellaneous,00.00,"15,034.84","1,20,278.75",
18-Oct-25,ATM,00.00,"20,046.46","1,00,232.29",
18-Oct-25,IMPS,"1,30,180.00",00.00,"2,30,412.29",
18-Oct-25,Purchase,01.91,00.00,"2,30,414.20",
18-Oct-25,Cash,00.00,"23,041.42","2,07,372.78",
18-Oct-25,Bill,00.00,"34,562.13","1,72,810.65",
19-Oct-25,Cash,00.00,"43,202.66","1,29,607.99",
19-Oct-25,NEFT,00.00,"1,29,607.99",00.00,
19-Oct-25,Bill,01.30,00.00,01.30,
19-Oct-25,Bill,"15,425.40",00.00,"15,426.70",
19-Oct-25,Transportellaneous,00.00,"5,142.23","10,284.47",
19-Oct-25,Debit Card,00.00,"2,571.12","7,713.35",
19-Oct-25,Transfer,03.00,00.00,"7,716.35",
19-Oct-25,ATM,"1,11,391.00",00.00,"1,19,107.35",
19-Oct-25,Bill,05.20,00.00,"1,19,112.55",
19-Oct-25,Tax,"2,488.00",00.00,"1,21,600.55",
19-Oct-25,Tax,47.85,00.00,"1,21,648.40",
19-Oct-25,Commission,00.00,"40,549.47","81,098.93",
19-Oct-25,ATM,00.00,"27,032.98","54,065.95",
19-Oct-25,Purchase,03.00,00.00,"54,068.95",
19-Oct-25,Bill,00.00,"18,022.98","36,045.97",
19-Oct-25,Interest,"2,621.10",00.00,"38,667.07",
19-Oct-25,NEFT,182,00.00,"38,849.07",
19-Oct-25,Transportellaneous,36.05,00.00,"38,885.12",
19-Oct-25,NEFT,00.00,"12,961.71","25,923.41",
19-Oct-25,Cash,00.00,"12,961.71","12,961.70",
19-Oct-25,Purchase,00.00,"1,296.17","11,665.53",
19-Oct-25,Cheque,"13,900.53",00.00,"25,566.06",
20-Oct-25,Cheque,"29,599.00",00.00,"55,165.06",
20-Oct-25,NEFT,121.36,00.00,"55,286.42",
20-Oct-25,RTGS,06.32,00.00,"55,292.74",
20-Oct-25,Transportellaneous,00.00,"6,911.59","48,381.15",
20-Oct-25,Reversal,"17,919.00",00.00,"66,300.15",
20-Oct-25,Transportellaneous,00.00,"6,630.02","59,670.13",
20-Oct-25,Interest,00.00,"7,458.77","52,211.36",
20-Oct-25,NEFT,00.00,"5,801.26","46,410.10",
20-Oct-25,RTGS,00.00,"5,156.68","41,253.42",
20-Oct-25,Debit Card,00.00,"8,250.68","33,002.74",
20-Oct-25,Tax,"1,716.00",00.00,"34,718.74",
20-Oct-25,Interest,677.9,00.00,"35,396.64",
20-Oct-25,Cheque,00.00,"35,396.64",00.00,
20-Oct-25,Purchase,"10,76,976.25",00.00,"10,76,976.25",
20-Oct-25,Interest,"17,21,042.00",00.00,"27,98,018.25",
20-Oct-25,Reversal,70,00.00,"27,98,088.25",
20-Oct-25,Transfer,"1,84,750.40",00.00,"29,82,838.65",
20-Oct-25,Reversal,00.00,"3,31,426.52","26,51,412.13",
20-Oct-25,IMPS,00.00,"3,78,773.16","22,72,638.97",
20-Oct-25,Reversal,00.00,"7,57,546.32","15,15,092.65",
20-Oct-25,Reversal,"2,288.00",00.00,"15,17,380.65",
20-Oct-25,ATM,00.00,"1,51,738.07","13,65,642.58",
20-Oct-25,Commission,08.00,00.00,"13,65,650.58",
20-Oct-25,Reversal,00.00,"6,82,825.29","6,82,825.29",
20-Oct-25,IMPS,00.00,"1,13,804.22","5,69,021.08",
20-Oct-25,Cash,00.00,"2,84,510.54","2,84,510.54",
20-Oct-25,Cash,00.00,"28,451.05","2,56,059.49",
20-Oct-25,Commission,"14,187.61",00.00,"2,70,247.10",
21-Oct-25,Cash,142,00.00,"2,70,389.10",
21-Oct-25,Purchase,00.00,"38,627.01","2,31,762.09",
21-Oct-25,Cash,"5,928.00",00.00,"2,37,690.09",
21-Oct-25,Purchase,00.00,"2,37,690.09",00.00,
21-Oct-25,Debit Card,299,00.00,299,
21-Oct-25,Interest,00.00,59.8,239.2,
21-Oct-25,Transportellaneous,00.00,26.58,212.62,
21-Oct-25,Bill,00.00,30.37,182.25,
21-Oct-25,Cheque,00.00,30.38,151.88,
21-Oct-25,ATM,00.00,50.63,101.25,
21-Oct-25,ATM,00.00,33.75,67.5,
21-Oct-25,RTGS,00.00,16.88,50.62,
21-Oct-25,Purchase,"5,96,662.00",00.00,"5,96,712.62",
21-Oct-25,ATM,00.00,"66,301.40","5,30,411.22",
21-Oct-25,IMPS,00.00,"2,65,205.61","2,65,205.61",
21-Oct-25,NEFT,00.00,"26,520.56","2,38,685.05",
21-Oct-25,Purchase,00.00,"26,520.56","2,12,164.49",
21-Oct-25,Debit Card,"2,618.80",00.00,"2,14,783.29",
21-Oct-25,IMPS,"19,84,938.00",00.00,"21,99,721.29",
21-Oct-25,NEFT,00.00,"2,74,965.16","19,24,756.13",
21-Oct-25,Reversal,03.07,00.00,"19,24,759.20",
22-Oct-25,IMPS,00.00,"19,24,759.20",00.00,
22-Oct-25,Debit Card,480.24,00.00,480.24,
22-Oct-25,ATM,00.00,68.61,411.63,
22-Oct-25,Interest,"22,921.00",00.00,"23,332.63",
22-Oct-25,Purchase,07.70,00.00,"23,340.33",
22-Oct-25,Reversal,"3,606.00",00.00,"26,946.33",
22-Oct-25,Transfer,"2,88,076.00",00.00,"3,15,022.33",
22-Oct-25,Purchase,00.00,"35,002.48","2,80,019.85",
23-Oct-25,Cheque,00.00,"40,002.84","2,40,017.01",
23-Oct-25,NEFT,00.00,"48,003.40","1,92,013.61",
24-Oct-25,Debit Card,00.00,"48,003.40","1,44,010.21",
24-Oct-25,Reversal,05.00,00.00,"1,44,015.21",
24-Oct-25,Commission,303.49,00.00,"1,44,318.70",
24-Oct-25,IMPS,00.00,"14,431.87","1,29,886.83",
24-Oct-25,Transfer,00.00,"16,235.85","1,13,650.98",
24-Oct-25,Cash,"3,885.00",00.00,"1,17,535.98",
24-Oct-25,Cash,00.00,"16,790.85","1,00,745.13",
24-Oct-25,Commission,"11,187.00",00.00,"1,11,932.13",
24-Oct-25,Reversal,00.00,"12,436.90","99,495.23",
24-Oct-25,NEFT,00.00,"19,899.05","79,596.18",
25-Oct-25,Interest,00.00,"39,798.09","39,798.09",
25-Oct-25,Purchase,00.00,"13,266.03","26,532.06",
25-Oct-25,Interest,00.00,"13,266.03","13,266.03",
25-Oct-25,Purchase,64,00.00,"13,330.03",
25-Oct-25,Bill,00.00,"2,666.01","10,664.02",
25-Oct-25,Debit Card,02.28,00.00,"10,666.30",
25-Oct-25,Purchase,00.00,"5,333.15","5,333.15",
25-Oct-25,Tax,00.00,"1,066.63","4,266.52",
25-Oct-25,ATM,05.00,00.00,"4,271.52",
25-Oct-25,Cash,00.00,"1,067.88","3,203.64",
25-Oct-25,Transfer,"2,13,147.70",00.00,"2,16,351.34",
25-Oct-25,ATM,"4,001.00",00.00,"2,20,352.34",
25-Oct-25,Cash,283.74,00.00,"2,20,636.08",
25-Oct-25,Commission,"1,495.84",00.00,"2,22,131.92",
25-Oct-25,Purchase,"23,321.00",00.00,"2,45,452.92",
25-Oct-25,Transfer,05.86,00.00,"2,45,458.78",
25-Oct-25,Cash,509,00.00,"2,45,967.78",
25-Oct-25,Cheque,"2,00,335.00",00.00,"4,46,302.78",
25-Oct-25,Interest,07.00,00.00,"4,46,309.78",
25-Oct-25,Transportellaneous,00.00,"44,630.98","4,01,678.80",
25-Oct-25,RTGS,05.00,00.00,"4,01,683.80",
25-Oct-25,Tax,"2,28,956.38",00.00,"6,30,640.18",
26-Oct-25,Bill,16,00.00,"6,30,656.18",
26-Oct-25,Cash,00.00,"6,30,656.18",00.00,
26-Oct-25,Reversal,383.7,00.00,383.7,
26-Oct-25,ATM,00.00,76.74,306.96,
26-Oct-25,ATM,"8,53,609.80",00.00,"8,53,916.76",
26-Oct-25,Bill,00.00,"1,06,739.60","7,47,177.16",
26-Oct-25,Transportellaneous,46,00.00,"7,47,223.16",
26-Oct-25,Transportellaneous,00.00,"1,86,805.79","5,60,417.37",
26-Oct-25,RTGS,00.00,"56,041.74","5,04,375.63",
26-Oct-25,NEFT,00.00,"1,68,125.21","3,36,250.42",
26-Oct-25,ATM,00.00,"56,041.74","2,80,208.68",
26-Oct-25,Cash,00.00,"40,029.81","2,40,178.87",
26-Oct-25,Transfer,00.00,"24,017.89","2,16,160.98",
26-Oct-25,Debit Card,361,00.00,"2,16,521.98",
26-Oct-25,Debit Card,06.80,00.00,"2,16,528.78",
26-Oct-25,Reversal,"12,52,559.00",00.00,"14,69,087.78",
26-Oct-25,IMPS,"1,39,140.30",00.00,"16,08,228.08",
26-Oct-25,NEFT,00.00,"3,21,645.62","12,86,582.46",
26-Oct-25,RTGS,573.4,00.00,"12,87,155.86",
26-Oct-25,Tax,00.00,"1,60,894.48","11,26,261.38",
26-Oct-25,Reversal,"3,32,277.80",00.00,"14,58,539.18",
26-Oct-25,Reversal,43,00.00,"14,58,582.18",
26-Oct-25,Tax,00.00,"4,86,194.06","9,72,388.12",
27-Oct-25,Cheque,00.00,"1,38,912.59","8,33,475.53",
27-Oct-25,Bill,452,00.00,"8,33,927.53",
27-Oct-25,Cash,"19,26,902.50",00.00,"27,60,830.03",
27-Oct-25,Interest,00.00,"3,45,103.75","24,15,726.28",
27-Oct-25,NEFT,02.80,00.00,"24,15,729.08",
27-Oct-25,Interest,"20,91,899.75",00.00,"45,07,628.83",
27-Oct-25,Cash,00.00,"9,01,525.77","36,06,103.06",
27-Oct-25,IMPS,642,00.00,"36,06,745.06",
27-Oct-25,Cash,00.00,"4,00,749.45","32,05,995.61",
27-Oct-25,Transportellaneous,00.00,"10,68,665.20","21,37,330.41",
27-Oct-25,Interest,00.00,"5,34,332.60","16,02,997.81",
27-Oct-25,Purchase,00.00,"1,78,110.87","14,24,886.94",
27-Oct-25,Tax,00.00,"2,84,977.39","11,39,909.55",
27-Oct-25,Transportellaneous,"13,86,369.75",00.00,"25,26,279.30",
27-Oct-25,Cash,00.00,"3,15,784.91","22,10,494.39",
27-Oct-25,Debit Card,"85,124.90",00.00,"22,95,619.29",
27-Oct-25,Transfer,00.00,"3,82,603.22","19,13,016.08",
27-Oct-25,Debit Card,06.40,00.00,"19,13,022.48",
27-Oct-25,Interest,00.00,"3,18,837.08","15,94,185.40",
27-Oct-25,RTGS,00.00,"1,59,418.54","14,34,766.86",
27-Oct-25,Purchase,00.00,"7,17,383.43","7,17,383.43",
27-Oct-25,Transportellaneous,04.79,00.00,"7,17,388.22",
27-Oct-25,Cheque,"19,35,549.50",00.00,"26,52,937.72",
27-Oct-25,Purchase,29.52,00.00,"26,52,967.24",
27-Oct-25,ATM,00.00,"2,94,774.14","23,58,193.10",
27-Oct-25,Cash,51.72,00.00,"23,58,244.82",
27-Oct-25,Cheque,00.00,"3,36,892.12","20,21,352.70",
27-Oct-25,Tax,08.00,00.00,"20,21,360.70",
28-Oct-25,Transfer,00.00,"2,02,136.07","18,19,224.63",
28-Oct-25,Purchase,00.00,"3,03,204.11","15,16,020.52",
28-Oct-25,Bill,"2,03,866.40",00.00,"17,19,886.92",
28-Oct-25,Transfer,"3,853.00",00.00,"17,23,739.92",
28-Oct-25,Bill,00.00,"2,87,289.99","14,36,449.93",
28-Oct-25,Debit Card,05.00,00.00,"14,36,454.93",
28-Oct-25,Tax,"2,217.80",00.00,"14,38,672.73",
28-Oct-25,Debit Card,"2,58,870.25",00.00,"16,97,542.98",
28-Oct-25,Debit Card,00.00,"4,24,385.75","12,73,157.23",
28-Oct-25,Commission,00.00,"3,18,289.31","9,54,867.92",
28-Oct-25,Purchase,00.00,"3,18,289.31","6,36,578.61",
28-Oct-25,Cash,00.00,"1,06,096.44","5,30,482.18",
28-Oct-25,Debit Card,730,00.00,"5,31,212.18",
28-Oct-25,Reversal,49,00.00,"5,31,261.18",
28-Oct-25,Tax,00.00,"1,77,087.06","3,54,174.12",
28-Oct-25,RTGS,43.93,00.00,"3,54,218.05",
28-Oct-25,RTGS,00.00,"59,036.34","2,95,181.71",
28-Oct-25,Reversal,00.00,"98,393.90","1,96,787.81",
28-Oct-25,Tax,00.00,"28,112.54","1,68,675.27",
28-Oct-25,Commission,115.7,00.00,"1,68,790.97",
28-Oct-25,Commission,"26,897.00",00.00,"1,95,687.97",
28-Oct-25,Tax,00.00,"97,843.99","97,843.98",
28-Oct-25,Purchase,00.00,"48,921.99","48,921.99",
28-Oct-25,NEFT,00.00,"12,230.50","36,691.49",
28-Oct-25,Commission,00.00,"7,338.30","29,353.19",
28-Oct-25,IMPS,"17,18,559.75",00.00,"17,47,912.94",
28-Oct-25,Debit Card,"1,556.04",00.00,"17,49,468.98",
28-Oct-25,Purchase,19.5,00.00,"17,49,488.48",
28-Oct-25,Transfer,373,00.00,"17,49,861.48",
28-Oct-25,RTGS,00.00,"2,18,732.69","15,31,128.80",
28-Oct-25,Reversal,55,00.00,"15,31,183.80",
28-Oct-25,Purchase,00.00,"1,53,118.38","13,78,065.42",
28-Oct-25,Transfer,00.00,"2,29,677.57","11,48,387.85",
28-Oct-25,Reversal,"12,87,206.00",00.00,"24,35,593.85",
28-Oct-25,Cheque,"51,077.00",00.00,"24,86,670.85",
29-Oct-25,Debit Card,140.4,00.00,"24,86,811.25",
29-Oct-25,IMPS,402.2,00.00,"24,87,213.45",
29-Oct-25,Commission,"20,00,024.75",00.00,"44,87,238.20",
29-Oct-25,Bill,384.73,00.00,"44,87,622.93",
29-Oct-25,RTGS,00.00,"5,60,952.87","39,26,670.06",
29-Oct-25,Cash,00.00,"5,60,952.87","33,65,717.19",
29-Oct-25,Bill,"2,569.00",00.00,"33,68,286.19",
29-Oct-25,Debit Card,05.00,00.00,"33,68,291.19",
29-Oct-25,RTGS,458,00.00,"33,68,749.19",
29-Oct-25,Bill,00.00,"11,22,916.40","22,45,832.79",
29-Oct-25,NEFT,"10,589.50",00.00,"22,56,422.29",
29-Oct-25,Transportellaneous,"13,894.00",00.00,"22,70,316.29",
30-Oct-25,RTGS,00.00,"2,27,031.63","20,43,284.66",
30-Oct-25,RTGS,238.97,00.00,"20,43,523.63",
30-Oct-25,Commission,00.00,"20,43,523.63",00.00,
30-Oct-25,Debit Card,"66,554.90",00.00,"66,554.90",
30-Oct-25,Bill,00.00,"33,277.45","33,277.45",
30-Oct-25,Cheque,49.7,00.00,"33,327.15",
30-Oct-25,Interest,00.00,"4,761.02","28,566.13",
30-Oct-25,NEFT,00.00,"3,570.77","24,995.36",
30-Oct-25,NEFT,23,00.00,"25,018.36",
30-Oct-25,Reversal,"6,16,044.00",00.00,"6,41,062.36",
30-Oct-25,Reversal,"7,50,648.00",00.00,"13,91,710.36",
30-Oct-25,Transfer,"4,38,125.50",00.00,"18,29,835.86",
30-Oct-25,Reversal,00.00,"4,57,458.97","13,72,376.90",
30-Oct-25,Transportellaneous,00.00,"13,72,376.90",00.00,
30-Oct-25,IMPS,06.00,00.00,06.00,
30-Oct-25,NEFT,"25,122.63",00.00,"25,128.63",
30-Oct-25,Reversal,"16,01,152.00",00.00,"16,26,280.63",
30-Oct-25,Bill,00.00,"2,71,046.77","13,55,233.86",
30-Oct-25,Bill,00.00,"4,51,744.62","9,03,489.24",
30-Oct-25,Debit Card,05.40,00.00,"9,03,494.64",
30-Oct-25,Commission,00.00,"9,03,494.64",00.00,
30-Oct-25,Commission,08.90,00.00,08.90,
30-Oct-25,RTGS,"18,83,824.80",00.00,"18,83,833.70",
30-Oct-25,Transportellaneous,00.00,"2,09,314.86","16,74,518.84",
30-Oct-25,Cash,00.00,"4,18,629.71","12,55,889.13",
30-Oct-25,Reversal,00.00,"1,39,543.24","11,16,345.89",
30-Oct-25,Transfer,00.00,"1,59,477.98","9,56,867.91",
30-Oct-25,Transfer,318.6,00.00,"9,57,186.51",
31-Oct-25,NEFT,07.03,00.00,"9,57,193.54",
01-Nov-25,Tax,178,00.00,"9,57,371.54",
01-Nov-25,Commission,338,00.00,"9,57,709.54",
01-Nov-25,NEFT,"1,90,266.56",00.00,"11,47,976.10",
01-Nov-25,IMPS,"1,19,449.50",00.00,"12,67,425.60",
01-Nov-25,NEFT,00.00,"12,67,425.60",00.00,
01-Nov-25,Cash,45,00.00,45,
01-Nov-25,RTGS,00.00,15,30,
01-Nov-25,IMPS,00.00,03.00,27,
01-Nov-25,Purchase,"4,49,529.00",00.00,"4,49,556.00",
01-Nov-25,Debit Card,"6,698.90",00.00,"4,56,254.90",
01-Nov-25,Commission,54.5,00.00,"4,56,309.40",
01-Nov-25,IMPS,00.00,"57,038.68","3,99,270.72",
01-Nov-25,RTGS,00.00,"79,854.14","3,19,416.58",
01-Nov-25,IMPS,"2,52,650.00",00.00,"5,72,066.58",
01-Nov-25,Purchase,00.00,"2,86,033.29","2,86,033.29",
01-Nov-25,NEFT,00.00,"57,206.66","2,28,826.63",
01-Nov-25,Interest,00.00,"38,137.77","1,90,688.86",
01-Nov-25,Interest,310.78,00.00,"1,90,999.64",
01-Nov-25,ATM,"3,04,384.50",00.00,"4,95,384.14",
01-Nov-25,Cash,00.00,"2,47,692.07","2,47,692.07",
01-Nov-25,Cash,"1,22,711.25",00.00,"3,70,403.32",
01-Nov-25,Cash,"2,905.00",00.00,"3,73,308.32",
01-Nov-25,RTGS,"3,923.40",00.00,"3,77,231.72",
01-Nov-25,Interest,497.4,00.00,"3,77,729.12",
01-Nov-25,Transportellaneous,22.27,00.00,"3,77,751.39",
01-Nov-25,Reversal,00.00,"1,88,875.70","1,88,875.70",
01-Nov-25,IMPS,"4,13,782.00",00.00,"6,02,657.70",
01-Nov-25,Tax,00.00,"75,332.21","5,27,325.49",
01-Nov-25,IMPS,"2,812.00",00.00,"5,30,137.49",
01-Nov-25,Interest,00.00,"5,30,137.49",00.00,
01-Nov-25,Reversal,"13,96,081.50",00.00,"13,96,081.50",
01-Nov-25,Purchase,02.00,00.00,"13,96,083.50",
01-Nov-25,Transfer,00.00,"1,39,608.35","12,56,475.15",
01-Nov-25,ATM,00.00,"2,09,412.53","10,47,062.62",
01-Nov-25,Cash,00.00,"1,16,340.29","9,30,722.33",
01-Nov-25,Interest,"2,36,525.00",00.00,"11,67,247.33",
01-Nov-25,Interest,00.00,"11,67,247.33",00.00,
02-Nov-25,Bill,"20,46,945.80",00.00,"20,46,945.80",
02-Nov-25,RTGS,"10,77,895.50",00.00,"31,24,841.30",
02-Nov-25,Tax,00.00,"10,41,613.77","20,83,227.53",
02-Nov-25,Transportellaneous,00.00,"2,31,469.73","18,51,757.80",
02-Nov-25,Tax,00.00,"3,70,351.56","14,81,406.24",
02-Nov-25,Reversal,00.00,"14,81,406.24",00.00,
02-Nov-25,Debit Card,20.1,00.00,20.1,
03-Nov-25,IMPS,00.00,02.51,17.59,
03-Nov-25,RTGS,"1,585.20",00.00,"1,602.79",
04-Nov-25,Cash,"4,027.06",00.00,"5,629.85",
04-Nov-25,Purchase,"1,116.00",00.00,"6,745.85",
04-Nov-25,ATM,481.4,00.00,"7,227.25",
04-Nov-25,Cash,00.20,00.00,"7,227.45",
04-Nov-25,NEFT,"1,93,835.10",00.00,"2,01,062.55",
04-Nov-25,Reversal,"2,21,302.00",00.00,"4,22,364.55",
04-Nov-25,Debit Card,00.00,"2,11,182.28","2,11,182.28",
04-Nov-25,Cheque,00.00,"21,118.23","1,90,064.05",
04-Nov-25,Reversal,"26,336.80",00.00,"2,16,400.85",
04-Nov-25,Interest,00.00,"24,044.54","1,92,356.31",
04-Nov-25,Cash,"3,43,741.00",00.00,"5,36,097.31",
04-Nov-25,Tax,37,00.00,"5,36,134.31",
04-Nov-25,Tax,205,00.00,"5,36,339.31",
04-Nov-25,Debit Card,00.00,"76,619.90","4,59,719.41",
04-Nov-25,Cash,"5,681.00",00.00,"4,65,400.41",
04-Nov-25,RTGS,"13,41,172.00",00.00,"18,06,572.41",
04-Nov-25,Cash,00.00,"1,80,657.24","16,25,915.17",
04-Nov-25,Transfer,00.00,"2,32,273.60","13,93,641.57",
04-Nov-25,IMPS,00.00,"1,54,849.06","12,38,792.51",
04-Nov-25,NEFT,00.00,"1,76,970.36","10,61,822.15",
04-Nov-25,Debit Card,05.00,00.00,"10,61,827.15",
04-Nov-25,Cash,00.00,"10,61,827.15",00.00,
04-Nov-25,Purchase,760,00.00,760,
04-Nov-25,Transfer,00.00,108.57,651.43,
04-Nov-25,Transportellaneous,00.00,93.06,558.37,
04-Nov-25,RTGS,54.3,00.00,612.67,
04-Nov-25,Debit Card,"1,39,893.10",00.00,"1,40,505.77",
04-Nov-25,Transfer,"5,756.00",00.00,"1,46,261.77",
04-Nov-25,Debit Card,"6,547.00",00.00,"1,52,808.77",
05-Nov-25,Cash,00.00,"19,101.10","1,33,707.67",
05-Nov-25,IMPS,07.00,00.00,"1,33,714.67",
05-Nov-25,Transfer,00.00,"33,428.67","1,00,286.00",
05-Nov-25,IMPS,03.43,00.00,"1,00,289.43",
05-Nov-25,Cash,00.00,"16,714.91","83,574.52",
05-Nov-25,Debit Card,00.00,"83,574.52",00.00,
05-Nov-25,Cheque,07.20,00.00,07.20,
05-Nov-25,IMPS,00.00,02.40,04.80,
05-Nov-25,Transfer,"1,66,217.03",00.00,"1,66,221.83",
05-Nov-25,Tax,00.00,"33,244.37","1,32,977.46",
05-Nov-25,IMPS,05.00,00.00,"1,32,982.46",
05-Nov-25,Transfer,00.00,"13,298.25","1,19,684.21",
05-Nov-25,RTGS,00.00,"29,921.05","89,763.16",
05-Nov-25,Transportellaneous,21.52,00.00,"89,784.68",
05-Nov-25,Interest,00.00,"9,976.08","79,808.60",
05-Nov-25,Tax,"8,404.00",00.00,"88,212.60",
05-Nov-25,RTGS,00.00,"9,801.40","78,411.20",
05-Nov-25,Transportellaneous,00.00,"13,068.53","65,342.67",
05-Nov-25,Cheque,"6,392.18",00.00,"71,734.85",
05-Nov-25,RTGS,998,00.00,"72,732.85",
05-Nov-25,RTGS,00.00,"72,732.85",00.00,
05-Nov-25,RTGS,"3,230.00",00.00,"3,230.00",
05-Nov-25,Interest,07.10,00.00,"3,237.10",
05-Nov-25,ATM,"22,155.40",00.00,"25,392.50",
05-Nov-25,ATM,00.00,"3,627.50","21,765.00",
05-Nov-25,RTGS,"6,571.34",00.00,"28,336.34",
05-Nov-25,IMPS,00.00,"5,667.27","22,669.07",
05-Nov-25,Purchase,"10,74,488.00",00.00,"10,97,157.07",
05-Nov-25,Cash,"2,084.90",00.00,"10,99,241.97",
05-Nov-25,Interest,"3,750.00",00.00,"11,02,991.97",
05-Nov-25,Transportellaneous,07.79,00.00,"11,02,999.76",
05-Nov-25,RTGS,"8,68,146.00",00.00,"19,71,145.76",
05-Nov-25,Transportellaneous,00.00,"2,19,016.20","17,52,129.56",
05-Nov-25,Cheque,00.00,"2,92,021.59","14,60,107.97",
05-Nov-25,Interest,44,00.00,"14,60,151.97",
05-Nov-25,ATM,00.00,"4,86,717.32","9,73,434.65",
06-Nov-25,Tax,"3,727.50",00.00,"9,77,162.15",
06-Nov-25,Debit Card,"1,33,686.88",00.00,"11,10,849.03",
06-Nov-25,RTGS,"19,859.20",00.00,"11,30,708.23",
06-Nov-25,Debit Card,"2,357.00",00.00,"11,33,065.23",
06-Nov-25,Bill,"67,356.00",00.00,"12,00,421.23",
06-Nov-25,Interest,00.00,"1,20,042.12","10,80,379.11",
06-Nov-25,Transfer,"23,350.00",00.00,"11,03,729.11",
06-Nov-25,Interest,00.00,"5,51,864.56","5,51,864.56",
06-Nov-25,Commission,00.00,"1,37,966.14","4,13,898.42",
06-Nov-25,IMPS,"1,61,229.60",00.00,"5,75,128.02",
06-Nov-25,Interest,00.00,"82,161.15","4,92,966.87",
06-Nov-25,Transfer,00.00,"82,161.15","4,10,805.72",
06-Nov-25,Cash,187.1,00.00,"4,10,992.82",
06-Nov-25,Tax,00.00,"4,10,992.82",00.00,
06-Nov-25,ATM,"14,516.60",00.00,"14,516.60",
06-Nov-25,Interest,00.00,"4,838.87","9,677.73",
06-Nov-25,Bill,"3,923.80",00.00,"13,601.53",
06-Nov-25,Cheque,00.00,"2,266.92","11,334.61",
06-Nov-25,IMPS,00.00,"1,259.40","10,075.21",
06-Nov-25,IMPS,53.8,00.00,"10,129.01",
06-Nov-25,Commission,31.4,00.00,"10,160.41",
06-Nov-25,NEFT,55,00.00,"10,215.41",
07-Nov-25,RTGS,00.00,"10,215.41",00.00,
07-Nov-25,Cheque,"2,06,673.94",00.00,"2,06,673.94",
07-Nov-25,NEFT,00.00,"20,667.39","1,86,006.55",
07-Nov-25,Bill,00.00,"23,250.82","1,62,755.73",
07-Nov-25,ATM,"1,356.40",00.00,"1,64,112.13",
07-Nov-25,Purchase,"13,318.00",00.00,"1,77,430.13",
07-Nov-25,RTGS,00.00,"44,357.53","1,33,072.60",
07-Nov-25,Cash,"16,410.56",00.00,"1,49,483.16",
08-Nov-25,Cash,249.84,00.00,"1,49,733.00",
08-Nov-25,Bill,"6,065.00",00.00,"1,55,798.00",
08-Nov-25,Transportellaneous,329,00.00,"1,56,127.00",
08-Nov-25,Debit Card,710,00.00,"1,56,837.00",
08-Nov-25,RTGS,02.09,00.00,"1,56,839.09",
08-Nov-25,IMPS,"10,393.51",00.00,"1,67,232.60",
08-Nov-25,Cash,00.00,"33,446.52","1,33,786.08",
09-Nov-25,Transfer,00.00,"26,757.22","1,07,028.86",
09-Nov-25,Commission,01.00,00.00,"1,07,029.86",
09-Nov-25,Interest,"6,513.00",00.00,"1,13,542.86",
09-Nov-25,Cash,"15,952.40",00.00,"1,29,495.26",
09-Nov-25,IMPS,00.00,"16,186.91","1,13,308.35",
09-Nov-25,RTGS,00.00,"12,589.82","1,00,718.53",
09-Nov-25,RTGS,"3,804.90",00.00,"1,04,523.43",
09-Nov-25,Interest,"31,933.00",00.00,"1,36,456.43",
09-Nov-25,NEFT,00.00,"45,485.48","90,970.95",
09-Nov-25,Bill,00.00,"45,485.48","45,485.48",
09-Nov-25,Transfer,06.00,00.00,"45,491.48",
09-Nov-25,NEFT,00.00,"15,163.83","30,327.65",
09-Nov-25,Transfer,00.00,"3,369.74","26,957.91",
09-Nov-25,Reversal,00.00,"6,739.48","20,218.43",
09-Nov-25,IMPS,"3,469.77",00.00,"23,688.20",
09-Nov-25,Transfer,00.00,"7,896.07","15,792.13",
09-Nov-25,Interest,07.15,00.00,"15,799.28",
09-Nov-25,Cheque,00.00,"3,949.82","11,849.46",
09-Nov-25,ATM,00.00,"3,949.82","7,899.64",
09-Nov-25,Interest,"20,64,615.00",00.00,"20,72,514.64",
09-Nov-25,Cash,56,00.00,"20,72,570.64",
09-Nov-25,Purchase,"14,35,957.00",00.00,"35,08,527.64",
09-Nov-25,Debit Card,00.00,"3,50,852.76","31,57,674.88",
09-Nov-25,Commission,"32,187.00",00.00,"31,89,861.88",
09-Nov-25,Cheque,00.00,"5,31,643.65","26,58,218.23",
09-Nov-25,Interest,00.00,"8,86,072.74","17,72,145.49",
09-Nov-25,Cash,00.00,"1,77,214.55","15,94,930.94",
09-Nov-25,Debit Card,07.30,00.00,"15,94,938.24",
09-Nov-25,Interest,00.00,"1,99,367.28","13,95,570.96",
09-Nov-25,Tax,06.62,00.00,"13,95,577.58",
09-Nov-25,Interest,"1,125.00",00.00,"13,96,702.58",
09-Nov-25,Debit Card,00.00,"13,96,702.58",00.00,
09-Nov-25,NEFT,42.8,00.00,42.8,
09-Nov-25,Cash,31,00.00,73.8,
09-Nov-25,Commission,"25,654.30",00.00,"25,728.10",
09-Nov-25,Transfer,00.00,"4,288.02","21,440.08",
09-Nov-25,Bill,"10,31,709.00",00.00,"10,53,149.08",
09-Nov-25,Bill,00.00,"5,26,574.54","5,26,574.54",
09-Nov-25,Reversal,00.00,"1,75,524.85","3,51,049.69",
09-Nov-25,ATM,00.00,"70,209.94","2,80,839.75",
09-Nov-25,Bill,00.00,"31,204.42","2,49,635.33",
09-Nov-25,Cheque,"4,202.47",00.00,"2,53,837.80",
09-Nov-25,Transfer,00.00,"42,306.30","2,11,531.50",
09-Nov-25,Debit Card,00.00,"30,218.79","1,81,312.71",
09-Nov-25,Transfer,00.00,"45,328.18","1,35,984.53",
09-Nov-25,Transfer,00.00,"67,992.27","67,992.26",
09-Nov-25,Reversal,00.00,"13,598.45","54,393.81",
09-Nov-25,RTGS,00.00,"6,799.23","47,594.58",
09-Nov-25,Purchase,"18,795.75",00.00,"66,390.33",
09-Nov-25,Transportellaneous,172.7,00.00,"66,563.03",
09-Nov-25,Reversal,41,00.00,"66,604.03",
09-Nov-25,Tax,"9,825.99",00.00,"76,430.02",
10-Nov-25,Reversal,00.00,"7,643.00","68,787.02",
10-Nov-25,Interest,"26,269.00",00.00,"95,056.02",
10-Nov-25,Transfer,00.00,"11,882.00","83,174.02",
10-Nov-25,Bill,00.00,"13,862.34","69,311.68",
10-Nov-25,Commission,"1,20,586.50",00.00,"1,89,898.18",
10-Nov-25,Purchase,00.00,"1,89,898.18",00.00,
10-Nov-25,NEFT,"1,12,730.70",00.00,"1,12,730.70",
10-Nov-25,Transportellaneous,00.00,"16,104.39","96,626.31",
10-Nov-25,Interest,220.98,00.00,"96,847.29",
10-Nov-25,Transportellaneous,00.00,"96,847.29",00.00,
10-Nov-25,Cheque,"6,492.26",00.00,"6,492.26",
10-Nov-25,Bill,"1,63,477.00",00.00,"1,69,969.26",
10-Nov-25,IMPS,"14,639.16",00.00,"1,84,608.42",
10-Nov-25,Tax,"1,65,276.70",00.00,"3,49,885.12",
10-Nov-25,Tax,00.00,"49,983.59","2,99,901.53",
10-Nov-25,Cash,"6,39,819.00",00.00,"9,39,720.53",
10-Nov-25,Transfer,00.00,"1,56,620.09","7,83,100.44",
10-Nov-25,Transfer,00.00,"2,61,033.48","5,22,066.96",
11-Nov-25,Transportellaneous,00.00,"1,74,022.32","3,48,044.64",
11-Nov-25,Purchase,00.00,"1,16,014.88","2,32,029.76",
11-Nov-25,Cash,00.00,"33,147.11","1,98,882.65",
11-Nov-25,IMPS,"3,445.21",00.00,"2,02,327.86",
11-Nov-25,Purchase,00.00,"50,581.97","1,51,745.89",
11-Nov-25,Transfer,08.00,00.00,"1,51,753.89",
11-Nov-25,Interest,07.94,00.00,"1,51,761.83",
11-Nov-25,Purchase,00.00,"1,51,761.83",00.00,
11-Nov-25,Interest,24.41,00.00,24.41,
11-Nov-25,Transfer,"22,939.80",00.00,"22,964.21",
11-Nov-25,RTGS,00.00,"11,482.11","11,482.10",
11-Nov-25,Interest,"27,690.00",00.00,"39,172.10",
11-Nov-25,Bill,00.00,"4,896.51","34,275.59",
11-Nov-25,Interest,"13,98,807.25",00.00,"14,33,082.84",
11-Nov-25,Reversal,00.00,"1,79,135.36","12,53,947.49",
11-Nov-25,RTGS,00.00,"6,26,973.75","6,26,973.74",
11-Nov-25,Reversal,"18,146.29",00.00,"6,45,120.03",
11-Nov-25,Tax,00.00,"92,160.00","5,52,960.03",
11-Nov-25,NEFT,59.35,00.00,"5,53,019.38",
11-Nov-25,RTGS,00.70,00.00,"5,53,020.08",
11-Nov-25,Cheque,00.00,"1,84,340.03","3,68,680.05",
11-Nov-25,Transfer,00.00,"52,668.58","3,16,011.47",
11-Nov-25,Reversal,00.00,"45,144.50","2,70,866.97",
11-Nov-25,Transportellaneous,00.00,"38,695.28","2,32,171.69",
11-Nov-25,Debit Card,"2,19,501.00",00.00,"4,51,672.69",
11-Nov-25,RTGS,321.63,00.00,"4,51,994.32",
11-Nov-25,Reversal,00.00,"90,398.86","3,61,595.46",
11-Nov-25,NEFT,00.00,"1,20,531.82","2,41,063.64",
11-Nov-25,Cheque,00.00,"34,437.66","2,06,625.98",
11-Nov-25,IMPS,00.00,"41,325.20","1,65,300.78",
11-Nov-25,NEFT,06.40,00.00,"1,65,307.18",
11-Nov-25,IMPS,189.8,00.00,"1,65,496.98",
12-Nov-25,IMPS,"1,54,007.80",00.00,"3,19,504.78",
12-Nov-25,Purchase,00.00,"3,19,504.78",00.00,
12-Nov-25,IMPS,31,00.00,31,
12-Nov-25,Debit Card,00.00,07.75,23.25,
12-Nov-25,ATM,00.00,02.58,20.67,
12-Nov-25,Bill,443,00.00,463.67,
12-Nov-25,Transfer,"1,05,760.38",00.00,"1,06,224.05",
12-Nov-25,NEFT,"1,70,886.80",00.00,"2,77,110.85",
12-Nov-25,Tax,26,00.00,"2,77,136.85",
12-Nov-25,Cash,00.00,"30,792.98","2,46,343.87",
12-Nov-25,NEFT,00.00,"27,371.54","2,18,972.33",
12-Nov-25,IMPS,"1,38,353.20",00.00,"3,57,325.53",
12-Nov-25,IMPS,122,00.00,"3,57,447.53",
12-Nov-25,Interest,00.00,"39,716.39","3,17,731.14",
12-Nov-25,Cheque,"1,514.89",00.00,"3,19,246.03",
12-Nov-25,Bill,"1,19,663.59",00.00,"4,38,909.62",
12-Nov-25,Purchase,00.00,"2,19,454.81","2,19,454.81",
12-Nov-25,Interest,"8,562.00",00.00,"2,28,016.81",
12-Nov-25,Cash,00.00,"28,502.10","1,99,514.71",
12-Nov-25,IMPS,"4,95,631.75",00.00,"6,95,146.46",
12-Nov-25,Cash,00.00,"3,47,573.23","3,47,573.23",
13-Nov-25,NEFT,"2,677.92",00.00,"3,50,251.15",
13-Nov-25,Transportellaneous,00.00,"58,375.19","2,91,875.96",
13-Nov-25,Purchase,"1,29,448.00",00.00,"4,21,323.96",
13-Nov-25,Bill,"19,76,256.50",00.00,"23,97,580.46",
13-Nov-25,RTGS,00.00,"11,98,790.23","11,98,790.23",
13-Nov-25,Bill,"11,34,970.00",00.00,"23,33,760.23",
13-Nov-25,Transfer,01.47,00.00,"23,33,761.70",
13-Nov-25,Interest,00.00,"5,83,440.43","17,50,321.28",
13-Nov-25,Bill,425.2,00.00,"17,50,746.48",
14-Nov-25,Debit Card,"3,505.00",00.00,"17,54,251.48",
14-Nov-25,Cash,"2,886.00",00.00,"17,57,137.48",
14-Nov-25,Reversal,465.5,00.00,"17,57,602.98",
14-Nov-25,Reversal,35.5,00.00,"17,57,638.48",
15-Nov-25,NEFT,07.80,00.00,"17,57,646.28",
15-Nov-25,NEFT,02.50,00.00,"17,57,648.78",
15-Nov-25,Transportellaneous,465,00.00,"17,58,113.78",
15-Nov-25,Bill,00.00,"8,79,056.89","8,79,056.89",
16-Nov-25,Purchase,"93,915.40",00.00,"9,72,972.29",
16-Nov-25,Commission,00.00,"1,08,108.03","8,64,864.26",
16-Nov-25,Cash,"73,117.60",00.00,"9,37,981.86",
16-Nov-25,IMPS,"2,52,548.50",00.00,"11,90,530.36",
16-Nov-25,Interest,00.00,"1,19,053.04","10,71,477.32",
16-Nov-25,Cash,"2,20,308.00",00.00,"12,91,785.32",
16-Nov-25,Tax,00.00,"1,29,178.53","11,62,606.79",
16-Nov-25,Cash,00.00,"1,93,767.80","9,68,838.99",
16-Nov-25,NEFT,00.00,"1,61,473.17","8,07,365.82",
16-Nov-25,Interest,00.00,"1,61,473.16","6,45,892.66",
16-Nov-25,Tax,00.00,"2,15,297.55","4,30,595.11",
16-Nov-25,Purchase,"20,52,362.00",00.00,"24,82,957.11",
16-Nov-25,Interest,300.93,00.00,"24,83,258.04",
16-Nov-25,Transportellaneous,00.00,"12,41,629.02","12,41,629.02",
16-Nov-25,Debit Card,"2,52,443.70",00.00,"14,94,072.72",
16-Nov-25,IMPS,03.00,00.00,"14,94,075.72",
16-Nov-25,Bill,140.3,00.00,"14,94,216.02",
16-Nov-25,IMPS,00.00,"4,98,072.01","9,96,144.01",
16-Nov-25,IMPS,00.00,"3,32,048.00","6,64,096.01",
16-Nov-25,Purchase,00.00,"1,32,819.20","5,31,276.81",
16-Nov-25,Cash,00.00,"1,32,819.20","3,98,457.61",
16-Nov-25,Bill,47.3,00.00,"3,98,504.91",
16-Nov-25,RTGS,00.00,"49,813.11","3,48,691.80",
16-Nov-25,Reversal,07.00,00.00,"3,48,698.80",
16-Nov-25,NEFT,"17,141.95",00.00,"3,65,840.75",
16-Nov-25,Reversal,00.00,"1,21,946.92","2,43,893.83",
16-Nov-25,NEFT,00.00,"40,648.97","2,03,244.86",
16-Nov-25,IMPS,00.00,"29,034.98","1,74,209.88",
16-Nov-25,Commission,00.00,"17,420.99","1,56,788.89",
16-Nov-25,Cash,240.98,00.00,"1,57,029.87",
16-Nov-25,IMPS,11.2,00.00,"1,57,041.07",
16-Nov-25,Reversal,00.00,"26,173.51","1,30,867.56",
16-Nov-25,Cheque,39,00.00,"1,30,906.56",
16-Nov-25,Cheque,00.00,"43,635.52","87,271.04",
16-Nov-25,Interest,"15,49,636.50",00.00,"16,36,907.54",
16-Nov-25,Bill,00.00,"2,04,613.44","14,32,294.10",
16-Nov-25,Purchase,00.00,"7,16,147.05","7,16,147.05",
16-Nov-25,Tax,00.00,"1,19,357.84","5,96,789.21",
16-Nov-25,RTGS,36.52,00.00,"5,96,825.73",
16-Nov-25,RTGS,00.00,"99,470.96","4,97,354.78",
16-Nov-25,Debit Card,35.2,00.00,"4,97,389.98",
16-Nov-25,Commission,"12,205.00",00.00,"5,09,594.98",
16-Nov-25,Cheque,00.00,"63,699.37","4,45,895.61",
16-Nov-25,Reversal,00.00,"74,315.94","3,71,579.68",
16-Nov-25,ATM,00.00,"1,23,859.89","2,47,719.79",
16-Nov-25,Reversal,"2,983.00",00.00,"2,50,702.79",
16-Nov-25,Transportellaneous,00.00,"62,675.70","1,88,027.09",
16-Nov-25,Transportellaneous,00.00,"31,337.85","1,56,689.24",
16-Nov-25,Interest,00.00,"19,586.16","1,37,103.08",
16-Nov-25,Debit Card,"12,09,714.75",00.00,"13,46,817.83",
16-Nov-25,Transfer,"18,018.00",00.00,"13,64,835.83",
16-Nov-25,ATM,"30,844.13",00.00,"13,95,679.96",
16-Nov-25,Transportellaneous,"2,811.60",00.00,"13,98,491.56",
17-Nov-25,Commission,06.00,00.00,"13,98,497.56",
17-Nov-25,Transfer,"7,28,139.50",00.00,"21,26,637.06",
17-Nov-25,Transportellaneous,"16,437.00",00.00,"21,43,074.06",
17-Nov-25,Purchase,35,00.00,"21,43,109.06",
18-Nov-25,Bill,19.11,00.00,"21,43,128.17",
18-Nov-25,IMPS,"1,64,088.80",00.00,"23,07,216.97",
18-Nov-25,Interest,00.00,"2,30,721.70","20,76,495.27",
18-Nov-25,Commission,00.00,"20,76,495.27",00.00,
18-Nov-25,Cash,05.00,00.00,05.00,
18-Nov-25,NEFT,04.00,00.00,09.00,
18-Nov-25,Debit Card,00.00,01.13,07.88,
18-Nov-25,RTGS,00.00,00.88,07.00,
18-Nov-25,Tax,381.5,00.00,388.5,
18-Nov-25,Cash,276,00.00,664.5,
18-Nov-25,Transportellaneous,240.66,00.00,905.16,
18-Nov-25,Cash,02.00,00.00,907.16,
18-Nov-25,Transfer,00.00,226.79,680.37,
18-Nov-25,RTGS,00.00,75.6,604.77,
18-Nov-25,Interest,00.00,86.4,518.37,
18-Nov-25,RTGS,00.00,129.59,388.78,
18-Nov-25,Cash,"3,035.00",00.00,"3,423.78",
18-Nov-25,RTGS,00.00,"1,711.89","1,711.89",
18-Nov-25,RTGS,00.00,190.21,"1,521.68",
18-Nov-25,RTGS,35.13,00.00,"1,556.81",
18-Nov-25,Cheque,"18,853.00",00.00,"20,409.81",
18-Nov-25,Bill,00.00,"10,204.91","10,204.91",
18-Nov-25,Transfer,00.00,"10,204.91",00.00,
18-Nov-25,Transfer,"2,240.20",00.00,"2,240.20",
18-Nov-25,Interest,"7,55,083.00",00.00,"7,57,323.20",
18-Nov-25,IMPS,00.00,"1,26,220.53","6,31,102.67",
18-Nov-25,IMPS,00.00,"2,10,367.56","4,20,735.11",
18-Nov-25,Transportellaneous,00.00,"1,40,245.04","2,80,490.07",
18-Nov-25,IMPS,07.40,00.00,"2,80,497.47",
18-Nov-25,Cheque,159,00.00,"2,80,656.47",
18-Nov-25,RTGS,00.00,"56,131.29","2,24,525.18",
18-Nov-25,Tax,43.4,00.00,"2,24,568.58",
18-Nov-25,NEFT,59.3,00.00,"2,24,627.88",
18-Nov-25,Commission,00.00,"1,12,313.94","1,12,313.94",
18-Nov-25,Interest,00.00,"28,078.49","84,235.46",
18-Nov-25,Transfer,"2,79,032.00",00.00,"3,63,267.46",
18-Nov-25,Transportellaneous,00.00,"90,816.87","2,72,450.60",
18-Nov-25,Cash,"14,728.90",00.00,"2,87,179.50",
18-Nov-25,Cheque,"19,666.00",00.00,"3,06,845.50",
18-Nov-25,IMPS,00.00,"30,684.55","2,76,160.95",
18-Nov-25,RTGS,00.00,"2,76,160.95",00.00,
18-Nov-25,Debit Card,"14,135.80",00.00,"14,135.80",
18-Nov-25,Cheque,00.00,"2,355.97","11,779.83",
18-Nov-25,ATM,02.00,00.00,"11,781.83",
18-Nov-25,Transfer,00.00,"11,781.83",00.00,
18-Nov-25,IMPS,"1,68,106.00",00.00,"1,68,106.00",
18-Nov-25,Reversal,00.00,"28,017.67","1,40,088.33",
18-Nov-25,Transfer,"4,419.00",00.00,"1,44,507.33",
18-Nov-25,NEFT,03.60,00.00,"1,44,510.93",
18-Nov-25,Tax,"7,67,050.00",00.00,"9,11,560.93",
18-Nov-25,Cheque,00.00,"1,51,926.82","7,59,634.11",
18-Nov-25,NEFT,00.00,"3,79,817.06","3,79,817.06",
18-Nov-25,Debit Card,"10,27,183.80",00.00,"14,07,000.86",
18-Nov-25,Transportellaneous,00.00,"14,07,000.86",00.00,
18-Nov-25,Cheque,03.94,00.00,03.94,
19-Nov-25,ATM,04.49,00.00,08.43,
19-Nov-25,Reversal,00.00,02.11,06.32,
19-Nov-25,Debit Card,00.00,06.32,00.00,
19-Nov-25,Tax,402,00.00,402,
19-Nov-25,ATM,451.8,00.00,853.8,
20-Nov-25,Cheque,00.00,213.45,640.35,
20-Nov-25,RTGS,04.00,00.00,644.35,
20-Nov-25,Cash,00.00,644.35,00.00,
20-Nov-25,Cash,42.51,00.00,42.51,
20-Nov-25,Bill,00.00,04.25,38.26,
20-Nov-25,Cash,00.00,04.78,33.48,
20-Nov-25,Cheque,00.00,06.70,26.78,
20-Nov-25,Debit Card,471,00.00,497.78,
20-Nov-25,Interest,"2,382.49",00.00,"2,880.27",
20-Nov-25,Purchase,"31,382.30",00.00,"34,262.57",
20-Nov-25,Purchase,00.00,"3,806.95","30,455.62",
20-Nov-25,RTGS,04.90,00.00,"30,460.52",
20-Nov-25,Debit Card,07.00,00.00,"30,467.52",
20-Nov-25,Tax,"5,369.00",00.00,"35,836.52",
20-Nov-25,Commission,07.90,00.00,"35,844.42",
20-Nov-25,Bill,"5,693.09",00.00,"41,537.51",
20-Nov-25,Purchase,00.00,"10,384.38","31,153.13",
20-Nov-25,Reversal,37,00.00,"31,190.13",
21-Nov-25,Tax,"31,350.61",00.00,"62,540.74",
21-Nov-25,Purchase,00.00,"6,254.07","56,286.67",
21-Nov-25,IMPS,00.00,"6,254.07","50,032.60",
21-Nov-25,Cash,00.00,"25,016.30","25,016.30",
21-Nov-25,Cash,19,00.00,"25,035.30",
21-Nov-25,Cash,00.00,"2,781.70","22,253.60",
21-Nov-25,Reversal,00.00,"7,417.87","14,835.73",
21-Nov-25,Purchase,00.00,"1,648.41","13,187.32",
21-Nov-25,Cheque,00.00,"1,883.90","11,303.42",
21-Nov-25,Transfer,00.00,"2,260.68","9,042.74",
21-Nov-25,NEFT,00.00,"4,521.37","4,521.37",
21-Nov-25,Debit Card,45.11,00.00,"4,566.48",
22-Nov-25,Transportellaneous,00.00,"1,141.62","3,424.86",
22-Nov-25,Cash,"1,021.85",00.00,"4,446.71",
22-Nov-25,Bill,00.00,555.84,"3,890.87",
22-Nov-25,Reversal,"19,681.30",00.00,"23,572.17",
22-Nov-25,NEFT,"10,21,043.20",00.00,"10,44,615.37",
22-Nov-25,Cash,00.00,"3,48,205.12","6,96,410.25",
22-Nov-25,RTGS,"20,53,121.00",00.00,"27,49,531.25",
22-Nov-25,Reversal,"1,205.00",00.00,"27,50,736.25",
22-Nov-25,Bill,"2,44,918.25",00.00,"29,95,654.50",
22-Nov-25,Transportellaneous,00.00,"14,97,827.25","14,97,827.25",
22-Nov-25,Bill,112.3,00.00,"14,97,939.55",
22-Nov-25,IMPS,"14,95,273.50",00.00,"29,93,213.05",
22-Nov-25,ATM,627.8,00.00,"29,93,840.85",
22-Nov-25,Tax,"11,35,635.00",00.00,"41,29,475.85",
22-Nov-25,RTGS,00.00,"4,12,947.59","37,16,528.26",
22-Nov-25,Commission,31,00.00,"37,16,559.26",
23-Nov-25,Commission,01.09,00.00,"37,16,560.35",
23-Nov-25,Cash,03.63,00.00,"37,16,563.98",
23-Nov-25,NEFT,"2,13,530.00",00.00,"39,30,093.98",
23-Nov-25,Commission,00.00,"7,86,018.80","31,44,075.18",
23-Nov-25,Reversal,"2,811.00",00.00,"31,46,886.18",
23-Nov-25,Commission,00.00,"3,49,654.02","27,97,232.16",
23-Nov-25,Debit Card,50,00.00,"27,97,282.16",
23-Nov-25,IMPS,01.10,00.00,"27,97,283.26",
23-Nov-25,NEFT,"2,61,632.00",00.00,"30,58,915.26",
23-Nov-25,Bill,00.00,"7,64,728.82","22,94,186.44",
23-Nov-25,Cheque,33.3,00.00,"22,94,219.74",
23-Nov-25,NEFT,02.30,00.00,"22,94,222.04",
23-Nov-25,Bill,"91,053.00",00.00,"23,85,275.04",
23-Nov-25,NEFT,00.80,00.00,"23,85,275.84",
23-Nov-25,Tax,00.00,"3,40,753.69","20,44,522.15",
23-Nov-25,Cheque,03.00,00.00,"20,44,525.15",
23-Nov-25,Transportellaneous,00.00,"3,40,754.19","17,03,770.96",
23-Nov-25,Cash,00.00,"8,51,885.48","8,51,885.48",
23-Nov-25,Interest,00.00,"85,188.55","7,66,696.93",
23-Nov-25,Cheque,00.00,"76,669.69","6,90,027.24",
23-Nov-25,Transfer,00.00,"98,575.32","5,91,451.92",
23-Nov-25,Purchase,106.04,00.00,"5,91,557.96",
23-Nov-25,RTGS,"18,93,912.75",00.00,"24,85,470.71",
23-Nov-25,Transfer,"16,068.60",00.00,"25,01,539.31",
23-Nov-25,Transfer,"1,333.22",00.00,"25,02,872.53",
23-Nov-25,ATM,"2,438.20",00.00,"25,05,310.73",
23-Nov-25,IMPS,24,00.00,"25,05,334.73",
23-Nov-25,Tax,238.27,00.00,"25,05,573.00",
23-Nov-25,Reversal,22.5,00.00,"25,05,595.50",
23-Nov-25,Bill,"16,711.67",00.00,"25,22,307.17",
23-Nov-25,Debit Card,00.00,00.00,"25,22,307.17",
23-Nov-25,NEFT,00.00,"12,61,153.59","12,61,153.58",
23-Nov-25,Reversal,381.7,00.00,"12,61,535.28",
23-Nov-25,IMPS,04.97,00.00,"12,61,540.25",
23-Nov-25,Cheque,483,00.00,"12,62,023.25",
23-Nov-25,Transportellaneous,213,00.00,"12,62,236.25",
23-Nov-25,NEFT,"9,80,183.25",00.00,"22,42,419.50",
23-Nov-25,Purchase,00.00,"3,73,736.58","18,68,682.92",
23-Nov-25,Bill,00.00,"1,86,868.29","16,81,814.63",
23-Nov-25,IMPS,"50,538.30",00.00,"17,32,352.93",
23-Nov-25,IMPS,"1,386.30",00.00,"17,33,739.23",
23-Nov-25,Bill,"1,530.00",00.00,"17,35,269.23",
23-Nov-25,Cash,00.00,"8,67,634.62","8,67,634.62",
23-Nov-25,Reversal,306,00.00,"8,67,940.62",
23-Nov-25,Purchase,00.00,"2,89,313.54","5,78,627.08",
23-Nov-25,Bill,"2,51,863.00",00.00,"8,30,490.08",
23-Nov-25,Reversal,00.00,"1,18,641.44","7,11,848.64",
23-Nov-25,Interest,00.00,"88,981.08","6,22,867.56",
23-Nov-25,IMPS,"23,136.00",00.00,"6,46,003.56",
23-Nov-25,Transportellaneous,02.17,00.00,"6,46,005.73",
23-Nov-25,NEFT,41.5,00.00,"6,46,047.23",
23-Nov-25,Commission,00.00,"1,29,209.45","5,16,837.78",
23-Nov-25,ATM,00.00,"1,72,279.26","3,44,558.52",
23-Nov-25,Purchase,00.00,"1,14,852.84","2,29,705.68",
23-Nov-25,RTGS,00.00,"45,941.14","1,83,764.54",
23-Nov-25,Purchase,00.00,"1,83,764.54",00.00,
23-Nov-25,Transfer,504.4,00.00,504.4,
23-Nov-25,Bill,"2,57,707.00",00.00,"2,58,211.40",
23-Nov-25,Purchase,"8,89,411.75",00.00,"11,47,623.15",
23-Nov-25,NEFT,494,00.00,"11,48,117.15",
23-Nov-25,ATM,00.00,"5,74,058.58","5,74,058.57",
23-Nov-25,Debit Card,00.00,"1,91,352.86","3,82,705.71",
23-Nov-25,Transfer,00.00,"38,270.57","3,44,435.14",
23-Nov-25,Commission,"3,711.70",00.00,"3,48,146.84",
23-Nov-25,Commission,"2,303.15",00.00,"3,50,449.99",
23-Nov-25,Debit Card,"13,951.22",00.00,"3,64,401.21",
23-Nov-25,Purchase,00.00,"52,057.32","3,12,343.89",
24-Nov-25,Transfer,00.00,"31,234.39","2,81,109.50",
24-Nov-25,Purchase,"1,05,583.20",00.00,"3,86,692.70",
24-Nov-25,RTGS,00.00,"55,241.81","3,31,450.89",
24-Nov-25,IMPS,10.76,00.00,"3,31,461.65",
24-Nov-25,Cheque,00.00,"3,31,461.65",00.00,
24-Nov-25,RTGS,01.00,00.00,01.00,
24-Nov-25,Debit Card,"2,01,240.50",00.00,"2,01,241.50",
24-Nov-25,Interest,"3,364.41",00.00,"2,04,605.91",
24-Nov-25,Debit Card,00.00,"20,460.59","1,84,145.32",
24-Nov-25,Purchase,"3,33,973.25",00.00,"5,18,118.57",
24-Nov-25,Transportellaneous,00.00,"1,29,529.64","3,88,588.93",
24-Nov-25,Bill,00.00,"55,512.70","3,33,076.23",
24-Nov-25,Reversal,00.00,"55,512.71","2,77,563.52",
24-Nov-25,Transportellaneous,"13,370.38",00.00,"2,90,933.90",
24-Nov-25,Tax,00.00,"58,186.78","2,32,747.12",
24-Nov-25,Transportellaneous,00.00,"38,791.19","1,93,955.93",
24-Nov-25,Reversal,00.00,"27,707.99","1,66,247.94",
24-Nov-25,Interest,"3,899.20",00.00,"1,70,147.14",
24-Nov-25,Cheque,"46,092.62",00.00,"2,16,239.76",
24-Nov-25,ATM,00.00,"72,079.92","1,44,159.84",
24-Nov-25,ATM,00.00,"16,017.76","1,28,142.08",
24-Nov-25,Cash,"1,83,503.80",00.00,"3,11,645.88",
24-Nov-25,Transfer,"18,630.00",00.00,"3,30,275.88",
24-Nov-25,Cheque,00.00,"33,027.59","2,97,248.29",
24-Nov-25,Commission,"20,15,985.50",00.00,"23,13,233.79",
24-Nov-25,Cheque,00.00,"5,78,308.45","17,34,925.34",
24-Nov-25,Reversal,00.00,"2,89,154.22","14,45,771.12",
24-Nov-25,Interest,"1,668.50",00.00,"14,47,439.62",
24-Nov-25,ATM,"10,52,588.50",00.00,"25,00,028.12",
24-Nov-25,NEFT,00.00,"6,25,007.03","18,75,021.09",
24-Nov-25,Purchase,317,00.00,"18,75,338.09",
25-Nov-25,RTGS,01.10,00.00,"18,75,339.19",
26-Nov-25,Interest,"3,62,503.50",00.00,"22,37,842.69",
26-Nov-25,RTGS,"3,88,103.20",00.00,"26,25,945.89",
26-Nov-25,IMPS,"1,31,409.00",00.00,"27,57,354.89",
26-Nov-25,Debit Card,54.27,00.00,"27,57,409.16",
26-Nov-25,NEFT,03.09,00.00,"27,57,412.25",
26-Nov-25,IMPS,00.00,"2,75,741.23","24,81,671.02",
26-Nov-25,Transfer,"4,97,052.00",00.00,"29,78,723.02",
26-Nov-25,Tax,00.00,"7,44,680.76","22,34,042.26",
26-Nov-25,Tax,00.00,"2,79,255.28","19,54,786.98",
26-Nov-25,Cash,00.00,"2,44,348.37","17,10,438.61",
26-Nov-25,Reversal,215.22,00.00,"17,10,653.83",
26-Nov-25,Bill,00.00,"2,44,379.12","14,66,274.71",
26-Nov-25,Debit Card,00.00,"2,44,379.12","12,21,895.59",
26-Nov-25,RTGS,28.35,00.00,"12,21,923.94",
26-Nov-25,Cash,00.00,"3,05,480.99","9,16,442.96",
26-Nov-25,Cash,00.00,"1,52,740.49","7,63,702.47",
26-Nov-25,Transportellaneous,00.00,"1,52,740.49","6,10,961.98",
26-Nov-25,IMPS,05.55,00.00,"6,10,967.53",
26-Nov-25,Transfer,44,00.00,"6,11,011.53",
27-Nov-25,IMPS,00.00,"2,03,670.51","4,07,341.02",
27-Nov-25,Interest,00.00,"81,468.20","3,25,872.82",
27-Nov-25,Transportellaneous,00.00,"32,587.28","2,93,285.54",
27-Nov-25,Transfer,312,00.00,"2,93,597.54",
27-Nov-25,Tax,00.00,"41,942.51","2,51,655.03",
27-Nov-25,Cheque,00.00,"83,885.01","1,67,770.02",
27-Nov-25,Debit Card,00.00,"23,967.15","1,43,802.87",
27-Nov-25,Tax,92,00.00,"1,43,894.87",
27-Nov-25,Debit Card,00.00,"71,947.44","71,947.44",
27-Nov-25,Debit Card,"14,43,844.50",00.00,"15,15,791.94",
27-Nov-25,Cheque,00.00,"1,68,421.33","13,47,370.61",
27-Nov-25,NEFT,08.00,00.00,"13,47,378.61",
27-Nov-25,Interest,00.00,"1,68,422.33","11,78,956.28",
27-Nov-25,Reversal,18,00.00,"11,78,974.28",
27-Nov-25,Commission,"13,03,455.25",00.00,"24,82,429.53",
27-Nov-25,Transportellaneous,"8,72,745.00",00.00,"33,55,174.53",
27-Nov-25,Reversal,"4,866.00",00.00,"33,60,040.53",
27-Nov-25,Commission,00.00,"33,60,040.53",00.00,
27-Nov-25,Tax,"15,36,610.20",00.00,"15,36,610.20",
27-Nov-25,Transportellaneous,272.2,00.00,"15,36,882.40",
27-Nov-25,Cheque,00.00,"3,84,220.60","11,52,661.80",
27-Nov-25,IMPS,00.00,"5,76,330.90","5,76,330.90",
27-Nov-25,Commission,00.00,"57,633.09","5,18,697.81",
27-Nov-25,ATM,101.8,00.00,"5,18,799.61",
27-Nov-25,Bill,00.00,"1,29,699.90","3,89,099.71",
27-Nov-25,Cash,39,00.00,"3,89,138.71",
27-Nov-25,Interest,00.00,"64,856.45","3,24,282.26",
27-Nov-25,Transportellaneous,00.00,"40,535.28","2,83,746.98",
27-Nov-25,Purchase,"63,296.70",00.00,"3,47,043.68",
27-Nov-25,Commission,280.4,00.00,"3,47,324.08",
27-Nov-25,Tax,00.00,"3,47,324.08",00.00,
27-Nov-25,Transfer,292,00.00,292,
27-Nov-25,Interest,00.00,292,00.00,
27-Nov-25,Reversal,"16,94,342.00",00.00,"16,94,342.00",
27-Nov-25,IMPS,"1,15,701.78",00.00,"18,10,043.78",
27-Nov-25,Purchase,00.00,"4,52,510.95","13,57,532.84",
27-Nov-25,Cheque,00.00,"4,52,510.95","9,05,021.89",
27-Nov-25,Commission,00.00,"1,81,004.38","7,24,017.51",
27-Nov-25,Debit Card,"16,47,505.00",00.00,"23,71,522.51",
27-Nov-25,NEFT,"26,981.00",00.00,"23,98,503.51",
27-Nov-25,Transportellaneous,00.00,"2,39,850.35","21,58,653.16",
27-Nov-25,Cash,00.00,"7,19,551.05","14,39,102.11",
27-Nov-25,Transportellaneous,00.00,"1,79,887.76","12,59,214.35",
27-Nov-25,ATM,00.00,"6,29,607.18","6,29,607.18",
27-Nov-25,Transportellaneous,39.06,00.00,"6,29,646.24",
27-Nov-25,ATM,"1,62,487.50",00.00,"7,92,133.74",
27-Nov-25,IMPS,00.00,"3,96,066.87","3,96,066.87",
27-Nov-25,Transfer,"2,052.50",00.00,"3,98,119.37",
27-Nov-25,Cheque,344,00.00,"3,98,463.37",
27-Nov-25,IMPS,00.00,"56,923.34","3,41,540.03",
27-Nov-25,IMPS,00.00,"1,70,770.02","1,70,770.02",
27-Nov-25,Tax,00.00,"34,154.00","1,36,616.02",
27-Nov-25,Tax,00.00,"17,077.00","1,19,539.02",
27-Nov-25,Reversal,59,00.00,"1,19,598.02",
27-Nov-25,Bill,19,00.00,"1,19,617.02",
27-Nov-25,Tax,25.4,00.00,"1,19,642.42",
27-Nov-25,IMPS,00.00,"23,928.48","95,713.94",
27-Nov-25,IMPS,02.70,00.00,"95,716.64",
27-Nov-25,Cash,04.00,00.00,"95,720.64",
27-Nov-25,Transportellaneous,00.00,"19,144.13","76,576.51",
27-Nov-25,Transfer,"9,41,853.75",00.00,"10,18,430.26",
27-Nov-25,NEFT,"2,932.20",00.00,"10,21,362.46",
27-Nov-25,Purchase,54.9,00.00,"10,21,417.36",
27-Nov-25,Reversal,00.00,"1,70,236.23","8,51,181.13",
27-Nov-25,Cheque,"10,54,865.00",00.00,"19,06,046.13",
27-Nov-25,RTGS,33.3,00.00,"19,06,079.43",
27-Nov-25,IMPS,"20,29,638.25",00.00,"39,35,717.68",
27-Nov-25,ATM,00.00,"39,35,717.68",00.00,
27-Nov-25,Transfer,"2,351.32",00.00,"2,351.32",
27-Nov-25,Commission,27.7,00.00,"2,379.02",
27-Nov-25,Reversal,00.00,396.5,"1,982.52",
27-Nov-25,IMPS,00.00,660.84,"1,321.68",
27-Nov-25,Reversal,"15,605.40",00.00,"16,927.08",
27-Nov-25,Interest,00.00,"1,880.79","15,046.29",
27-Nov-25,Bill,00.00,"1,504.63","13,541.66",
27-Nov-25,Transportellaneous,11.7,00.00,"13,553.36",
27-Nov-25,Reversal,"1,440.30",00.00,"14,993.66",
27-Nov-25,Cash,"80,385.94",00.00,"95,379.60",
27-Nov-25,Commission,"13,099.00",00.00,"1,08,478.60",
27-Nov-25,IMPS,00.50,00.00,"1,08,479.10",
27-Nov-25,Tax,"3,57,532.75",00.00,"4,66,011.85",
27-Nov-25,Bill,00.00,"2,33,005.93","2,33,005.92",
27-Nov-25,Transportellaneous,00.00,"23,300.59","2,09,705.33",
27-Nov-25,Transportellaneous,"2,442.10",00.00,"2,12,147.43",
27-Nov-25,Debit Card,"60,582.00",00.00,"2,72,729.43",
27-Nov-25,Transfer,00.00,"30,303.27","2,42,426.16",
27-Nov-25,Purchase,00.00,"34,632.31","2,07,793.85",
27-Nov-25,Cheque,"1,99,969.88",00.00,"4,07,763.73",
27-Nov-25,Bill,00.00,"58,251.96","3,49,511.77",
27-Nov-25,Commission,"1,40,668.06",00.00,"4,90,179.83",
27-Nov-25,NEFT,00.00,"4,90,179.83",00.00,
27-Nov-25,Debit Card,"3,65,466.00",00.00,"3,65,466.00",
27-Nov-25,Bill,07.30,00.00,"3,65,473.30",
27-Nov-25,Transportellaneous,"22,726.93",00.00,"3,88,200.23",
27-Nov-25,Tax,"2,17,523.00",00.00,"6,05,723.23",
27-Nov-25,NEFT,00.00,"1,51,430.81","4,54,292.42",
27-Nov-25,Cheque,"5,63,880.75",00.00,"10,18,173.17",
27-Nov-25,Debit Card,00.00,"2,54,543.29","7,63,629.88",
27-Nov-25,Interest,"5,55,230.25",00.00,"13,18,860.13",
28-Nov-25,Commission,"13,926.25",00.00,"13,32,786.38",
28-Nov-25,ATM,00.00,"3,33,196.60","9,99,589.78",
28-Nov-25,Commission,00.00,"99,958.98","8,99,630.80",
28-Nov-25,Debit Card,00.00,"1,28,518.69","7,71,112.11",
28-Nov-25,Interest,"5,11,227.00",00.00,"12,82,339.11",
28-Nov-25,Interest,"11,98,446.75",00.00,"24,80,785.86",
28-Nov-25,Reversal,"76,833.56",00.00,"25,57,619.42",
28-Nov-25,Reversal,08.20,00.00,"25,57,627.62",
28-Nov-25,IMPS,136,00.00,"25,57,763.62",
28-Nov-25,NEFT,"2,960.90",00.00,"25,60,724.52",
28-Nov-25,NEFT,"23,606.00",00.00,"25,84,330.52",
28-Nov-25,Reversal,00.00,"8,61,443.51","17,22,887.01",
28-Nov-25,Purchase,00.00,"1,91,431.89","15,31,455.12",
28-Nov-25,IMPS,00.00,"3,82,863.78","11,48,591.34",
28-Nov-25,Cash,00.00,"5,74,295.67","5,74,295.67",
28-Nov-25,IMPS,00.00,"57,429.57","5,16,866.10",
28-Nov-25,Purchase,"28,388.00",00.00,"5,45,254.10",
28-Nov-25,IMPS,"16,449.10",00.00,"5,61,703.20",
28-Nov-25,Purchase,"1,52,351.69",00.00,"7,14,054.89",
28-Nov-25,NEFT,00.00,"89,256.86","6,24,798.03",
28-Nov-25,Debit Card,197.45,00.00,"6,24,995.48",
28-Nov-25,ATM,411.9,00.00,"6,25,407.38",
28-Nov-25,Cash,07.58,00.00,"6,25,414.96",
28-Nov-25,Cheque,00.00,"62,541.50","5,62,873.46",
28-Nov-25,Cash,"1,68,526.00",00.00,"7,31,399.46",
28-Nov-25,Cheque,"7,94,957.75",00.00,"15,26,357.21",
28-Nov-25,Interest,00.00,"5,08,785.74","10,17,571.47",
28-Nov-25,Reversal,"2,984.60",00.00,"10,20,556.07",
28-Nov-25,Transfer,00.00,"1,13,395.12","9,07,160.95",
28-Nov-25,Bill,00.00,"4,53,580.48","4,53,580.48",
28-Nov-25,Interest,00.00,"2,26,790.24","2,26,790.24",
28-Nov-25,NEFT,00.00,"2,26,790.24",00.00,
28-Nov-25,Cheque,"8,649.62",00.00,"8,649.62",
28-Nov-25,Purchase,00.00,"2,162.41","6,487.22",
28-Nov-25,RTGS,"21,294.60",00.00,"27,781.82",
28-Nov-25,Bill,00.00,"2,778.18","25,003.64",
28-Nov-25,Debit Card,00.00,"4,167.27","20,836.37",
28-Nov-25,ATM,00.00,"2,083.64","18,752.73",
28-Nov-25,Bill,00.00,"4,688.18","14,064.55",
28-Nov-25,RTGS,"2,17,787.53",00.00,"2,31,852.08",
28-Nov-25,Cheque,331.55,00.00,"2,32,183.63",
28-Nov-25,Transfer,"9,94,009.75",00.00,"12,26,193.38",
29-Nov-25,Bill,00.00,"12,26,193.38",00.00,
29-Nov-25,Cash,"8,07,423.00",00.00,"8,07,423.00",
29-Nov-25,Purchase,00.00,"1,15,346.14","6,92,076.86",
29-Nov-25,Reversal,06.00,00.00,"6,92,082.86",
29-Nov-25,RTGS,00.00,"1,73,020.72","5,19,062.14",
29-Nov-25,ATM,00.00,"64,882.77","4,54,179.37",
29-Nov-25,ATM,00.00,"45,417.94","4,08,761.43",
29-Nov-25,Transportellaneous,00.00,"1,02,190.36","3,06,571.07",
29-Nov-25,Debit Card,495.5,00.00,"3,07,066.57",
29-Nov-25,Bill,00.00,"76,766.64","2,30,299.93",
29-Nov-25,Bill,10.4,00.00,"2,30,310.33",
29-Nov-25,Commission,04.90,00.00,"2,30,315.23",
29-Nov-25,Transportellaneous,00.00,"57,578.81","1,72,736.42",
29-Nov-25,Bill,"28,280.63",00.00,"2,01,017.05",
29-Nov-25,IMPS,319.58,00.00,"2,01,336.63",
29-Nov-25,Debit Card,00.00,"28,762.38","1,72,574.25",
29-Nov-25,NEFT,04.97,00.00,"1,72,579.22",
29-Nov-25,Reversal,00.00,"43,144.81","1,29,434.42",
30-Nov-25,Reversal,00.00,"18,490.63","1,10,943.79",
30-Nov-25,NEFT,"27,739.40",00.00,"1,38,683.19",
30-Nov-25,Transportellaneous,"1,51,676.81",00.00,"2,90,360.00",
30-Nov-25,Interest,00.00,"1,45,180.00","1,45,180.00",
30-Nov-25,Commission,02.43,00.00,"1,45,182.43",
30-Nov-25,Bill,105.7,00.00,"1,45,288.13",
30-Nov-25,Tax,00.00,"36,322.03","1,08,966.10",
30-Nov-25,Transfer,"1,00,849.00",00.00,"2,09,815.10",
30-Nov-25,IMPS,00.00,"23,312.79","1,86,502.31",
30-Nov-25,Cheque,23.7,00.00,"1,86,526.01",
30-Nov-25,Tax,00.00,"23,315.75","1,63,210.26",
30-Nov-25,Cheque,00.00,"81,605.13","81,605.13",
30-Nov-25,Transfer,00.00,"8,160.51","73,444.62",
30-Nov-25,Bill,00.00,"18,361.16","55,083.46",
30-Nov-25,Cheque,07.00,00.00,"55,090.46",
30-Nov-25,Cheque,"19,014.00",00.00,"74,104.46",
30-Nov-25,Transfer,"5,089.52",00.00,"79,193.98",
30-Nov-25,Transportellaneous,00.00,"79,193.98",00.00,
30-Nov-25,Purchase,"1,68,898.30",00.00,"1,68,898.30",
30-Nov-25,IMPS,"1,229.00",00.00,"1,70,127.30",
30-Nov-25,Tax,"1,65,718.00",00.00,"3,35,845.30",
30-Nov-25,Tax,00.00,"67,169.06","2,68,676.24",
30-Nov-25,Purchase,00.00,"33,584.53","2,35,091.71",
30-Nov-25,IMPS,01.30,00.00,"2,35,093.01",
30-Nov-25,ATM,00.00,"58,773.25","1,76,319.76",
30-Nov-25,Debit Card,"2,16,789.30",00.00,"3,93,109.06",
30-Nov-25,ATM,00.00,"78,621.81","3,14,487.25",
30-Nov-25,Purchase,330.8,00.00,"3,14,818.05",
30-Nov-25,Commission,"28,448.53",00.00,"3,43,266.58",
30-Nov-25,Bill,"1,345.75",00.00,"3,44,612.33",
30-Nov-25,Cash,07.90,00.00,"3,44,620.23",
30-Nov-25,Cash,00.00,"86,155.06","2,58,465.17",
30-Nov-25,Bill,04.00,00.00,"2,58,469.17",
30-Nov-25,Transportellaneous,"3,32,016.75",00.00,"5,90,485.92",
30-Nov-25,Purchase,"13,257.00",00.00,"6,03,742.92",
30-Nov-25,Interest,"1,141.32",00.00,"6,04,884.24",
01-Dec-25,Tax,00.00,"2,01,628.08","4,03,256.16",
01-Dec-25,NEFT,"16,82,179.75",00.00,"20,85,435.91",
01-Dec-25,Cheque,"17,92,602.00",00.00,"38,78,037.91",
01-Dec-25,Debit Card,00.00,"4,84,754.74","33,93,283.17",
01-Dec-25,Cheque,00.00,"3,39,328.32","30,53,954.85",
01-Dec-25,Cheque,00.00,"5,08,992.48","25,44,962.38",
01-Dec-25,Commission,01.70,00.00,"25,44,964.08",
01-Dec-25,Purchase,00.00,"4,24,160.68","21,20,803.40",
01-Dec-25,Interest,52.7,00.00,"21,20,856.10",
01-Dec-25,Cheque,00.00,"10,60,428.05","10,60,428.05",
01-Dec-25,RTGS,291.34,00.00,"10,60,719.39",
01-Dec-25,Bill,00.00,"1,76,786.57","8,83,932.82",
01-Dec-25,Bill,604.11,00.00,"8,84,536.93",
01-Dec-25,Cash,"29,427.95",00.00,"9,13,964.88",
02-Dec-25,IMPS,00.00,"1,14,245.61","7,99,719.27",
02-Dec-25,Purchase,02.00,00.00,"7,99,721.27",
02-Dec-25,Tax,00.00,"1,14,245.90","6,85,475.37",
02-Dec-25,Cash,"1,88,466.00",00.00,"8,73,941.37",
02-Dec-25,Bill,00.00,"1,24,848.77","7,49,092.60",
02-Dec-25,Debit Card,00.00,"74,909.26","6,74,183.34",
02-Dec-25,Interest,"2,40,653.88",00.00,"9,14,837.22",
02-Dec-25,Transfer,00.00,"3,04,945.74","6,09,891.48",
02-Dec-25,Reversal,07.79,00.00,"6,09,899.27",
02-Dec-25,Tax,00.00,"6,09,899.27",00.00,
02-Dec-25,Purchase,08.00,00.00,08.00,
02-Dec-25,Debit Card,"81,426.72",00.00,"81,434.72",
02-Dec-25,Commission,"14,68,188.00",00.00,"15,49,622.72",
02-Dec-25,ATM,00.00,"3,09,924.54","12,39,698.18",
02-Dec-25,Reversal,00.00,"3,09,924.55","9,29,773.64",
02-Dec-25,IMPS,00.00,"1,03,308.18","8,26,465.46",
02-Dec-25,IMPS,00.00,"2,06,616.37","6,19,849.10",
02-Dec-25,ATM,"3,30,558.00",00.00,"9,50,407.10",
02-Dec-25,Purchase,"32,180.00",00.00,"9,82,587.10",
02-Dec-25,ATM,54,00.00,"9,82,641.10",
02-Dec-25,RTGS,"3,391.00",00.00,"9,86,032.10",
02-Dec-25,Commission,"2,26,724.16",00.00,"12,12,756.26",
02-Dec-25,Transfer,"20,049.42",00.00,"12,32,805.68",
02-Dec-25,Transfer,00.00,"3,08,201.42","9,24,604.26",
02-Dec-25,Commission,00.00,"1,54,100.71","7,70,503.55",
02-Dec-25,Purchase,00.00,"7,70,503.55",00.00,
02-Dec-25,Debit Card,"3,845.60",00.00,"3,845.60",
02-Dec-25,Transportellaneous,00.00,640.93,"3,204.67",
02-Dec-25,Purchase,00.00,"1,068.22","2,136.45",
02-Dec-25,Reversal,00.00,"1,068.23","1,068.22",
02-Dec-25,NEFT,23.8,00.00,"1,092.02",
02-Dec-25,Reversal,"2,105.50",00.00,"3,197.52",
02-Dec-25,Interest,"9,515.00",00.00,"12,712.52",
02-Dec-25,Cash,15.71,00.00,"12,728.23",
02-Dec-25,Cheque,"2,862.00",00.00,"15,590.23",
02-Dec-25,Commission,"15,92,488.00",00.00,"16,08,078.23",
02-Dec-25,Cheque,"1,475.20",00.00,"16,09,553.43",
02-Dec-25,Interest,04.00,00.00,"16,09,557.43",
02-Dec-25,Reversal,"1,553.14",00.00,"16,11,110.57",
02-Dec-25,Debit Card,04.00,00.00,"16,11,114.57",
02-Dec-25,Commission,00.00,"2,01,389.32","14,09,725.25",
02-Dec-25,Interest,"1,86,430.00",00.00,"15,96,155.25",
02-Dec-25,NEFT,00.00,"7,98,077.63","7,98,077.62",
02-Dec-25,Purchase,00.00,"2,66,025.87","5,32,051.75",
02-Dec-25,ATM,"31,970.00",00.00,"5,64,021.75",
03-Dec-25,Cheque,00.00,"94,003.63","4,70,018.12",
03-Dec-25,Purchase,05.43,00.00,"4,70,023.55",
03-Dec-25,Debit Card,"1,51,460.10",00.00,"6,21,483.65",
03-Dec-25,Transportellaneous,17.1,00.00,"6,21,500.75",
03-Dec-25,Interest,00.00,"1,03,583.46","5,17,917.29",
03-Dec-25,Cheque,00.00,"2,58,958.65","2,58,958.64",
03-Dec-25,ATM,04.51,00.00,"2,58,963.15",
03-Dec-25,Bill,24.56,00.00,"2,58,987.71",
03-Dec-25,Bill,00.00,"2,58,987.71",00.00,
04-Dec-25,Cheque,"18,472.80",00.00,"18,472.80",
05-Dec-25,Purchase,174,00.00,"18,646.80",
05-Dec-25,IMPS,"1,18,104.60",00.00,"1,36,751.40",
05-Dec-25,Reversal,01.00,00.00,"1,36,752.40",
05-Dec-25,Reversal,"11,52,062.00",00.00,"12,88,814.40",
05-Dec-25,Cheque,00.00,"4,29,604.80","8,59,209.60",
05-Dec-25,Cheque,51.69,00.00,"8,59,261.29",
05-Dec-25,RTGS,00.00,"85,926.13","7,73,335.16",
05-Dec-25,Bill,"18,879.60",00.00,"7,92,214.76",
05-Dec-25,ATM,05.00,00.00,"7,92,219.76",
05-Dec-25,IMPS,00.00,"3,96,109.88","3,96,109.88",
05-Dec-25,Commission,"6,108.54",00.00,"4,02,218.42",
05-Dec-25,RTGS,00.00,"67,036.40","3,35,182.02",
05-Dec-25,Bill,"1,504.00",00.00,"3,36,686.02",
05-Dec-25,Purchase,00.00,"42,085.75","2,94,600.27",
05-Dec-25,Transfer,00.00,"49,100.05","2,45,500.22",
05-Dec-25,RTGS,00.00,"40,916.70","2,04,583.52",
05-Dec-25,IMPS,00.00,"40,916.70","1,63,666.82",
05-Dec-25,Tax,00.00,"32,733.36","1,30,933.46",
05-Dec-25,Purchase,00.00,"26,186.69","1,04,746.77",
05-Dec-25,Interest,43.29,00.00,"1,04,790.06",
05-Dec-25,Bill,00.30,00.00,"1,04,790.36",
06-Dec-25,RTGS,00.00,"17,465.06","87,325.30",
06-Dec-25,Interest,192,00.00,"87,517.30",
06-Dec-25,NEFT,00.00,"17,503.46","70,013.84",
06-Dec-25,ATM,"48,615.00",00.00,"1,18,628.84",
06-Dec-25,ATM,51,00.00,"1,18,679.84",
06-Dec-25,ATM,"4,76,270.00",00.00,"5,94,949.84",
06-Dec-25,Transfer,00.00,"1,18,989.97","4,75,959.87",
06-Dec-25,Transfer,00.00,"1,58,653.29","3,17,306.58",
06-Dec-25,ATM,00.00,"1,05,768.86","2,11,537.72",
06-Dec-25,RTGS,00.00,"1,05,768.86","1,05,768.86",
06-Dec-25,Reversal,"1,46,689.40",00.00,"2,52,458.26",
06-Dec-25,Purchase,205.6,00.00,"2,52,663.86",
06-Dec-25,ATM,00.00,"31,582.98","2,21,080.88",
06-Dec-25,NEFT,"16,24,788.25",00.00,"18,45,869.13",
06-Dec-25,Interest,"18,22,486.00",00.00,"36,68,355.13",
06-Dec-25,ATM,00.00,"18,34,177.57","18,34,177.56",
06-Dec-25,Interest,00.00,"18,34,177.56",00.00,
06-Dec-25,IMPS,"18,43,191.25",00.00,"18,43,191.25",
06-Dec-25,Cash,00.00,"3,07,198.54","15,35,992.71",
06-Dec-25,Debit Card,"30,045.07",00.00,"15,66,037.78",
06-Dec-25,Transportellaneous,00.00,"15,66,037.78",00.00,
06-Dec-25,RTGS,395.7,00.00,395.7,
06-Dec-25,Tax,00.00,395.7,00.00,
06-Dec-25,Bill,"1,197.42",00.00,"1,197.42",
06-Dec-25,Transportellaneous,"1,974.53",00.00,"3,171.95",
06-Dec-25,Bill,438.6,00.00,"3,610.55",
06-Dec-25,Debit Card,00.00,"3,610.55",00.00,
06-Dec-25,NEFT,06.40,00.00,06.40,
06-Dec-25,ATM,00.00,00.64,05.76,
07-Dec-25,Interest,00.00,02.88,02.88,
07-Dec-25,Interest,30.2,00.00,33.08,
07-Dec-25,Transportellaneous,00.00,11.03,22.05,
07-Dec-25,ATM,00.00,07.35,14.7,
07-Dec-25,Reversal,"12,24,387.25",00.00,"12,24,401.95",
07-Dec-25,Commission,00.00,"4,08,133.98","8,16,267.97",
07-Dec-25,ATM,00.00,"2,04,066.99","6,12,200.98",
07-Dec-25,Reversal,"1,94,419.80",00.00,"8,06,620.78",
07-Dec-25,NEFT,07.30,00.00,"8,06,628.08",
07-Dec-25,Debit Card,00.00,"1,00,828.51","7,05,799.57",
07-Dec-25,IMPS,00.00,"3,52,899.79","3,52,899.78",
07-Dec-25,Cheque,00.00,"1,17,633.26","2,35,266.52",
07-Dec-25,Transfer,00.00,"26,140.72","2,09,125.80",
08-Dec-25,ATM,"11,448.00",00.00,"2,20,573.80",
08-Dec-25,Bill,"1,023.00",00.00,"2,21,596.80",
08-Dec-25,Debit Card,00.00,"2,21,596.80",00.00,
08-Dec-25,RTGS,"1,54,029.53",00.00,"1,54,029.53",
08-Dec-25,RTGS,"3,385.00",00.00,"1,57,414.53",
08-Dec-25,Cheque,490.6,00.00,"1,57,905.13",
09-Dec-25,NEFT,00.00,"19,738.14","1,38,166.99",
09-Dec-25,Transfer,37.31,00.00,"1,38,204.30",
09-Dec-25,Cash,00.00,"13,820.43","1,24,383.87",
09-Dec-25,Cash,104.3,00.00,"1,24,488.17",
09-Dec-25,IMPS,"23,655.16",00.00,"1,48,143.33",
09-Dec-25,Debit Card,00.00,"18,517.92","1,29,625.41",
09-Dec-25,Cash,00.00,"14,402.82","1,15,222.59",
09-Dec-25,RTGS,00.00,"38,407.53","76,815.06",
09-Dec-25,Transportellaneous,"11,506.00",00.00,"88,321.06",
09-Dec-25,NEFT,01.00,00.00,"88,322.06",
09-Dec-25,Commission,00.00,"11,040.26","77,281.80",
09-Dec-25,Tax,00.00,"19,320.45","57,961.35",
09-Dec-25,ATM,"18,14,176.50",00.00,"18,72,137.85",
09-Dec-25,Debit Card,"10,038.90",00.00,"18,82,176.75",
09-Dec-25,Transportellaneous,"9,129.00",00.00,"18,91,305.75",
09-Dec-25,RTGS,00.00,"2,36,413.22","16,54,892.53",
09-Dec-25,NEFT,42.22,00.00,"16,54,934.75",
09-Dec-25,IMPS,"2,54,283.40",00.00,"19,09,218.15",
09-Dec-25,Transportellaneous,00.00,"1,90,921.82","17,18,296.34",
09-Dec-25,Reversal,00.00,"1,71,829.63","15,46,466.71",
09-Dec-25,Tax,00.00,"1,71,829.63","13,74,637.08",
09-Dec-25,Interest,"99,252.00",00.00,"14,73,889.08",
09-Dec-25,NEFT,00.00,"1,84,236.14","12,89,652.94",
09-Dec-25,Transfer,03.00,00.00,"12,89,655.94",
09-Dec-25,Reversal,00.00,"1,84,236.56","11,05,419.38",
09-Dec-25,Transfer,"18,23,617.00",00.00,"29,29,036.38",
09-Dec-25,Commission,00.00,"4,18,433.77","25,10,602.61",
09-Dec-25,Bill,00.00,"3,58,657.52","21,51,945.09",
09-Dec-25,Reversal,00.00,"7,17,315.03","14,34,630.06",
09-Dec-25,NEFT,00.00,"3,58,657.52","10,75,972.54",
09-Dec-25,Reversal,01.37,00.00,"10,75,973.91",
09-Dec-25,Cash,"12,074.03",00.00,"10,88,047.94",
09-Dec-25,Purchase,00.00,"1,55,435.42","9,32,612.52",
09-Dec-25,Cash,"27,484.60",00.00,"9,60,097.12",
09-Dec-25,Cash,00.00,"1,60,016.19","8,00,080.93",
09-Dec-25,Interest,00.00,"2,66,693.64","5,33,387.29",
09-Dec-25,NEFT,00.00,"53,338.73","4,80,048.56",
09-Dec-25,Purchase,00.00,"53,338.73","4,26,709.83",
09-Dec-25,RTGS,"24,062.94",00.00,"4,50,772.77",
09-Dec-25,Cheque,"1,98,919.80",00.00,"6,49,692.57",
09-Dec-25,NEFT,05.90,00.00,"6,49,698.47",
09-Dec-25,Commission,00.00,"3,24,849.24","3,24,849.24",
09-Dec-25,Cheque,26,00.00,"3,24,875.24",
09-Dec-25,Cash,00.00,"40,609.41","2,84,265.83",
09-Dec-25,Cash,"4,856.00",00.00,"2,89,121.83",
09-Dec-25,RTGS,428.77,00.00,"2,89,550.60",
09-Dec-25,Debit Card,00.00,"32,172.29","2,57,378.31",
09-Dec-25,Reversal,02.40,00.00,"2,57,380.71",
09-Dec-25,Cash,"22,071.30",00.00,"2,79,452.01",
09-Dec-25,Commission,"9,272.00",00.00,"2,88,724.01",
09-Dec-25,RTGS,00.00,"96,241.34","1,92,482.67",
09-Dec-25,Cheque,00.00,"27,497.52","1,64,985.15",
09-Dec-25,IMPS,425,00.00,"1,65,410.15",
09-Dec-25,NEFT,23.05,00.00,"1,65,433.20",
09-Dec-25,Transfer,01.00,00.00,"1,65,434.20",
09-Dec-25,Interest,"19,20,404.00",00.00,"20,85,838.20",
09-Dec-25,RTGS,00.00,"5,21,459.55","15,64,378.65",
09-Dec-25,NEFT,02.00,00.00,"15,64,380.65",
09-Dec-25,Cash,00.00,"3,91,095.16","11,73,285.49",
09-Dec-25,NEFT,"6,38,534.75",00.00,"18,11,820.24",
09-Dec-25,ATM,00.00,"18,11,820.24",00.00,
09-Dec-25,Cash,53.58,00.00,53.58,
09-Dec-25,Bill,00.00,07.65,45.93,
09-Dec-25,Transfer,00.00,22.97,22.96,
09-Dec-25,ATM,256,00.00,278.96,
10-Dec-25,ATM,00.00,69.74,209.22,
11-Dec-25,Cheque,00.00,69.74,139.48,
11-Dec-25,Reversal,"14,64,716.75",00.00,"14,64,856.23",
11-Dec-25,Cash,00.00,"2,92,971.25","11,71,884.98",
11-Dec-25,RTGS,00.00,"1,17,188.50","10,54,696.48",
11-Dec-25,Bill,221,00.00,"10,54,917.48",
11-Dec-25,Cheque,00.00,"2,10,983.50","8,43,933.98",
11-Dec-25,Interest,00.00,"1,68,786.80","6,75,147.18",
11-Dec-25,Transportellaneous,00.00,"96,449.60","5,78,697.58",
11-Dec-25,Interest,00.00,"72,337.20","5,06,360.38",
11-Dec-25,Debit Card,06.90,00.00,"5,06,367.28",
12-Dec-25,Bill,54,00.00,"5,06,421.28",
12-Dec-25,Purchase,00.00,"1,01,284.26","4,05,137.02",
12-Dec-25,Cheque,00.00,"40,513.70","3,64,623.32",
12-Dec-25,Reversal,00.00,"60,770.55","3,03,852.77",
12-Dec-25,IMPS,00.00,"30,385.28","2,73,467.49",
12-Dec-25,Cheque,00.00,"91,155.83","1,82,311.66",
12-Dec-25,Cheque,"28,793.00",00.00,"2,11,104.66",
12-Dec-25,Cash,00.00,"1,05,552.33","1,05,552.33",
12-Dec-25,Tax,03.80,00.00,"1,05,556.13",
12-Dec-25,Interest,"1,60,473.80",00.00,"2,66,029.93",
12-Dec-25,ATM,00.00,"29,558.88","2,36,471.05",
12-Dec-25,NEFT,00.00,"59,117.76","1,77,353.29",
12-Dec-25,RTGS,00.00,"88,676.65","88,676.64",
12-Dec-25,RTGS,29.42,00.00,"88,706.06",
12-Dec-25,Reversal,07.86,00.00,"88,713.92",
12-Dec-25,NEFT,00.00,"88,713.92",00.00,
12-Dec-25,Reversal,66,00.00,66,
12-Dec-25,Purchase,00.00,08.25,57.75,
12-Dec-25,RTGS,00.20,00.00,57.95,
12-Dec-25,Purchase,00.00,57.95,00.00,
12-Dec-25,Cheque,"2,394.94",00.00,"2,394.94",
12-Dec-25,Debit Card,00.00,"2,394.94",00.00,
12-Dec-25,ATM,37,00.00,37,
12-Dec-25,Tax,00.00,07.40,29.6,
12-Dec-25,Bill,"19,04,850.50",00.00,"19,04,880.10",
12-Dec-25,Tax,00.00,"3,17,480.02","15,87,400.08",
12-Dec-25,Bill,06.00,00.00,"15,87,406.08",
12-Dec-25,NEFT,10.68,00.00,"15,87,416.76",
12-Dec-25,Cheque,00.00,"7,93,708.38","7,93,708.38",
12-Dec-25,Cash,"7,94,749.00",00.00,"15,88,457.38",
12-Dec-25,Bill,"14,549.00",00.00,"16,03,006.38",
12-Dec-25,Tax,00.00,"4,00,751.60","12,02,254.78",
12-Dec-25,RTGS,"19,38,344.50",00.00,"31,40,599.28",
13-Dec-25,Transfer,"3,680.80",00.00,"31,44,280.08",
13-Dec-25,Purchase,18,00.00,"31,44,298.08",
13-Dec-25,ATM,20.6,00.00,"31,44,318.68",
13-Dec-25,Interest,00.00,"7,86,079.67","23,58,239.01",
13-Dec-25,Transportellaneous,00.00,"3,36,891.29","20,21,347.72",
13-Dec-25,RTGS,05.00,00.00,"20,21,352.72",
14-Dec-25,Interest,104.1,00.00,"20,21,456.82",
14-Dec-25,Cash,00.00,"3,36,909.47","16,84,547.35",
14-Dec-25,Reversal,00.00,"1,87,171.93","14,97,375.42",
14-Dec-25,Bill,00.00,"2,99,475.08","11,97,900.34",
14-Dec-25,NEFT,"2,017.90",00.00,"11,99,918.24",
14-Dec-25,Interest,"18,260.40",00.00,"12,18,178.64",
14-Dec-25,Cash,"1,82,921.00",00.00,"14,01,099.64",
14-Dec-25,Commission,28.67,00.00,"14,01,128.31",
14-Dec-25,RTGS,00.00,"2,33,521.39","11,67,606.92",
14-Dec-25,Bill,"1,378.40",00.00,"11,68,985.32",
14-Dec-25,Purchase,470.5,00.00,"11,69,455.82",
14-Dec-25,ATM,00.00,"11,69,455.82",00.00,
14-Dec-25,Reversal,"2,30,329.22",00.00,"2,30,329.22",
14-Dec-25,Commission,00.00,"23,032.92","2,07,296.30",
14-Dec-25,Transfer,03.33,00.00,"2,07,299.63",
14-Dec-25,Bill,"1,707.50",00.00,"2,09,007.13",
15-Dec-25,Interest,44.9,00.00,"2,09,052.03",
16-Dec-25,Purchase,00.00,"1,04,526.02","1,04,526.02",
16-Dec-25,Reversal,00.00,"14,932.29","89,593.73",
16-Dec-25,Cheque,"78,792.00",00.00,"1,68,385.73",
16-Dec-25,Cash,"3,805.20",00.00,"1,72,190.93",
16-Dec-25,Transportellaneous,00.00,"1,72,190.93",00.00,
16-Dec-25,Transfer,"3,528.00",00.00,"3,528.00",
16-Dec-25,IMPS,"7,08,399.00",00.00,"7,11,927.00",
16-Dec-25,Interest,00.00,"7,11,927.00",00.00,
16-Dec-25,Interest,13.4,00.00,13.4,
16-Dec-25,Interest,"3,804.05",00.00,"3,817.45",
16-Dec-25,NEFT,00.00,545.35,"3,272.10",
16-Dec-25,Tax,00.00,818.03,"2,454.07",
16-Dec-25,RTGS,00.00,409.01,"2,045.06",
16-Dec-25,Transfer,00.00,681.69,"1,363.37",
16-Dec-25,RTGS,00.00,454.46,908.91,
16-Dec-25,Interest,"2,674.00",00.00,"3,582.91",
16-Dec-25,NEFT,"24,173.35",00.00,"27,756.26",
16-Dec-25,IMPS,"30,399.97",00.00,"58,156.23",
16-Dec-25,Transportellaneous,00.00,"7,269.53","50,886.70",
17-Dec-25,Tax,"2,283.40",00.00,"53,170.10",
17-Dec-25,Transfer,32.4,00.00,"53,202.50",
17-Dec-25,Commission,00.00,"6,650.31","46,552.19",
17-Dec-25,Transfer,03.70,00.00,"46,555.89",
17-Dec-25,Purchase,272.7,00.00,"46,828.59",
17-Dec-25,ATM,00.00,"11,707.15","35,121.44",
17-Dec-25,Debit Card,00.00,"35,121.44",00.00,
17-Dec-25,Purchase,"8,99,110.00",00.00,"8,99,110.00",
17-Dec-25,Tax,00.00,"2,24,777.50","6,74,332.50",
17-Dec-25,ATM,01.00,00.00,"6,74,333.50",
17-Dec-25,Purchase,"12,438.11",00.00,"6,86,771.61",
17-Dec-25,Transportellaneous,"16,123.27",00.00,"7,02,894.88",
17-Dec-25,Transportellaneous,252,00.00,"7,03,146.88",
17-Dec-25,Transportellaneous,00.00,"7,03,146.88",00.00,
17-Dec-25,Commission,"27,773.20",00.00,"27,773.20",
17-Dec-25,Reversal,62.27,00.00,"27,835.47",
17-Dec-25,ATM,"2,082.70",00.00,"29,918.17",
18-Dec-25,ATM,"16,30,494.00",00.00,"16,60,412.17",
18-Dec-25,RTGS,00.00,"2,76,735.36","13,83,676.81",
18-Dec-25,Interest,"4,932.10",00.00,"13,88,608.91",
18-Dec-25,Transfer,00.00,"1,98,372.70","11,90,236.21",
18-Dec-25,NEFT,00.00,"1,48,779.53","10,41,456.68",
18-Dec-25,IMPS,"6,12,016.20",00.00,"16,53,472.88",
18-Dec-25,Transportellaneous,00.00,"2,06,684.11","14,46,788.77",
18-Dec-25,Transfer,03.00,00.00,"14,46,791.77",
18-Dec-25,NEFT,"85,094.44",00.00,"15,31,886.21",
18-Dec-25,Debit Card,00.00,"1,70,209.58","13,61,676.63",
18-Dec-25,Reversal,"1,24,727.62",00.00,"14,86,404.25",
18-Dec-25,NEFT,102.87,00.00,"14,86,507.12",
18-Dec-25,Transfer,00.00,"1,65,167.46","13,21,339.66",
18-Dec-25,Transportellaneous,00.00,"2,64,267.93","10,57,071.73",
18-Dec-25,Transportellaneous,28.6,00.00,"10,57,100.33",
18-Dec-25,Cheque,00.00,"1,17,455.59","9,39,644.74",
18-Dec-25,Transfer,00.00,"1,17,455.59","8,22,189.15",
18-Dec-25,RTGS,00.00,"91,354.35","7,30,834.80",
18-Dec-25,NEFT,06.10,00.00,"7,30,840.90",
18-Dec-25,NEFT,"27,770.61",00.00,"7,58,611.51",
18-Dec-25,IMPS,"52,612.50",00.00,"8,11,224.01",
19-Dec-25,Transfer,53.3,00.00,"8,11,277.31",
19-Dec-25,NEFT,"20,18,046.00",00.00,"28,29,323.31",
19-Dec-25,Interest,00.00,"14,14,661.66","14,14,661.66",
19-Dec-25,Cheque,74.18,00.00,"14,14,735.84",
19-Dec-25,RTGS,00.00,"2,02,105.12","12,12,630.72",
19-Dec-25,Transfer,00.00,"2,02,105.12","10,10,525.60",
19-Dec-25,Transportellaneous,"7,78,732.75",00.00,"17,89,258.35",
19-Dec-25,Tax,00.00,"17,89,258.35",00.00,
19-Dec-25,NEFT,08.00,00.00,08.00,
19-Dec-25,Commission,"9,87,124.00",00.00,"9,87,132.00",
19-Dec-25,Cash,"13,74,336.00",00.00,"23,61,468.00",
19-Dec-25,Bill,00.00,"11,80,734.00","11,80,734.00",
19-Dec-25,RTGS,00.00,"1,96,789.00","9,83,945.00",
19-Dec-25,RTGS,324,00.00,"9,84,269.00",
19-Dec-25,IMPS,00.00,"1,09,363.22","8,74,905.78",
19-Dec-25,Interest,720.3,00.00,"8,75,626.08",
19-Dec-25,Tax,00.00,"1,09,453.26","7,66,172.82",
19-Dec-25,Cash,"1,02,253.20",00.00,"8,68,426.02",
19-Dec-25,Transportellaneous,"39,281.00",00.00,"9,07,707.02",
19-Dec-25,Reversal,00.00,"2,26,926.76","6,80,780.26",
19-Dec-25,Cheque,00.00,"68,078.03","6,12,702.23",
19-Dec-25,IMPS,"1,782.33",00.00,"6,14,484.56",
19-Dec-25,Transportellaneous,"2,448.00",00.00,"6,16,932.56",
19-Dec-25,IMPS,"2,496.00",00.00,"6,19,428.56",
19-Dec-25,Cash,"1,332.60",00.00,"6,20,761.16",
20-Dec-25,IMPS,00.00,"1,55,190.29","4,65,570.87",
20-Dec-25,NEFT,"2,256.50",00.00,"4,67,827.37",
20-Dec-25,Cash,00.00,"51,980.82","4,15,846.55",
20-Dec-25,Cheque,"3,294.50",00.00,"4,19,141.05",
20-Dec-25,NEFT,00.00,"2,09,570.53","2,09,570.52",
20-Dec-25,Cash,00.00,"1,04,785.26","1,04,785.26",
20-Dec-25,Commission,22.9,00.00,"1,04,808.16",
20-Dec-25,Transportellaneous,00.00,"52,404.08","52,404.08",
20-Dec-25,Debit Card,00.00,"13,101.02","39,303.06",
20-Dec-25,Interest,00.00,"39,303.06",00.00,
20-Dec-25,Cheque,07.14,00.00,07.14,
20-Dec-25,Purchase,"20,14,391.25",00.00,"20,14,398.39",
20-Dec-25,Purchase,"11,034.00",00.00,"20,25,432.39",
20-Dec-25,RTGS,"15,520.10",00.00,"20,40,952.49",
20-Dec-25,Cash,00.00,"6,80,317.50","13,60,634.99",
20-Dec-25,Transportellaneous,"23,042.00",00.00,"13,83,676.99",
20-Dec-25,RTGS,00.00,"2,30,612.83","11,53,064.16",
20-Dec-25,Commission,"3,918.40",00.00,"11,56,982.56",
20-Dec-25,Commission,06.80,00.00,"11,56,989.36",
20-Dec-25,Reversal,00.00,"1,44,623.67","10,12,365.69",
20-Dec-25,RTGS,00.00,"1,68,727.62","8,43,638.08",
20-Dec-25,RTGS,00.00,"1,68,727.62","6,74,910.46",
20-Dec-25,Reversal,"93,857.06",00.00,"7,68,767.52",
20-Dec-25,Cash,70,00.00,"7,68,837.52",
20-Dec-25,IMPS,146.64,00.00,"7,68,984.16",
20-Dec-25,NEFT,00.00,"1,53,796.83","6,15,187.33",
21-Dec-25,Transfer,00.00,"1,02,531.22","5,12,656.11",
21-Dec-25,Purchase,00.00,"73,236.59","4,39,419.52",
21-Dec-25,Bill,00.00,"54,927.44","3,84,492.08",
21-Dec-25,Bill,00.00,"64,082.01","3,20,410.07",
21-Dec-25,Debit Card,00.00,"40,051.26","2,80,358.81",
21-Dec-25,Purchase,737,00.00,"2,81,095.81",
21-Dec-25,Transportellaneous,143,00.00,"2,81,238.81",
21-Dec-25,Cheque,00.00,"28,123.88","2,53,114.93",
21-Dec-25,Debit Card,00.00,"28,123.88","2,24,991.05",
21-Dec-25,Cash,205.7,00.00,"2,25,196.75",
21-Dec-25,Reversal,00.00,"75,065.58","1,50,131.17",
21-Dec-25,Tax,"7,04,215.00",00.00,"8,54,346.17",
21-Dec-25,IMPS,00.62,00.00,"8,54,346.79",
21-Dec-25,Tax,00.00,"1,42,391.13","7,11,955.66",
21-Dec-25,Reversal,"14,498.72",00.00,"7,26,454.38",
21-Dec-25,Purchase,00.00,"80,717.15","6,45,737.23",
21-Dec-25,Transfer,00.00,"6,45,737.23",00.00,
21-Dec-25,Bill,40,00.00,40,
21-Dec-25,NEFT,05.00,00.00,45,
21-Dec-25,Cash,"2,251.00",00.00,"2,296.00",
21-Dec-25,Reversal,00.00,"1,148.00","1,148.00",
21-Dec-25,Tax,00.00,127.56,"1,020.44",
21-Dec-25,Tax,00.00,102.04,918.4,
21-Dec-25,Debit Card,00.00,131.2,787.2,
21-Dec-25,Tax,05.60,00.00,792.8,
21-Dec-25,IMPS,00.00,79.28,713.52,
22-Dec-25,NEFT,38.6,00.00,752.12,
22-Dec-25,Cheque,00.00,188.03,564.09,
22-Dec-25,RTGS,00.00,564.09,00.00,
22-Dec-25,IMPS,07.03,00.00,07.03,
22-Dec-25,Purchase,00.00,03.52,03.52,
22-Dec-25,Tax,499.86,00.00,503.38,
22-Dec-25,Cash,"9,19,355.50",00.00,"9,19,858.88",
22-Dec-25,NEFT,00.00,"1,83,971.78","7,35,887.10",
22-Dec-25,RTGS,00.00,"2,45,295.70","4,90,591.40",
22-Dec-25,Transfer,00.00,"49,059.14","4,41,532.26",
23-Dec-25,Transfer,00.00,"4,41,532.26",00.00,
23-Dec-25,Transfer,412,00.00,412,
23-Dec-25,Purchase,00.00,45.78,366.22,
23-Dec-25,Debit Card,"2,10,151.50",00.00,"2,10,517.72",
23-Dec-25,Commission,"9,047.27",00.00,"2,19,564.99",
23-Dec-25,ATM,186,00.00,"2,19,750.99",
23-Dec-25,Tax,"19,60,571.00",00.00,"21,80,321.99",
23-Dec-25,Commission,37.5,00.00,"21,80,359.49",
23-Dec-25,Tax,506,00.00,"21,80,865.49",
23-Dec-25,Transfer,435.07,00.00,"21,81,300.56",
23-Dec-25,ATM,"18,64,582.00",00.00,"40,45,882.56",
23-Dec-25,Commission,"1,337.63",00.00,"40,47,220.19",
23-Dec-25,Bill,00.00,"8,09,444.04","32,37,776.15",
23-Dec-25,NEFT,"15,69,767.20",00.00,"48,07,543.35",
23-Dec-25,Transfer,00.00,"24,03,771.68","24,03,771.67",
23-Dec-25,Cash,00.00,"6,00,942.92","18,02,828.75",
23-Dec-25,Reversal,"11,44,546.00",00.00,"29,47,374.75",
23-Dec-25,Debit Card,00.00,"14,73,687.38","14,73,687.38",
23-Dec-25,NEFT,00.00,"2,94,737.48","11,78,949.90",
23-Dec-25,Debit Card,57,00.00,"11,79,006.90",
23-Dec-25,Reversal,00.00,"2,35,801.38","9,43,205.52",
23-Dec-25,Tax,00.00,"1,04,800.61","8,38,404.91",
23-Dec-25,Commission,00.00,"1,39,734.15","6,98,670.76",
23-Dec-25,Transportellaneous,"65,531.00",00.00,"7,64,201.76",
23-Dec-25,NEFT,"18,24,184.00",00.00,"25,88,385.76",
23-Dec-25,NEFT,00.00,"25,88,385.76",00.00,
23-Dec-25,Tax,"3,551.97",00.00,"3,551.97",
23-Dec-25,Transportellaneous,00.00,592,"2,959.98",
23-Dec-25,Reversal,"19,47,795.50",00.00,"19,50,755.48",
23-Dec-25,Cheque,00.00,"9,75,377.74","9,75,377.74",
23-Dec-25,Tax,00.00,"1,95,075.55","7,80,302.19",
23-Dec-25,Commission,"7,96,224.80",00.00,"15,76,526.99",
23-Dec-25,Commission,"1,298.00",00.00,"15,77,824.99",
23-Dec-25,Bill,00.00,"1,57,782.50","14,20,042.49",
23-Dec-25,Interest,00.00,"1,42,004.25","12,78,038.24",
23-Dec-25,NEFT,00.00,"1,42,004.25","11,36,033.99",
23-Dec-25,ATM,00.00,"1,13,603.40","10,22,430.59",
23-Dec-25,NEFT,"1,798.90",00.00,"10,24,229.49",
23-Dec-25,Purchase,468,00.00,"10,24,697.49",
23-Dec-25,Bill,"3,967.51",00.00,"10,28,665.00",
23-Dec-25,Bill,00.00,"2,05,733.00","8,22,932.00",
23-Dec-25,Tax,00.00,"4,11,466.00","4,11,466.00",
23-Dec-25,Transportellaneous,00.00,"82,293.20","3,29,172.80",
23-Dec-25,NEFT,00.00,"1,64,586.40","1,64,586.40",
23-Dec-25,Bill,"3,044.12",00.00,"1,67,630.52",
23-Dec-25,IMPS,00.00,"20,953.82","1,46,676.70",
23-Dec-25,Cash,00.00,"24,446.12","1,22,230.58",
24-Dec-25,NEFT,05.00,00.00,"1,22,235.58",
24-Dec-25,Debit Card,00.00,"40,745.19","81,490.39",
24-Dec-25,Cheque,"10,745.04",00.00,"92,235.43",
24-Dec-25,Reversal,00.00,"11,529.43","80,706.00",
24-Dec-25,Purchase,"30,035.00",00.00,"1,10,741.00",
24-Dec-25,Debit Card,00.00,"13,842.63","96,898.38",
24-Dec-25,Bill,"1,042.00",00.00,"97,940.38",
24-Dec-25,Interest,"1,017.10",00.00,"98,957.48",
24-Dec-25,Reversal,"1,08,802.00",00.00,"2,07,759.48",
24-Dec-25,Cheque,05.60,00.00,"2,07,765.08",
24-Dec-25,Commission,00.00,"51,941.27","1,55,823.81",
24-Dec-25,Bill,00.00,"1,55,823.81",00.00,
24-Dec-25,Reversal,"26,944.00",00.00,"26,944.00",
24-Dec-25,Debit Card,00.00,"3,368.00","23,576.00",
24-Dec-25,Bill,00.00,"3,929.33","19,646.67",
24-Dec-25,Transfer,477.81,00.00,"20,124.48",
24-Dec-25,Reversal,00.00,"2,874.93","17,249.55",
24-Dec-25,NEFT,00.00,"8,624.78","8,624.78",
24-Dec-25,Debit Card,00.00,"2,156.20","6,468.59",
24-Dec-25,Cash,10,00.00,"6,478.59",
24-Dec-25,ATM,00.00,719.84,"5,758.75",
24-Dec-25,Cheque,329.3,00.00,"6,088.05",
24-Dec-25,NEFT,00.00,"1,522.01","4,566.04",
24-Dec-25,ATM,"2,45,701.38",00.00,"2,50,267.42",
24-Dec-25,Commission,"20,22,174.80",00.00,"22,72,442.22",
24-Dec-25,Reversal,00.00,"5,68,110.56","17,04,331.66",
24-Dec-25,IMPS,00.00,"2,13,041.46","14,91,290.20",
24-Dec-25,Interest,60.5,00.00,"14,91,350.70",
24-Dec-25,Commission,07.00,00.00,"14,91,357.70",
24-Dec-25,Commission,00.00,"1,86,419.71","13,04,937.99",
24-Dec-25,Purchase,"3,045.55",00.00,"13,07,983.54",
24-Dec-25,IMPS,00.00,"1,45,331.50","11,62,652.04",
24-Dec-25,Tax,00.00,"5,81,326.02","5,81,326.02",
24-Dec-25,Cash,63,00.00,"5,81,389.02",
24-Dec-25,NEFT,10.3,00.00,"5,81,399.32",
24-Dec-25,NEFT,00.00,"96,899.89","4,84,499.43",
24-Dec-25,Debit Card,00.00,"2,42,249.72","2,42,249.72",
24-Dec-25,IMPS,"1,22,534.00",00.00,"3,64,783.72",
24-Dec-25,Reversal,00.00,"36,478.37","3,28,305.35",
24-Dec-25,Commission,00.00,"82,076.34","2,46,229.01",
24-Dec-25,Purchase,"6,881.00",00.00,"2,53,110.01",
24-Dec-25,Purchase,125.4,00.00,"2,53,235.41",
24-Dec-25,Reversal,237.4,00.00,"2,53,472.81",
24-Dec-25,Cheque,"10,45,922.00",00.00,"12,99,394.81",
24-Dec-25,Debit Card,00.00,"1,85,627.83","11,13,766.98",
24-Dec-25,Transportellaneous,301.2,00.00,"11,14,068.18",
24-Dec-25,Interest,00.00,"2,78,517.05","8,35,551.14",
24-Dec-25,Debit Card,35,00.00,"8,35,586.14",
24-Dec-25,Commission,00.00,"1,39,264.36","6,96,321.78",
24-Dec-25,Cheque,"1,23,639.81",00.00,"8,19,961.59",
24-Dec-25,NEFT,"26,320.60",00.00,"8,46,282.19",
24-Dec-25,NEFT,00.00,"2,11,570.55","6,34,711.64",
24-Dec-25,Tax,"16,242.00",00.00,"6,50,953.64",
24-Dec-25,ATM,36.99,00.00,"6,50,990.63",
24-Dec-25,Transfer,478.06,00.00,"6,51,468.69",
24-Dec-25,IMPS,"15,82,083.00",00.00,"22,33,551.69",
24-Dec-25,Debit Card,00.00,"2,79,193.96","19,54,357.73",
24-Dec-25,NEFT,00.00,"6,51,452.58","13,02,905.15",
24-Dec-25,Reversal,00.00,"2,17,150.86","10,85,754.29",
24-Dec-25,RTGS,00.00,"10,85,754.29",00.00,
24-Dec-25,Transfer,"31,258.20",00.00,"31,258.20",
24-Dec-25,Transportellaneous,00.00,"15,629.10","15,629.10",
24-Dec-25,Interest,00.00,"2,604.85","13,024.25",
24-Dec-25,Cash,00.00,"2,604.85","10,419.40",
24-Dec-25,Cash,"19,321.95",00.00,"29,741.35",
24-Dec-25,RTGS,03.97,00.00,"29,745.32",
24-Dec-25,Purchase,"12,734.00",00.00,"42,479.32",
24-Dec-25,NEFT,00.00,"5,309.92","37,169.40",
24-Dec-25,Tax,00.00,"7,433.88","29,735.52",
24-Dec-25,Cheque,00.00,"7,433.88","22,301.64",
24-Dec-25,ATM,00.00,"3,716.94","18,584.70",
24-Dec-25,Interest,00.00,"3,097.45","15,487.25",
24-Dec-25,Interest,00.00,"7,743.63","7,743.62",
24-Dec-25,Cash,"1,049.40",00.00,"8,793.02",
24-Dec-25,Cheque,00.00,"4,396.51","4,396.51",
24-Dec-25,Interest,"31,409.91",00.00,"35,806.42",
25-Dec-25,Purchase,"22,536.00",00.00,"58,342.42",
25-Dec-25,Cheque,16.5,00.00,"58,358.92",
25-Dec-25,Debit Card,03.00,00.00,"58,361.92",
25-Dec-25,Transportellaneous,00.00,00.00,"58,361.92",
25-Dec-25,Purchase,"26,194.00",00.00,"84,555.92",
25-Dec-25,Transfer,"3,703.04",00.00,"88,258.96",
25-Dec-25,Interest,00.00,"88,258.96",00.00,
26-Dec-25,Cheque,124,00.00,124,
26-Dec-25,Cash,00.00,17.71,106.29,
27-Dec-25,IMPS,00.00,10.63,95.66,
27-Dec-25,ATM,"2,23,444.20",00.00,"2,23,539.86",
27-Dec-25,Commission,00.00,"1,11,769.93","1,11,769.93",
27-Dec-25,Cash,00.00,"1,11,769.93",00.00,
27-Dec-25,Cash,"12,029.60",00.00,"12,029.60",
27-Dec-25,Transfer,00.00,"3,007.40","9,022.20",
27-Dec-25,Commission,00.00,"1,503.70","7,518.50",
27-Dec-25,Interest,00.00,"1,503.70","6,014.80",
27-Dec-25,Tax,"1,97,896.90",00.00,"2,03,911.70",
27-Dec-25,Purchase,"30,985.00",00.00,"2,34,896.70",
27-Dec-25,RTGS,03.40,00.00,"2,34,900.10",
27-Dec-25,NEFT,"2,05,458.59",00.00,"4,40,358.69",
27-Dec-25,Transfer,00.00,"73,393.12","3,66,965.58",
27-Dec-25,Purchase,00.00,"45,870.70","3,21,094.88",
27-Dec-25,Purchase,"1,25,404.00",00.00,"4,46,498.88",
27-Dec-25,Transportellaneous,"18,681.00",00.00,"4,65,179.88",
27-Dec-25,ATM,03.74,00.00,"4,65,183.62",
27-Dec-25,RTGS,59.7,00.00,"4,65,243.32",
27-Dec-25,IMPS,"1,92,505.00",00.00,"6,57,748.32",
27-Dec-25,ATM,02.00,00.00,"6,57,750.32",
27-Dec-25,Purchase,04.00,00.00,"6,57,754.32",
27-Dec-25,NEFT,00.00,"3,28,877.16","3,28,877.16",
28-Dec-25,Cash,"5,933.28",00.00,"3,34,810.44",
28-Dec-25,Interest,48.2,00.00,"3,34,858.64",
28-Dec-25,ATM,00.00,"66,971.73","2,67,886.91",
28-Dec-25,Purchase,"85,282.00",00.00,"3,53,168.91",
28-Dec-25,Transfer,00.00,"3,53,168.91",00.00,
28-Dec-25,Tax,559,00.00,559,
28-Dec-25,Reversal,122.8,00.00,681.8,
28-Dec-25,Cash,00.00,85.23,596.57,
28-Dec-25,Purchase,00.00,99.43,497.14,
28-Dec-25,NEFT,58.9,00.00,556.04,
28-Dec-25,Debit Card,"45,009.00",00.00,"45,565.04",
28-Dec-25,Bill,00.00,"5,062.78","40,502.26",
28-Dec-25,NEFT,00.00,"5,062.78","35,439.48",
28-Dec-25,NEFT,"2,735.70",00.00,"38,175.18",
28-Dec-25,Debit Card,03.30,00.00,"38,178.48",
28-Dec-25,Cash,00.00,"4,242.05","33,936.43",
28-Dec-25,RTGS,"3,93,662.00",00.00,"4,27,598.43",
28-Dec-25,Tax,"71,191.22",00.00,"4,98,789.65",
28-Dec-25,Reversal,"1,207.00",00.00,"4,99,996.65",
28-Dec-25,Interest,40,00.00,"5,00,036.65",
28-Dec-25,NEFT,00.00,"1,25,009.16","3,75,027.49",
28-Dec-25,Transportellaneous,231,00.00,"3,75,258.49",
28-Dec-25,Commission,00.00,"41,695.39","3,33,563.10",
28-Dec-25,Transfer,00.00,00.00,"3,33,563.10",
28-Dec-25,Transportellaneous,00.00,"1,66,781.55","1,66,781.55",
28-Dec-25,Purchase,00.00,"55,593.85","1,11,187.70",
28-Dec-25,RTGS,00.00,"27,796.93","83,390.77",
28-Dec-25,NEFT,00.00,"9,265.64","74,125.13",
28-Dec-25,Cash,"2,325.00",00.00,"76,450.13",
28-Dec-25,Interest,00.00,"12,741.69","63,708.44",
28-Dec-25,Bill,00.00,"9,101.21","54,607.23",
28-Dec-25,Cheque,"77,377.03",00.00,"1,31,984.26",
28-Dec-25,Reversal,00.00,"13,198.43","1,18,785.83",
28-Dec-25,Bill,36.7,00.00,"1,18,822.53",
28-Dec-25,Debit Card,02.00,00.00,"1,18,824.53",
28-Dec-25,Interest,59.9,00.00,"1,18,884.43",
28-Dec-25,ATM,00.00,"19,814.07","99,070.36",
28-Dec-25,Cheque,"84,503.09",00.00,"1,83,573.45",
28-Dec-25,IMPS,00.00,"61,191.15","1,22,382.30",
28-Dec-25,Transportellaneous,"24,119.70",00.00,"1,46,502.00",
28-Dec-25,RTGS,522,00.00,"1,47,024.00",
28-Dec-25,Reversal,11,00.00,"1,47,035.00",
29-Dec-25,RTGS,00.00,"36,758.75","1,10,276.25",
29-Dec-25,Transfer,50.1,00.00,"1,10,326.35",
29-Dec-25,Purchase,00.00,"22,065.27","88,261.08",
29-Dec-25,Purchase,"80,751.84",00.00,"1,69,012.92",
29-Dec-25,ATM,61,00.00,"1,69,073.92",
29-Dec-25,Reversal,00.00,"21,134.24","1,47,939.68",
29-Dec-25,IMPS,45.47,00.00,"1,47,985.15",
29-Dec-25,Bill,"65,594.20",00.00,"2,13,579.35",
29-Dec-25,NEFT,00.00,"35,596.56","1,77,982.79",
29-Dec-25,Debit Card,"1,453.00",00.00,"1,79,435.79",
29-Dec-25,Purchase,"20,41,153.00",00.00,"22,20,588.79",
29-Dec-25,Debit Card,21.94,00.00,"22,20,610.73",
29-Dec-25,Tax,00.00,"7,40,203.58","14,80,407.15",
29-Dec-25,Interest,"30,996.90",00.00,"15,11,404.05",
29-Dec-25,Cheque,00.00,"1,67,933.78","13,43,470.27",
29-Dec-25,IMPS,00.00,"4,47,823.42","8,95,646.85",
30-Dec-25,Purchase,145.28,00.00,"8,95,792.13",
30-Dec-25,RTGS,00.00,"89,579.21","8,06,212.92",
30-Dec-25,Purchase,07.00,00.00,"8,06,219.92",
30-Dec-25,Transportellaneous,"2,052.27",00.00,"8,08,272.19",
30-Dec-25,IMPS,299.49,00.00,"8,08,571.68",
30-Dec-25,Cash,01.90,00.00,"8,08,573.58",
30-Dec-25,Interest,00.00,"80,857.36","7,27,716.22",
31-Dec-25,Commission,459.59,00.00,"7,28,175.81",
31-Dec-25,Bill,"13,04,739.50",00.00,"20,32,915.31",
31-Dec-25,RTGS,07.80,00.00,"20,32,923.11",
31-Dec-25,ATM,26.51,00.00,"20,32,949.62",
31-Dec-25,IMPS,07.00,00.00,"20,32,956.62",
31-Dec-25,ATM,00.00,"2,90,422.37","17,42,534.25",
31-Dec-25,Cheque,"24,730.10",00.00,"17,67,264.35",
31-Dec-25,Bill,"20,339.90",00.00,"17,87,604.25",
31-Dec-25,Cheque,00.00,"8,93,802.13","8,93,802.12",
31-Dec-25,Transfer,00.00,"2,97,934.04","5,95,868.08",
31-Dec-25,Debit Card,00.00,"1,98,622.69","3,97,245.39",
31-Dec-25,IMPS,"20,18,147.00",00.00,"24,15,392.39",
31-Dec-25,Transfer,"15,39,990.75",00.00,"39,55,383.14",
31-Dec-25,IMPS,00.00,"3,95,538.31","35,59,844.83",
31-Dec-25,ATM,451.43,00.00,"35,60,296.26",
31-Dec-25,Transfer,"18,26,670.00",00.00,"53,86,966.26",
31-Dec-25,IMPS,00.87,00.00,"53,86,967.13",
31-Dec-25,Purchase,00.00,"26,93,483.57","26,93,483.56",
31-Dec-25,RTGS,07.00,00.00,"26,93,490.56",
31-Dec-25,Transfer,00.00,"26,93,490.56",00.00,
01-Jan-26,Interest,01.70,00.00,01.70,
01-Jan-26,NEFT,"1,343.65",00.00,"1,345.35",
01-Jan-26,RTGS,00.00,448.45,896.9,
01-Jan-26,Commission,"27,297.56",00.00,"28,194.46",
01-Jan-26,Cheque,00.00,"7,048.62","21,145.84",
01-Jan-26,ATM,"28,103.60",00.00,"49,249.44",
01-Jan-26,Interest,59,00.00,"49,308.44",
01-Jan-26,Bill,01.90,00.00,"49,310.34",
01-Jan-26,Interest,00.00,"7,044.33","42,266.01",
01-Jan-26,Purchase,491.3,00.00,"42,757.31",
01-Jan-26,Reversal,48.93,00.00,"42,806.24",
01-Jan-26,Transportellaneous,59.19,00.00,"42,865.43",
01-Jan-26,Debit Card,00.00,"8,573.09","34,292.34",
01-Jan-26,IMPS,00.00,"34,292.34",00.00,
01-Jan-26,Purchase,96,00.00,96,
01-Jan-26,Commission,00.00,19.2,76.8,
01-Jan-26,Cash,00.00,25.6,51.2,
01-Jan-26,ATM,00.00,25.6,25.6,
01-Jan-26,Bill,00.00,04.27,21.33,
01-Jan-26,Bill,"26,679.00",00.00,"26,700.33",
01-Jan-26,Purchase,04.00,00.00,"26,704.33",
01-Jan-26,Purchase,00.00,"3,814.90","22,889.43",
01-Jan-26,Interest,694.5,00.00,"23,583.93",
01-Jan-26,IMPS,00.00,"2,358.39","21,225.54",
01-Jan-26,IMPS,00.00,"3,032.22","18,193.32",
01-Jan-26,IMPS,00.00,"3,032.22","15,161.10",
01-Jan-26,Cheque,00.00,"1,516.11","13,644.99",
01-Jan-26,IMPS,00.00,"2,729.00","10,915.99",
01-Jan-26,RTGS,"12,52,353.80",00.00,"12,63,269.79",
01-Jan-26,RTGS,00.00,"12,63,269.79",00.00,
01-Jan-26,Cash,"20,35,879.00",00.00,"20,35,879.00",
01-Jan-26,RTGS,228.8,00.00,"20,36,107.80",
01-Jan-26,Cash,"26,099.82",00.00,"20,62,207.62",
02-Jan-26,IMPS,"32,167.00",00.00,"20,94,374.62",
02-Jan-26,Transfer,00.00,"2,61,796.83","18,32,577.79",
02-Jan-26,Commission,00.00,"1,83,257.78","16,49,320.01",
02-Jan-26,Purchase,14,00.00,"16,49,334.01",
02-Jan-26,NEFT,00.00,"2,74,889.00","13,74,445.01",
03-Jan-26,Commission,00.00,"1,52,716.11","12,21,728.90",
03-Jan-26,IMPS,"19,036.61",00.00,"12,40,765.51",
03-Jan-26,Commission,00.00,"1,77,252.22","10,63,513.29",
04-Jan-26,Transportellaneous,"11,53,144.00",00.00,"22,16,657.29",
04-Jan-26,IMPS,"1,63,514.03",00.00,"23,80,171.32",
04-Jan-26,Cheque,00.00,"3,40,024.47","20,40,146.85",
04-Jan-26,Cash,00.00,"20,40,146.85",00.00,
04-Jan-26,ATM,08.00,00.00,08.00,
04-Jan-26,Bill,00.00,02.00,06.00,
04-Jan-26,Interest,28,00.00,34,
04-Jan-26,Reversal,241.44,00.00,275.44,
04-Jan-26,Cheque,00.00,39.35,236.09,
04-Jan-26,NEFT,00.00,26.23,209.86,
04-Jan-26,IMPS,29.3,00.00,239.16,
04-Jan-26,Cheque,"2,556.00",00.00,"2,795.16",
04-Jan-26,Commission,"87,933.00",00.00,"90,728.16",
04-Jan-26,Purchase,00.00,"45,364.08","45,364.08",
04-Jan-26,RTGS,21.1,00.00,"45,385.18",
04-Jan-26,NEFT,"30,975.00",00.00,"76,360.18",
04-Jan-26,Reversal,402,00.00,"76,762.18",
04-Jan-26,ATM,00.00,"9,595.27","67,166.91",
04-Jan-26,Transfer,"27,555.75",00.00,"94,722.66",
04-Jan-26,Transportellaneous,00.00,"18,944.53","75,778.13",
04-Jan-26,Reversal,"26,187.99",00.00,"1,01,966.12",
04-Jan-26,Interest,"1,460.12",00.00,"1,03,426.24",
04-Jan-26,Bill,00.00,"12,928.28","90,497.96",
04-Jan-26,Transportellaneous,"2,25,121.59",00.00,"3,15,619.55",
04-Jan-26,Interest,"2,39,487.31",00.00,"5,55,106.86",
05-Jan-26,Transfer,32.2,00.00,"5,55,139.06",
05-Jan-26,Transportellaneous,06.46,00.00,"5,55,145.52",
05-Jan-26,IMPS,00.00,"79,306.50","4,75,839.02",
05-Jan-26,Cash,"2,27,603.00",00.00,"7,03,442.02",
05-Jan-26,Purchase,00.00,"3,51,721.01","3,51,721.01",
05-Jan-26,RTGS,00.00,"58,620.17","2,93,100.84",
05-Jan-26,Reversal,"6,00,274.75",00.00,"8,93,375.59",
05-Jan-26,IMPS,00.00,"4,46,687.80","4,46,687.80",
05-Jan-26,Cash,"1,48,365.03",00.00,"5,95,052.83",
05-Jan-26,Transfer,00.00,"59,505.28","5,35,547.55",
05-Jan-26,ATM,205.5,00.00,"5,35,753.05",
05-Jan-26,Commission,00.00,"1,78,584.35","3,57,168.70",
05-Jan-26,RTGS,00.00,"1,78,584.35","1,78,584.35",
05-Jan-26,Commission,00.00,"19,842.71","1,58,741.64",
05-Jan-26,Bill,00.00,"26,456.94","1,32,284.70",
05-Jan-26,Bill,"1,88,292.80",00.00,"3,20,577.50",
05-Jan-26,Commission,03.47,00.00,"3,20,580.97",
05-Jan-26,RTGS,00.00,"80,145.24","2,40,435.73",
05-Jan-26,Cash,306.39,00.00,"2,40,742.12",
06-Jan-26,Purchase,08.00,00.00,"2,40,750.12",
06-Jan-26,IMPS,448.77,00.00,"2,41,198.89",
06-Jan-26,IMPS,"23,092.00",00.00,"2,64,290.89",
06-Jan-26,Tax,00.00,"88,096.96","1,76,193.93",
06-Jan-26,Interest,00.00,"44,048.48","1,32,145.45",
06-Jan-26,RTGS,215.35,00.00,"1,32,360.80",
06-Jan-26,Reversal,00.00,"18,908.69","1,13,452.11",
06-Jan-26,IMPS,00.00,"22,690.42","90,761.69",
06-Jan-26,Cash,16.8,00.00,"90,778.49",
06-Jan-26,NEFT,"2,08,122.91",00.00,"2,98,901.40",
06-Jan-26,ATM,"27,730.52",00.00,"3,26,631.92",
07-Jan-26,Transfer,00.00,"1,63,315.96","1,63,315.96",
07-Jan-26,Cheque,"3,579.00",00.00,"1,66,894.96",
07-Jan-26,NEFT,"1,24,826.20",00.00,"2,91,721.16",
07-Jan-26,Commission,02.00,00.00,"2,91,723.16",
07-Jan-26,Cash,"1,17,015.00",00.00,"4,08,738.16",
07-Jan-26,Cash,285,00.00,"4,09,023.16",
07-Jan-26,Bill,"3,069.00",00.00,"4,12,092.16",
07-Jan-26,Commission,587.36,00.00,"4,12,679.52",
07-Jan-26,Interest,00.00,"1,03,169.88","3,09,509.64",
07-Jan-26,Cash,"99,109.10",00.00,"4,08,618.74",
07-Jan-26,Transfer,00.00,"1,02,154.69","3,06,464.06",
07-Jan-26,Cash,"17,457.53",00.00,"3,23,921.59",
07-Jan-26,IMPS,"8,055.00",00.00,"3,31,976.59",
07-Jan-26,Transportellaneous,00.00,"47,425.23","2,84,551.36",
07-Jan-26,Reversal,25.05,00.00,"2,84,576.41",
07-Jan-26,Tax,00.00,"94,858.80","1,89,717.61",
07-Jan-26,ATM,00.00,"63,239.20","1,26,478.41",
07-Jan-26,Purchase,917,00.00,"1,27,395.41",
07-Jan-26,Transportellaneous,00.00,"1,27,395.41",00.00,
08-Jan-26,Commission,"25,099.00",00.00,"25,099.00",
08-Jan-26,IMPS,415.3,00.00,"25,514.30",
08-Jan-26,RTGS,00.00,"6,378.58","19,135.72",
08-Jan-26,Reversal,"1,975.00",00.00,"21,110.72",
08-Jan-26,Interest,"28,619.00",00.00,"49,729.72",
08-Jan-26,Debit Card,00.00,"12,432.43","37,297.29",
08-Jan-26,Tax,00.00,"37,297.29",00.00,
08-Jan-26,Purchase,269.1,00.00,269.1,
08-Jan-26,Purchase,"3,645.00",00.00,"3,914.10",
08-Jan-26,RTGS,00.00,978.53,"2,935.58",
08-Jan-26,Reversal,"3,33,231.50",00.00,"3,36,167.08",
08-Jan-26,Interest,136,00.00,"3,36,303.08",
08-Jan-26,Cheque,00.00,"84,075.77","2,52,227.31",
08-Jan-26,Cash,"13,245.00",00.00,"2,65,472.31",
08-Jan-26,NEFT,"20,066.66",00.00,"2,85,538.97",
08-Jan-26,Purchase,00.00,"57,107.79","2,28,431.18",
08-Jan-26,NEFT,00.67,00.00,"2,28,431.85",
08-Jan-26,IMPS,00.00,"76,143.95","1,52,287.90",
08-Jan-26,Cheque,"1,503.64",00.00,"1,53,791.54",
08-Jan-26,Interest,00.00,"38,447.89","1,15,343.66",
08-Jan-26,Transfer,"20,147.00",00.00,"1,35,490.66",
08-Jan-26,Cheque,00.00,"19,355.81","1,16,134.85",
08-Jan-26,Reversal,"30,384.06",00.00,"1,46,518.91",
08-Jan-26,Interest,"2,864.80",00.00,"1,49,383.71",
08-Jan-26,Cheque,00.80,00.00,"1,49,384.51",
08-Jan-26,Tax,00.00,"37,346.13","1,12,038.38",
08-Jan-26,Cash,00.00,"14,004.80","98,033.58",
08-Jan-26,Purchase,"17,04,507.00",00.00,"18,02,540.58",
08-Jan-26,Debit Card,00.00,"3,00,423.43","15,02,117.15",
08-Jan-26,Bill,132.3,00.00,"15,02,249.45",
08-Jan-26,Bill,00.00,"1,66,916.61","13,35,332.84",
08-Jan-26,RTGS,"1,06,288.00",00.00,"14,41,620.84",
08-Jan-26,Cheque,37.76,00.00,"14,41,658.60",
08-Jan-26,RTGS,00.00,"2,88,331.72","11,53,326.88",
08-Jan-26,RTGS,"79,294.20",00.00,"12,32,621.08",
08-Jan-26,Reversal,00.00,"3,08,155.27","9,24,465.81",
08-Jan-26,Cash,00.00,"1,54,077.64","7,70,388.18",
08-Jan-26,Purchase,"29,744.20",00.00,"8,00,132.38",
08-Jan-26,Cash,00.00,"1,33,355.40","6,66,776.98",
08-Jan-26,ATM,00.00,"66,677.70","6,00,099.28",
08-Jan-26,Commission,00.00,"1,20,019.86","4,80,079.42",
08-Jan-26,Cheque,00.00,"53,342.16","4,26,737.26",
08-Jan-26,Transportellaneous,00.00,"1,42,245.75","2,84,491.51",
08-Jan-26,Reversal,00.00,"31,610.17","2,52,881.34",
08-Jan-26,Commission,702.2,00.00,"2,53,583.54",
08-Jan-26,Reversal,00.00,"63,395.89","1,90,187.66",
09-Jan-26,Reversal,00.00,"21,131.96","1,69,055.70",
09-Jan-26,Purchase,63.32,00.00,"1,69,119.02",
09-Jan-26,Cheque,00.00,"16,911.90","1,52,207.12",
09-Jan-26,Transportellaneous,483,00.00,"1,52,690.12",
09-Jan-26,Transfer,"1,04,094.00",00.00,"2,56,784.12",
09-Jan-26,Commission,00.00,"36,683.45","2,20,100.67",
09-Jan-26,Commission,00.00,"1,10,050.34","1,10,050.34",
09-Jan-26,Interest,00.00,"13,756.29","96,294.05",
09-Jan-26,Bill,00.00,"96,294.05",00.00,
09-Jan-26,RTGS,"8,19,248.00",00.00,"8,19,248.00",
09-Jan-26,Interest,"13,704.30",00.00,"8,32,952.30",
09-Jan-26,Commission,"1,17,757.72",00.00,"9,50,710.02",
10-Jan-26,Reversal,29.44,00.00,"9,50,739.46",
10-Jan-26,NEFT,00.00,"4,75,369.73","4,75,369.73",
10-Jan-26,Transportellaneous,00.00,"79,228.29","3,96,141.44",
10-Jan-26,Cash,00.00,"99,035.36","2,97,106.08",
10-Jan-26,Purchase,00.00,"59,421.22","2,37,684.86",
10-Jan-26,ATM,"1,217.04",00.00,"2,38,901.90",
10-Jan-26,Transfer,273.63,00.00,"2,39,175.53",
10-Jan-26,Interest,00.00,"59,793.88","1,79,381.65",
10-Jan-26,Debit Card,00.00,"35,876.33","1,43,505.32",
10-Jan-26,Cheque,00.00,"47,835.11","95,670.21",
10-Jan-26,Cheque,"12,42,739.00",00.00,"13,38,409.21",
10-Jan-26,Bill,00.00,"1,48,712.13","11,89,697.08",
10-Jan-26,Commission,00.00,"1,69,956.73","10,19,740.35",
10-Jan-26,Debit Card,00.76,00.00,"10,19,741.11",
10-Jan-26,Purchase,00.00,"3,39,913.70","6,79,827.41",
10-Jan-26,Transportellaneous,"1,93,327.22",00.00,"8,73,154.63",
10-Jan-26,Purchase,00.00,"2,91,051.54","5,82,103.09",
10-Jan-26,IMPS,58.7,00.00,"5,82,161.79",
10-Jan-26,IMPS,00.00,"58,216.18","5,23,945.61",
11-Jan-26,ATM,432.2,00.00,"5,24,377.81",
11-Jan-26,Commission,03.40,00.00,"5,24,381.21",
11-Jan-26,Cheque,"13,846.00",00.00,"5,38,227.21",
11-Jan-26,Reversal,00.00,"76,889.60","4,61,337.61",
11-Jan-26,Transfer,00.00,"2,30,668.81","2,30,668.80",
11-Jan-26,Cheque,00.00,"57,667.20","1,73,001.60",
11-Jan-26,Cash,"12,699.00",00.00,"1,85,700.60",
11-Jan-26,Cheque,"10,337.00",00.00,"1,96,037.60",
11-Jan-26,Cash,00.00,"32,672.93","1,63,364.67",
11-Jan-26,NEFT,"20,74,160.50",00.00,"22,37,525.17",
11-Jan-26,Reversal,00.00,"11,18,762.59","11,18,762.58",
11-Jan-26,Debit Card,00.00,"3,72,920.86","7,45,841.72",
11-Jan-26,Bill,02.47,00.00,"7,45,844.19",
12-Jan-26,ATM,00.00,"1,49,168.84","5,96,675.35",
12-Jan-26,Interest,00.00,"2,98,337.68","2,98,337.68",
12-Jan-26,Reversal,50.46,00.00,"2,98,388.14",
13-Jan-26,RTGS,00.00,"74,597.04","2,23,791.10",
13-Jan-26,Cheque,00.00,"31,970.16","1,91,820.94",
13-Jan-26,Interest,00.00,"38,364.19","1,53,456.75",
13-Jan-26,Cash,"22,251.50",00.00,"1,75,708.25",
13-Jan-26,Commission,00.00,"87,854.13","87,854.12",
13-Jan-26,NEFT,00.00,"14,642.35","73,211.77",
13-Jan-26,NEFT,37,00.00,"73,248.77",
13-Jan-26,Bill,00.00,"10,464.11","62,784.66",
13-Jan-26,Cheque,00.00,"7,848.08","54,936.58",
13-Jan-26,RTGS,00.00,"54,936.58",00.00,
13-Jan-26,Debit Card,44,00.00,44,
13-Jan-26,IMPS,00.00,04.89,39.11,
13-Jan-26,Commission,00.00,04.89,34.22,
13-Jan-26,ATM,"31,383.00",00.00,"31,417.22",
13-Jan-26,Transfer,"2,008.86",00.00,"33,426.08",
13-Jan-26,IMPS,00.00,"6,685.22","26,740.86",
13-Jan-26,Debit Card,269,00.00,"27,009.86",
14-Jan-26,Interest,00.00,"2,700.99","24,308.87",
14-Jan-26,Commission,00.00,"4,051.48","20,257.39",
14-Jan-26,Purchase,"2,45,321.50",00.00,"2,65,578.89",
14-Jan-26,ATM,"1,86,530.97",00.00,"4,52,109.86",
14-Jan-26,Transfer,00.00,00.00,"4,52,109.86",
14-Jan-26,IMPS,00.00,"90,421.97","3,61,687.89",
14-Jan-26,RTGS,07.40,00.00,"3,61,695.29",
14-Jan-26,Commission,00.00,"40,188.37","3,21,506.92",
14-Jan-26,Bill,00.00,"45,929.56","2,75,577.36",
14-Jan-26,Tax,00.00,"34,447.17","2,41,130.19",
14-Jan-26,Transfer,00.00,"60,282.55","1,80,847.64",
15-Jan-26,Interest,00.00,"25,835.38","1,55,012.26",
15-Jan-26,Transfer,35.15,00.00,"1,55,047.41",
16-Jan-26,Commission,"2,610.50",00.00,"1,57,657.91",
16-Jan-26,Bill,00.00,"78,828.96","78,828.96",
16-Jan-26,Cash,07.00,00.00,"78,835.96",
17-Jan-26,Cheque,00.00,"26,278.65","52,557.31",
17-Jan-26,Transportellaneous,328.7,00.00,"52,886.01",
17-Jan-26,Transfer,00.00,"6,610.75","46,275.26",
17-Jan-26,Cash,00.00,"7,712.54","38,562.72",
17-Jan-26,Tax,00.00,"7,712.54","30,850.18",
17-Jan-26,ATM,"16,337.00",00.00,"47,187.18",
17-Jan-26,Bill,03.90,00.00,"47,191.08",
17-Jan-26,Tax,"14,593.00",00.00,"61,784.08",
17-Jan-26,ATM,00.00,"10,297.35","51,486.73",
17-Jan-26,Transfer,254.7,00.00,"51,741.43",
17-Jan-26,Transfer,07.17,00.00,"51,748.60",
17-Jan-26,Cash,"21,391.00",00.00,"73,139.60",
17-Jan-26,Reversal,381.53,00.00,"73,521.13",
17-Jan-26,Bill,04.00,00.00,"73,525.13",
17-Jan-26,Purchase,202,00.00,"73,727.13",
17-Jan-26,Cash,11.43,00.00,"73,738.56",
17-Jan-26,Cash,00.00,"18,434.64","55,303.92",
17-Jan-26,Bill,00.00,"5,530.39","49,773.53",
17-Jan-26,Interest,"1,40,772.00",00.00,"1,90,545.53",
17-Jan-26,IMPS,02.57,00.00,"1,90,548.10",
17-Jan-26,Bill,53.1,00.00,"1,90,601.20",
17-Jan-26,Cash,00.00,"38,120.24","1,52,480.96",
17-Jan-26,Commission,00.00,"21,782.99","1,30,697.97",
17-Jan-26,Interest,00.00,"43,565.99","87,131.98",
17-Jan-26,RTGS,00.00,"10,891.50","76,240.48",
17-Jan-26,Interest,00.00,"7,624.05","68,616.43",
17-Jan-26,Debit Card,03.73,00.00,"68,620.16",
17-Jan-26,Transfer,"6,10,101.75",00.00,"6,78,721.91",
17-Jan-26,Debit Card,00.00,"1,35,744.38","5,42,977.53",
17-Jan-26,Debit Card,00.00,"1,80,992.51","3,61,985.02",
17-Jan-26,Transportellaneous,03.37,00.00,"3,61,988.39",
17-Jan-26,Debit Card,437.85,00.00,"3,62,426.24",
17-Jan-26,Debit Card,03.00,00.00,"3,62,429.24",
17-Jan-26,RTGS,04.80,00.00,"3,62,434.04",
17-Jan-26,Purchase,36,00.00,"3,62,470.04",
17-Jan-26,NEFT,"10,71,291.75",00.00,"14,33,761.79",
17-Jan-26,Cheque,56.59,00.00,"14,33,818.38",
17-Jan-26,Bill,00.00,"4,77,939.46","9,55,878.92",
17-Jan-26,Reversal,07.01,00.00,"9,55,885.93",
17-Jan-26,Debit Card,44.6,00.00,"9,55,930.53",
17-Jan-26,Interest,00.00,"95,593.05","8,60,337.48",
17-Jan-26,Cash,17,00.00,"8,60,354.48",
17-Jan-26,NEFT,00.00,"1,07,544.31","7,52,810.17",
17-Jan-26,Purchase,"3,78,050.00",00.00,"11,30,860.17",
17-Jan-26,Debit Card,00.00,"2,26,172.03","9,04,688.14",
17-Jan-26,Reversal,258.84,00.00,"9,04,946.98",
17-Jan-26,Tax,306.73,00.00,"9,05,253.71",
17-Jan-26,Interest,"11,66,773.00",00.00,"20,72,026.71",
17-Jan-26,Bill,00.00,"6,90,675.57","13,81,351.14",
17-Jan-26,Debit Card,00.00,"2,30,225.19","11,51,125.95",
17-Jan-26,ATM,00.00,"3,83,708.65","7,67,417.30",
18-Jan-26,ATM,06.00,00.00,"7,67,423.30",
18-Jan-26,RTGS,00.00,"1,27,903.88","6,39,519.42",
19-Jan-26,NEFT,"3,75,693.25",00.00,"10,15,212.67",
19-Jan-26,Interest,00.00,"2,53,803.17","7,61,409.50",
19-Jan-26,Transportellaneous,"1,33,167.00",00.00,"8,94,576.50",
19-Jan-26,RTGS,"88,888.50",00.00,"9,83,465.00",
19-Jan-26,Tax,"1,27,314.00",00.00,"11,10,779.00",
19-Jan-26,NEFT,00.00,"2,77,694.75","8,33,084.25",
19-Jan-26,Cheque,00.00,"83,308.43","7,49,775.82",
19-Jan-26,NEFT,00.00,"83,308.42","6,66,467.40",
19-Jan-26,RTGS,00.00,"74,051.93","5,92,415.47",
19-Jan-26,Bill,00.00,"1,97,471.82","3,94,943.65",
19-Jan-26,NEFT,448.5,00.00,"3,95,392.15",
19-Jan-26,Debit Card,"1,90,738.00",00.00,"5,86,130.15",
19-Jan-26,ATM,04.00,00.00,"5,86,134.15",
19-Jan-26,Tax,00.00,"65,126.02","5,21,008.13",
19-Jan-26,ATM,40.19,00.00,"5,21,048.32",
19-Jan-26,Debit Card,"17,114.60",00.00,"5,38,162.92",
19-Jan-26,ATM,787.67,00.00,"5,38,950.59",
19-Jan-26,ATM,36,00.00,"5,38,986.59",
19-Jan-26,NEFT,00.00,"1,79,662.20","3,59,324.39",
19-Jan-26,Reversal,00.00,"39,924.93","3,19,399.46",
19-Jan-26,Debit Card,"2,996.43",00.00,"3,22,395.89",
19-Jan-26,Transportellaneous,281,00.00,"3,22,676.89",
19-Jan-26,Reversal,"2,871.40",00.00,"3,25,548.29",
19-Jan-26,Reversal,"14,00,256.00",00.00,"17,25,804.29",
19-Jan-26,Purchase,20,00.00,"17,25,824.29",
19-Jan-26,Purchase,00.00,"2,15,728.04","15,10,096.25",
19-Jan-26,Reversal,03.00,00.00,"15,10,099.25",
19-Jan-26,Cheque,"1,01,847.00",00.00,"16,11,946.25",
19-Jan-26,ATM,"3,615.04",00.00,"16,15,561.29",
19-Jan-26,Commission,"2,928.40",00.00,"16,18,489.69",
19-Jan-26,RTGS,00.00,"2,02,311.21","14,16,178.48",
19-Jan-26,RTGS,00.00,"1,77,022.31","12,39,156.17",
19-Jan-26,Commission,00.00,"2,47,831.23","9,91,324.94",
19-Jan-26,Cheque,"15,60,511.00",00.00,"25,51,835.94",
19-Jan-26,ATM,"15,398.00",00.00,"25,67,233.94",
19-Jan-26,Cash,00.00,"6,41,808.49","19,25,425.46",
19-Jan-26,IMPS,05.90,00.00,"19,25,431.36",
19-Jan-26,Debit Card,"23,889.16",00.00,"19,49,320.52",
19-Jan-26,Commission,"1,200.70",00.00,"19,50,521.22",
19-Jan-26,NEFT,00.00,"2,78,645.89","16,71,875.33",
19-Jan-26,Bill,00.00,"16,71,875.33",00.00,
19-Jan-26,Cash,03.84,00.00,03.84,
19-Jan-26,Bill,"24,423.00",00.00,"24,426.84",
19-Jan-26,Commission,00.00,"24,426.84",00.00,
19-Jan-26,Interest,"26,644.22",00.00,"26,644.22",
19-Jan-26,IMPS,"8,505.00",00.00,"35,149.22",
19-Jan-26,Transfer,00.00,"5,021.32","30,127.90",
19-Jan-26,Interest,"3,30,242.00",00.00,"3,60,369.90",
19-Jan-26,Interest,"31,475.77",00.00,"3,91,845.67",
19-Jan-26,NEFT,"1,165.80",00.00,"3,93,011.47",
19-Jan-26,Commission,00.00,"43,667.94","3,49,343.53",
19-Jan-26,IMPS,01.50,00.00,"3,49,345.03",
19-Jan-26,Transportellaneous,"13,85,332.00",00.00,"17,34,677.03",
19-Jan-26,Interest,"7,355.00",00.00,"17,42,032.03",
19-Jan-26,Debit Card,"32,734.20",00.00,"17,74,766.23",
19-Jan-26,Commission,"12,72,600.00",00.00,"30,47,366.23",
19-Jan-26,IMPS,00.00,"15,23,683.12","15,23,683.12",
19-Jan-26,Transportellaneous,00.00,"1,90,460.39","13,33,222.73",
19-Jan-26,Bill,00.00,"2,66,644.55","10,66,578.18",
19-Jan-26,Bill,"1,50,818.30",00.00,"12,17,396.48",
19-Jan-26,RTGS,02.00,00.00,"12,17,398.48",
19-Jan-26,Debit Card,00.00,"1,52,174.81","10,65,223.67",
19-Jan-26,Reversal,00.00,"10,65,223.67",00.00,
19-Jan-26,IMPS,"9,61,198.00",00.00,"9,61,198.00",
19-Jan-26,Tax,07.20,00.00,"9,61,205.20",
19-Jan-26,Bill,00.00,"1,60,200.87","8,01,004.33",
19-Jan-26,ATM,"2,20,981.00",00.00,"10,21,985.33",
19-Jan-26,Cheque,"1,326.00",00.00,"10,23,311.33",
19-Jan-26,RTGS,00.00,"1,70,551.89","8,52,759.44",
19-Jan-26,Purchase,00.00,"2,13,189.86","6,39,569.58",
19-Jan-26,Transportellaneous,00.00,"3,19,784.79","3,19,784.79",
19-Jan-26,Interest,00.00,"63,956.96","2,55,827.83",
19-Jan-26,NEFT,364,00.00,"2,56,191.83",
19-Jan-26,Transfer,"26,009.20",00.00,"2,82,201.03",
19-Jan-26,Transportellaneous,00.00,"94,067.01","1,88,134.02",
19-Jan-26,Commission,00.00,"23,516.75","1,64,617.27",
19-Jan-26,Transportellaneous,04.60,00.00,"1,64,621.87",
19-Jan-26,Debit Card,00.00,"23,517.41","1,41,104.46",
19-Jan-26,NEFT,00.00,"28,220.89","1,12,883.57",
19-Jan-26,Bill,00.00,"18,813.93","94,069.64",
19-Jan-26,Cheque,22,00.00,"94,091.64",
19-Jan-26,Transportellaneous,412.09,00.00,"94,503.73",
19-Jan-26,RTGS,"5,506.90",00.00,"1,00,010.63",
19-Jan-26,Transportellaneous,00.00,"16,668.44","83,342.19",
19-Jan-26,Purchase,00.00,"10,417.77","72,924.42",
19-Jan-26,Cash,275,00.00,"73,199.42",
19-Jan-26,ATM,"88,074.00",00.00,"1,61,273.42",
19-Jan-26,Bill,00.00,"16,127.34","1,45,146.08",
19-Jan-26,Cheque,00.00,"16,127.34","1,29,018.74",
19-Jan-26,RTGS,"26,215.00",00.00,"1,55,233.74",
20-Jan-26,Tax,00.00,"25,872.29","1,29,361.45",
20-Jan-26,Commission,00.00,"21,560.24","1,07,801.21",
20-Jan-26,Commission,00.00,"11,977.91","95,823.30",
20-Jan-26,Cheque,00.00,"47,911.65","47,911.65",
20-Jan-26,NEFT,03.50,00.00,"47,915.15",
20-Jan-26,Commission,01.96,00.00,"47,917.11",
20-Jan-26,Bill,00.00,"11,979.28","35,937.83",
20-Jan-26,Transfer,00.00,"7,187.57","28,750.26",
20-Jan-26,Interest,00.00,"7,187.57","21,562.70",
20-Jan-26,ATM,00.00,"2,695.34","18,867.36",
20-Jan-26,Interest,00.00,"3,144.56","15,722.80",
20-Jan-26,ATM,00.00,"15,722.80",00.00,
20-Jan-26,Debit Card,"10,318.34",00.00,"10,318.34",
20-Jan-26,Purchase,"16,963.44",00.00,"27,281.78",
20-Jan-26,NEFT,00.00,"4,546.96","22,734.82",
20-Jan-26,ATM,61.7,00.00,"22,796.52",
20-Jan-26,Transfer,00.00,"22,796.52",00.00,
20-Jan-26,Transportellaneous,"2,762.00",00.00,"2,762.00",
20-Jan-26,Purchase,00.00,"1,381.00","1,381.00",
20-Jan-26,Reversal,00.00,172.63,"1,208.38",
20-Jan-26,Reversal,00.00,172.63,"1,035.75",
20-Jan-26,Cash,00.00,207.15,828.6,
20-Jan-26,Reversal,00.00,828.6,00.00,
20-Jan-26,Commission,"2,27,819.40",00.00,"2,27,819.40",
20-Jan-26,Cheque,00.00,"2,27,819.40",00.00,
20-Jan-26,NEFT,"2,10,862.00",00.00,"2,10,862.00",
20-Jan-26,Tax,00.00,"23,429.11","1,87,432.89",
20-Jan-26,Tax,00.00,"62,477.63","1,24,955.26",
20-Jan-26,Interest,00.00,"20,825.88","1,04,129.38",
20-Jan-26,Cheque,00.00,"17,354.90","86,774.48",
20-Jan-26,RTGS,495.1,00.00,"87,269.58",
20-Jan-26,Transfer,00.00,"10,908.70","76,360.88",
20-Jan-26,Reversal,00.00,"19,090.22","57,270.66",
20-Jan-26,Bill,00.00,"57,270.66",00.00,
20-Jan-26,Reversal,270.8,00.00,270.8,
21-Jan-26,IMPS,00.00,38.69,232.11,